league,season,team,player,nation,pos,age,born,90s,Tackles_Tkl,Tackles_TklW,Tackles_Def 3rd,Tackles_Mid 3rd,Tackles_Att 3rd,Challenges_Tkl,Challenges_Att,Challenges_Tkl%,Challenges_Lost,Blocks_Blocks,Blocks_Sh,Blocks_Pass,Int,Tkl+Int,Clr,Err,nextSeason
ENG-Premier League,2017,Arsenal,Aaron Ramsey,WAL,MF,26,1990,20.5,35,27,18,17,0,8,44,18.2,36,14,3,11,24,59,6,1,2018
ENG-Premier League,2017,Arsenal,Ainsley Maitland-Niles,ENG,"DF,MF",19,1997,10.2,25,17,12,7,6,14,31,45.2,17,15,1,14,12,37,35,2,2018
ENG-Premier League,2017,Arsenal,Alex Iwobi,NGA,"MF,FW",21,1996,20.3,19,15,8,8,3,5,18,27.8,13,19,1,18,7,26,10,1,2018
ENG-Premier League,2017,Arsenal,Alex Oxlade-Chamberlain,ENG,DF,23,1993,2.7,5,3,2,2,1,2,3,66.7,1,5,2,3,6,11,8,0,2018
ENG-Premier League,2017,Arsenal,Alexandre Lacazette,FRA,FW,26,1991,24.5,24,17,6,11,7,4,27,14.8,23,19,3,16,7,31,5,0,2018
ENG-Premier League,2017,Arsenal,Alexis Sánchez,CHI,"MF,FW",28,1988,16.7,20,9,9,4,7,7,32,21.9,25,5,2,3,6,26,1,0,2018
ENG-Premier League,2017,Arsenal,Calum Chambers,ENG,DF,22,1995,9.6,17,10,10,6,1,5,14,35.7,9,14,11,3,18,35,47,0,2018
ENG-Premier League,2017,Arsenal,Danny Welbeck,ENG,"FW,MF",26,1990,13.3,20,13,9,5,6,4,12,33.3,8,22,1,21,11,31,13,0,2018
ENG-Premier League,2017,Arsenal,David Ospina,COL,GK,28,1988,4.2,0,0,0,0,0,0,0,,0,0,0,0,0,0,1,0,2018
ENG-Premier League,2017,Arsenal,Eddie Nketiah,ENG,FW,18,1999,0.2,1,1,0,1,0,0,0,,0,0,0,0,0,1,0,0,2018
ENG-Premier League,2017,Arsenal,Francis Coquelin,FRA,"MF,DF",26,1991,1.9,5,4,2,3,0,1,3,33.3,2,1,0,1,3,8,2,0,2018
ENG-Premier League,2017,Arsenal,Granit Xhaka,SUI,MF,24,1992,36.2,78,57,35,40,3,26,69,37.7,43,30,9,21,37,115,68,4,2018
ENG-Premier League,2017,Arsenal,Henrikh Mkhitaryan,ARM,"FW,MF",28,1989,8.8,18,13,9,7,2,5,21,23.8,16,16,2,14,8,26,7,0,2018
ENG-Premier League,2017,Arsenal,Héctor Bellerín,ESP,DF,22,1995,33.9,57,43,36,12,9,25,52,48.1,27,42,8,34,23,80,89,4,2018
ENG-Premier League,2017,Arsenal,Jack Wilshere,ENG,MF,25,1992,13.3,15,10,3,7,5,4,20,20.0,16,10,2,8,8,23,5,0,2018
ENG-Premier League,2017,Arsenal,Joe Willock,ENG,MF,17,1999,0.9,4,2,4,0,0,1,1,100.0,0,3,0,3,1,5,2,0,2018
ENG-Premier League,2017,Arsenal,Konstantinos Mavropanos,GRE,DF,19,1997,2.2,1,1,1,0,0,1,2,50.0,1,4,3,1,6,7,11,1,2018
ENG-Premier League,2017,Arsenal,Laurent Koscielny,FRA,DF,31,1985,24.7,43,21,27,12,4,19,33,57.6,14,28,15,13,54,97,138,3,2018
ENG-Premier League,2017,Arsenal,Mesut Özil,GER,"MF,FW",28,1988,24.0,20,13,6,10,4,5,22,22.7,17,11,1,10,12,32,9,0,2018
ENG-Premier League,2017,Arsenal,Mohamed Elneny,EGY,MF,25,1992,9.6,12,6,6,3,3,6,10,60.0,4,11,0,11,10,22,12,2,2018
ENG-Premier League,2017,Arsenal,Nacho Monreal,ESP,DF,31,1986,24.9,54,32,19,29,6,21,48,43.8,27,26,7,19,56,110,83,2,2018
ENG-Premier League,2017,Arsenal,Olivier Giroud,FRA,FW,30,1986,4.3,5,4,1,2,2,1,5,20.0,4,1,0,1,1,6,4,0,2018
ENG-Premier League,2017,Arsenal,Per Mertesacker,GER,DF,32,1984,4.1,2,2,0,2,0,0,1,0.0,1,4,3,1,6,8,22,2,2018
ENG-Premier League,2017,Arsenal,Petr Čech,CZE,GK,35,1982,33.8,1,1,1,0,0,1,1,100.0,0,0,0,0,0,1,23,7,2018
ENG-Premier League,2017,Arsenal,Pierre-Emerick Aubameyang,GAB,FW,28,1989,11.7,5,4,3,2,0,1,7,14.3,6,14,1,13,3,8,7,0,2018
ENG-Premier League,2017,Arsenal,Reiss Nelson,ENG,"FW,MF",17,1999,1.6,4,3,1,1,2,0,0,,0,4,0,4,3,7,0,0,2018
ENG-Premier League,2017,Arsenal,Rob Holding,ENG,DF,21,1995,9.1,19,14,13,5,1,4,12,33.3,8,16,10,6,21,40,40,2,2018
ENG-Premier League,2017,Arsenal,Sead Kolašinac,BIH,DF,24,1993,23.9,49,37,28,13,8,20,39,51.3,19,15,3,12,26,75,56,0,2018
ENG-Premier League,2017,Arsenal,Shkodran Mustafi,GER,DF,25,1992,25.3,64,46,42,18,4,28,54,51.9,26,23,15,8,57,121,175,2,2018
ENG-Premier League,2017,Arsenal,Theo Walcott,ENG,"FW,MF",28,1989,0.8,1,0,1,0,0,0,0,,0,0,0,0,1,2,0,0,2018
ENG-Premier League,2017,Bournemouth,Adam Smith,ENG,"DF,MF",26,1991,23.0,50,36,33,16,1,24,53,45.3,29,46,8,38,31,81,73,0,2018
ENG-Premier League,2017,Bournemouth,Andrew Surman,ENG,MF,30,1986,20.6,16,12,5,8,3,6,23,26.1,17,33,12,21,16,32,52,2,2018
ENG-Premier League,2017,Bournemouth,Asmir Begović,BIH,GK,30,1987,38.0,0,0,0,0,0,0,2,0.0,2,0,0,0,2,2,16,7,2018
ENG-Premier League,2017,Bournemouth,Benik Afobe,COD,FW,24,1993,6.8,4,3,1,2,1,1,6,16.7,5,4,0,4,0,4,6,0,2018
ENG-Premier League,2017,Bournemouth,Callum Wilson,ENG,FW,25,1992,22.0,9,5,2,6,1,1,14,7.1,13,15,3,12,3,12,15,0,2018
ENG-Premier League,2017,Bournemouth,Charlie Daniels,ENG,"DF,MF",30,1986,33.4,48,34,32,12,4,22,41,53.7,19,34,7,27,31,79,114,0,2018
ENG-Premier League,2017,Bournemouth,Dan Gosling,ENG,MF,27,1990,21.6,50,25,19,26,5,19,68,27.9,49,36,8,28,25,75,35,0,2018
ENG-Premier League,2017,Bournemouth,Emerson Hyndman,USA,MF,21,1996,0.6,0,0,0,0,0,0,1,0.0,1,2,0,2,1,1,1,0,2018
ENG-Premier League,2017,Bournemouth,Harry Arter,IRL,MF,27,1989,10.7,19,16,10,7,2,6,23,26.1,17,18,5,13,9,28,6,0,2018
ENG-Premier League,2017,Bournemouth,Jack Simpson,ENG,DF,20,1996,0.8,1,1,1,0,0,0,1,0.0,1,1,0,1,0,1,4,0,2018
ENG-Premier League,2017,Bournemouth,Jermain Defoe,ENG,FW,34,1982,12.1,12,9,2,6,4,2,10,20.0,8,10,0,10,4,16,1,0,2018
ENG-Premier League,2017,Bournemouth,Jordon Ibe,ENG,"MF,FW",21,1995,22.2,14,12,7,5,2,6,22,27.3,16,5,0,5,10,24,11,0,2018
ENG-Premier League,2017,Bournemouth,Joshua King,NOR,"FW,MF",25,1992,27.3,36,26,11,17,8,4,27,14.8,23,23,3,20,4,40,14,1,2018
ENG-Premier League,2017,Bournemouth,Junior Stanislas,ENG,"MF,FW",27,1989,14.3,16,8,8,4,4,7,15,46.7,8,21,6,15,6,22,15,0,2018
ENG-Premier League,2017,Bournemouth,Lewis Cook,ENG,MF,20,1997,24.9,67,35,37,30,0,26,69,37.7,43,33,12,21,35,102,25,2,2018
ENG-Premier League,2017,Bournemouth,Lys Mousset,FRA,"FW,MF",21,1996,6.6,9,5,6,3,0,0,8,0.0,8,5,2,3,3,12,9,0,2018
ENG-Premier League,2017,Bournemouth,Marc Pugh,ENG,"MF,FW",30,1987,10.9,7,3,2,4,1,2,10,20.0,8,6,1,5,13,20,13,2,2018
ENG-Premier League,2017,Bournemouth,Nathan Aké,NED,DF,22,1995,37.3,53,32,34,16,3,22,40,55.0,18,47,24,23,48,101,246,2,2018
ENG-Premier League,2017,Bournemouth,Ryan Fraser,SCO,"MF,DF",23,1994,22.3,11,8,7,2,2,7,20,35.0,13,20,4,16,17,28,34,0,2018
ENG-Premier League,2017,Bournemouth,Simon Francis,ENG,DF,32,1985,30.1,49,34,26,16,7,24,43,55.8,19,29,18,11,49,98,194,4,2018
ENG-Premier League,2017,Bournemouth,Steve Cook,ENG,DF,26,1991,30.7,37,19,28,7,2,19,29,65.5,10,63,45,18,54,91,232,4,2018
ENG-Premier League,2017,Bournemouth,Tyrone Mings,ENG,DF,24,1993,2.2,1,1,1,0,0,0,0,,0,2,2,0,6,7,13,1,2018
ENG-Premier League,2017,Brighton,Anthony Knockaert,FRA,"MF,FW",25,1991,26.9,39,26,25,11,3,16,55,29.1,39,29,3,26,23,62,16,0,2018
ENG-Premier League,2017,Brighton,Beram Kayal,ISR,MF,29,1988,8.3,18,11,10,7,1,6,26,23.1,20,11,4,7,12,30,9,0,2018
ENG-Premier League,2017,Brighton,Bruno,ESP,DF,36,1980,22.4,30,17,21,6,3,14,22,63.6,8,17,11,6,38,68,76,0,2018
ENG-Premier League,2017,Brighton,Connor Goldson,ENG,DF,24,1992,2.2,2,2,1,1,0,1,4,25.0,3,3,3,0,1,3,9,0,2018
ENG-Premier League,2017,Brighton,Dale Stephens,ENG,MF,28,1989,36.0,104,62,63,39,2,32,114,28.1,82,53,16,37,63,167,69,1,2018
ENG-Premier League,2017,Brighton,Davy Pröpper,NED,MF,25,1991,34.7,73,44,35,35,3,18,83,21.7,65,35,11,24,60,133,80,2,2018
ENG-Premier League,2017,Brighton,Ezequiel Schelotto,ITA,DF,28,1989,14.6,20,13,14,6,0,12,27,44.4,15,7,3,4,19,39,58,2,2018
ENG-Premier League,2017,Brighton,Gaëtan Bong,CMR,DF,29,1988,24.8,39,32,25,11,3,15,26,57.7,11,24,6,18,40,79,81,1,2018
ENG-Premier League,2017,Brighton,Glenn Murray,ENG,FW,33,1983,24.4,18,12,4,11,3,2,18,11.1,16,16,4,12,5,23,27,0,2018
ENG-Premier League,2017,Brighton,Izzy Brown,ENG,"MF,FW",20,1997,3.5,3,3,2,1,0,1,7,14.3,6,3,0,3,1,4,3,0,2018
ENG-Premier League,2017,Brighton,Jamie Murphy,SCO,MF,27,1989,1.9,2,2,2,0,0,2,4,50.0,2,0,0,0,1,3,3,0,2018
ENG-Premier League,2017,Brighton,José Izquierdo,COL,"MF,FW",25,1992,22.0,23,15,12,9,2,7,19,36.8,12,6,0,6,16,39,34,0,2018
ENG-Premier League,2017,Brighton,Jürgen Locadia,NED,"FW,MF",23,1993,2.5,1,0,0,1,0,0,1,0.0,1,0,0,0,1,2,1,1,2018
ENG-Premier League,2017,Brighton,Leonardo Ulloa,ARG,FW,31,1986,3.0,3,1,0,1,2,1,7,14.3,6,1,0,1,0,3,3,0,2018
ENG-Premier League,2017,Brighton,Lewis Dunk,ENG,DF,25,1991,38.0,67,33,49,18,0,25,48,52.1,23,73,58,15,71,138,230,2,2018
ENG-Premier League,2017,Brighton,Liam Rosenior,ENG,DF,33,1984,1.8,4,3,2,1,1,2,5,40.0,3,2,1,1,4,8,7,0,2018
ENG-Premier League,2017,Brighton,Markus Suttner,AUT,DF,30,1987,13.1,25,15,18,4,3,10,22,45.5,12,16,2,14,12,37,49,1,2018
ENG-Premier League,2017,Brighton,Mathew Ryan,AUS,GK,25,1992,38.0,0,0,0,0,0,0,3,0.0,3,0,0,0,3,3,10,3,2018
ENG-Premier League,2017,Brighton,Pascal Groß,GER,"FW,MF",26,1991,32.5,36,24,18,16,2,10,67,14.9,57,31,5,26,14,50,20,0,2018
ENG-Premier League,2017,Brighton,Sam Baldock,ENG,FW,28,1989,0.4,0,0,0,0,0,0,0,,0,0,0,0,0,0,0,0,2018
ENG-Premier League,2017,Brighton,Shane Duffy,IRL,DF,25,1992,36.6,31,19,22,9,0,7,20,35.0,13,66,59,7,50,81,332,5,2018
ENG-Premier League,2017,Brighton,Solly March,ENG,"MF,FW",23,1994,20.6,54,41,34,14,6,22,54,40.7,32,27,3,24,13,67,49,0,2018
ENG-Premier League,2017,Brighton,Tomer Hemed,ISR,FW,30,1987,9.4,7,5,3,4,0,2,10,20.0,8,10,1,9,2,9,12,0,2018
ENG-Premier League,2017,Brighton,Uwe Hünemeier,GER,DF,31,1986,0.2,0,0,0,0,0,0,0,,0,0,0,0,0,0,4,0,2018
ENG-Premier League,2017,Burnley,Aaron Lennon,ENG,MF,30,1987,12.4,20,14,5,14,1,2,20,10.0,18,20,5,15,8,28,18,0,2018
ENG-Premier League,2017,Burnley,Aiden O'Neill,AUS,MF,19,1998,0.0,,,,,,,,,,,,,,,,,2018
ENG-Premier League,2017,Burnley,Ashley Barnes,ENG,FW,27,1989,24.1,21,14,1,14,6,5,29,17.2,24,26,5,21,2,23,19,0,2018
ENG-Premier League,2017,Burnley,Ashley Westwood,ENG,MF,27,1990,12.3,13,10,10,3,0,2,16,12.5,14,17,9,8,19,32,16,0,2018
ENG-Premier League,2017,Burnley,Ben Mee,ENG,DF,27,1989,29.0,33,20,22,11,0,16,29,55.2,13,51,42,9,33,66,217,1,2018
ENG-Premier League,2017,Burnley,Charlie Taylor,ENG,DF,23,1993,10.6,16,4,9,6,1,7,12,58.3,5,13,5,8,15,31,52,0,2018
ENG-Premier League,2017,Burnley,Chris Wood,NZL,FW,25,1991,18.0,7,3,2,3,2,3,13,23.1,10,12,4,8,0,7,16,0,2018
ENG-Premier League,2017,Burnley,Georges-Kévin N'Koudou,CMR,"MF,FW",22,1995,2.5,7,6,5,1,1,3,8,37.5,5,4,0,4,1,8,1,0,2018
ENG-Premier League,2017,Burnley,Jack Cork,ENG,MF,28,1989,38.0,60,44,25,27,8,20,62,32.3,42,36,15,21,41,101,86,1,2018
ENG-Premier League,2017,Burnley,James Tarkowski,ENG,DF,24,1992,31.0,46,26,36,10,0,17,38,44.7,21,55,43,12,50,96,223,2,2018
ENG-Premier League,2017,Burnley,Jeff Hendrick,IRL,"FW,MF",25,1992,25.9,16,10,4,10,2,3,17,17.6,14,11,2,9,8,24,21,1,2018
ENG-Premier League,2017,Burnley,Jonathan Walters,IRL,FW,33,1983,0.4,0,0,0,0,0,0,0,,0,0,0,0,0,0,1,0,2018
ENG-Premier League,2017,Burnley,Jóhann Berg Guðmundsson,ISL,MF,26,1990,31.5,43,27,16,19,8,20,47,42.6,27,21,1,20,34,77,43,0,2018
ENG-Premier League,2017,Burnley,Kevin Long,IRL,DF,26,1990,16.0,32,23,28,4,0,16,26,61.5,10,25,14,11,19,51,129,1,2018
ENG-Premier League,2017,Burnley,Matthew Lowton,ENG,DF,28,1989,25.5,55,34,26,27,2,28,60,46.7,32,35,15,20,39,94,141,2,2018
ENG-Premier League,2017,Burnley,Nahki Wells,BER,"FW,MF",27,1990,0.6,4,3,0,3,1,1,1,100.0,0,2,0,2,0,4,0,0,2018
ENG-Premier League,2017,Burnley,Nick Pope,ENG,GK,25,1992,34.6,0,0,0,0,0,0,1,0.0,1,0,0,0,0,0,21,0,2018
ENG-Premier League,2017,Burnley,Phil Bardsley,SCO,DF,32,1985,12.5,17,16,9,7,1,4,11,36.4,7,22,6,16,22,39,77,0,2018
ENG-Premier League,2017,Burnley,Robbie Brady,IRL,MF,25,1992,14.2,32,21,14,17,1,8,28,28.6,20,17,3,14,7,39,29,0,2018
ENG-Premier League,2017,Burnley,Sam Vokes,WAL,FW,27,1989,11.1,3,1,1,2,0,0,3,0.0,3,6,2,4,3,6,15,0,2018
ENG-Premier League,2017,Burnley,Scott Arfield,CAN,"MF,FW",28,1988,14.8,36,26,20,13,3,19,44,43.2,25,22,1,21,11,47,24,0,2018
ENG-Premier League,2017,Burnley,Stephen Ward,IRL,DF,31,1985,27.3,39,31,27,8,4,20,42,47.6,22,27,12,15,42,81,126,0,2018
ENG-Premier League,2017,Burnley,Steven Defour,BEL,MF,29,1988,22.2,33,22,12,18,3,10,46,21.7,36,35,7,28,46,79,25,0,2018
ENG-Premier League,2017,Burnley,Tom Heaton,ENG,GK,31,1986,3.4,0,0,0,0,0,0,0,,0,0,0,0,0,0,0,0,2018
ENG-Premier League,2017,Chelsea,Andreas Christensen,DEN,DF,21,1996,23.2,26,13,23,3,0,10,15,66.7,5,25,17,8,39,65,109,5,2018
ENG-Premier League,2017,Chelsea,Antonio Rüdiger,GER,DF,24,1993,26.0,31,21,20,10,1,15,31,48.4,16,29,15,14,24,55,115,1,2018
ENG-Premier League,2017,Chelsea,Callum Hudson-Odoi,ENG,"FW,DF",16,2000,0.3,0,0,0,0,0,0,0,,0,0,0,0,0,0,0,0,2018
ENG-Premier League,2017,Chelsea,Cesc Fàbregas,ESP,MF,30,1987,25.6,68,49,30,29,9,18,69,26.1,51,25,4,21,22,90,26,2,2018
ENG-Premier League,2017,Chelsea,Charly Musonda Jr.,BEL,FW,20,1996,0.4,1,0,0,0,1,1,1,100.0,0,0,0,0,0,1,0,0,2018
ENG-Premier League,2017,Chelsea,César Azpilicueta,ESP,DF,27,1989,37.0,80,59,47,26,7,27,54,50.0,27,48,22,26,54,134,135,1,2018
ENG-Premier League,2017,Chelsea,Danny Drinkwater,ENG,MF,27,1990,5.9,15,10,6,8,1,3,17,17.6,14,10,2,8,8,23,7,0,2018
ENG-Premier League,2017,Chelsea,David Luiz,BRA,"DF,MF",30,1987,9.3,18,11,13,4,1,11,21,52.4,10,9,5,4,24,42,45,2,2018
ENG-Premier League,2017,Chelsea,Davide Zappacosta,ITA,"DF,MF",25,1992,12.2,26,11,14,9,3,11,25,44.0,14,11,2,9,6,32,26,0,2018
ENG-Premier League,2017,Chelsea,Eden Hazard,BEL,"FW,MF",26,1991,26.9,6,3,2,3,1,3,21,14.3,18,11,0,11,3,9,0,0,2018
ENG-Premier League,2017,Chelsea,Emerson Palmieri,ITA,DF,22,1994,3.1,6,4,4,2,0,5,5,100.0,0,2,0,2,2,8,10,0,2018
ENG-Premier League,2017,Chelsea,Ethan Ampadu,WAL,DF,16,2000,0.1,1,1,0,1,0,0,0,,0,0,0,0,0,1,2,0,2018
ENG-Premier League,2017,Chelsea,Gary Cahill,ENG,DF,31,1985,23.2,29,21,15,9,5,10,21,47.6,11,21,14,7,27,56,127,1,2018
ENG-Premier League,2017,Chelsea,Jeremie Boga,CIV,MF,20,1997,0.2,0,0,0,0,0,0,0,,0,0,0,0,0,0,0,0,2018
ENG-Premier League,2017,Chelsea,Marcos Alonso,ESP,"DF,MF",26,1990,31.7,51,33,30,18,3,23,44,52.3,21,36,5,31,47,98,76,1,2018
ENG-Premier League,2017,Chelsea,Michy Batshuayi,BEL,FW,23,1993,4.0,5,4,2,3,0,1,3,33.3,2,0,0,0,1,6,3,0,2018
ENG-Premier League,2017,Chelsea,N'Golo Kanté,FRA,MF,26,1991,33.3,113,77,55,52,6,33,92,35.9,59,40,4,36,85,198,29,3,2018
ENG-Premier League,2017,Chelsea,Olivier Giroud,FRA,FW,30,1986,6.8,4,3,1,2,1,1,3,33.3,2,0,0,0,1,5,5,0,2018
ENG-Premier League,2017,Chelsea,Pedro,ESP,"MF,FW",30,1987,16.9,20,11,6,8,6,5,18,27.8,13,13,1,12,13,33,7,1,2018
ENG-Premier League,2017,Chelsea,Ross Barkley,ENG,MF,23,1993,1.4,0,0,0,0,0,0,1,0.0,1,3,1,2,0,0,2,0,2018
ENG-Premier League,2017,Chelsea,Thibaut Courtois,BEL,GK,25,1992,35.0,0,0,0,0,0,0,0,,0,0,0,0,0,0,8,1,2018
ENG-Premier League,2017,Chelsea,Tiemoué Bakayoko,FRA,MF,22,1994,23.6,64,41,25,32,7,16,48,33.3,32,23,6,17,37,101,38,4,2018
ENG-Premier League,2017,Chelsea,Victor Moses,NGA,"DF,MF",26,1990,23.4,37,29,21,13,3,14,24,58.3,10,29,4,25,15,52,39,2,2018
ENG-Premier League,2017,Chelsea,Willian,BRA,"MF,FW",28,1988,21.0,22,17,7,12,3,0,16,0.0,16,13,1,12,10,32,10,0,2018
ENG-Premier League,2017,Chelsea,Willy Caballero,ARG,GK,35,1981,3.0,0,0,0,0,0,0,0,,0,0,0,0,0,0,3,0,2018
ENG-Premier League,2017,Chelsea,Álvaro Morata,ESP,FW,24,1992,22.9,13,8,0,7,6,1,21,4.8,20,17,4,13,6,19,20,0,2018
ENG-Premier League,2017,Crystal Palace,Aaron Wan-Bissaka,ENG,DF,19,1997,7.0,30,19,20,7,3,15,19,78.9,4,18,7,11,15,45,45,0,2018
ENG-Premier League,2017,Crystal Palace,Alexander Sørloth,NOR,FW,21,1995,4.0,6,3,1,4,1,4,12,33.3,8,5,0,5,2,8,5,0,2018
ENG-Premier League,2017,Crystal Palace,Andros Townsend,ENG,"FW,MF",26,1991,34.7,60,34,35,12,13,24,75,32.0,51,49,1,48,35,95,28,0,2018
ENG-Premier League,2017,Crystal Palace,Bakary Sako,MLI,"FW,MF",29,1988,5.3,7,6,5,0,2,2,9,22.2,7,2,0,2,1,8,2,0,2018
ENG-Premier League,2017,Crystal Palace,Christian Benteke,BEL,FW,26,1990,24.9,11,4,3,7,1,2,17,11.8,15,15,3,12,3,14,44,0,2018
ENG-Premier League,2017,Crystal Palace,Damien Delaney,IRL,DF,36,1981,1.1,2,1,2,0,0,1,1,100.0,0,5,4,1,3,5,7,0,2018
ENG-Premier League,2017,Crystal Palace,Freddie Ladapo,ENG,FW,24,1993,0.2,0,0,0,0,0,0,0,,0,0,0,0,0,0,0,0,2018
ENG-Premier League,2017,Crystal Palace,James McArthur,SCO,MF,29,1987,27.0,58,44,28,27,3,23,61,37.7,38,39,2,37,36,94,44,2,2018
ENG-Premier League,2017,Crystal Palace,James Tomkins,ENG,DF,28,1989,26.5,47,26,36,10,1,16,31,51.6,15,24,12,12,63,110,216,1,2018
ENG-Premier League,2017,Crystal Palace,Jason Puncheon,ENG,MF,31,1986,7.2,13,4,3,7,3,1,5,20.0,4,3,0,3,5,18,4,0,2018
ENG-Premier League,2017,Crystal Palace,Jaïro Riedewald,NED,"MF,DF",20,1996,4.9,11,8,6,4,1,0,2,0.0,2,7,1,6,12,23,13,0,2018
ENG-Premier League,2017,Crystal Palace,Jeffrey Schlupp,GHA,"DF,MF",24,1992,19.4,57,36,35,20,2,23,43,53.5,20,34,8,26,24,81,67,0,2018
ENG-Premier League,2017,Crystal Palace,Joel Ward,ENG,DF,27,1989,17.9,35,30,23,12,0,16,28,57.1,12,27,11,16,28,63,76,0,2018
ENG-Premier League,2017,Crystal Palace,Julián Speroni,ARG,GK,38,1979,11.0,0,0,0,0,0,0,0,,0,0,0,0,1,1,4,0,2018
ENG-Premier League,2017,Crystal Palace,Lee Chung-yong,KOR,"FW,MF",29,1988,1.5,2,0,0,1,1,0,0,,0,3,0,3,2,4,0,1,2018
ENG-Premier League,2017,Crystal Palace,Levi Lumeka,ENG,FW,18,1998,0.3,1,1,1,0,0,0,0,,0,0,0,0,1,2,0,0,2018
ENG-Premier League,2017,Crystal Palace,Luka Milivojević,SRB,MF,26,1991,34.2,85,52,40,37,8,31,86,36.0,55,50,12,38,71,156,81,3,2018
ENG-Premier League,2017,Crystal Palace,Mamadou Sakho,FRA,DF,27,1990,17.8,21,14,15,5,1,9,16,56.3,7,19,11,8,30,51,101,3,2018
ENG-Premier League,2017,Crystal Palace,Martin Kelly,ENG,DF,27,1990,13.3,19,13,15,4,0,14,26,53.8,12,16,11,5,9,28,67,3,2018
ENG-Premier League,2017,Crystal Palace,Pape Souaré,SEN,DF,27,1990,0.1,0,0,0,0,0,0,0,,0,0,0,0,0,0,0,0,2018
ENG-Premier League,2017,Crystal Palace,Patrick van Aanholt,NED,DF,26,1990,24.3,47,32,29,15,3,16,34,47.1,18,24,5,19,47,94,64,2,2018
ENG-Premier League,2017,Crystal Palace,Ruben Loftus-Cheek,ENG,MF,21,1996,20.8,21,15,7,13,1,7,30,23.3,23,19,2,17,22,43,31,0,2018
ENG-Premier League,2017,Crystal Palace,Scott Dann,ENG,DF,30,1987,15.9,10,5,8,2,0,7,17,41.2,10,17,14,3,23,33,98,1,2018
ENG-Premier League,2017,Crystal Palace,Sullay Kaikai,SLE,MF,21,1995,0.2,1,0,0,1,0,0,0,,0,1,0,1,0,1,1,0,2018
ENG-Premier League,2017,Crystal Palace,Timothy Fosu-Mensah,NED,DF,19,1998,17.7,42,33,33,8,1,21,34,61.8,13,17,9,8,31,73,74,1,2018
ENG-Premier League,2017,Crystal Palace,Wayne Hennessey,WAL,GK,30,1987,27.0,0,0,0,0,0,0,0,,0,1,0,1,2,2,5,1,2018
ENG-Premier League,2017,Crystal Palace,Wilfried Zaha,CIV,"FW,MF",24,1992,28.3,30,23,9,13,8,4,23,17.4,19,24,0,24,7,37,4,0,2018
ENG-Premier League,2017,Crystal Palace,Yohan Cabaye,FRA,MF,31,1986,26.4,70,44,39,28,3,24,97,24.7,73,47,4,43,79,149,29,4,2018
ENG-Premier League,2017,Everton,Aaron Lennon,ENG,"FW,MF",30,1987,8.8,17,10,10,5,2,5,21,23.8,16,13,1,12,11,28,9,0,2018
ENG-Premier League,2017,Everton,Ademola Lookman,NGA,"FW,MF",19,1997,1.8,1,1,0,1,0,0,2,0.0,2,2,0,2,1,2,3,0,2018
ENG-Premier League,2017,Everton,Ashley Williams,WAL,DF,32,1984,20.4,23,13,17,6,0,9,18,50.0,9,31,23,8,36,59,173,3,2018
ENG-Premier League,2017,Everton,Beni Baningime,COD,MF,18,1998,2.2,6,2,1,2,3,0,4,0.0,4,5,1,4,2,8,2,0,2018
ENG-Premier League,2017,Everton,Cenk Tosun,TUR,FW,26,1991,11.0,6,3,2,2,2,1,11,9.1,10,9,4,5,1,7,13,0,2018
ENG-Premier League,2017,Everton,Cuco Martina,CUW,DF,27,1989,20.3,61,35,38,15,8,27,46,58.7,19,17,4,13,42,103,130,2,2018
ENG-Premier League,2017,Everton,Davy Klaassen,NED,"MF,FW",24,1993,2.8,3,1,1,2,0,2,6,33.3,4,2,1,1,1,4,2,0,2018
ENG-Premier League,2017,Everton,Dominic Calvert-Lewin,ENG,FW,20,1997,20.9,15,8,5,3,7,2,15,13.3,13,13,1,12,10,25,23,1,2018
ENG-Premier League,2017,Everton,Eliaquim Mangala,FRA,DF,26,1991,1.5,2,1,1,1,0,0,0,,0,0,0,0,1,3,4,1,2018
ENG-Premier League,2017,Everton,Gylfi Sigurðsson,ISL,"MF,FW",27,1989,25.1,38,26,15,14,9,16,57,28.1,41,37,7,30,34,72,36,0,2018
ENG-Premier League,2017,Everton,Idrissa Gana Gueye,SEN,MF,27,1989,30.6,117,93,65,41,11,35,86,40.7,51,59,9,50,62,179,48,1,2018
ENG-Premier League,2017,Everton,James McCarthy,IRL,MF,26,1990,2.3,9,9,3,4,2,1,5,20.0,4,9,2,7,5,14,3,1,2018
ENG-Premier League,2017,Everton,Jonjoe Kenny,ENG,DF,20,1997,17.7,41,33,28,10,3,20,32,62.5,12,17,7,10,28,69,95,0,2018
ENG-Premier League,2017,Everton,Jordan Pickford,ENG,GK,23,1994,38.0,0,0,0,0,0,0,2,0.0,2,0,0,0,2,2,26,5,2018
ENG-Premier League,2017,Everton,Kevin Mirallas,BEL,"FW,MF",29,1987,1.5,4,3,1,2,1,0,1,0.0,1,0,0,0,0,4,3,0,2018
ENG-Premier League,2017,Everton,Leighton Baines,ENG,DF,32,1984,21.2,25,13,18,3,4,9,14,64.3,5,18,6,12,25,50,56,0,2018
ENG-Premier League,2017,Everton,Mason Holgate,ENG,DF,20,1996,13.2,23,16,15,7,1,10,21,47.6,11,12,9,3,23,46,86,2,2018
ENG-Premier League,2017,Everton,Michael Keane,ENG,DF,24,1993,28.4,33,25,26,5,2,19,43,44.2,24,39,28,11,53,86,214,0,2018
ENG-Premier League,2017,Everton,Morgan Schneiderlin,FRA,MF,27,1989,23.7,58,40,34,21,3,15,44,34.1,29,18,7,11,61,119,59,1,2018
ENG-Premier League,2017,Everton,Muhamed Bešić,BIH,MF,24,1992,0.5,1,1,1,0,0,1,3,33.3,2,2,2,0,0,1,1,0,2018
ENG-Premier League,2017,Everton,Nikola Vlašić,CRO,"MF,FW",19,1997,6.4,9,5,3,6,0,2,9,22.2,7,14,2,12,9,18,10,0,2018
ENG-Premier League,2017,Everton,Oumar Niasse,SEN,FW,27,1990,12.1,10,6,2,5,3,4,19,21.1,15,3,2,1,2,12,6,0,2018
ENG-Premier League,2017,Everton,Phil Jagielka,ENG,DF,34,1982,22.9,33,23,24,9,0,8,21,38.1,13,30,20,10,39,72,179,1,2018
ENG-Premier League,2017,Everton,Ramiro Funes Mori,ARG,DF,26,1991,1.3,0,0,0,0,0,0,0,,0,1,1,0,3,3,14,0,2018
ENG-Premier League,2017,Everton,Sandro Ramírez,ESP,"FW,MF",22,1995,3.1,2,1,0,1,1,0,3,0.0,3,1,0,1,1,3,0,0,2018
ENG-Premier League,2017,Everton,Séamus Coleman,IRL,DF,28,1988,11.5,14,14,9,3,2,6,11,54.5,5,16,12,4,10,24,29,2,2018
ENG-Premier League,2017,Everton,Theo Walcott,ENG,FW,28,1989,12.8,27,19,12,13,2,7,15,46.7,8,9,0,9,8,35,12,0,2018
ENG-Premier League,2017,Everton,Tom Davies,ENG,MF,19,1998,21.1,30,20,14,11,5,12,54,22.2,42,19,5,14,24,54,21,0,2018
ENG-Premier League,2017,Everton,Wayne Rooney,ENG,"MF,FW",31,1985,25.2,28,19,11,13,4,10,42,23.8,32,25,6,19,16,44,43,2,2018
ENG-Premier League,2017,Everton,Yannick Bolasie,COD,FW,28,1989,9.5,8,7,4,1,3,2,7,28.6,5,5,0,5,4,12,8,0,2018
ENG-Premier League,2017,Huddersfield,Aaron Mooy,AUS,MF,26,1990,34.1,102,60,39,51,12,23,55,41.8,32,39,5,34,38,140,52,0,2018
ENG-Premier League,2017,Huddersfield,Abdelhamid Sabiri,MAR,MF,20,1996,2.4,5,4,2,0,3,1,7,14.3,6,4,0,4,1,6,2,0,2018
ENG-Premier League,2017,Huddersfield,Alex Pritchard,ENG,"MF,FW",24,1993,11.1,18,8,2,6,10,10,21,47.6,11,6,1,5,5,23,11,0,2018
ENG-Premier League,2017,Huddersfield,Chris Löwe,GER,DF,28,1989,17.6,43,29,26,15,2,20,44,45.5,24,21,8,13,34,77,65,3,2018
ENG-Premier League,2017,Huddersfield,Christopher Schindler,GER,DF,27,1990,36.3,83,61,56,27,0,24,41,58.5,17,54,30,24,75,158,275,1,2018
ENG-Premier League,2017,Huddersfield,Collin Quaner,GER,"FW,MF",26,1991,14.2,22,15,8,8,6,9,26,34.6,17,24,4,20,11,33,15,0,2018
ENG-Premier League,2017,Huddersfield,Danny Williams,USA,MF,28,1989,12.5,23,14,13,9,1,7,22,31.8,15,12,2,10,26,49,27,0,2018
ENG-Premier League,2017,Huddersfield,Dean Whitehead,ENG,MF,35,1982,0.8,0,0,0,0,0,0,1,0.0,1,1,0,1,2,2,0,0,2018
ENG-Premier League,2017,Huddersfield,Elias Kachunga,COD,"FW,MF",25,1992,14.8,30,26,13,12,5,8,19,42.1,11,14,1,13,2,32,9,0,2018
ENG-Premier League,2017,Huddersfield,Florent Hadergjonaj,KVX,"DF,MF",23,1994,18.6,21,16,7,10,4,12,30,40.0,18,22,10,12,17,38,45,0,2018
ENG-Premier League,2017,Huddersfield,Joe Lolley,ENG,"FW,MF",24,1992,2.5,2,0,1,1,0,0,2,0.0,2,0,0,0,3,5,2,1,2018
ENG-Premier League,2017,Huddersfield,Jonas Lössl,DEN,GK,28,1989,38.0,1,0,1,0,0,1,5,20.0,4,0,0,0,4,5,13,6,2018
ENG-Premier League,2017,Huddersfield,Jonathan Hogg,ENG,MF,28,1988,26.6,93,64,29,59,5,26,89,29.2,63,51,12,39,69,162,48,0,2018
ENG-Premier League,2017,Huddersfield,Kasey Palmer,JAM,"MF,FW",20,1996,1.9,6,3,2,3,1,2,8,25.0,6,5,0,5,0,6,2,0,2018
ENG-Premier League,2017,Huddersfield,Laurent Depoitre,BEL,FW,28,1988,20.2,14,8,4,8,2,3,21,14.3,18,15,3,12,11,25,36,0,2018
ENG-Premier League,2017,Huddersfield,Martin Cranie,ENG,DF,30,1986,2.0,3,2,2,1,0,0,1,0.0,1,3,3,0,1,4,10,0,2018
ENG-Premier League,2017,Huddersfield,Mathias Jørgensen,DEN,DF,27,1990,38.0,55,36,40,13,2,19,45,42.2,26,49,20,29,76,131,249,5,2018
ENG-Premier League,2017,Huddersfield,Michael Hefele,GER,DF,26,1990,0.4,0,0,0,0,0,0,0,,0,0,0,0,1,1,5,0,2018
ENG-Premier League,2017,Huddersfield,Philip Billing,DEN,MF,21,1996,8.5,25,16,11,11,3,8,22,36.4,14,17,1,16,18,43,19,0,2018
ENG-Premier League,2017,Huddersfield,Rajiv van La Parra,NED,"FW,MF",26,1991,23.7,41,29,18,15,8,12,41,29.3,29,27,1,26,21,62,8,1,2018
ENG-Premier League,2017,Huddersfield,Scott Malone,ENG,DF,26,1991,12.4,39,29,27,10,2,17,24,70.8,7,12,2,10,26,65,43,2,2018
ENG-Premier League,2017,Huddersfield,Steve Mounié,BEN,FW,22,1994,20.6,11,8,2,4,5,0,19,0.0,19,23,3,20,7,18,30,0,2018
ENG-Premier League,2017,Huddersfield,Terence Kongolo,NED,DF,23,1994,11.7,33,20,19,13,1,14,22,63.6,8,12,6,6,32,65,71,0,2018
ENG-Premier League,2017,Huddersfield,Tom Ince,ENG,"MF,FW",25,1992,27.2,35,27,14,16,5,10,29,34.5,19,20,0,20,12,47,12,0,2018
ENG-Premier League,2017,Huddersfield,Tommy Smith,ENG,DF,25,1992,21.2,38,27,18,14,6,23,36,63.9,13,22,6,16,26,64,80,3,2018
ENG-Premier League,2017,Leicester City,Adrien Silva,POR,MF,28,1989,8.5,22,13,8,13,1,6,28,21.4,22,12,2,10,14,36,0,0,2018
ENG-Premier League,2017,Leicester City,Aleksandar Dragović,AUT,DF,26,1991,8.5,13,10,13,0,0,7,13,53.8,6,16,8,8,16,29,46,0,2018
ENG-Premier League,2017,Leicester City,Andy King,WAL,MF,28,1988,6.0,8,5,0,5,3,0,3,0.0,3,4,2,2,5,13,13,0,2018
ENG-Premier League,2017,Leicester City,Ben Chilwell,ENG,DF,20,1996,20.6,36,26,21,10,5,15,32,46.9,17,31,4,27,28,64,71,3,2018
ENG-Premier League,2017,Leicester City,Ben Hamer,ENG,GK,29,1987,3.1,0,0,0,0,0,0,1,0.0,1,0,0,0,0,0,3,1,2018
ENG-Premier League,2017,Leicester City,Christian Fuchs,AUT,DF,31,1986,21.3,41,27,25,12,4,14,40,35.0,26,23,3,20,58,99,86,0,2018
ENG-Premier League,2017,Leicester City,Daniel Amartey,GHA,DF,22,1994,5.4,8,4,7,1,0,3,7,42.9,4,7,3,4,7,15,21,1,2018
ENG-Premier League,2017,Leicester City,Danny Simpson,ENG,DF,30,1987,25.6,38,22,31,6,1,22,45,48.9,23,31,19,12,34,72,132,1,2018
ENG-Premier League,2017,Leicester City,Demarai Gray,JAM,"MF,FW",21,1996,18.9,17,15,6,9,2,4,23,17.4,19,27,0,27,11,28,14,1,2018
ENG-Premier League,2017,Leicester City,Eldin Jakupović,SUI,GK,32,1984,2.0,0,0,0,0,0,0,0,,0,0,0,0,0,0,4,0,2018
ENG-Premier League,2017,Leicester City,Fousseni Diabaté,MLI,"MF,FW",21,1995,6.5,9,6,5,3,1,1,4,25.0,3,6,0,6,8,17,8,0,2018
ENG-Premier League,2017,Leicester City,Hamza Choudhury,ENG,"MF,DF",19,1997,4.2,9,5,6,3,0,2,10,20.0,8,12,1,11,8,17,4,0,2018
ENG-Premier League,2017,Leicester City,Harry Maguire,ENG,DF,24,1993,38.0,63,46,47,15,1,26,43,60.5,17,35,28,7,48,111,181,1,2018
ENG-Premier League,2017,Leicester City,Harvey Barnes,ENG,"MF,FW",19,1997,0.1,0,0,0,0,0,0,0,,0,0,0,0,0,0,0,0,2018
ENG-Premier League,2017,Leicester City,Islam Slimani,ALG,FW,29,1988,2.8,2,2,1,1,0,1,4,25.0,3,2,0,2,0,2,2,0,2018
ENG-Premier League,2017,Leicester City,Jamie Vardy,ENG,FW,30,1987,36.1,15,9,3,7,5,1,8,12.5,7,21,1,20,2,17,17,0,2018
ENG-Premier League,2017,Leicester City,Kasper Schmeichel,DEN,GK,30,1986,32.9,1,0,1,0,0,1,3,33.3,2,1,0,1,0,1,18,5,2018
ENG-Premier League,2017,Leicester City,Kelechi Iheanacho,NGA,"FW,MF",20,1996,9.2,9,6,3,5,1,3,20,15.0,17,10,2,8,3,12,4,0,2018
ENG-Premier League,2017,Leicester City,Leonardo Ulloa,ARG,FW,31,1986,0.2,1,0,0,0,1,0,0,,0,0,0,0,0,1,1,0,2018
ENG-Premier League,2017,Leicester City,Marc Albrighton,ENG,"MF,FW",27,1989,28.2,52,33,16,29,7,16,52,30.8,36,32,4,28,27,79,34,0,2018
ENG-Premier League,2017,Leicester City,Matty James,ENG,MF,26,1991,11.0,19,10,7,11,1,2,10,20.0,8,14,2,12,17,36,25,0,2018
ENG-Premier League,2017,Leicester City,Riyad Mahrez,ALG,"MF,FW",26,1991,32.8,39,27,16,17,6,10,63,15.9,53,32,1,31,18,57,15,0,2018
ENG-Premier League,2017,Leicester City,Shinji Okazaki,JPN,"FW,MF",31,1986,14.7,25,16,3,18,4,4,28,14.3,24,15,1,14,8,33,6,0,2018
ENG-Premier League,2017,Leicester City,Vicente Iborra,ESP,MF,29,1988,15.7,23,18,13,10,0,9,36,25.0,27,25,11,14,19,42,49,1,2018
ENG-Premier League,2017,Leicester City,Wes Morgan,JAM,DF,33,1984,31.3,35,25,26,8,1,12,18,66.7,6,41,27,14,31,66,146,1,2018
ENG-Premier League,2017,Leicester City,Wilfred Ndidi,NGA,MF,20,1996,32.2,138,89,68,65,5,45,119,37.8,74,67,10,57,51,189,103,2,2018
ENG-Premier League,2017,Leicester City,Yohan Benalouane,TUN,DF,30,1987,1.0,7,3,6,1,0,4,6,66.7,2,1,1,0,1,8,4,0,2018
ENG-Premier League,2017,Liverpool,Adam Lallana,ENG,"MF,FW",29,1988,3.4,3,1,3,0,0,2,10,20.0,8,3,0,3,1,4,1,0,2018
ENG-Premier League,2017,Liverpool,Alberto Moreno,ESP,DF,25,1992,14.1,35,26,21,12,2,13,29,44.8,16,19,2,17,12,47,44,0,2018
ENG-Premier League,2017,Liverpool,Alex Oxlade-Chamberlain,ENG,"MF,FW",23,1993,16.6,32,21,13,14,5,6,21,28.6,15,24,0,24,20,52,14,0,2018
ENG-Premier League,2017,Liverpool,Andrew Robertson,SCO,DF,23,1994,21.6,31,17,19,9,3,15,29,51.7,14,22,2,20,26,57,56,0,2018
ENG-Premier League,2017,Liverpool,Ben Woodburn,WAL,FW,17,1999,0.1,0,0,0,0,0,0,0,,0,0,0,0,0,0,0,0,2018
ENG-Premier League,2017,Liverpool,Daniel Sturridge,ENG,FW,27,1989,4.8,0,0,0,0,0,0,1,0.0,1,1,0,1,0,0,1,0,2018
ENG-Premier League,2017,Liverpool,Danny Ings,ENG,FW,25,1992,3.0,5,3,1,3,1,0,0,,0,4,0,4,2,7,1,0,2018
ENG-Premier League,2017,Liverpool,Dejan Lovren,CRO,DF,28,1989,23.6,26,17,14,11,1,12,22,54.5,10,26,15,11,38,64,146,2,2018
ENG-Premier League,2017,Liverpool,Divock Origi,BEL,FW,22,1995,0.1,0,0,0,0,0,0,0,,0,0,0,0,0,0,0,0,2018
ENG-Premier League,2017,Liverpool,Dominic Solanke,ENG,FW,19,1997,6.6,7,4,0,6,1,1,4,25.0,3,5,1,4,2,9,9,0,2018
ENG-Premier League,2017,Liverpool,Emre Can,GER,MF,23,1994,23.2,67,54,32,29,6,18,43,41.9,25,32,4,28,28,95,37,1,2018
ENG-Premier League,2017,Liverpool,Georginio Wijnaldum,NED,MF,26,1990,26.5,34,23,13,16,5,11,23,47.8,12,20,2,18,25,59,20,0,2018
ENG-Premier League,2017,Liverpool,James Milner,ENG,MF,31,1986,19.7,58,45,18,32,8,15,39,38.5,24,33,5,28,21,79,23,0,2018
ENG-Premier League,2017,Liverpool,Joe Gomez,ENG,DF,20,1997,21.1,58,45,32,23,3,21,40,52.5,19,19,8,11,34,92,57,1,2018
ENG-Premier League,2017,Liverpool,Jordan Henderson,ENG,MF,27,1990,24.1,51,33,13,32,6,18,52,34.6,34,33,2,31,31,82,27,0,2018
ENG-Premier League,2017,Liverpool,Joël Matip,CMR,DF,25,1991,22.2,35,24,23,11,1,12,24,50.0,12,26,15,11,35,70,101,1,2018
ENG-Premier League,2017,Liverpool,Loris Karius,GER,GK,24,1993,19.0,0,0,0,0,0,0,0,,0,0,0,0,1,1,4,0,2018
ENG-Premier League,2017,Liverpool,Marko Grujić,SRB,"MF,DF",21,1996,0.2,2,2,0,1,1,2,2,100.0,0,0,0,0,0,2,0,0,2018
ENG-Premier League,2017,Liverpool,Mohamed Salah,EGY,FW,25,1992,32.3,12,6,2,5,5,3,23,13.0,20,10,0,10,5,17,5,0,2018
ENG-Premier League,2017,Liverpool,Nathaniel Clyne,ENG,"DF,FW",26,1991,1.9,3,1,2,1,0,0,1,0.0,1,2,1,1,0,3,3,0,2018
ENG-Premier League,2017,Liverpool,Philippe Coutinho,BRA,"MF,FW",25,1992,12.3,17,14,4,10,3,3,21,14.3,18,10,0,10,10,27,5,1,2018
ENG-Premier League,2017,Liverpool,Ragnar Klavan,EST,DF,31,1985,16.1,14,10,6,7,1,6,12,50.0,6,11,5,6,15,29,85,1,2018
ENG-Premier League,2017,Liverpool,Roberto Firmino,BRA,FW,25,1991,30.7,65,50,9,36,20,8,58,13.8,50,40,2,38,18,83,10,0,2018
ENG-Premier League,2017,Liverpool,Sadio Mané,SEN,FW,25,1992,24.3,28,20,8,11,9,3,23,13.0,20,20,0,20,9,37,8,0,2018
ENG-Premier League,2017,Liverpool,Simon Mignolet,BEL,GK,29,1988,19.0,2,1,2,0,0,1,3,33.3,2,0,0,0,0,2,5,3,2018
ENG-Premier League,2017,Liverpool,Trent Alexander-Arnold,ENG,DF,18,1998,17.5,37,25,23,9,5,22,36,61.1,14,20,5,15,28,65,46,1,2018
ENG-Premier League,2017,Liverpool,Virgil van Dijk,NED,DF,26,1991,14.0,15,8,7,7,1,4,5,80.0,1,8,2,6,18,33,80,1,2018
ENG-Premier League,2017,Manchester City,Aymeric Laporte,ESP,DF,23,1994,9.0,8,7,6,2,0,3,8,37.5,5,2,1,1,11,19,27,0,2018
ENG-Premier League,2017,Manchester City,Benjamin Mendy,FRA,"DF,FW",23,1994,4.0,5,4,2,0,3,5,7,71.4,2,5,0,5,8,13,9,0,2018
ENG-Premier League,2017,Manchester City,Bernardo Silva,POR,"FW,MF",22,1994,17.0,27,18,11,9,7,6,30,20.0,24,17,1,16,10,37,12,1,2018
ENG-Premier League,2017,Manchester City,Brahim Díaz,ESP,"FW,DF",17,1999,0.6,1,0,1,0,0,0,0,,0,3,0,3,1,2,0,0,2018
ENG-Premier League,2017,Manchester City,Claudio Bravo,CHI,GK,34,1983,2.5,0,0,0,0,0,0,1,0.0,1,0,0,0,0,0,0,0,2018
ENG-Premier League,2017,Manchester City,Danilo,BRA,DF,26,1991,15.0,43,29,25,12,6,19,35,54.3,16,15,6,9,19,62,33,0,2018
ENG-Premier League,2017,Manchester City,David Silva,ESP,MF,31,1986,27.0,32,21,11,17,4,9,45,20.0,36,28,5,23,18,50,7,0,2018
ENG-Premier League,2017,Manchester City,Ederson,BRA,GK,23,1993,35.5,1,1,1,0,0,0,0,,0,1,0,1,0,1,15,6,2018
ENG-Premier League,2017,Manchester City,Eliaquim Mangala,FRA,DF,26,1991,5.4,5,3,5,0,0,1,3,33.3,2,4,3,1,2,7,24,0,2018
ENG-Premier League,2017,Manchester City,Fabian Delph,ENG,DF,27,1989,19.3,46,34,21,16,9,18,37,48.6,19,16,0,16,30,76,42,2,2018
ENG-Premier League,2017,Manchester City,Fernandinho,BRA,MF,32,1985,32.0,62,35,22,28,12,24,65,36.9,41,38,6,32,47,109,68,2,2018
ENG-Premier League,2017,Manchester City,Gabriel Jesus,BRA,FW,20,1997,18.5,23,15,6,10,7,3,22,13.6,19,16,0,16,8,31,6,0,2018
ENG-Premier League,2017,Manchester City,John Stones,ENG,DF,23,1994,14.5,15,11,11,4,0,4,11,36.4,7,8,5,3,19,34,44,0,2018
ENG-Premier League,2017,Manchester City,Kevin De Bruyne,BEL,MF,26,1991,34.1,62,43,23,25,14,23,80,28.8,57,45,2,43,25,87,14,2,2018
ENG-Premier League,2017,Manchester City,Kyle Walker,ENG,DF,27,1990,30.9,47,31,20,21,6,18,31,58.1,13,21,2,19,29,76,75,2,2018
ENG-Premier League,2017,Manchester City,Leroy Sané,GER,FW,21,1996,26.9,27,21,14,7,6,8,22,36.4,14,22,1,21,13,40,6,0,2018
ENG-Premier League,2017,Manchester City,Lukas Nmecha,GER,FW,18,1998,0.2,0,0,0,0,0,0,0,,0,0,0,0,0,0,0,0,2018
ENG-Premier League,2017,Manchester City,Nicolás Otamendi,ARG,DF,29,1988,33.0,58,43,35,22,1,19,44,43.2,25,21,10,11,48,106,129,3,2018
ENG-Premier League,2017,Manchester City,Oleksandr Zinchenko,UKR,DF,20,1996,5.9,23,16,11,9,3,7,13,53.8,6,3,0,3,6,29,7,0,2018
ENG-Premier League,2017,Manchester City,Phil Foden,ENG,"MF,FW",17,2000,0.5,1,1,0,1,0,0,1,0.0,1,0,0,0,0,1,1,0,2018
ENG-Premier League,2017,Manchester City,Raheem Sterling,ENG,FW,22,1994,28.7,19,14,7,7,5,3,32,9.4,29,24,0,24,9,28,9,0,2018
ENG-Premier League,2017,Manchester City,Sergio Agüero,ARG,FW,29,1988,21.8,9,6,2,6,1,2,17,11.8,15,12,1,11,6,15,3,0,2018
ENG-Premier League,2017,Manchester City,Vincent Kompany,BEL,DF,31,1986,15.5,20,11,14,5,1,13,19,68.4,6,10,8,2,16,36,73,1,2018
ENG-Premier League,2017,Manchester City,Yaya Touré,CIV,MF,34,1983,2.6,2,2,1,0,1,1,1,100.0,0,3,1,2,5,7,4,0,2018
ENG-Premier League,2017,Manchester City,İlkay Gündoğan,GER,MF,26,1990,16.9,27,15,8,14,5,9,37,24.3,28,14,1,13,16,43,12,0,2018
ENG-Premier League,2017,Manchester Utd,Alexis Sánchez,CHI,"FW,MF",28,1988,11.6,21,17,10,4,7,4,27,14.8,23,8,0,8,17,38,0,0,2018
ENG-Premier League,2017,Manchester Utd,Ander Herrera,ESP,MF,27,1989,14.1,56,29,32,20,4,20,69,29.0,49,33,6,27,34,90,22,2,2018
ENG-Premier League,2017,Manchester Utd,Anthony Martial,FRA,FW,21,1995,17.6,15,13,9,2,4,3,12,25.0,9,5,1,4,3,18,7,0,2018
ENG-Premier League,2017,Manchester Utd,Antonio Valencia,ECU,DF,31,1985,30.4,57,32,21,28,8,16,36,44.4,20,47,6,41,48,105,80,0,2018
ENG-Premier League,2017,Manchester Utd,Ashley Young,ENG,DF,32,1985,27.1,53,32,30,17,6,18,47,38.3,29,24,5,19,57,110,86,1,2018
ENG-Premier League,2017,Manchester Utd,Axel Tuanzebe,ENG,FW,19,1997,0.0,0,0,0,0,0,0,0,,0,0,0,0,0,0,0,0,2018
ENG-Premier League,2017,Manchester Utd,Chris Smalling,ENG,DF,27,1989,28.2,40,25,28,12,0,16,28,57.1,12,32,28,4,63,103,162,1,2018
ENG-Premier League,2017,Manchester Utd,Daley Blind,NED,"DF,MF",27,1990,4.0,6,4,3,2,1,2,7,28.6,5,3,0,3,7,13,14,0,2018
ENG-Premier League,2017,Manchester Utd,David de Gea,ESP,GK,26,1990,37.0,0,0,0,0,0,0,1,0.0,1,1,0,1,0,0,9,3,2018
ENG-Premier League,2017,Manchester Utd,Eric Bailly,CIV,DF,23,1994,11.1,17,10,10,5,2,5,12,41.7,7,11,6,5,25,42,58,1,2018
ENG-Premier League,2017,Manchester Utd,Henrikh Mkhitaryan,ARM,"MF,FW",28,1989,10.2,15,11,4,7,4,5,25,20.0,20,8,0,8,7,22,3,0,2018
ENG-Premier League,2017,Manchester Utd,Jesse Lingard,ENG,"MF,FW",24,1992,20.2,30,21,10,13,7,5,27,18.5,22,18,3,15,9,39,13,0,2018
ENG-Premier League,2017,Manchester Utd,Juan Mata,ESP,FW,29,1988,21.4,18,13,4,12,2,2,24,8.3,22,10,0,10,15,33,10,1,2018
ENG-Premier League,2017,Manchester Utd,Luke Shaw,ENG,DF,22,1995,8.8,18,15,10,7,1,11,18,61.1,7,16,2,14,4,22,22,1,2018
ENG-Premier League,2017,Manchester Utd,Marcos Rojo,ARG,DF,27,1990,7.1,7,5,6,0,1,1,8,12.5,7,11,6,5,7,14,56,2,2018
ENG-Premier League,2017,Manchester Utd,Marcus Rashford,ENG,"FW,MF",19,1997,20.1,14,11,4,5,5,6,18,33.3,12,18,0,18,8,22,19,0,2018
ENG-Premier League,2017,Manchester Utd,Marouane Fellaini,BEL,MF,29,1987,7.6,15,8,6,8,1,2,11,18.2,9,12,3,9,14,29,19,1,2018
ENG-Premier League,2017,Manchester Utd,Matteo Darmian,ITA,DF,27,1989,4.9,16,14,7,7,2,6,19,31.6,13,5,3,2,7,23,23,0,2018
ENG-Premier League,2017,Manchester Utd,Michael Carrick,ENG,MF,36,1981,1.2,1,1,0,1,0,0,1,0.0,1,2,0,2,1,2,3,0,2018
ENG-Premier League,2017,Manchester Utd,Nemanja Matić,SRB,MF,28,1988,34.6,70,42,32,34,4,23,71,32.4,48,50,13,37,64,134,62,2,2018
ENG-Premier League,2017,Manchester Utd,Paul Pogba,FRA,MF,24,1993,23.9,33,23,13,15,5,5,33,15.2,28,16,0,16,21,54,26,0,2018
ENG-Premier League,2017,Manchester Utd,Phil Jones,ENG,DF,25,1992,21.9,25,18,20,5,0,9,20,45.0,11,25,17,8,41,66,133,2,2018
ENG-Premier League,2017,Manchester Utd,Romelu Lukaku,BEL,FW,24,1993,31.9,7,4,1,3,3,0,13,0.0,13,9,2,7,3,10,22,2,2018
ENG-Premier League,2017,Manchester Utd,Scott McTominay,SCO,MF,20,1996,7.0,11,9,4,5,2,5,13,38.5,8,3,0,3,13,24,9,0,2018
ENG-Premier League,2017,Manchester Utd,Sergio Romero,ARG,GK,30,1987,1.0,0,0,0,0,0,0,0,,0,0,0,0,0,0,0,0,2018
ENG-Premier League,2017,Manchester Utd,Victor Lindelöf,SWE,DF,23,1994,14.3,17,11,10,6,1,9,14,64.3,5,15,11,4,13,30,67,1,2018
ENG-Premier League,2017,Manchester Utd,Zlatan Ibrahimović,SWE,"MF,FW",35,1981,1.2,2,1,1,0,1,0,1,0.0,1,0,0,0,0,2,1,0,2018
ENG-Premier League,2017,Newcastle Utd,Aleksandar Mitrović,SRB,FW,22,1994,1.1,1,1,0,1,0,0,1,0.0,1,1,0,1,0,1,2,0,2018
ENG-Premier League,2017,Newcastle Utd,Ayoze Pérez,ESP,"MF,FW",24,1993,27.7,39,21,11,15,13,12,54,22.2,42,36,1,35,24,63,28,0,2018
ENG-Premier League,2017,Newcastle Utd,Chancel Mbemba,COD,DF,22,1994,7.5,16,12,13,3,0,10,17,58.8,7,7,3,4,15,31,44,1,2018
ENG-Premier League,2017,Newcastle Utd,Christian Atsu,GHA,"FW,MF",25,1992,19.8,17,16,10,7,0,7,20,35.0,13,35,5,30,13,30,27,1,2018
ENG-Premier League,2017,Newcastle Utd,Ciaran Clark,IRL,DF,27,1989,19.4,25,17,17,8,0,11,21,52.4,10,15,10,5,17,42,144,1,2018
ENG-Premier League,2017,Newcastle Utd,DeAndre Yedlin,USA,DF,24,1993,31.6,57,33,39,14,4,26,54,48.1,28,37,7,30,44,101,114,0,2018
ENG-Premier League,2017,Newcastle Utd,Dwight Gayle,ENG,FW,26,1990,21.8,12,10,2,8,2,1,21,4.8,20,16,2,14,6,18,17,0,2018
ENG-Premier League,2017,Newcastle Utd,Florian Lejeune,FRA,DF,26,1991,23.4,34,20,26,8,0,14,30,46.7,16,21,15,6,46,80,154,0,2018
ENG-Premier League,2017,Newcastle Utd,Henri Saivet,SEN,MF,26,1990,0.9,5,3,4,1,0,2,5,40.0,3,0,0,0,4,9,8,1,2018
ENG-Premier League,2017,Newcastle Utd,Isaac Hayden,ENG,MF,22,1995,15.3,40,23,23,16,1,12,34,35.3,22,21,6,15,23,63,43,0,2018
ENG-Premier League,2017,Newcastle Utd,Islam Slimani,ALG,FW,29,1988,1.5,0,0,0,0,0,0,2,0.0,2,0,0,0,1,1,1,0,2018
ENG-Premier League,2017,Newcastle Utd,Jacob Murphy,ENG,"MF,FW",22,1995,12.8,13,10,5,4,4,7,27,25.9,20,16,0,16,6,19,13,2,2018
ENG-Premier League,2017,Newcastle Utd,Jamaal Lascelles,ENG,DF,23,1993,32.5,31,19,19,11,1,12,19,63.2,7,33,24,9,28,59,232,1,2018
ENG-Premier League,2017,Newcastle Utd,Javier Manquillo,ESP,DF,23,1994,19.5,36,22,25,8,3,15,30,50.0,15,25,6,19,18,54,65,0,2018
ENG-Premier League,2017,Newcastle Utd,Jesús Gámez,ESP,DF,32,1985,1.1,4,2,1,0,3,1,3,33.3,2,2,0,2,2,6,5,0,2018
ENG-Premier League,2017,Newcastle Utd,Jonjo Shelvey,ENG,MF,25,1992,25.2,39,24,17,21,1,8,26,30.8,18,26,5,21,28,67,33,0,2018
ENG-Premier League,2017,Newcastle Utd,Joselu,ESP,FW,27,1990,19.0,22,17,10,11,1,7,34,20.6,27,25,2,23,11,33,39,0,2018
ENG-Premier League,2017,Newcastle Utd,Karl Darlow,ENG,GK,26,1990,10.0,0,0,0,0,0,0,0,,0,0,0,0,0,0,3,4,2018
ENG-Premier League,2017,Newcastle Utd,Kenedy,BRA,"MF,DF",21,1996,11.4,31,17,16,13,2,12,35,34.3,23,12,1,11,14,45,11,0,2018
ENG-Premier League,2017,Newcastle Utd,Martin Dúbravka,SVK,GK,28,1989,12.0,0,0,0,0,0,0,0,,0,0,0,0,0,0,3,2,2018
ENG-Premier League,2017,Newcastle Utd,Massadio Haïdara,MLI,FW,24,1992,0.0,0,0,0,0,0,0,0,,0,0,0,0,0,0,0,0,2018
ENG-Premier League,2017,Newcastle Utd,Matt Ritchie,SCO,"MF,FW",27,1989,31.2,46,32,22,18,6,14,53,26.4,39,37,5,32,35,81,63,1,2018
ENG-Premier League,2017,Newcastle Utd,Mikel Merino,ESP,MF,21,1996,15.0,56,40,21,32,3,17,56,30.4,39,36,8,28,34,90,25,0,2018
ENG-Premier League,2017,Newcastle Utd,Mohamed Diamé,SEN,MF,30,1987,22.7,89,64,33,48,8,16,62,25.8,46,44,7,37,48,137,30,2,2018
ENG-Premier League,2017,Newcastle Utd,Paul Dummett,WAL,DF,25,1991,17.8,28,19,21,7,0,13,27,48.1,14,27,10,17,23,51,107,1,2018
ENG-Premier League,2017,Newcastle Utd,Rob Elliot,IRL,GK,31,1986,16.0,0,0,0,0,0,0,1,0.0,1,0,0,0,0,0,8,0,2018
ENG-Premier League,2017,Newcastle Utd,Rolando Aarons,ENG,"MF,FW",21,1995,1.5,4,4,3,1,0,4,6,66.7,2,3,0,3,1,5,0,0,2018
ENG-Premier League,2017,Southampton,Alex McCarthy,ENG,GK,27,1989,18.0,0,0,0,0,0,0,0,,0,0,0,0,1,1,8,0,2018
ENG-Premier League,2017,Southampton,Charlie Austin,ENG,FW,28,1989,11.5,7,5,1,3,3,3,10,30.0,7,15,3,12,1,8,10,0,2018
ENG-Premier League,2017,Southampton,Cédric Soares,POR,DF,25,1991,31.0,54,34,40,10,4,22,31,71.0,9,32,8,24,24,78,109,2,2018
ENG-Premier League,2017,Southampton,Dušan Tadić,SRB,"MF,FW",28,1988,31.0,46,29,16,22,8,11,35,31.4,24,38,2,36,19,65,29,1,2018
ENG-Premier League,2017,Southampton,Fraser Forster,ENG,GK,29,1988,20.0,0,0,0,0,0,0,0,,0,0,0,0,0,0,7,4,2018
ENG-Premier League,2017,Southampton,Guido Carrillo,ARG,FW,26,1991,5.0,5,1,0,3,2,0,1,0.0,1,4,0,4,0,5,5,0,2018
ENG-Premier League,2017,Southampton,Jack Stephens,ENG,DF,23,1994,22.0,29,20,24,5,0,13,25,52.0,12,30,18,12,41,70,108,2,2018
ENG-Premier League,2017,Southampton,James Ward-Prowse,ENG,"FW,MF",22,1994,19.1,23,16,9,11,3,3,27,11.1,24,29,1,28,8,31,31,0,2018
ENG-Premier League,2017,Southampton,Jan Bednarek,POL,DF,21,1996,4.7,6,3,6,0,0,3,6,50.0,3,2,1,1,5,11,27,0,2018
ENG-Premier League,2017,Southampton,Josh Sims,ENG,"FW,MF",20,1997,1.8,4,3,1,2,1,2,7,28.6,5,5,0,5,1,5,0,0,2018
ENG-Premier League,2017,Southampton,Jérémy Pied,FRA,DF,28,1989,2.0,9,6,8,1,0,6,9,66.7,3,3,2,1,8,17,4,0,2018
ENG-Premier League,2017,Southampton,Manolo Gabbiadini,ITA,FW,25,1991,12.0,3,2,0,2,1,1,15,6.7,14,3,0,3,4,7,6,0,2018
ENG-Premier League,2017,Southampton,Mario Lemina,GAB,MF,23,1993,19.1,55,40,21,29,5,12,30,40.0,18,18,6,12,36,91,36,4,2018
ENG-Premier League,2017,Southampton,Matt Targett,ENG,DF,21,1995,1.8,6,3,5,0,1,1,3,33.3,2,3,2,1,3,9,7,1,2018
ENG-Premier League,2017,Southampton,Maya Yoshida,JPN,DF,28,1988,22.8,27,20,22,5,0,18,25,72.0,7,32,14,18,41,68,133,2,2018
ENG-Premier League,2017,Southampton,Michael Obafemi,IRL,FW,17,2000,0.1,0,0,0,0,0,0,0,,0,0,0,0,0,0,0,0,2018
ENG-Premier League,2017,Southampton,Nathan Redmond,ENG,"FW,MF",23,1994,21.6,32,17,16,14,2,12,31,38.7,19,20,0,20,15,47,17,2,2018
ENG-Premier League,2017,Southampton,Oriol Romeu,ESP,MF,25,1991,32.2,93,64,41,44,8,32,100,32.0,68,59,19,40,69,162,77,2,2018
ENG-Premier League,2017,Southampton,Pierre Højbjerg,DEN,MF,21,1995,18.6,45,29,24,18,3,13,56,23.2,43,30,3,27,37,82,26,1,2018
ENG-Premier League,2017,Southampton,Ryan Bertrand,ENG,DF,27,1989,34.8,48,35,27,17,4,19,31,61.3,12,28,9,19,44,92,74,0,2018
ENG-Premier League,2017,Southampton,Sam McQueen,ENG,"DF,MF",22,1995,1.6,4,4,4,0,0,2,4,50.0,2,2,1,1,3,7,3,0,2018
ENG-Premier League,2017,Southampton,Shane Long,IRL,FW,30,1987,17.6,25,20,1,19,5,10,30,33.3,20,14,2,12,12,37,29,0,2018
ENG-Premier League,2017,Southampton,Sofiane Boufal,MAR,"FW,MF",23,1993,13.5,37,24,12,14,11,12,35,34.3,23,20,1,19,6,43,6,0,2018
ENG-Premier League,2017,Southampton,Steven Davis,NIR,MF,32,1985,16.9,30,21,10,17,3,11,30,36.7,19,22,6,16,15,45,24,1,2018
ENG-Premier League,2017,Southampton,Virgil van Dijk,NED,DF,26,1991,11.0,10,7,6,2,2,2,3,66.7,1,14,13,1,29,39,81,1,2018
ENG-Premier League,2017,Southampton,Wesley Hoedt,NED,DF,23,1994,28.0,60,51,48,12,0,36,61,59.0,25,32,17,15,40,100,177,2,2018
ENG-Premier League,2017,Stoke City,Badou Ndiaye,SEN,MF,26,1990,12.6,53,28,22,25,6,16,41,39.0,25,21,9,12,13,66,18,0,2018
ENG-Premier League,2017,Stoke City,Bojan Krkić,ESP,MF,26,1990,0.8,0,0,0,0,0,0,1,0.0,1,1,0,1,0,0,0,0,2018
ENG-Premier League,2017,Stoke City,Bruno Martins Indi,NED,DF,25,1992,13.8,21,12,18,3,0,10,19,52.6,9,16,11,5,21,42,77,1,2018
ENG-Premier League,2017,Stoke City,Charlie Adam,SCO,MF,31,1985,4.6,9,5,2,5,2,5,17,29.4,12,2,0,2,9,18,11,2,2018
ENG-Premier League,2017,Stoke City,Darren Fletcher,SCO,MF,33,1984,24.7,47,26,23,20,4,15,55,27.3,40,13,3,10,26,73,33,3,2018
ENG-Premier League,2017,Stoke City,Eric Maxim Choupo-Moting,CMR,"FW,MF",28,1989,25.7,42,30,21,16,5,9,32,28.1,23,31,3,28,23,65,29,1,2018
ENG-Premier League,2017,Stoke City,Erik Pieters,NED,DF,28,1988,30.2,71,47,43,26,2,24,51,47.1,27,70,25,45,61,132,127,5,2018
ENG-Premier League,2017,Stoke City,Geoff Cameron,USA,"DF,MF",32,1985,16.9,34,21,20,12,2,11,27,40.7,16,28,8,20,36,70,68,0,2018
ENG-Premier League,2017,Stoke City,Glen Johnson,ENG,DF,32,1984,6.1,7,5,5,2,0,3,12,25.0,9,7,2,5,10,17,23,0,2018
ENG-Premier League,2017,Stoke City,Ibrahim Afellay,NED,MF,31,1986,1.8,3,3,0,3,0,1,2,50.0,1,1,0,1,1,4,1,0,2018
ENG-Premier League,2017,Stoke City,Jack Butland,ENG,GK,24,1993,35.0,1,1,1,0,0,1,1,100.0,0,1,0,1,1,2,26,1,2018
ENG-Premier League,2017,Stoke City,Jesé,ESP,"FW,MF",24,1993,6.8,10,7,3,5,2,3,13,23.1,10,5,0,5,0,10,3,0,2018
ENG-Premier League,2017,Stoke City,Joe Allen,WAL,MF,27,1990,34.9,96,62,41,43,12,27,87,31.0,60,43,9,34,58,154,68,1,2018
ENG-Premier League,2017,Stoke City,Josh Tymon,ENG,DF,18,1999,1.8,5,1,4,1,0,2,3,66.7,1,1,0,1,1,6,3,0,2018
ENG-Premier League,2017,Stoke City,Julien Ngoy,BEL,MF,19,1997,0.2,1,1,0,1,0,1,2,50.0,1,0,0,0,0,1,0,0,2018
ENG-Premier League,2017,Stoke City,Kevin Wimmer,AUT,DF,24,1992,14.7,24,17,17,7,0,9,20,45.0,11,25,12,13,30,54,88,0,2018
ENG-Premier League,2017,Stoke City,Kostas Stafylidis,GRE,"DF,MF",23,1993,3.7,12,6,6,4,2,6,9,66.7,3,7,2,5,5,17,19,0,2018
ENG-Premier League,2017,Stoke City,Kurt Zouma,FRA,DF,22,1994,32.1,50,38,35,13,2,21,28,75.0,7,42,23,19,61,111,246,2,2018
ENG-Premier League,2017,Stoke City,Lasse Sørensen,DEN,MF,17,1999,0.8,2,2,2,0,0,1,5,20.0,4,2,0,2,0,2,3,0,2018
ENG-Premier League,2017,Stoke City,Lee Grant,ENG,GK,34,1983,3.0,1,1,1,0,0,1,1,100.0,0,0,0,0,0,1,0,0,2018
ENG-Premier League,2017,Stoke City,Mame Biram Diouf,SEN,"FW,DF",29,1987,28.8,48,36,26,15,7,8,21,38.1,13,22,0,22,14,62,76,1,2018
ENG-Premier League,2017,Stoke City,Moritz Bauer,AUT,"DF,MF",25,1992,14.5,24,17,17,7,0,10,26,38.5,16,9,1,8,12,36,48,0,2018
ENG-Premier League,2017,Stoke City,Peter Crouch,ENG,FW,36,1981,17.4,2,0,0,1,1,0,12,0.0,12,7,4,3,1,3,31,0,2018
ENG-Premier League,2017,Stoke City,Ramadan Sobhi,EGY,"MF,FW",20,1997,13.8,32,21,17,14,1,11,36,30.6,25,14,0,14,14,46,14,0,2018
ENG-Premier League,2017,Stoke City,Ryan Shawcross,ENG,DF,29,1987,26.3,36,20,25,9,2,13,25,52.0,12,33,23,10,40,76,224,1,2018
ENG-Premier League,2017,Stoke City,Saido Berahino,BDI,FW,23,1993,5.5,2,2,0,1,1,0,1,0.0,1,4,1,3,1,3,2,0,2018
ENG-Premier League,2017,Stoke City,Stephen Ireland,IRL,"MF,FW",30,1986,1.5,3,1,2,1,0,1,5,20.0,4,4,2,2,1,4,1,0,2018
ENG-Premier League,2017,Stoke City,Tom Edwards,ENG,"DF,MF",18,1999,5.3,15,9,10,5,0,8,8,100.0,0,5,2,3,5,20,20,0,2018
ENG-Premier League,2017,Stoke City,Tyrese Campbell,ENG,FW,17,1999,0.9,2,1,0,2,0,1,1,100.0,0,1,1,0,1,3,0,0,2018
ENG-Premier League,2017,Stoke City,Xherdan Shaqiri,SUI,"MF,FW",25,1991,33.8,25,17,9,11,5,10,39,25.6,29,9,1,8,16,41,6,2,2018
ENG-Premier League,2017,Swansea City,Alfie Mawson,ENG,DF,23,1994,38.0,32,22,24,8,0,16,27,59.3,11,41,32,9,35,67,229,5,2018
ENG-Premier League,2017,Swansea City,André Ayew,GHA,"MF,FW",27,1989,10.6,15,10,3,10,2,2,13,15.4,11,13,1,12,5,20,8,0,2018
ENG-Premier League,2017,Swansea City,Andy King,WAL,MF,28,1988,7.9,18,11,10,8,0,5,14,35.7,9,7,0,7,6,24,14,1,2018
ENG-Premier League,2017,Swansea City,Connor Roberts,WAL,DF,21,1995,3.0,6,4,5,1,0,3,3,100.0,0,2,0,2,3,9,6,0,2018
ENG-Premier League,2017,Swansea City,Federico Fernández,ARG,DF,28,1989,29.7,40,29,30,6,4,20,30,66.7,10,35,27,8,38,78,201,1,2018
ENG-Premier League,2017,Swansea City,Jay Fulton,SCO,MF,23,1994,0.2,0,0,0,0,0,0,0,,0,0,0,0,0,0,1,0,2018
ENG-Premier League,2017,Swansea City,Jordan Ayew,GHA,"FW,MF",25,1991,31.7,82,60,20,35,27,15,54,27.8,39,43,3,40,24,106,20,1,2018
ENG-Premier League,2017,Swansea City,Ki Sung-yueng,KOR,MF,28,1989,20.8,25,18,10,13,2,4,16,25.0,12,16,1,15,32,57,23,0,2018
ENG-Premier League,2017,Swansea City,Kyle Bartley,ENG,DF,26,1991,2.6,3,2,3,0,0,2,2,100.0,0,6,6,0,4,7,21,0,2018
ENG-Premier League,2017,Swansea City,Kyle Naughton,ENG,DF,28,1988,33.7,92,60,49,35,8,54,100,54.0,46,60,13,47,60,152,144,4,2018
ENG-Premier League,2017,Swansea City,Leon Britton,ENG,MF,34,1982,3.4,6,5,0,5,1,5,8,62.5,3,3,1,2,1,7,1,0,2018
ENG-Premier League,2017,Swansea City,Leroy Fer,NED,MF,27,1990,15.5,44,32,18,21,5,13,30,43.3,17,18,4,14,12,56,24,3,2018
ENG-Premier League,2017,Swansea City,Luciano Narsingh,NED,"FW,MF",26,1990,6.9,7,5,1,5,1,2,7,28.6,5,7,0,7,3,10,3,0,2018
ENG-Premier League,2017,Swansea City,Martin Olsson,SWE,DF,29,1988,35.0,34,26,18,10,6,12,29,41.4,17,21,4,17,31,65,81,0,2018
ENG-Premier League,2017,Swansea City,Mike van der Hoorn,NED,DF,24,1992,21.6,32,22,23,8,1,16,24,66.7,8,24,14,10,39,71,127,0,2018
ENG-Premier League,2017,Swansea City,Nathan Dyer,ENG,"MF,FW",29,1987,14.5,22,16,8,9,5,6,24,25.0,18,13,0,13,11,33,3,0,2018
ENG-Premier League,2017,Swansea City,Oliver McBurnie,SCO,"FW,MF",21,1996,3.1,4,3,0,2,2,1,3,33.3,2,2,0,2,0,4,3,0,2018
ENG-Premier League,2017,Swansea City,Renato Sanches,POR,MF,19,1997,7.8,12,7,6,6,0,6,18,33.3,12,9,1,8,7,19,5,1,2018
ENG-Premier League,2017,Swansea City,Roque Mesa,ESP,MF,28,1989,8.4,20,13,8,8,4,10,37,27.0,27,6,0,6,13,33,8,1,2018
ENG-Premier League,2017,Swansea City,Sam Clucas,ENG,MF,26,1990,22.7,34,19,21,11,2,10,29,34.5,19,31,7,24,29,63,34,1,2018
ENG-Premier League,2017,Swansea City,Tammy Abraham,ENG,FW,19,1997,19.2,10,8,1,7,2,1,13,7.7,12,8,1,7,1,11,11,0,2018
ENG-Premier League,2017,Swansea City,Tom Carroll,ENG,MF,25,1992,28.6,53,33,22,23,8,14,53,26.4,39,37,8,29,29,82,18,1,2018
ENG-Premier League,2017,Swansea City,Wayne Routledge,ENG,"MF,FW",32,1985,4.8,10,5,2,6,2,2,8,25.0,6,5,0,5,2,12,5,0,2018
ENG-Premier League,2017,Swansea City,Wilfried Bony,CIV,FW,28,1988,7.9,5,4,2,2,1,1,5,20.0,4,4,1,3,2,7,15,0,2018
ENG-Premier League,2017,Swansea City,Àngel Rangel,ESP,DF,34,1982,1.7,4,3,2,2,0,1,3,33.3,2,0,0,0,3,7,4,0,2018
ENG-Premier League,2017,Swansea City,Łukasz Fabiański,POL,GK,32,1985,38.0,0,0,0,0,0,0,0,,0,0,0,0,0,0,10,2,2018
ENG-Premier League,2017,Tottenham,Ben Davies,WAL,DF,24,1993,25.8,47,33,13,21,13,25,48,52.1,23,24,5,19,28,75,70,1,2018
ENG-Premier League,2017,Tottenham,Christian Eriksen,DEN,"MF,FW",25,1992,35.8,51,29,16,30,5,17,59,28.8,42,38,1,37,31,82,21,0,2018
ENG-Premier League,2017,Tottenham,Danny Rose,ENG,DF,27,1990,8.9,15,11,6,7,2,8,15,53.3,7,12,6,6,9,24,15,0,2018
ENG-Premier League,2017,Tottenham,Davinson Sánchez,COL,DF,21,1996,28.2,38,24,28,9,1,18,40,45.0,22,26,10,16,38,76,162,0,2018
ENG-Premier League,2017,Tottenham,Dele Alli,ENG,"MF,FW",21,1996,32.9,46,30,15,21,10,8,34,23.5,26,33,7,26,19,65,22,1,2018
ENG-Premier League,2017,Tottenham,Eric Dier,ENG,"MF,DF",23,1994,31.4,61,43,15,39,7,17,42,40.5,25,32,11,21,48,109,93,7,2018
ENG-Premier League,2017,Tottenham,Fernando Llorente,ESP,"FW,MF",32,1985,2.6,6,3,1,2,3,1,2,50.0,1,0,0,0,0,6,6,0,2018
ENG-Premier League,2017,Tottenham,Georges-Kévin N'Koudou,CMR,MF,22,1995,0.0,0,0,0,0,0,0,0,,0,0,0,0,0,0,1,0,2018
ENG-Premier League,2017,Tottenham,Harry Kane,ENG,FW,24,1993,34.2,17,12,2,8,7,4,15,26.7,11,15,4,11,5,22,19,0,2018
ENG-Premier League,2017,Tottenham,Harry Winks,ENG,MF,21,1996,8.6,15,12,8,5,2,8,16,50.0,8,12,2,10,11,26,10,1,2018
ENG-Premier League,2017,Tottenham,Hugo Lloris,FRA,GK,30,1986,36.0,1,1,1,0,0,1,4,25.0,3,0,0,0,2,3,34,8,2018
ENG-Premier League,2017,Tottenham,Jan Vertonghen,BEL,DF,30,1987,35.6,64,41,40,20,4,25,36,69.4,11,29,11,18,60,124,177,0,2018
ENG-Premier League,2017,Tottenham,Kieran Trippier,ENG,DF,26,1990,21.3,52,30,29,21,2,21,44,47.7,23,31,6,25,20,72,53,1,2018
ENG-Premier League,2017,Tottenham,Kyle Walker-Peters,ENG,DF,20,1997,2.1,5,4,4,1,0,2,4,50.0,2,2,0,2,3,8,8,0,2018
ENG-Premier League,2017,Tottenham,Lucas Moura,BRA,"FW,MF",24,1992,2.3,4,2,3,0,1,1,3,33.3,2,2,0,2,2,6,2,0,2018
ENG-Premier League,2017,Tottenham,Michel Vorm,NED,GK,33,1983,1.0,0,0,0,0,0,0,0,,0,0,0,0,0,0,1,0,2018
ENG-Premier League,2017,Tottenham,Mousa Dembélé,BEL,MF,30,1987,20.9,36,24,19,11,6,9,37,24.3,28,20,0,20,33,69,15,0,2018
ENG-Premier League,2017,Tottenham,Moussa Sissoko,FRA,"MF,FW",27,1989,15.4,23,17,14,5,4,9,12,75.0,3,11,1,10,9,32,23,1,2018
ENG-Premier League,2017,Tottenham,Paulo Gazzaniga,ARG,GK,25,1992,1.0,0,0,0,0,0,0,1,0.0,1,0,0,0,0,0,0,0,2018
ENG-Premier League,2017,Tottenham,Serge Aurier,CIV,DF,24,1992,15.9,48,27,27,13,8,11,31,35.5,20,20,1,19,31,79,54,1,2018
ENG-Premier League,2017,Tottenham,Son Heung-min,KOR,FW,25,1992,25.7,17,10,2,12,3,2,28,7.1,26,18,0,18,10,27,12,0,2018
ENG-Premier League,2017,Tottenham,Toby Alderweireld,BEL,DF,28,1989,13.1,19,13,7,11,1,8,15,53.3,7,11,5,6,4,23,55,0,2018
ENG-Premier League,2017,Tottenham,Victor Wanyama,KEN,MF,26,1991,9.4,30,20,13,16,1,14,31,45.2,17,13,3,10,10,40,20,1,2018
ENG-Premier League,2017,Tottenham,Vincent Janssen,NED,DF,23,1994,0.0,0,0,0,0,0,0,0,,0,0,0,0,0,0,0,0,2018
ENG-Premier League,2017,Tottenham,Érik Lamela,ARG,"FW,MF",25,1992,9.4,23,13,9,7,7,3,20,15.0,17,11,1,10,7,30,5,0,2018
ENG-Premier League,2017,Watford,Abdoulaye Doucouré,MLI,MF,24,1993,36.9,79,52,28,42,9,27,79,34.2,52,43,10,33,54,133,61,0,2018
ENG-Premier League,2017,Watford,Adrian Mariappa,JAM,DF,30,1986,24.6,45,26,33,12,0,14,34,41.2,20,25,16,9,45,90,133,4,2018
ENG-Premier League,2017,Watford,Andre Gray,JAM,FW,26,1991,16.6,2,1,0,1,1,0,3,0.0,3,11,0,11,4,6,3,0,2018
ENG-Premier League,2017,Watford,André Carrillo,PER,"FW,MF",26,1991,17.1,31,24,16,12,3,8,33,24.2,25,7,0,7,15,46,16,0,2018
ENG-Premier League,2017,Watford,Ben Watson,ENG,MF,32,1985,5.1,19,9,9,9,1,10,31,32.3,21,6,1,5,7,26,10,0,2018
ENG-Premier League,2017,Watford,Christian Kabasele,BEL,DF,26,1991,25.9,42,25,28,14,0,21,36,58.3,15,37,23,14,34,76,185,0,2018
ENG-Premier League,2017,Watford,Craig Cathcart,NIR,DF,28,1989,5.8,8,5,5,3,0,4,5,80.0,1,8,6,2,3,11,38,0,2018
ENG-Premier League,2017,Watford,Daryl Janmaat,NED,DF,28,1989,20.2,46,31,29,10,7,22,52,42.3,30,16,5,11,33,79,61,0,2018
ENG-Premier League,2017,Watford,Dodi Lukebakio,BEL,"MF,FW",19,1997,0.2,1,0,1,0,0,0,0,,0,0,0,0,0,1,0,0,2018
ENG-Premier League,2017,Watford,Gerard Deulofeu,ESP,"FW,MF",23,1994,4.8,5,3,2,2,1,2,11,18.2,9,0,0,0,4,9,3,1,2018
ENG-Premier League,2017,Watford,Heurelho Gomes,BRA,GK,36,1981,23.6,0,0,0,0,0,0,1,0.0,1,1,0,1,2,2,15,3,2018
ENG-Premier League,2017,Watford,Jerome Sinclair,ENG,"MF,FW",20,1996,0.3,0,0,0,0,0,0,1,0.0,1,0,0,0,1,1,0,0,2018
ENG-Premier League,2017,Watford,José Holebas,GRE,DF,33,1984,26.5,51,31,34,14,3,18,44,40.9,26,24,8,16,29,80,95,2,2018
ENG-Premier League,2017,Watford,Kiko Femenía,ESP,"DF,FW",26,1991,19.0,36,28,22,11,3,14,27,51.9,13,15,2,13,34,70,31,1,2018
ENG-Premier League,2017,Watford,Marvin Zeegelaar,NED,DF,26,1990,11.0,23,18,15,3,5,11,24,45.8,13,5,1,4,20,43,30,0,2018
ENG-Premier League,2017,Watford,Miguel Britos,URU,DF,32,1985,8.9,15,11,10,5,0,6,11,54.5,5,9,1,8,12,27,45,1,2018
ENG-Premier League,2017,Watford,Molla Wagué,MLI,DF,26,1991,4.9,5,3,3,2,0,2,5,40.0,3,1,0,1,9,14,30,0,2018
ENG-Premier League,2017,Watford,Nathaniel Chalobah,ENG,MF,22,1994,5.0,9,6,2,6,1,2,5,40.0,3,6,5,1,6,15,6,0,2018
ENG-Premier League,2017,Watford,Nordin Amrabat,MAR,FW,30,1987,2.2,6,3,1,5,0,1,3,33.3,2,1,0,1,0,6,2,0,2018
ENG-Premier League,2017,Watford,Orestis Karnezis,GRE,GK,32,1985,14.4,0,0,0,0,0,0,2,0.0,2,0,0,0,1,1,3,3,2018
ENG-Premier League,2017,Watford,Richarlison,BRA,"FW,MF",20,1997,31.4,64,44,26,28,10,10,39,25.6,29,39,5,34,24,88,32,1,2018
ENG-Premier League,2017,Watford,Roberto Pereyra,ARG,"MF,FW",26,1991,18.0,10,8,4,5,1,2,13,15.4,11,16,0,16,9,19,6,0,2018
ENG-Premier League,2017,Watford,Sebastian Prödl,AUT,DF,30,1987,17.4,22,17,19,3,0,8,15,53.3,7,20,9,11,31,53,92,1,2018
ENG-Premier League,2017,Watford,Stefano Okaka,ITA,FW,27,1989,5.0,6,4,0,6,0,3,6,50.0,3,3,0,3,0,6,0,0,2018
ENG-Premier League,2017,Watford,Tom Cleverley,ENG,MF,27,1989,21.1,48,26,25,16,7,21,52,40.4,31,11,1,10,25,73,21,0,2018
ENG-Premier League,2017,Watford,Troy Deeney,ENG,FW,29,1988,20.5,15,11,3,8,4,3,11,27.3,8,14,1,13,5,20,20,0,2018
ENG-Premier League,2017,Watford,Will Hughes,ENG,MF,22,1995,11.0,34,18,7,18,9,9,19,47.4,10,16,1,15,15,49,6,0,2018
ENG-Premier League,2017,Watford,Younès Kaboul,FRA,DF,31,1986,1.7,3,2,0,3,0,0,0,,0,4,2,2,2,5,15,0,2018
ENG-Premier League,2017,Watford,Étienne Capoue,FRA,MF,29,1988,17.1,43,26,15,25,3,19,47,40.4,28,21,1,20,43,86,38,0,2018
ENG-Premier League,2017,West Brom,Ahmed Hegazi,EGY,DF,26,1991,37.6,58,38,46,12,0,26,50,52.0,24,55,37,18,60,118,278,2,2018
ENG-Premier League,2017,West Brom,Allan Nyom,CMR,DF,29,1988,25.7,64,39,43,17,4,28,43,65.1,15,20,9,11,27,91,93,0,2018
ENG-Premier League,2017,West Brom,Ben Foster,ENG,GK,34,1983,37.0,1,0,1,0,0,0,7,0.0,7,0,0,0,1,2,12,1,2018
ENG-Premier League,2017,West Brom,Boaz Myhill,WAL,GK,34,1982,1.0,0,0,0,0,0,0,0,,0,0,0,0,0,0,1,0,2018
ENG-Premier League,2017,West Brom,Chris Brunt,NIR,"MF,DF",32,1984,21.3,41,24,19,21,1,11,31,35.5,20,28,4,24,22,63,45,1,2018
ENG-Premier League,2017,West Brom,Claudio Yacob,ARG,MF,30,1987,10.0,36,27,23,13,0,13,27,48.1,14,14,6,8,16,52,25,2,2018
ENG-Premier League,2017,West Brom,Craig Dawson,ENG,DF,27,1990,27.9,38,28,25,7,6,13,36,36.1,23,39,26,13,52,90,140,0,2018
ENG-Premier League,2017,West Brom,Daniel Sturridge,ENG,FW,27,1989,1.3,0,0,0,0,0,0,0,,0,0,0,0,0,0,0,0,2018
ENG-Premier League,2017,West Brom,Gareth Barry,ENG,MF,36,1981,21.4,35,19,17,14,4,15,45,33.3,30,19,11,8,14,49,34,0,2018
ENG-Premier League,2017,West Brom,Gareth McAuley,NIR,DF,37,1979,5.1,8,7,6,2,0,3,7,42.9,4,7,4,3,11,19,16,0,2018
ENG-Premier League,2017,West Brom,Grzegorz Krychowiak,POL,MF,27,1990,18.2,39,24,18,17,4,12,49,24.5,37,23,5,18,45,84,23,0,2018
ENG-Premier League,2017,West Brom,Hal Robson-Kanu,WAL,"FW,MF",28,1989,9.2,5,4,1,2,2,0,13,0.0,13,9,3,6,4,9,9,0,2018
ENG-Premier League,2017,West Brom,Jake Livermore,ENG,MF,27,1989,29.7,72,41,27,35,10,24,64,37.5,40,44,9,35,26,98,36,2,2018
ENG-Premier League,2017,West Brom,James McClean,IRL,"MF,FW",28,1989,15.6,40,28,23,14,3,10,55,18.2,45,18,4,14,20,60,22,0,2018
ENG-Premier League,2017,West Brom,James Morrison,SCO,MF,31,1986,2.3,2,1,0,2,0,1,4,25.0,3,1,1,0,1,3,1,0,2018
ENG-Premier League,2017,West Brom,Jay Rodriguez,ENG,"FW,MF",28,1989,31.2,31,21,12,11,8,9,50,18.0,41,32,2,30,19,50,41,0,2018
ENG-Premier League,2017,West Brom,Jonny Evans,NIR,DF,29,1988,25.2,29,22,19,8,2,14,33,42.4,19,22,13,9,48,77,131,1,2018
ENG-Premier League,2017,West Brom,Kieran Gibbs,ENG,DF,27,1989,31.4,41,24,27,10,4,16,30,53.3,14,32,12,20,48,89,102,0,2018
ENG-Premier League,2017,West Brom,Matt Phillips,SCO,"MF,DF",26,1991,23.3,27,16,17,5,5,10,29,34.5,19,21,1,20,24,51,43,0,2018
ENG-Premier League,2017,West Brom,Nacer Chadli,BEL,"FW,MF",27,1989,2.9,1,0,1,0,0,1,4,25.0,3,0,0,0,0,1,4,0,2018
ENG-Premier League,2017,West Brom,Oliver Burke,SCO,"FW,MF",20,1997,4.1,6,4,3,2,1,4,12,33.3,8,3,0,3,7,13,3,0,2018
ENG-Premier League,2017,West Brom,Rekeem Harper,ENG,MF,17,2000,0.2,1,1,0,1,0,0,0,,0,0,0,0,0,1,0,0,2018
ENG-Premier League,2017,West Brom,Salomón Rondón,VEN,FW,27,1989,30.7,14,6,0,7,7,5,26,19.2,21,27,0,27,14,28,20,0,2018
ENG-Premier League,2017,West Brom,Sam Field,ENG,MF,19,1998,6.0,14,11,8,4,2,3,10,30.0,7,6,1,5,11,25,8,0,2018
ENG-Premier League,2017,West Ham,Aaron Cresswell,ENG,DF,27,1989,34.1,34,21,12,20,2,19,30,63.3,11,42,17,25,44,78,117,1,2018
ENG-Premier League,2017,West Ham,Adrián,ESP,GK,30,1987,19.0,2,1,2,0,0,1,4,25.0,3,1,0,1,0,2,15,1,2018
ENG-Premier League,2017,West Ham,André Ayew,GHA,"MF,FW",27,1989,9.9,19,14,6,10,3,6,19,31.6,13,5,0,5,4,23,3,0,2018
ENG-Premier League,2017,West Ham,Andy Carroll,ENG,FW,28,1989,8.3,3,3,2,0,1,0,1,0.0,1,3,2,1,2,5,15,0,2018
ENG-Premier League,2017,West Ham,Angelo Ogbonna,ITA,DF,29,1988,32.0,30,24,18,10,2,8,18,44.4,10,40,27,13,58,88,197,1,2018
ENG-Premier League,2017,West Ham,Arthur Masuaku,COD,DF,23,1993,20.8,58,37,36,16,6,25,58,43.1,33,25,2,23,26,84,38,1,2018
ENG-Premier League,2017,West Ham,Cheikhou Kouyaté,SEN,MF,27,1989,31.1,71,49,43,26,2,23,62,37.1,39,31,11,20,32,103,56,1,2018
ENG-Premier League,2017,West Ham,Declan Rice,ENG,"DF,MF",18,1999,15.9,36,24,25,10,1,15,25,60.0,10,19,13,6,27,63,77,1,2018
ENG-Premier League,2017,West Ham,Diafra Sakho,SEN,FW,27,1989,3.4,5,2,1,4,0,0,3,0.0,3,3,0,3,1,6,2,0,2018
ENG-Premier League,2017,West Ham,Edimilson Fernandes,SUI,"MF,DF",21,1996,9.4,17,9,10,7,0,9,21,42.9,12,13,1,12,16,33,8,0,2018
ENG-Premier League,2017,West Ham,James Collins,WAL,DF,33,1983,11.7,15,9,11,4,0,8,11,72.7,3,13,10,3,16,31,120,1,2018
ENG-Premier League,2017,West Ham,Javier Hernández,MEX,FW,29,1988,17.2,11,7,2,7,2,3,14,21.4,11,6,1,5,6,17,1,0,2018
ENG-Premier League,2017,West Ham,Joe Hart,ENG,GK,30,1987,19.0,1,1,1,0,0,1,2,50.0,1,1,0,1,0,1,2,4,2018
ENG-Premier League,2017,West Ham,Jordan Hugill,ENG,FW,25,1992,0.3,0,0,0,0,0,0,1,0.0,1,0,0,0,0,0,0,0,2018
ENG-Premier League,2017,West Ham,Josh Cullen,IRL,MF,21,1996,0.1,0,0,0,0,0,0,1,0.0,1,1,1,0,2,2,0,0,2018
ENG-Premier League,2017,West Ham,José Fonte,POR,DF,33,1983,7.6,11,6,5,6,0,2,6,33.3,4,12,9,3,14,25,37,1,2018
ENG-Premier League,2017,West Ham,João Mário,POR,MF,24,1993,11.4,14,11,6,5,3,6,19,31.6,13,7,0,7,8,22,4,1,2018
ENG-Premier League,2017,West Ham,Manuel Lanzini,ARG,"MF,FW",24,1993,22.7,20,11,6,11,3,2,34,5.9,32,7,1,6,30,50,5,2,2018
ENG-Premier League,2017,West Ham,Mark Noble,ENG,MF,30,1987,26.7,61,36,32,22,7,16,76,21.1,60,28,10,18,47,108,32,1,2018
ENG-Premier League,2017,West Ham,Marko Arnautović,AUT,"FW,MF",28,1989,25.7,21,16,9,8,4,7,19,36.8,12,20,3,17,13,34,35,0,2018
ENG-Premier League,2017,West Ham,Michail Antonio,JAM,"FW,MF",27,1990,15.0,15,9,7,6,2,4,14,28.6,10,14,0,14,13,28,16,0,2018
ENG-Premier League,2017,West Ham,Pablo Zabaleta,ARG,"DF,MF",32,1985,36.5,96,67,54,28,14,48,98,49.0,50,72,13,59,61,157,152,0,2018
ENG-Premier League,2017,West Ham,Patrice Evra,FRA,"DF,MF",36,1981,2.5,6,4,5,1,0,6,8,75.0,2,4,1,3,7,13,6,0,2018
ENG-Premier League,2017,West Ham,Pedro Obiang,EQG,MF,25,1992,17.4,53,34,20,29,4,17,51,33.3,34,37,16,21,24,77,27,1,2018
ENG-Premier League,2017,West Ham,Reece Oxford,ENG,MF,18,1998,0.1,2,1,1,1,0,1,1,100.0,0,0,0,0,0,2,0,0,2018
ENG-Premier League,2017,West Ham,Sam Byram,ENG,"DF,MF",23,1993,2.8,9,5,6,3,0,4,9,44.4,5,6,2,4,9,18,16,0,2018
ENG-Premier League,2017,West Ham,Winston Reid,NZL,DF,29,1988,16.1,11,9,7,4,0,4,15,26.7,11,27,14,13,22,33,104,0,2018
ENG-Premier League,2018,Arsenal,Aaron Ramsey,WAL,MF,27,1990,14.8,34,18,11,15,8,7,25,28.0,18,7,1,6,9,43,3,0,2019
ENG-Premier League,2018,Arsenal,Ainsley Maitland-Niles,ENG,DF,20,1997,11.0,33,22,19,12,2,14,28,50.0,14,22,4,18,19,52,15,2,2019
ENG-Premier League,2018,Arsenal,Alex Iwobi,NGA,"FW,MF",22,1996,21.9,28,14,10,16,2,6,25,24.0,19,21,1,20,12,40,13,1,2019
ENG-Premier League,2018,Arsenal,Alexandre Lacazette,FRA,FW,27,1991,27.8,35,16,6,19,10,5,28,17.9,23,27,1,26,15,50,31,0,2019
ENG-Premier League,2018,Arsenal,Bernd Leno,GER,GK,26,1992,31.5,0,0,0,0,0,0,3,0.0,3,0,0,0,4,4,16,6,2019
ENG-Premier League,2018,Arsenal,Bukayo Saka,ENG,FW,16,2001,0.1,0,0,0,0,0,0,0,,0,0,0,0,0,0,0,0,2019
ENG-Premier League,2018,Arsenal,Carl Jenkinson,ENG,DF,26,1992,1.8,3,2,2,0,1,2,3,66.7,1,4,3,1,0,3,2,0,2019
ENG-Premier League,2018,Arsenal,Danny Welbeck,ENG,"FW,MF",27,1990,1.7,3,2,0,2,1,0,0,,0,2,0,2,1,4,2,0,2019
ENG-Premier League,2018,Arsenal,Denis Suárez,ESP,"MF,FW",24,1994,0.8,1,1,0,1,0,0,5,0.0,5,0,0,0,1,2,0,0,2019
ENG-Premier League,2018,Arsenal,Eddie Nketiah,ENG,"MF,FW",19,1999,0.7,1,1,0,1,0,0,0,,0,0,0,0,0,1,1,0,2019
ENG-Premier League,2018,Arsenal,Granit Xhaka,SUI,"MF,DF",25,1992,27.8,52,29,29,20,3,24,59,40.7,35,35,9,26,36,88,56,3,2019
ENG-Premier League,2018,Arsenal,Henrikh Mkhitaryan,ARM,"FW,MF",29,1989,18.2,28,22,8,17,3,6,22,27.3,16,34,2,32,16,44,13,0,2019
ENG-Premier League,2018,Arsenal,Héctor Bellerín,ESP,DF,23,1995,17.0,15,12,8,4,3,6,13,46.2,7,17,5,12,20,35,37,3,2019
ENG-Premier League,2018,Arsenal,Joe Willock,ENG,"MF,FW",18,1999,0.7,1,0,0,1,0,0,0,,0,1,0,1,1,2,0,0,2019
ENG-Premier League,2018,Arsenal,Konstantinos Mavropanos,GRE,DF,20,1997,1.6,1,0,0,1,0,1,1,100.0,0,1,1,0,7,8,5,0,2019
ENG-Premier League,2018,Arsenal,Laurent Koscielny,FRA,DF,32,1985,14.8,19,11,9,9,1,10,16,62.5,6,20,15,5,30,49,72,0,2019
ENG-Premier League,2018,Arsenal,Lucas Torreira,URU,MF,22,1996,26.5,65,39,24,32,9,25,57,43.9,32,34,7,27,41,106,33,2,2019
ENG-Premier League,2018,Arsenal,Mattéo Guendouzi,FRA,MF,19,1999,23.9,44,26,18,23,3,17,47,36.2,30,28,5,23,30,74,24,3,2019
ENG-Premier League,2018,Arsenal,Mesut Özil,GER,"MF,FW",29,1988,19.3,12,5,6,3,3,3,21,14.3,18,10,2,8,4,16,5,0,2019
ENG-Premier League,2018,Arsenal,Mohamed Elneny,EGY,MF,26,1992,4.2,13,4,9,1,3,1,2,50.0,1,7,4,3,2,15,8,0,2019
ENG-Premier League,2018,Arsenal,Nacho Monreal,ESP,DF,32,1986,20.7,35,17,21,9,5,15,25,60.0,10,28,10,18,31,66,62,0,2019
ENG-Premier League,2018,Arsenal,Petr Čech,CZE,GK,36,1982,6.5,1,1,1,0,0,1,1,100.0,0,0,0,0,0,1,5,2,2019
ENG-Premier League,2018,Arsenal,Pierre-Emerick Aubameyang,GAB,FW,29,1989,30.3,21,17,6,9,6,8,28,28.6,20,26,0,26,8,29,22,0,2019
ENG-Premier League,2018,Arsenal,Rob Holding,ENG,DF,22,1995,9.0,11,7,9,2,0,2,8,25.0,6,9,7,2,12,23,40,0,2019
ENG-Premier League,2018,Arsenal,Sead Kolašinac,BIH,"DF,MF",25,1993,21.0,34,21,21,7,6,20,34,58.8,14,12,3,9,20,54,28,3,2019
ENG-Premier League,2018,Arsenal,Shkodran Mustafi,GER,DF,26,1992,29.0,62,45,42,17,3,31,40,77.5,9,34,17,17,58,120,168,1,2019
ENG-Premier League,2018,Arsenal,Sokratis Papastathopoulos,GRE,DF,30,1988,24.4,42,25,30,11,1,15,28,53.6,13,34,17,17,26,68,112,1,2019
ENG-Premier League,2018,Arsenal,Stephan Lichtsteiner,SUI,DF,34,1984,10.4,15,9,5,4,6,9,16,56.3,7,11,4,7,9,24,25,1,2019
ENG-Premier League,2018,Bournemouth,Adam Smith,ENG,"DF,MF",27,1991,23.0,46,32,26,14,6,19,41,46.3,22,26,7,19,31,77,68,1,2019
ENG-Premier League,2018,Bournemouth,Andrew Surman,ENG,MF,31,1986,16.0,11,6,6,5,0,3,13,23.1,10,20,7,13,10,21,34,1,2019
ENG-Premier League,2018,Bournemouth,Artur Boruc,POL,GK,38,1980,12.0,1,0,1,0,0,1,3,33.3,2,0,0,0,0,1,1,0,2019
ENG-Premier League,2018,Bournemouth,Asmir Begović,BIH,GK,31,1987,24.0,0,0,0,0,0,0,3,0.0,3,1,0,1,1,1,15,7,2019
ENG-Premier League,2018,Bournemouth,Callum Wilson,ENG,FW,26,1992,28.1,9,7,4,3,2,0,8,0.0,8,14,4,10,4,13,16,0,2019
ENG-Premier League,2018,Bournemouth,Charlie Daniels,ENG,DF,31,1986,17.6,25,15,18,6,1,13,22,59.1,9,14,4,10,20,45,56,2,2019
ENG-Premier League,2018,Bournemouth,Chris Mepham,WAL,DF,20,1997,9.4,9,3,9,0,0,7,11,63.6,4,12,5,7,14,23,57,2,2019
ENG-Premier League,2018,Bournemouth,Dan Gosling,ENG,MF,28,1990,19.3,57,23,27,21,9,28,53,52.8,25,33,11,22,20,77,46,1,2019
ENG-Premier League,2018,Bournemouth,David Brooks,WAL,"MF,FW",21,1997,25.1,37,26,12,19,6,19,44,43.2,25,36,7,29,24,61,28,0,2019
ENG-Premier League,2018,Bournemouth,Diego Rico,ESP,"DF,MF",25,1993,6.8,14,9,8,2,4,4,12,33.3,8,13,2,11,14,28,20,0,2019
ENG-Premier League,2018,Bournemouth,Dominic Solanke,ENG,"FW,MF",20,1997,3.9,8,3,1,4,3,1,8,12.5,7,4,1,3,2,10,9,0,2019
ENG-Premier League,2018,Bournemouth,Emerson Hyndman,USA,MF,22,1996,0.4,6,2,6,0,0,2,3,66.7,1,0,0,0,1,7,0,0,2019
ENG-Premier League,2018,Bournemouth,Jack Simpson,ENG,DF,21,1996,4.5,9,5,8,1,0,6,9,66.7,3,5,4,1,9,18,25,2,2019
ENG-Premier League,2018,Bournemouth,Jefferson Lerma,COL,MF,23,1994,27.8,45,31,20,20,5,14,54,25.9,40,35,19,16,54,99,88,1,2019
ENG-Premier League,2018,Bournemouth,Jermain Defoe,ENG,FW,35,1982,0.3,0,0,0,0,0,0,0,,0,0,0,0,0,0,0,0,2019
ENG-Premier League,2018,Bournemouth,Jordon Ibe,ENG,"MF,DF",22,1995,8.9,6,5,0,5,1,2,7,28.6,5,2,0,2,4,10,4,0,2019
ENG-Premier League,2018,Bournemouth,Joshua King,NOR,"FW,MF",26,1992,32.9,30,19,7,19,4,8,29,27.6,21,28,4,24,7,37,14,0,2019
ENG-Premier League,2018,Bournemouth,Junior Stanislas,ENG,"MF,FW",28,1989,11.5,12,6,5,4,3,3,7,42.9,4,8,1,7,2,14,15,0,2019
ENG-Premier League,2018,Bournemouth,Lewis Cook,ENG,MF,21,1997,8.0,13,6,6,7,0,8,19,42.1,11,8,2,6,8,21,7,1,2019
ENG-Premier League,2018,Bournemouth,Lys Mousset,FRA,FW,22,1996,4.1,3,1,1,1,1,1,4,25.0,3,3,0,3,1,4,3,0,2019
ENG-Premier League,2018,Bournemouth,Mark Travers,IRL,GK,19,1999,2.0,0,0,0,0,0,0,0,,0,0,0,0,0,0,2,0,2019
ENG-Premier League,2018,Bournemouth,Nathan Aké,NED,DF,23,1995,37.9,66,35,42,21,3,22,35,62.9,13,51,35,16,32,98,241,0,2019
ENG-Premier League,2018,Bournemouth,Nathaniel Clyne,ENG,DF,27,1991,12.7,33,18,16,14,3,11,23,47.8,12,13,3,10,16,49,33,1,2019
ENG-Premier League,2018,Bournemouth,Ryan Fraser,SCO,"MF,FW",24,1994,35.2,19,11,9,8,2,10,32,31.3,22,23,6,17,22,41,33,0,2019
ENG-Premier League,2018,Bournemouth,Sam Surridge,ENG,"MF,FW",20,1998,0.1,1,0,0,0,1,0,0,,0,0,0,0,0,1,0,0,2019
ENG-Premier League,2018,Bournemouth,Simon Francis,ENG,DF,33,1985,13.7,25,14,19,5,1,12,24,50.0,12,15,7,8,19,44,73,1,2019
ENG-Premier League,2018,Bournemouth,Steve Cook,ENG,DF,27,1991,31.0,36,19,31,5,0,20,27,74.1,7,36,21,15,50,86,202,1,2019
ENG-Premier League,2018,Bournemouth,Tyrone Mings,ENG,DF,25,1993,1.6,4,3,3,1,0,2,3,66.7,1,5,2,3,6,10,8,0,2019
ENG-Premier League,2018,Brighton,Alireza Jahanbakhsh,IRN,"FW,MF",24,1993,11.3,32,18,17,11,4,11,30,36.7,19,16,0,16,11,43,4,0,2019
ENG-Premier League,2018,Brighton,Anthony Knockaert,FRA,"MF,FW",26,1991,20.4,33,21,12,15,6,13,30,43.3,17,13,0,13,29,62,11,0,2019
ENG-Premier League,2018,Brighton,Beram Kayal,ISR,MF,30,1988,10.4,28,17,16,11,1,5,21,23.8,16,17,10,7,15,43,25,0,2019
ENG-Premier League,2018,Brighton,Bernardo,BRA,DF,23,1995,19.5,62,43,43,13,6,31,45,68.9,14,32,13,19,34,96,82,0,2019
ENG-Premier League,2018,Brighton,Bruno,ESP,DF,37,1980,12.6,25,16,20,3,2,14,18,77.8,4,7,2,5,11,36,30,1,2019
ENG-Premier League,2018,Brighton,Dale Stephens,ENG,MF,29,1989,27.6,83,57,37,41,5,28,74,37.8,46,33,13,20,46,129,47,0,2019
ENG-Premier League,2018,Brighton,David Button,ENG,GK,29,1989,4.0,0,0,0,0,0,0,0,,0,0,0,0,0,0,2,0,2019
ENG-Premier League,2018,Brighton,Davy Pröpper,NED,MF,26,1991,28.3,50,28,23,21,6,16,52,30.8,36,21,6,15,53,103,37,0,2019
ENG-Premier League,2018,Brighton,Florin Andone,ROU,FW,25,1993,9.8,10,2,3,4,3,1,6,16.7,5,9,1,8,3,13,12,0,2019
ENG-Premier League,2018,Brighton,Gaëtan Bong,CMR,DF,30,1988,20.1,16,10,7,6,3,6,10,60.0,4,16,6,10,25,41,57,2,2019
ENG-Premier League,2018,Brighton,Glenn Murray,ENG,FW,34,1983,27.9,17,7,4,7,6,4,20,20.0,16,20,3,17,2,19,17,1,2019
ENG-Premier League,2018,Brighton,José Izquierdo,COL,"MF,FW",26,1992,8.8,15,9,9,4,2,10,20,50.0,10,7,1,6,5,20,7,0,2019
ENG-Premier League,2018,Brighton,Jürgen Locadia,NED,"FW,MF",24,1993,13.7,15,10,5,8,2,3,7,42.9,4,8,0,8,9,24,13,0,2019
ENG-Premier League,2018,Brighton,Leon Balogun,NGA,DF,30,1988,6.6,12,6,11,1,0,8,9,88.9,1,5,3,2,17,29,32,1,2019
ENG-Premier League,2018,Brighton,Lewis Dunk,ENG,DF,26,1991,35.0,42,26,31,10,1,17,39,43.6,22,49,38,11,46,88,196,5,2019
ENG-Premier League,2018,Brighton,Martín Montoya,ESP,DF,27,1991,24.1,58,35,29,21,8,32,55,58.2,23,30,10,20,48,106,76,1,2019
ENG-Premier League,2018,Brighton,Mathew Ryan,AUS,GK,26,1992,34.0,1,0,1,0,0,1,2,50.0,1,0,0,0,0,1,13,1,2019
ENG-Premier League,2018,Brighton,Pascal Groß,GER,"MF,FW",27,1991,20.7,27,12,12,12,3,11,36,30.6,25,20,8,12,13,40,23,0,2019
ENG-Premier League,2018,Brighton,Shane Duffy,IRL,DF,26,1992,34.3,35,20,23,7,5,14,25,56.0,11,57,47,10,36,71,244,3,2019
ENG-Premier League,2018,Brighton,Solly March,ENG,"FW,MF",24,1994,27.4,56,24,27,16,13,19,45,42.2,26,34,4,30,27,83,44,0,2019
ENG-Premier League,2018,Brighton,Yves Bissouma,MLI,MF,21,1996,19.7,62,30,33,27,2,20,38,52.6,18,21,5,16,33,95,29,2,2019
ENG-Premier League,2018,Burnley,Aaron Lennon,ENG,MF,31,1987,13.5,26,16,11,12,3,6,14,42.9,8,24,0,24,10,36,18,0,2019
ENG-Premier League,2018,Burnley,Ashley Barnes,ENG,FW,28,1989,26.5,28,17,4,17,7,6,29,20.7,23,29,8,21,2,30,25,0,2019
ENG-Premier League,2018,Burnley,Ashley Westwood,ENG,MF,28,1990,31.4,58,30,24,27,7,14,39,35.9,25,38,9,29,47,105,42,2,2019
ENG-Premier League,2018,Burnley,Ben Gibson,ENG,DF,25,1993,0.7,1,1,1,0,0,0,0,,0,1,1,0,0,1,2,0,2019
ENG-Premier League,2018,Burnley,Ben Mee,ENG,DF,28,1989,38.0,55,24,38,17,0,35,44,79.5,9,59,50,9,48,103,235,4,2019
ENG-Premier League,2018,Burnley,Charlie Taylor,ENG,DF,24,1993,36.0,55,26,37,15,3,24,50,48.0,26,74,35,39,40,95,120,0,2019
ENG-Premier League,2018,Burnley,Chris Wood,NZL,FW,26,1991,28.8,12,8,0,7,5,5,17,29.4,12,17,4,13,3,15,26,0,2019
ENG-Premier League,2018,Burnley,Dwight McNeil,ENG,MF,18,1999,17.7,36,22,16,17,3,13,44,29.5,31,30,3,27,13,49,35,0,2019
ENG-Premier League,2018,Burnley,Jack Cork,ENG,MF,29,1989,36.8,51,27,12,34,5,18,46,39.1,28,39,16,23,29,80,82,2,2019
ENG-Premier League,2018,Burnley,James Tarkowski,ENG,DF,25,1992,34.3,71,36,52,18,1,29,50,58.0,21,72,56,16,42,113,240,2,2019
ENG-Premier League,2018,Burnley,Jeff Hendrick,IRL,"MF,FW",26,1992,22.9,24,12,13,7,4,9,32,28.1,23,20,5,15,12,36,31,0,2019
ENG-Premier League,2018,Burnley,Joe Hart,ENG,GK,31,1987,19.0,0,0,0,0,0,0,1,0.0,1,0,0,0,0,0,11,3,2019
ENG-Premier League,2018,Burnley,Jóhann Berg Guðmundsson,ISL,MF,27,1990,19.5,27,11,14,10,3,16,34,47.1,18,25,4,21,33,60,34,0,2019
ENG-Premier League,2018,Burnley,Kevin Long,IRL,DF,27,1990,5.7,18,10,13,5,0,7,17,41.2,10,7,5,2,7,25,35,1,2019
ENG-Premier League,2018,Burnley,Matthew Lowton,ENG,DF,29,1989,19.4,56,35,21,31,4,32,60,53.3,28,29,7,22,30,86,80,1,2019
ENG-Premier League,2018,Burnley,Matěj Vydra,CZE,FW,26,1992,3.5,2,1,0,1,1,0,3,0.0,3,4,1,3,1,3,6,0,2019
ENG-Premier League,2018,Burnley,Peter Crouch,ENG,FW,37,1981,1.0,1,1,0,1,0,1,1,100.0,0,0,0,0,0,1,2,0,2019
ENG-Premier League,2018,Burnley,Phil Bardsley,SCO,DF,33,1985,18.6,32,19,15,14,3,12,21,57.1,9,25,12,13,31,63,68,1,2019
ENG-Premier League,2018,Burnley,Robbie Brady,IRL,MF,26,1992,8.0,15,7,5,5,5,6,17,35.3,11,7,1,6,7,22,18,1,2019
ENG-Premier League,2018,Burnley,Sam Vokes,WAL,FW,28,1989,10.2,4,2,1,2,1,0,0,,0,2,1,1,0,4,17,0,2019
ENG-Premier League,2018,Burnley,Stephen Ward,IRL,DF,32,1985,2.5,4,2,1,2,1,1,4,25.0,3,3,1,2,4,8,14,0,2019
ENG-Premier League,2018,Burnley,Steven Defour,BEL,MF,30,1988,5.0,8,4,2,4,2,3,14,21.4,11,11,3,8,8,16,7,0,2019
ENG-Premier League,2018,Burnley,Tom Heaton,ENG,GK,32,1986,19.0,0,0,0,0,0,0,2,0.0,2,0,0,0,0,0,8,2,2019
ENG-Premier League,2018,Cardiff City,Aron Gunnarsson,ISL,MF,29,1989,25.2,51,29,23,25,3,23,84,27.4,61,40,12,28,38,89,55,1,2019
ENG-Premier League,2018,Cardiff City,Bobby Reid,JAM,"FW,MF",25,1993,15.8,16,9,6,7,3,3,8,37.5,5,13,0,13,3,19,12,0,2019
ENG-Premier League,2018,Cardiff City,Bruno Ecuele Manga,GAB,DF,30,1988,37.5,69,36,48,16,5,29,58,50.0,29,62,28,34,81,150,179,4,2019
ENG-Premier League,2018,Cardiff City,Callum Paterson,SCO,"FW,MF",23,1994,22.2,21,14,7,7,7,5,26,19.2,21,23,2,21,8,29,29,0,2019
ENG-Premier League,2018,Cardiff City,Danny Ward,ENG,FW,26,1991,4.9,2,1,0,1,1,0,3,0.0,3,3,1,2,0,2,9,0,2019
ENG-Premier League,2018,Cardiff City,Gary Madine,ENG,"FW,MF",27,1990,0.4,1,1,0,1,0,0,0,,0,0,0,0,0,1,0,0,2019
ENG-Premier League,2018,Cardiff City,Greg Cunningham,IRL,DF,27,1991,7.0,18,7,11,4,3,9,16,56.3,7,9,3,6,17,35,16,1,2019
ENG-Premier League,2018,Cardiff City,Harry Arter,IRL,MF,28,1989,22.2,62,37,27,26,9,16,46,34.8,30,33,5,28,21,83,21,2,2019
ENG-Premier League,2018,Cardiff City,Jazz Richards,WAL,"DF,MF",27,1991,1.5,0,0,0,0,0,0,1,0.0,1,2,1,1,2,2,5,0,2019
ENG-Premier League,2018,Cardiff City,Joe Bennett,ENG,DF,28,1990,29.3,50,29,34,16,0,22,38,57.9,16,30,8,22,60,110,93,0,2019
ENG-Premier League,2018,Cardiff City,Joe Ralls,ENG,MF,24,1993,21.8,45,23,21,21,3,10,33,30.3,23,21,6,15,29,74,30,0,2019
ENG-Premier League,2018,Cardiff City,Josh Murphy,ENG,"MF,FW",23,1995,20.2,26,17,15,7,4,9,29,31.0,20,30,0,30,11,37,17,0,2019
ENG-Premier League,2018,Cardiff City,Junior Hoilett,CAN,"MF,FW",28,1990,23.8,40,27,26,11,3,15,53,28.3,38,34,0,34,32,72,30,0,2019
ENG-Premier League,2018,Cardiff City,Kadeem Harris,ENG,MF,25,1993,4.2,12,5,6,4,2,7,8,87.5,1,3,0,3,3,15,5,0,2019
ENG-Premier League,2018,Cardiff City,Kenneth Zohore,DEN,FW,24,1994,8.4,3,2,0,3,0,1,3,33.3,2,4,2,2,2,5,5,0,2019
ENG-Premier League,2018,Cardiff City,Leandro Bacuna,CUW,MF,26,1991,6.2,15,10,5,7,3,8,22,36.4,14,5,2,3,15,30,9,0,2019
ENG-Premier League,2018,Cardiff City,Lee Peltier,ENG,DF,31,1986,17.2,39,25,27,11,1,15,27,55.6,12,18,12,6,18,57,60,0,2019
ENG-Premier League,2018,Cardiff City,Loïc Damour,FRA,MF,27,1991,0.3,0,0,0,0,0,0,1,0.0,1,0,0,0,0,0,0,0,2019
ENG-Premier League,2018,Cardiff City,Nathaniel Mendez-Laing,ENG,"MF,FW",26,1992,10.9,34,25,18,12,4,12,26,46.2,14,17,1,16,13,47,20,0,2019
ENG-Premier League,2018,Cardiff City,Neil Etheridge,PHI,GK,28,1990,38.0,1,1,1,0,0,1,2,50.0,1,0,0,0,7,8,19,1,2019
ENG-Premier League,2018,Cardiff City,Oumar Niasse,SEN,FW,28,1990,10.3,12,3,1,5,6,4,8,50.0,4,7,0,7,2,14,7,0,2019
ENG-Premier League,2018,Cardiff City,Rhys Healey,WAL,FW,23,1994,0.6,1,0,0,1,0,0,1,0.0,1,0,0,0,0,1,0,0,2019
ENG-Premier League,2018,Cardiff City,Sean Morrison,ENG,DF,27,1991,33.8,35,17,29,4,2,15,28,53.6,13,47,30,17,52,87,204,5,2019
ENG-Premier League,2018,Cardiff City,Sol Bamba,CIV,DF,33,1985,27.5,74,42,44,30,0,31,55,56.4,24,72,32,40,82,156,181,3,2019
ENG-Premier League,2018,Cardiff City,Víctor Camarasa,ESP,MF,24,1994,28.5,28,15,8,15,5,6,31,19.4,25,17,2,15,33,61,28,1,2019
ENG-Premier League,2018,Chelsea,Andreas Christensen,DEN,DF,22,1996,6.9,10,4,2,6,2,2,5,40.0,3,4,2,2,4,14,29,0,2019
ENG-Premier League,2018,Chelsea,Antonio Rüdiger,GER,DF,25,1993,31.9,34,16,27,6,1,15,27,55.6,12,15,8,7,32,66,96,1,2019
ENG-Premier League,2018,Chelsea,Callum Hudson-Odoi,ENG,FW,17,2000,4.4,8,6,8,0,0,2,4,50.0,2,1,0,1,3,11,0,0,2019
ENG-Premier League,2018,Chelsea,Cesc Fàbregas,ESP,MF,31,1987,2.0,6,4,4,2,0,1,5,20.0,4,2,1,1,1,7,0,0,2019
ENG-Premier League,2018,Chelsea,César Azpilicueta,ESP,DF,28,1989,37.8,105,60,52,40,13,38,67,56.7,29,63,16,47,43,148,91,3,2019
ENG-Premier League,2018,Chelsea,David Luiz,BRA,DF,31,1987,36.0,41,31,27,13,1,21,28,75.0,7,33,18,15,35,76,149,1,2019
ENG-Premier League,2018,Chelsea,Davide Zappacosta,ITA,DF,26,1992,1.4,0,0,0,0,0,0,1,0.0,1,0,0,0,3,3,5,0,2019
ENG-Premier League,2018,Chelsea,Eden Hazard,BEL,FW,27,1991,32.5,14,9,2,1,11,5,17,29.4,12,10,0,10,13,27,6,1,2019
ENG-Premier League,2018,Chelsea,Emerson Palmieri,ITA,DF,23,1994,7.4,14,9,6,5,3,6,10,60.0,4,11,1,10,8,22,14,0,2019
ENG-Premier League,2018,Chelsea,Gary Cahill,ENG,DF,32,1985,0.3,0,0,0,0,0,0,0,,0,0,0,0,0,0,1,0,2019
ENG-Premier League,2018,Chelsea,Gonzalo Higuaín,ARG,FW,30,1987,12.1,10,7,2,4,4,2,11,18.2,9,4,0,4,1,11,5,0,2019
ENG-Premier League,2018,Chelsea,Jorginho,ITA,MF,26,1991,35.1,76,38,27,41,8,45,96,46.9,51,46,7,39,64,140,38,1,2019
ENG-Premier League,2018,Chelsea,Kepa Arrizabalaga,ESP,GK,23,1994,36.0,1,1,1,0,0,1,2,50.0,1,1,0,1,0,1,4,2,2019
ENG-Premier League,2018,Chelsea,Marcos Alonso,ESP,DF,27,1990,30.7,73,46,44,22,7,33,58,56.9,25,25,2,23,39,112,101,0,2019
ENG-Premier League,2018,Chelsea,Mateo Kovačić,CRO,MF,24,1994,19.3,45,29,23,19,3,20,46,43.5,26,19,2,17,8,53,18,1,2019
ENG-Premier League,2018,Chelsea,N'Golo Kanté,FRA,MF,27,1991,34.4,75,41,21,41,13,23,67,34.3,44,63,6,57,44,119,32,1,2019
ENG-Premier League,2018,Chelsea,Olivier Giroud,FRA,FW,31,1986,9.4,3,2,0,1,2,1,4,25.0,3,6,1,5,3,6,7,0,2019
ENG-Premier League,2018,Chelsea,Pedro,ESP,FW,31,1987,19.8,27,14,11,10,6,9,35,25.7,26,13,2,11,18,45,8,1,2019
ENG-Premier League,2018,Chelsea,Ross Barkley,ENG,MF,24,1993,13.8,15,10,5,7,3,4,14,28.6,10,8,1,7,9,24,17,2,2019
ENG-Premier League,2018,Chelsea,Ruben Loftus-Cheek,ENG,"MF,FW",22,1996,11.1,18,12,7,7,4,3,12,25.0,9,10,4,6,11,29,5,0,2019
ENG-Premier League,2018,Chelsea,Victor Moses,NGA,FW,27,1990,0.3,0,0,0,0,0,0,0,,0,1,0,1,0,0,0,0,2019
ENG-Premier League,2018,Chelsea,Willian,BRA,FW,29,1988,23.3,35,21,11,15,9,9,25,36.0,16,16,1,15,14,49,12,2,2019
ENG-Premier League,2018,Chelsea,Willy Caballero,ARG,GK,36,1981,2.0,0,0,0,0,0,0,0,,0,0,0,0,0,0,1,0,2019
ENG-Premier League,2018,Chelsea,Álvaro Morata,ESP,FW,25,1992,10.5,8,5,0,5,3,1,7,14.3,6,6,1,5,0,8,6,0,2019
ENG-Premier League,2018,Crystal Palace,Aaron Wan-Bissaka,ENG,DF,20,1997,34.8,129,90,90,33,6,55,65,84.6,10,49,16,33,84,213,161,0,2019
ENG-Premier League,2018,Crystal Palace,Alexander Sørloth,NOR,FW,22,1995,2.1,2,1,0,0,2,1,2,50.0,1,0,0,0,0,2,3,0,2019
ENG-Premier League,2018,Crystal Palace,Andros Townsend,ENG,"FW,MF",27,1991,33.4,62,35,38,16,8,35,89,39.3,54,48,5,43,38,100,28,0,2019
ENG-Premier League,2018,Crystal Palace,Bakary Sako,MLI,FW,30,1988,0.3,2,1,2,0,0,1,1,100.0,0,0,0,0,0,2,0,0,2019
ENG-Premier League,2018,Crystal Palace,Cheikhou Kouyaté,SEN,MF,28,1989,21.1,59,33,23,31,5,9,33,27.3,24,29,11,18,16,75,33,0,2019
ENG-Premier League,2018,Crystal Palace,Christian Benteke,BEL,FW,27,1990,9.0,5,1,0,4,1,1,4,25.0,3,7,2,5,0,5,14,0,2019
ENG-Premier League,2018,Crystal Palace,Connor Wickham,ENG,"FW,MF",25,1993,0.7,0,0,0,0,0,0,0,,0,0,0,0,0,0,2,0,2019
ENG-Premier League,2018,Crystal Palace,James McArthur,SCO,MF,30,1987,34.0,84,51,38,32,14,30,78,38.5,48,64,22,42,39,123,55,0,2019
ENG-Premier League,2018,Crystal Palace,James Tomkins,ENG,DF,29,1989,28.4,34,20,27,7,0,15,28,53.6,13,23,10,13,34,68,184,3,2019
ENG-Premier League,2018,Crystal Palace,Jason Puncheon,ENG,MF,32,1986,0.1,1,1,1,0,0,0,0,,0,0,0,0,0,1,0,0,2019
ENG-Premier League,2018,Crystal Palace,Jeffrey Schlupp,GHA,"MF,FW",25,1992,18.6,41,20,18,18,5,10,27,37.0,17,30,8,22,19,60,27,1,2019
ENG-Premier League,2018,Crystal Palace,Joel Ward,ENG,DF,28,1989,6.1,12,7,7,4,1,3,10,30.0,7,2,0,2,10,22,35,0,2019
ENG-Premier League,2018,Crystal Palace,Jordan Ayew,GHA,FW,26,1991,13.1,38,23,12,19,7,6,20,30.0,14,16,0,16,7,45,6,0,2019
ENG-Premier League,2018,Crystal Palace,Julián Speroni,ARG,GK,39,1979,1.0,0,0,0,0,0,0,0,,0,0,0,0,0,0,1,2,2019
ENG-Premier League,2018,Crystal Palace,Luka Milivojević,SRB,MF,27,1991,38.0,90,69,36,47,7,39,91,42.9,52,47,15,32,72,162,68,3,2019
ENG-Premier League,2018,Crystal Palace,Luke Dreher,ENG,FW,19,1998,0.0,0,0,0,0,0,0,0,,0,0,0,0,0,0,0,0,2019
ENG-Premier League,2018,Crystal Palace,Mamadou Sakho,FRA,DF,28,1990,26.8,25,16,22,3,0,11,18,61.1,7,26,16,10,41,66,136,2,2019
ENG-Premier League,2018,Crystal Palace,Martin Kelly,ENG,DF,28,1990,12.3,21,13,18,2,1,14,19,73.7,5,18,12,6,11,32,88,1,2019
ENG-Premier League,2018,Crystal Palace,Max Meyer,GER,MF,22,1995,15.7,33,18,14,18,1,11,20,55.0,9,6,0,6,15,48,19,0,2019
ENG-Premier League,2018,Crystal Palace,Michy Batshuayi,BEL,FW,24,1993,8.3,2,1,1,1,0,1,2,50.0,1,8,3,5,3,5,0,0,2019
ENG-Premier League,2018,Crystal Palace,Pape Souaré,SEN,DF,28,1990,0.0,0,0,0,0,0,0,0,,0,0,0,0,1,1,0,0,2019
ENG-Premier League,2018,Crystal Palace,Patrick van Aanholt,NED,DF,27,1990,35.5,48,24,35,11,2,24,40,60.0,16,33,9,24,40,88,91,2,2019
ENG-Premier League,2018,Crystal Palace,Scott Dann,ENG,DF,31,1987,7.4,6,2,5,1,0,3,7,42.9,4,16,12,4,5,11,46,0,2019
ENG-Premier League,2018,Crystal Palace,Vicente Guaita,ESP,GK,31,1987,19.5,0,0,0,0,0,0,0,,0,0,0,0,0,0,5,2,2019
ENG-Premier League,2018,Crystal Palace,Wayne Hennessey,WAL,GK,31,1987,17.5,0,0,0,0,0,0,2,0.0,2,0,0,0,0,0,5,1,2019
ENG-Premier League,2018,Crystal Palace,Wilfried Zaha,CIV,FW,25,1992,33.7,39,20,11,23,5,12,34,35.3,22,19,0,19,10,49,4,0,2019
ENG-Premier League,2018,Everton,Ademola Lookman,NGA,"FW,MF",20,1997,6.9,15,7,7,5,3,4,6,66.7,2,10,0,10,7,22,2,0,2019
ENG-Premier League,2018,Everton,André Gomes,POR,MF,25,1993,22.0,39,23,12,24,3,13,59,22.0,46,27,4,23,20,59,18,0,2019
ENG-Premier League,2018,Everton,Bernard,BRA,"FW,MF",25,1992,23.5,49,30,19,22,8,15,55,27.3,40,37,2,35,27,76,14,1,2019
ENG-Premier League,2018,Everton,Cenk Tosun,TUR,FW,27,1991,11.8,13,9,3,6,4,4,13,30.8,9,12,0,12,5,18,3,0,2019
ENG-Premier League,2018,Everton,Dominic Calvert-Lewin,ENG,FW,21,1997,19.8,13,7,3,3,7,7,15,46.7,8,16,3,13,7,20,19,0,2019
ENG-Premier League,2018,Everton,Gylfi Sigurðsson,ISL,MF,28,1989,34.6,56,36,20,25,11,16,47,34.0,31,38,4,34,28,84,24,0,2019
ENG-Premier League,2018,Everton,Idrissa Gana Gueye,SEN,MF,28,1989,31.4,142,89,70,63,9,38,76,50.0,38,52,8,44,74,216,48,1,2019
ENG-Premier League,2018,Everton,James McCarthy,IRL,MF,27,1990,0.2,2,1,1,1,0,0,0,,0,0,0,0,1,3,0,0,2019
ENG-Premier League,2018,Everton,Jonjoe Kenny,ENG,DF,21,1997,8.8,21,16,16,4,1,10,18,55.6,8,13,2,11,17,38,36,1,2019
ENG-Premier League,2018,Everton,Jordan Pickford,ENG,GK,24,1994,38.0,0,0,0,0,0,0,0,,0,0,0,0,0,0,20,8,2019
ENG-Premier League,2018,Everton,Kurt Zouma,FRA,DF,23,1994,29.0,32,21,16,14,2,4,11,36.4,7,27,12,15,54,86,126,2,2019
ENG-Premier League,2018,Everton,Leighton Baines,ENG,DF,33,1984,4.2,8,6,4,3,1,4,6,66.7,2,2,0,2,2,10,8,0,2019
ENG-Premier League,2018,Everton,Lucas Digne,FRA,DF,25,1993,32.9,71,46,45,18,8,28,45,62.2,17,43,9,34,60,131,116,0,2019
ENG-Premier League,2018,Everton,Mason Holgate,ENG,DF,21,1996,4.5,5,4,4,1,0,1,1,100.0,0,3,2,1,3,8,32,0,2019
ENG-Premier League,2018,Everton,Michael Keane,ENG,DF,25,1993,33.0,41,25,22,16,3,19,32,59.4,13,30,22,8,43,84,185,4,2019
ENG-Premier League,2018,Everton,Morgan Schneiderlin,FRA,MF,28,1989,9.3,24,16,11,11,2,6,14,42.9,8,16,3,13,15,39,16,0,2019
ENG-Premier League,2018,Everton,Oumar Niasse,SEN,FW,28,1990,0.7,0,0,0,0,0,0,1,0.0,1,0,0,0,0,0,0,0,2019
ENG-Premier League,2018,Everton,Phil Jagielka,ENG,DF,35,1982,3.7,7,5,3,4,0,1,4,25.0,3,1,0,1,2,9,14,0,2019
ENG-Premier League,2018,Everton,Richarlison,BRA,"FW,MF",21,1997,29.6,49,34,19,20,10,8,24,33.3,16,30,2,28,16,65,39,0,2019
ENG-Premier League,2018,Everton,Séamus Coleman,IRL,DF,29,1988,28.4,44,25,23,18,3,19,30,63.3,11,14,5,9,26,70,86,0,2019
ENG-Premier League,2018,Everton,Theo Walcott,ENG,"FW,MF",29,1989,23.5,27,17,11,9,7,10,22,45.5,12,17,1,16,22,49,8,0,2019
ENG-Premier League,2018,Everton,Tom Davies,ENG,MF,20,1998,10.9,27,17,9,17,1,7,23,30.4,16,15,1,14,16,43,9,1,2019
ENG-Premier League,2018,Everton,Yerry Mina,COL,DF,23,1994,9.9,14,7,8,6,0,6,9,66.7,3,11,5,6,8,22,54,3,2019
ENG-Premier League,2018,Fulham,Aboubakar Kamara,MTN,FW,23,1995,7.7,8,4,1,5,2,3,7,42.9,4,6,0,6,1,9,6,0,2019
ENG-Premier League,2018,Fulham,Aleksandar Mitrović,SRB,FW,23,1994,36.4,19,9,3,13,3,5,15,33.3,10,22,8,14,6,25,53,0,2019
ENG-Premier League,2018,Fulham,Alfie Mawson,ENG,DF,24,1994,12.6,11,7,7,4,0,6,10,60.0,4,20,17,3,19,30,64,1,2019
ENG-Premier League,2018,Fulham,Andre-Frank Zambo Anguissa,CMR,MF,22,1995,16.9,48,29,23,20,5,18,52,34.6,34,25,6,19,34,82,32,0,2019
ENG-Premier League,2018,Fulham,André Schürrle,GER,"FW,MF",27,1990,18.2,30,19,14,10,6,12,42,28.6,30,16,1,15,8,38,17,1,2019
ENG-Premier League,2018,Fulham,Calum Chambers,ENG,"MF,DF",23,1995,28.8,64,36,32,27,5,16,48,33.3,32,37,12,25,69,133,113,4,2019
ENG-Premier League,2018,Fulham,Cyrus Christie,IRL,"DF,MF",25,1992,21.6,43,23,26,13,4,18,41,43.9,23,25,11,14,29,72,96,1,2019
ENG-Premier League,2018,Fulham,Denis Odoi,GHA,DF,30,1988,28.8,48,34,29,16,3,21,33,63.6,12,45,24,21,42,90,153,0,2019
ENG-Premier League,2018,Fulham,Fabricio,ESP,GK,30,1987,2.0,1,1,1,0,0,0,0,,0,0,0,0,0,1,3,2,2019
ENG-Premier League,2018,Fulham,Floyd Ayité,TOG,"FW,MF",29,1988,5.3,4,4,2,1,1,2,6,33.3,4,8,1,7,7,11,5,0,2019
ENG-Premier League,2018,Fulham,Harvey Elliott,ENG,MF,15,2003,0.2,0,0,0,0,0,0,0,,0,1,0,1,0,0,0,0,2019
ENG-Premier League,2018,Fulham,Håvard Nordtveit,NOR,DF,28,1990,4.0,9,4,8,1,0,4,5,80.0,1,3,3,0,8,17,15,1,2019
ENG-Premier League,2018,Fulham,Ibrahima Cissé,GUI,MF,24,1994,1.0,0,0,0,0,0,0,1,0.0,1,0,0,0,3,3,4,0,2019
ENG-Premier League,2018,Fulham,Jean Seri,CIV,MF,27,1991,24.9,41,28,20,20,1,13,45,28.9,32,40,9,31,32,73,17,4,2019
ENG-Premier League,2018,Fulham,Joe Bryan,ENG,"DF,MF",24,1993,26.1,61,41,35,21,5,24,42,57.1,18,34,12,22,31,92,82,1,2019
ENG-Premier League,2018,Fulham,Kevin McDonald,SCO,MF,29,1988,9.3,15,11,6,8,1,5,13,38.5,8,8,2,6,9,24,22,0,2019
ENG-Premier League,2018,Fulham,Lazar Marković,SRB,MF,24,1994,0.5,0,0,0,0,0,0,0,,0,0,0,0,0,0,2,0,2019
ENG-Premier League,2018,Fulham,Luciano Vietto,ARG,"FW,MF",24,1993,11.0,15,11,5,5,5,4,19,21.1,15,9,0,9,6,21,5,0,2019
ENG-Premier League,2018,Fulham,Marcus Bettinelli,ENG,GK,26,1992,7.0,0,0,0,0,0,0,0,,0,0,0,0,0,0,5,0,2019
ENG-Premier League,2018,Fulham,Maxime Le Marchand,FRA,DF,28,1989,25.0,56,36,45,11,0,23,47,48.9,24,30,16,14,54,110,129,2,2019
ENG-Premier League,2018,Fulham,Neeskens Kebano,COD,"FW,MF",26,1992,1.2,3,1,2,1,0,1,1,100.0,0,3,0,3,0,3,3,0,2019
ENG-Premier League,2018,Fulham,Ryan Babel,NED,"FW,MF",31,1986,13.9,8,4,1,5,2,3,9,33.3,6,12,0,12,6,14,13,1,2019
ENG-Premier League,2018,Fulham,Ryan Sessegnon,ENG,"FW,DF",18,2000,25.6,22,14,8,8,6,6,22,27.3,16,25,2,23,19,41,49,1,2019
ENG-Premier League,2018,Fulham,Sergio Rico,ESP,GK,24,1993,29.0,1,1,1,0,0,1,1,100.0,0,0,0,0,1,2,13,5,2019
ENG-Premier League,2018,Fulham,Stefan Johansen,NOR,MF,27,1991,4.6,11,3,4,7,0,5,8,62.5,3,5,0,5,3,14,6,0,2019
ENG-Premier League,2018,Fulham,Tim Ream,USA,DF,30,1987,22.7,23,14,16,7,0,14,28,50.0,14,19,10,9,25,48,80,2,2019
ENG-Premier League,2018,Fulham,Timothy Fosu-Mensah,NED,DF,20,1998,8.8,18,7,12,6,0,8,13,61.5,5,11,5,6,12,30,30,1,2019
ENG-Premier League,2018,Fulham,Tom Cairney,SCO,"MF,FW",27,1991,24.4,37,21,9,22,6,12,16,75.0,4,21,5,16,10,47,13,1,2019
ENG-Premier League,2018,Huddersfield,Aaron Mooy,AUS,"MF,FW",27,1990,25.9,62,42,19,27,16,21,52,40.4,31,43,7,36,14,76,22,0,2019
ENG-Premier League,2018,Huddersfield,Aaron Rowe,ENG,FW,17,2000,0.8,1,0,1,0,0,0,0,,0,0,0,0,1,2,1,0,2019
ENG-Premier League,2018,Huddersfield,Abdelhamid Sabiri,MAR,FW,21,1996,0.5,2,1,1,1,0,0,0,,0,1,0,1,1,3,0,0,2019
ENG-Premier League,2018,Huddersfield,Adama Diakhaby,FRA,"FW,MF",22,1996,6.1,6,3,4,1,1,3,11,27.3,8,7,0,7,1,7,2,0,2019
ENG-Premier League,2018,Huddersfield,Alex Pritchard,ENG,"MF,FW",25,1993,23.1,36,24,10,18,8,10,35,28.6,25,26,2,24,17,53,9,0,2019
ENG-Premier League,2018,Huddersfield,Ben Hamer,ENG,GK,30,1987,6.1,0,0,0,0,0,0,3,0.0,3,0,0,0,1,1,3,2,2019
ENG-Premier League,2018,Huddersfield,Chris Löwe,GER,"DF,MF",29,1989,22.9,34,18,17,15,2,12,33,36.4,21,21,3,18,23,57,56,0,2019
ENG-Premier League,2018,Huddersfield,Christopher Schindler,GER,DF,28,1990,36.2,61,36,46,14,1,27,47,57.4,20,69,34,35,70,131,138,4,2019
ENG-Premier League,2018,Huddersfield,Collin Quaner,GER,FW,27,1991,0.4,0,0,0,0,0,0,1,0.0,1,0,0,0,0,0,0,0,2019
ENG-Premier League,2018,Huddersfield,Danny Williams,USA,MF,29,1989,1.1,0,0,0,0,0,0,0,,0,4,1,3,1,1,2,0,2019
ENG-Premier League,2018,Huddersfield,Demeaco Duhaney,ENG,DF,19,1998,0.5,1,0,1,0,0,1,3,33.3,2,2,0,2,1,2,1,0,2019
ENG-Premier League,2018,Huddersfield,Elias Kachunga,COD,"FW,MF",26,1992,13.1,22,9,8,12,2,9,25,36.0,16,16,1,15,4,26,10,0,2019
ENG-Premier League,2018,Huddersfield,Erik Durm,GER,DF,26,1992,22.8,35,22,24,8,3,14,33,42.4,19,26,6,20,41,76,42,0,2019
ENG-Premier League,2018,Huddersfield,Florent Hadergjonaj,KVX,"DF,MF",24,1994,20.5,30,17,10,18,2,13,37,35.1,24,21,7,14,21,51,37,1,2019
ENG-Premier League,2018,Huddersfield,Isaac Mbenza,BEL,"FW,MF",22,1996,11.0,10,9,5,5,0,2,4,50.0,2,4,0,4,5,15,4,0,2019
ENG-Premier League,2018,Huddersfield,Jason Puncheon,ENG,MF,32,1986,4.2,7,4,1,5,1,1,7,14.3,6,3,1,2,3,10,8,0,2019
ENG-Premier League,2018,Huddersfield,Joel Coleman,ENG,GK,22,1995,1.0,0,0,0,0,0,0,0,,0,0,0,0,0,0,0,0,2019
ENG-Premier League,2018,Huddersfield,Jon Gorenc Stanković,SVN,"MF,DF",22,1996,7.9,26,18,18,7,1,14,26,53.8,12,16,9,7,9,35,20,1,2019
ENG-Premier League,2018,Huddersfield,Jonas Lössl,DEN,GK,29,1989,30.9,0,0,0,0,0,0,1,0.0,1,1,0,1,2,2,12,2,2019
ENG-Premier League,2018,Huddersfield,Jonathan Hogg,ENG,MF,29,1988,26.3,78,41,18,51,9,27,69,39.1,42,46,7,39,73,151,19,1,2019
ENG-Premier League,2018,Huddersfield,Juninho Bacuna,CUW,"MF,DF",20,1997,15.7,46,29,22,19,5,22,54,40.7,32,21,1,20,24,70,12,1,2019
ENG-Premier League,2018,Huddersfield,Karlan Grant,ENG,FW,20,1997,9.7,5,2,1,2,2,1,3,33.3,2,8,0,8,2,7,1,1,2019
ENG-Premier League,2018,Huddersfield,Laurent Depoitre,BEL,FW,29,1988,11.9,6,4,2,3,1,0,3,0.0,3,9,0,9,2,8,8,0,2019
ENG-Premier League,2018,Huddersfield,Mathias Jørgensen,DEN,DF,28,1990,23.9,49,31,27,21,1,27,46,58.7,19,29,14,15,69,118,83,0,2019
ENG-Premier League,2018,Huddersfield,Matty Daly,ENG,MF,17,2001,0.8,0,0,0,0,0,0,0,,0,0,0,0,0,0,0,0,2019
ENG-Premier League,2018,Huddersfield,Philip Billing,DEN,MF,22,1996,24.3,73,44,26,39,8,19,42,45.2,23,57,16,41,53,126,43,0,2019
ENG-Premier League,2018,Huddersfield,Rajiv van La Parra,NED,"FW,MF",27,1991,4.5,8,5,1,7,0,1,6,16.7,5,0,0,0,4,12,3,1,2019
ENG-Premier League,2018,Huddersfield,Ramadan Sobhi,EGY,"FW,MF",21,1997,0.9,1,1,0,1,0,0,0,,0,2,0,2,1,2,0,0,2019
ENG-Premier League,2018,Huddersfield,Steve Mounié,BEN,FW,23,1994,19.8,9,6,3,4,2,2,12,16.7,10,10,1,9,5,14,15,0,2019
ENG-Premier League,2018,Huddersfield,Terence Kongolo,NED,DF,24,1994,30.2,74,46,44,26,4,27,47,57.4,20,42,16,26,65,139,106,1,2019
ENG-Premier League,2018,Huddersfield,Tommy Smith,ENG,DF,26,1992,12.7,26,13,14,11,1,10,25,40.0,15,12,4,8,18,44,25,0,2019
ENG-Premier League,2018,Leicester City,Adrien Silva,POR,MF,29,1989,1.0,2,2,0,1,1,0,2,0.0,2,1,0,1,1,3,1,0,2019
ENG-Premier League,2018,Leicester City,Ben Chilwell,ENG,DF,21,1996,36.0,55,29,34,18,3,24,55,43.6,31,37,7,30,38,93,156,0,2019
ENG-Premier League,2018,Leicester City,Christian Fuchs,AUT,DF,32,1986,2.3,4,3,0,4,0,1,2,50.0,1,0,0,0,4,8,8,0,2019
ENG-Premier League,2018,Leicester City,Daniel Amartey,GHA,DF,23,1994,7.1,18,12,11,6,1,10,15,66.7,5,6,4,2,17,35,28,1,2019
ENG-Premier League,2018,Leicester City,Danny Simpson,ENG,DF,31,1987,3.2,11,3,8,3,0,3,5,60.0,2,7,3,4,6,17,20,0,2019
ENG-Premier League,2018,Leicester City,Demarai Gray,JAM,"FW,MF",22,1996,22.1,25,12,7,14,4,6,16,37.5,10,19,0,19,9,34,15,0,2019
ENG-Premier League,2018,Leicester City,Fousseni Diabaté,MLI,FW,22,1995,0.6,2,0,2,0,0,0,1,0.0,1,2,0,2,0,2,0,0,2019
ENG-Premier League,2018,Leicester City,Hamza Choudhury,ENG,MF,20,1997,6.6,24,10,13,10,1,9,15,60.0,6,12,3,9,15,39,13,0,2019
ENG-Premier League,2018,Leicester City,Harry Maguire,ENG,DF,25,1993,28.8,31,17,21,9,1,11,17,64.7,6,32,18,14,36,67,155,4,2019
ENG-Premier League,2018,Leicester City,Harvey Barnes,ENG,"MF,FW",20,1997,11.2,10,6,5,4,1,4,6,66.7,2,7,1,6,3,13,7,0,2019
ENG-Premier League,2018,Leicester City,James Maddison,ENG,"MF,FW",21,1996,31.5,48,32,20,25,3,14,58,24.1,44,20,4,16,12,60,10,1,2019
ENG-Premier League,2018,Leicester City,Jamie Vardy,ENG,FW,31,1987,30.3,14,8,3,6,5,4,17,23.5,13,16,1,15,6,20,28,0,2019
ENG-Premier League,2018,Leicester City,Jonny Evans,NIR,DF,30,1988,22.2,24,13,20,4,0,13,18,72.2,5,28,10,18,33,57,152,3,2019
ENG-Premier League,2018,Leicester City,Kasper Schmeichel,DEN,GK,31,1986,38.0,1,1,1,0,0,1,1,100.0,0,0,0,0,3,4,14,3,2019
ENG-Premier League,2018,Leicester City,Kelechi Iheanacho,NGA,"FW,MF",21,1996,10.5,6,5,4,1,1,1,5,20.0,4,5,0,5,2,8,3,0,2019
ENG-Premier League,2018,Leicester City,Marc Albrighton,ENG,"FW,MF",28,1989,18.1,35,22,18,14,3,13,31,41.9,18,26,3,23,23,58,30,0,2019
ENG-Premier League,2018,Leicester City,Nampalys Mendy,SEN,MF,26,1992,23.2,33,18,16,16,1,6,22,27.3,16,24,8,16,26,59,26,2,2019
ENG-Premier League,2018,Leicester City,Rachid Ghezzal,ALG,"FW,MF",26,1992,8.3,14,5,3,7,4,3,18,16.7,15,10,1,9,7,21,4,1,2019
ENG-Premier League,2018,Leicester City,Ricardo Pereira,POR,"DF,FW",24,1993,34.7,118,66,66,40,12,54,112,48.2,58,60,6,54,60,178,130,1,2019
ENG-Premier League,2018,Leicester City,Shinji Okazaki,JPN,"MF,FW",32,1986,3.2,5,5,2,3,0,0,1,0.0,1,7,1,6,2,7,1,0,2019
ENG-Premier League,2018,Leicester City,Vicente Iborra,ESP,MF,30,1988,2.5,4,1,1,3,0,0,7,0.0,7,1,0,1,8,12,4,1,2019
ENG-Premier League,2018,Leicester City,Wes Morgan,JAM,DF,34,1984,21.4,27,15,14,12,1,6,7,85.7,1,24,10,14,32,59,109,1,2019
ENG-Premier League,2018,Leicester City,Wilfred Ndidi,NGA,MF,21,1996,36.6,142,98,66,67,9,46,95,48.4,49,64,9,55,83,225,85,2,2019
ENG-Premier League,2018,Leicester City,Youri Tielemans,BEL,MF,21,1997,12.1,17,8,5,9,3,5,17,29.4,12,13,2,11,5,22,13,1,2019
ENG-Premier League,2018,Leicester City,Çağlar Söyüncü,TUR,DF,22,1996,4.1,5,2,4,1,0,3,6,50.0,3,8,5,3,7,12,22,3,2019
ENG-Premier League,2018,Liverpool,Adam Lallana,ENG,"MF,FW",30,1988,5.2,16,9,6,7,3,5,12,41.7,7,10,1,9,5,21,4,0,2019
ENG-Premier League,2018,Liverpool,Alberto Moreno,ESP,DF,26,1992,1.7,3,2,1,2,0,1,3,33.3,2,1,0,1,2,5,0,0,2019
ENG-Premier League,2018,Liverpool,Alex Oxlade-Chamberlain,ENG,MF,24,1993,0.2,1,1,0,1,0,1,1,100.0,0,0,0,0,1,2,0,0,2019
ENG-Premier League,2018,Liverpool,Alisson,BRA,GK,25,1992,38.0,2,1,2,0,0,2,2,100.0,0,0,0,0,1,3,14,6,2019
ENG-Premier League,2018,Liverpool,Andrew Robertson,SCO,DF,24,1994,35.7,80,49,41,31,8,39,70,55.7,31,33,6,27,29,109,57,3,2019
ENG-Premier League,2018,Liverpool,Daniel Sturridge,ENG,"FW,MF",28,1989,5.7,3,3,1,1,1,2,3,66.7,1,4,0,4,1,4,0,0,2019
ENG-Premier League,2018,Liverpool,Dejan Lovren,CRO,DF,29,1989,11.0,15,9,10,5,0,7,15,46.7,8,11,7,4,11,26,51,2,2019
ENG-Premier League,2018,Liverpool,Divock Origi,BEL,FW,23,1995,4.1,6,1,2,3,1,1,4,25.0,3,2,0,2,0,6,2,0,2019
ENG-Premier League,2018,Liverpool,Fabinho,BRA,MF,24,1993,22.4,59,31,17,38,4,24,59,40.7,35,34,6,28,28,87,27,2,2019
ENG-Premier League,2018,Liverpool,Georginio Wijnaldum,NED,MF,27,1990,30.3,41,28,14,20,7,14,27,51.9,13,21,7,14,21,62,24,0,2019
ENG-Premier League,2018,Liverpool,James Milner,ENG,"MF,DF",32,1986,19.9,43,23,14,24,5,15,41,36.6,26,40,5,35,18,61,30,0,2019
ENG-Premier League,2018,Liverpool,Joe Gomez,ENG,DF,21,1997,11.8,18,11,10,7,1,9,15,60.0,6,10,5,5,14,32,42,0,2019
ENG-Premier League,2018,Liverpool,Jordan Henderson,ENG,MF,28,1990,22.1,46,36,20,22,4,16,39,41.0,23,27,3,24,30,76,17,0,2019
ENG-Premier League,2018,Liverpool,Joël Matip,CMR,DF,26,1991,17.1,39,26,23,12,4,13,24,54.2,11,12,7,5,32,71,78,0,2019
ENG-Premier League,2018,Liverpool,Mohamed Salah,EGY,FW,26,1992,36.1,21,9,3,11,7,5,16,31.3,11,9,0,9,5,26,6,0,2019
ENG-Premier League,2018,Liverpool,Naby Keïta,GUI,"MF,FW",23,1995,15.4,37,15,13,19,5,14,42,33.3,28,29,4,25,12,49,16,1,2019
ENG-Premier League,2018,Liverpool,Nathaniel Clyne,ENG,DF,27,1991,1.2,4,3,2,2,0,2,4,50.0,2,1,0,1,2,6,1,0,2019
ENG-Premier League,2018,Liverpool,Rafael Camacho,POR,DF,18,2000,0.0,1,0,1,0,0,1,1,100.0,0,0,0,0,0,1,0,0,2019
ENG-Premier League,2018,Liverpool,Roberto Firmino,BRA,"FW,MF",26,1991,29.0,30,20,5,16,9,7,34,20.6,27,35,1,34,6,36,16,0,2019
ENG-Premier League,2018,Liverpool,Sadio Mané,SEN,FW,26,1992,34.2,35,29,12,17,6,14,43,32.6,29,28,4,24,15,50,10,1,2019
ENG-Premier League,2018,Liverpool,Trent Alexander-Arnold,ENG,DF,19,1998,27.4,61,39,31,22,8,36,68,52.9,32,19,3,16,35,96,68,0,2019
ENG-Premier League,2018,Liverpool,Virgil van Dijk,NED,DF,27,1991,37.6,38,28,26,11,1,14,14,100.0,0,29,18,11,40,78,201,1,2019
ENG-Premier League,2018,Liverpool,Xherdan Shaqiri,SUI,"FW,MF",26,1991,11.8,14,4,3,9,2,9,19,47.4,10,6,1,5,6,20,6,0,2019
ENG-Premier League,2018,Manchester City,Aymeric Laporte,ESP,DF,24,1994,34.0,42,20,27,14,1,22,34,64.7,12,16,9,7,39,81,98,2,2019
ENG-Premier League,2018,Manchester City,Benjamin Mendy,FRA,DF,24,1994,10.0,16,10,10,5,1,9,17,52.9,8,13,4,9,10,26,18,0,2019
ENG-Premier League,2018,Manchester City,Bernardo Silva,POR,"MF,FW",23,1994,31.7,52,39,18,21,13,16,67,23.9,51,47,3,44,25,77,26,1,2019
ENG-Premier League,2018,Manchester City,Danilo,BRA,DF,27,1991,9.0,20,16,6,12,2,12,17,70.6,5,5,0,5,15,35,22,1,2019
ENG-Premier League,2018,Manchester City,David Silva,ESP,MF,32,1986,26.7,30,18,12,11,7,1,20,5.0,19,18,1,17,22,52,15,0,2019
ENG-Premier League,2018,Manchester City,Ederson,BRA,GK,24,1993,38.0,3,3,2,1,0,3,3,100.0,0,0,0,0,1,4,12,2,2019
ENG-Premier League,2018,Manchester City,Fabian Delph,ENG,DF,28,1989,8.1,23,14,11,7,5,12,23,52.2,11,3,0,3,13,36,19,1,2019
ENG-Premier League,2018,Manchester City,Fernandinho,BRA,MF,33,1985,26.4,57,43,19,30,8,26,47,55.3,21,28,4,24,41,98,70,0,2019
ENG-Premier League,2018,Manchester City,Gabriel Jesus,BRA,FW,21,1997,11.5,10,3,5,2,3,0,5,0.0,5,16,2,14,3,13,4,0,2019
ENG-Premier League,2018,Manchester City,John Stones,ENG,DF,24,1994,19.6,16,11,9,5,2,4,9,44.4,5,15,9,6,14,30,64,1,2019
ENG-Premier League,2018,Manchester City,Kevin De Bruyne,BEL,MF,27,1991,10.8,22,15,6,12,4,7,21,33.3,14,13,1,12,3,25,2,1,2019
ENG-Premier League,2018,Manchester City,Kyle Walker,ENG,DF,28,1990,30.9,40,26,20,20,0,24,38,63.2,14,19,5,14,36,76,58,2,2019
ENG-Premier League,2018,Manchester City,Leroy Sané,GER,FW,22,1996,20.7,24,15,8,7,9,2,23,8.7,21,21,2,19,8,32,2,0,2019
ENG-Premier League,2018,Manchester City,Nicolás Otamendi,ARG,DF,30,1988,13.7,24,14,17,6,1,5,9,55.6,4,6,4,2,29,53,56,1,2019
ENG-Premier League,2018,Manchester City,Oleksandr Zinchenko,UKR,DF,21,1996,12.8,34,20,13,15,6,14,33,42.4,19,14,3,11,20,54,19,1,2019
ENG-Premier League,2018,Manchester City,Phil Foden,ENG,MF,18,2000,3.7,7,6,1,3,3,2,9,22.2,7,1,0,1,4,11,1,0,2019
ENG-Premier League,2018,Manchester City,Raheem Sterling,ENG,FW,23,1994,30.8,32,16,11,12,9,9,25,36.0,16,28,3,25,17,49,4,0,2019
ENG-Premier League,2018,Manchester City,Riyad Mahrez,ALG,"FW,MF",27,1991,14.9,14,7,3,7,4,6,18,33.3,12,18,1,17,9,23,3,1,2019
ENG-Premier League,2018,Manchester City,Sergio Agüero,ARG,FW,30,1988,27.3,17,9,1,10,6,5,9,55.6,4,15,1,14,9,26,3,0,2019
ENG-Premier League,2018,Manchester City,Vincent Kompany,BEL,DF,32,1986,13.6,16,10,11,3,2,8,9,88.9,1,11,8,3,16,32,55,0,2019
ENG-Premier League,2018,Manchester City,İlkay Gündoğan,GER,MF,27,1990,23.7,19,12,4,12,3,6,31,19.4,25,12,3,9,28,47,19,1,2019
ENG-Premier League,2018,Manchester Utd,Alexis Sánchez,CHI,"FW,MF",29,1988,9.8,17,10,5,9,3,5,13,38.5,8,7,0,7,9,26,2,0,2019
ENG-Premier League,2018,Manchester Utd,Ander Herrera,ESP,MF,28,1989,15.6,54,28,24,22,8,21,61,34.4,40,38,6,32,37,91,25,1,2019
ENG-Premier League,2018,Manchester Utd,Andreas Pereira,BRA,MF,22,1996,6.7,8,6,5,2,1,4,15,26.7,11,9,2,7,11,19,8,1,2019
ENG-Premier League,2018,Manchester Utd,Angel Gomes,ENG,"MF,FW",17,2000,0.3,1,0,0,0,1,0,0,,0,0,0,0,0,1,0,0,2019
ENG-Premier League,2018,Manchester Utd,Anthony Martial,FRA,FW,22,1995,18.0,9,7,2,5,2,1,11,9.1,10,12,0,12,3,12,8,0,2019
ENG-Premier League,2018,Manchester Utd,Antonio Valencia,ECU,DF,32,1985,5.2,8,6,2,4,2,3,4,75.0,1,9,0,9,5,13,10,0,2019
ENG-Premier League,2018,Manchester Utd,Ashley Young,ENG,DF,33,1985,28.5,52,32,34,16,2,20,39,51.3,19,36,10,26,55,107,74,0,2019
ENG-Premier League,2018,Manchester Utd,Chris Smalling,ENG,DF,28,1989,23.6,30,17,21,9,0,11,17,64.7,6,37,25,12,26,56,109,1,2019
ENG-Premier League,2018,Manchester Utd,David de Gea,ESP,GK,27,1990,38.0,0,0,0,0,0,0,2,0.0,2,1,0,1,0,0,11,4,2019
ENG-Premier League,2018,Manchester Utd,Diogo Dalot,POR,"DF,FW",19,1999,11.3,24,12,8,14,2,14,19,73.7,5,15,2,13,10,34,35,1,2019
ENG-Premier League,2018,Manchester Utd,Eric Bailly,CIV,DF,24,1994,7.1,15,9,14,1,0,8,10,80.0,2,9,4,5,13,28,39,1,2019
ENG-Premier League,2018,Manchester Utd,Fred,BRA,MF,25,1993,11.6,29,17,12,16,1,15,33,45.5,18,26,2,24,16,45,14,2,2019
ENG-Premier League,2018,Manchester Utd,James Garner,ENG,MF,17,2001,0.0,0,0,0,0,0,0,0,,0,0,0,0,0,0,0,0,2019
ENG-Premier League,2018,Manchester Utd,Jesse Lingard,ENG,"FW,MF",25,1992,18.5,29,18,8,11,10,7,28,25.0,21,18,2,16,10,39,9,1,2019
ENG-Premier League,2018,Manchester Utd,Juan Mata,ESP,"FW,MF",30,1988,14.3,9,4,7,1,1,6,21,28.6,15,8,1,7,6,15,6,0,2019
ENG-Premier League,2018,Manchester Utd,Luke Shaw,ENG,DF,23,1995,28.8,55,29,17,31,7,28,47,59.6,19,42,12,30,21,76,93,2,2019
ENG-Premier League,2018,Manchester Utd,Marcos Rojo,ARG,DF,28,1990,2.4,5,3,3,2,0,1,6,16.7,5,3,2,1,6,11,9,1,2019
ENG-Premier League,2018,Manchester Utd,Marcus Rashford,ENG,FW,20,1997,25.9,24,12,4,12,8,7,29,24.1,22,27,0,27,3,27,24,0,2019
ENG-Premier League,2018,Manchester Utd,Marouane Fellaini,BEL,MF,30,1987,8.4,21,13,11,9,1,9,17,52.9,8,9,5,4,4,25,34,1,2019
ENG-Premier League,2018,Manchester Utd,Mason Greenwood,ENG,FW,16,2001,1.3,3,3,2,0,1,2,3,66.7,1,2,0,2,0,3,1,0,2019
ENG-Premier League,2018,Manchester Utd,Matteo Darmian,ITA,DF,28,1989,4.9,14,8,10,4,0,4,11,36.4,7,9,0,9,7,21,20,0,2019
ENG-Premier League,2018,Manchester Utd,Nemanja Matić,SRB,MF,29,1988,27.1,50,30,27,19,4,30,59,50.8,29,39,18,21,31,81,53,4,2019
ENG-Premier League,2018,Manchester Utd,Paul Pogba,FRA,MF,25,1993,33.4,47,30,21,21,5,17,43,39.5,26,30,9,21,18,65,39,0,2019
ENG-Premier League,2018,Manchester Utd,Phil Jones,ENG,DF,26,1992,14.0,19,13,12,7,0,8,13,61.5,5,16,11,5,23,42,67,3,2019
ENG-Premier League,2018,Manchester Utd,Romelu Lukaku,BEL,FW,25,1993,23.7,8,4,0,6,2,2,10,20.0,8,12,1,11,2,10,19,0,2019
ENG-Premier League,2018,Manchester Utd,Scott McTominay,SCO,"MF,DF",21,1996,9.6,10,9,3,6,1,4,10,40.0,6,9,4,5,15,25,16,0,2019
ENG-Premier League,2018,Manchester Utd,Tahith Chong,NED,FW,18,1999,0.4,0,0,0,0,0,0,0,,0,1,0,1,0,0,1,0,2019
ENG-Premier League,2018,Manchester Utd,Victor Lindelöf,SWE,DF,24,1994,28.9,40,27,28,12,0,13,23,56.5,10,21,12,9,24,64,121,3,2019
ENG-Premier League,2018,Newcastle Utd,Antonio Barreca,ITA,DF,23,1995,0.1,0,0,0,0,0,0,0,,0,0,0,0,0,0,0,0,2019
ENG-Premier League,2018,Newcastle Utd,Ayoze Pérez,ESP,"MF,FW",25,1993,32.4,59,22,24,28,7,17,63,27.0,46,55,4,51,42,101,33,1,2019
ENG-Premier League,2018,Newcastle Utd,Christian Atsu,GHA,MF,26,1992,16.6,24,15,9,11,4,5,16,31.3,11,13,3,10,7,31,16,0,2019
ENG-Premier League,2018,Newcastle Utd,Ciaran Clark,IRL,DF,28,1989,9.5,20,17,15,5,0,9,12,75.0,3,11,7,4,12,32,58,0,2019
ENG-Premier League,2018,Newcastle Utd,DeAndre Yedlin,USA,DF,25,1993,27.5,54,32,36,14,4,19,41,46.3,22,36,10,26,28,82,88,0,2019
ENG-Premier League,2018,Newcastle Utd,Fabian Schär,SUI,DF,26,1991,22.2,60,39,37,19,4,24,50,48.0,26,40,16,24,67,127,145,2,2019
ENG-Premier League,2018,Newcastle Utd,Federico Fernández,ARG,DF,29,1989,16.5,16,12,12,4,0,10,18,55.6,8,19,12,7,25,41,106,1,2019
ENG-Premier League,2018,Newcastle Utd,Florian Lejeune,FRA,DF,27,1991,11.7,25,15,17,7,1,11,24,45.8,13,16,5,11,21,46,49,0,2019
ENG-Premier League,2018,Newcastle Utd,Isaac Hayden,ENG,MF,23,1995,20.7,73,43,19,45,9,23,41,56.1,18,32,4,28,40,113,30,0,2019
ENG-Premier League,2018,Newcastle Utd,Jacob Murphy,ENG,"MF,DF",23,1995,3.4,6,2,4,2,0,2,4,50.0,2,5,2,3,1,7,7,0,2019
ENG-Premier League,2018,Newcastle Utd,Jamaal Lascelles,ENG,DF,24,1993,30.5,32,21,25,5,2,11,14,78.6,3,43,28,15,39,71,218,3,2019
ENG-Premier League,2018,Newcastle Utd,Javier Manquillo,ESP,DF,24,1994,12.2,27,19,14,11,2,9,14,64.3,5,9,1,8,17,44,58,0,2019
ENG-Premier League,2018,Newcastle Utd,Jonjo Shelvey,ENG,MF,26,1992,10.5,22,12,10,9,3,8,17,47.1,9,10,3,7,7,29,15,0,2019
ENG-Premier League,2018,Newcastle Utd,Joselu,ESP,FW,28,1990,6.6,14,8,4,5,5,4,9,44.4,5,5,0,5,3,17,15,0,2019
ENG-Premier League,2018,Newcastle Utd,Kenedy,BRA,"MF,DF",22,1996,15.0,30,22,11,16,3,12,29,41.4,17,10,0,10,32,62,24,1,2019
ENG-Premier League,2018,Newcastle Utd,Ki Sung-yueng,KOR,MF,29,1989,14.5,14,10,5,8,1,3,12,25.0,9,11,1,10,19,33,20,0,2019
ENG-Premier League,2018,Newcastle Utd,Martin Dúbravka,SVK,GK,29,1989,38.0,2,0,2,0,0,1,3,33.3,2,0,0,0,0,2,20,5,2019
ENG-Premier League,2018,Newcastle Utd,Matt Ritchie,SCO,"DF,MF",28,1989,32.5,70,44,35,27,8,19,47,40.4,28,34,11,23,51,121,76,1,2019
ENG-Premier League,2018,Newcastle Utd,Miguel Almirón,PAR,MF,24,1994,8.4,20,12,7,10,3,4,10,40.0,6,14,1,13,8,28,5,0,2019
ENG-Premier League,2018,Newcastle Utd,Mohamed Diamé,SEN,MF,31,1987,24.1,76,46,35,36,5,16,54,29.6,38,42,9,33,30,106,39,1,2019
ENG-Premier League,2018,Newcastle Utd,Paul Dummett,WAL,DF,26,1991,22.1,34,22,24,9,1,19,32,59.4,13,25,11,14,37,71,133,0,2019
ENG-Premier League,2018,Newcastle Utd,Salomón Rondón,VEN,FW,28,1989,28.9,8,3,2,4,2,4,24,16.7,20,14,3,11,5,13,39,0,2019
ENG-Premier League,2018,Newcastle Utd,Sean Longstaff,ENG,MF,20,1997,7.6,17,13,6,11,0,9,24,37.5,15,19,4,15,10,27,7,0,2019
ENG-Premier League,2018,Newcastle Utd,Yoshinori Mutō,JPN,"FW,MF",26,1992,5.8,8,4,3,5,0,2,7,28.6,5,9,0,9,5,13,3,1,2019
ENG-Premier League,2018,Southampton,Alex McCarthy,ENG,GK,28,1989,25.0,0,0,0,0,0,0,0,,0,0,0,0,0,0,6,2,2019
ENG-Premier League,2018,Southampton,Angus Gunn,SCO,GK,22,1996,12.0,0,0,0,0,0,0,0,,0,0,0,0,0,0,8,3,2019
ENG-Premier League,2018,Southampton,Callum Slattery,ENG,MF,19,1999,1.2,4,3,0,4,0,3,7,42.9,4,1,1,0,2,6,1,0,2019
ENG-Premier League,2018,Southampton,Charlie Austin,ENG,FW,29,1989,10.9,13,7,3,6,4,6,11,54.5,5,12,2,10,2,15,13,0,2019
ENG-Premier League,2018,Southampton,Cédric Soares,POR,DF,26,1991,16.6,22,16,15,6,1,9,15,60.0,6,21,5,16,22,44,60,2,2019
ENG-Premier League,2018,Southampton,Danny Ings,ENG,FW,26,1992,18.3,30,14,5,19,6,11,28,39.3,17,30,2,28,5,35,9,0,2019
ENG-Premier League,2018,Southampton,Fraser Forster,ENG,GK,30,1988,1.0,0,0,0,0,0,0,0,,0,0,0,0,0,0,1,0,2019
ENG-Premier League,2018,Southampton,Jack Stephens,ENG,DF,24,1994,18.9,25,13,17,7,1,16,28,57.1,12,25,13,12,37,62,96,2,2019
ENG-Premier League,2018,Southampton,James Ward-Prowse,ENG,"MF,DF",23,1994,21.6,36,17,19,13,4,14,43,32.6,29,30,6,24,27,63,59,0,2019
ENG-Premier League,2018,Southampton,Jan Bednarek,POL,DF,22,1996,23.9,41,25,25,16,0,21,37,56.8,16,44,27,17,71,112,171,0,2019
ENG-Premier League,2018,Southampton,Jannik Vestergaard,DEN,DF,25,1992,22.5,53,33,37,13,3,28,45,62.2,17,35,20,15,35,88,174,1,2019
ENG-Premier League,2018,Southampton,Josh Sims,ENG,MF,21,1997,2.4,1,0,1,0,0,1,3,33.3,2,2,0,2,1,2,1,0,2019
ENG-Premier League,2018,Southampton,Kayne Ramsey,ENG,DF,17,2000,1.0,0,0,0,0,0,0,0,,0,0,0,0,0,0,7,0,2019
ENG-Premier League,2018,Southampton,Manolo Gabbiadini,ITA,"FW,MF",26,1991,5.3,6,2,1,4,1,1,2,50.0,1,5,0,5,3,9,6,0,2019
ENG-Premier League,2018,Southampton,Mario Lemina,GAB,MF,24,1993,17.9,49,32,23,23,3,15,34,44.1,19,27,3,24,43,92,31,1,2019
ENG-Premier League,2018,Southampton,Matt Targett,ENG,DF,22,1995,13.2,27,19,15,7,5,12,26,46.2,14,19,3,16,27,54,42,0,2019
ENG-Premier League,2018,Southampton,Maya Yoshida,JPN,DF,29,1988,16.9,16,12,5,10,1,4,13,30.8,9,24,20,4,42,58,103,1,2019
ENG-Premier League,2018,Southampton,Michael Obafemi,IRL,FW,18,2000,1.5,1,1,0,0,1,0,0,,0,1,1,0,1,2,0,0,2019
ENG-Premier League,2018,Southampton,Mohamed Elyounoussi,NOR,MF,23,1994,8.8,16,12,7,6,3,6,19,31.6,13,11,1,10,6,22,5,0,2019
ENG-Premier League,2018,Southampton,Nathan Redmond,ENG,"MF,FW",24,1994,36.3,45,22,14,19,12,14,41,34.1,27,54,2,52,20,65,23,1,2019
ENG-Premier League,2018,Southampton,Oriol Romeu,ESP,MF,26,1991,23.7,81,46,39,38,4,32,77,41.6,45,43,17,26,52,133,44,1,2019
ENG-Premier League,2018,Southampton,Pierre Højbjerg,DEN,MF,22,1995,30.7,71,49,20,44,7,24,73,32.9,49,51,8,43,60,131,30,1,2019
ENG-Premier League,2018,Southampton,Ryan Bertrand,ENG,DF,28,1989,24.0,46,27,22,20,4,16,31,51.6,15,27,5,22,28,74,51,0,2019
ENG-Premier League,2018,Southampton,Sam Gallagher,ENG,FW,22,1995,0.4,0,0,0,0,0,0,0,,0,1,0,1,0,0,1,0,2019
ENG-Premier League,2018,Southampton,Shane Long,IRL,"FW,MF",31,1987,14.1,15,8,4,5,6,3,16,18.8,13,10,1,9,7,22,18,0,2019
ENG-Premier League,2018,Southampton,Steven Davis,NIR,MF,33,1985,1.1,2,2,0,2,0,0,0,,0,2,0,2,1,3,5,0,2019
ENG-Premier League,2018,Southampton,Stuart Armstrong,SCO,MF,26,1992,15.9,28,20,14,6,8,8,42,19.0,34,14,0,14,12,40,12,0,2019
ENG-Premier League,2018,Southampton,Tyreke Johnson,ENG,MF,19,1998,0.0,0,0,0,0,0,0,0,,0,0,0,0,0,0,0,0,2019
ENG-Premier League,2018,Southampton,Wesley Hoedt,NED,DF,24,1994,13.0,28,12,23,5,0,17,26,65.4,9,20,13,7,23,51,79,2,2019
ENG-Premier League,2018,Southampton,Yan Valery,TUN,DF,19,1999,19.0,42,36,26,10,6,16,29,55.2,13,24,3,21,22,64,72,1,2019
ENG-Premier League,2018,Tottenham,Ben Davies,WAL,DF,25,1993,20.5,56,30,39,13,4,38,54,70.4,16,23,10,13,23,79,68,1,2019
ENG-Premier League,2018,Tottenham,Christian Eriksen,DEN,MF,26,1992,30.8,41,25,8,20,13,17,59,28.8,42,26,3,23,15,56,13,0,2019
ENG-Premier League,2018,Tottenham,Danny Rose,ENG,DF,28,1990,20.0,49,31,26,16,7,20,32,62.5,12,24,4,20,24,73,28,3,2019
ENG-Premier League,2018,Tottenham,Davinson Sánchez,COL,DF,22,1996,21.6,37,20,28,9,0,20,37,54.1,17,17,9,8,30,67,103,2,2019
ENG-Premier League,2018,Tottenham,Dele Alli,ENG,MF,22,1996,20.3,33,19,6,14,13,5,24,20.8,19,33,5,28,19,52,20,0,2019
ENG-Premier League,2018,Tottenham,Eric Dier,ENG,"MF,DF",24,1994,16.7,26,16,7,15,4,19,47,40.4,28,27,12,15,21,47,46,1,2019
ENG-Premier League,2018,Tottenham,Fernando Llorente,ESP,FW,33,1985,7.7,4,2,3,0,1,2,3,66.7,1,7,2,5,1,5,10,0,2019
ENG-Premier League,2018,Tottenham,Georges-Kévin N'Koudou,CMR,FW,23,1995,0.1,0,0,0,0,0,0,0,,0,0,0,0,0,0,0,0,2019
ENG-Premier League,2018,Tottenham,Harry Kane,ENG,FW,25,1993,26.9,10,6,2,8,0,1,14,7.1,13,16,6,10,1,11,14,0,2019
ENG-Premier League,2018,Tottenham,Harry Winks,ENG,MF,22,1996,17.7,22,13,12,9,1,5,30,16.7,25,19,3,16,21,43,19,0,2019
ENG-Premier League,2018,Tottenham,Hugo Lloris,FRA,GK,31,1986,33.0,1,0,1,0,0,0,2,0.0,2,0,0,0,0,1,13,5,2019
ENG-Premier League,2018,Tottenham,Jan Vertonghen,BEL,DF,31,1987,21.2,39,24,17,20,2,14,24,58.3,10,18,11,7,32,71,81,0,2019
ENG-Premier League,2018,Tottenham,Juan Foyth,ARG,DF,20,1998,9.9,31,17,20,11,0,14,19,73.7,5,12,5,7,10,41,50,1,2019
ENG-Premier League,2018,Tottenham,Kieran Trippier,ENG,DF,27,1990,25.3,67,37,43,16,8,37,62,59.7,25,38,5,33,23,90,77,2,2019
ENG-Premier League,2018,Tottenham,Kyle Walker-Peters,ENG,DF,21,1997,4.2,7,4,4,2,1,3,4,75.0,1,5,1,4,4,11,6,0,2019
ENG-Premier League,2018,Tottenham,Lucas Moura,BRA,"FW,MF",25,1992,23.6,35,18,8,20,7,9,27,33.3,18,15,1,14,24,59,24,0,2019
ENG-Premier League,2018,Tottenham,Luke Amos,ENG,MF,21,1997,0.0,1,0,0,1,0,0,0,,0,0,0,0,0,1,0,0,2019
ENG-Premier League,2018,Tottenham,Michel Vorm,NED,GK,34,1983,2.0,0,0,0,0,0,0,0,,0,0,0,0,0,0,1,0,2019
ENG-Premier League,2018,Tottenham,Mousa Dembélé,BEL,MF,31,1987,5.7,13,9,6,6,1,4,7,57.1,3,4,1,3,7,20,5,2,2019
ENG-Premier League,2018,Tottenham,Moussa Sissoko,FRA,"MF,FW",28,1989,25.9,36,25,18,14,4,15,29,51.7,14,31,4,27,16,52,25,2,2019
ENG-Premier League,2018,Tottenham,Oliver Skipp,ENG,MF,17,2000,2.4,7,3,4,3,0,4,6,66.7,2,2,1,1,1,8,7,0,2019
ENG-Premier League,2018,Tottenham,Paulo Gazzaniga,ARG,GK,26,1992,3.0,0,0,0,0,0,0,0,,0,0,0,0,0,0,1,0,2019
ENG-Premier League,2018,Tottenham,Serge Aurier,CIV,DF,25,1992,6.3,20,12,12,4,4,8,15,53.3,7,8,2,6,7,27,20,0,2019
ENG-Premier League,2018,Tottenham,Son Heung-min,KOR,"FW,MF",26,1992,22.7,23,12,7,12,4,10,34,29.4,24,26,2,24,8,31,4,1,2019
ENG-Premier League,2018,Tottenham,Toby Alderweireld,BEL,DF,29,1989,32.5,37,23,25,10,2,12,22,54.5,10,41,22,19,24,61,175,0,2019
ENG-Premier League,2018,Tottenham,Victor Wanyama,KEN,MF,27,1991,5.7,13,13,8,5,0,6,12,50.0,6,9,3,6,7,20,11,0,2019
ENG-Premier League,2018,Tottenham,Vincent Janssen,NED,FW,24,1994,0.4,2,1,0,2,0,0,0,,0,0,0,0,0,2,1,0,2019
ENG-Premier League,2018,Tottenham,Érik Lamela,ARG,"MF,FW",26,1992,10.8,17,13,6,7,4,5,14,35.7,9,14,0,14,7,24,1,0,2019
ENG-Premier League,2018,Watford,Abdoulaye Doucouré,MLI,MF,25,1993,34.0,71,38,27,32,12,19,57,33.3,38,31,8,23,34,105,55,5,2019
ENG-Premier League,2018,Watford,Adam Masina,MAR,DF,24,1994,11.2,30,17,16,13,1,13,25,52.0,12,19,4,15,17,47,40,0,2019
ENG-Premier League,2018,Watford,Adrian Mariappa,JAM,DF,31,1986,21.4,35,22,29,6,0,16,32,50.0,16,23,15,8,26,61,120,2,2019
ENG-Premier League,2018,Watford,Andre Gray,JAM,FW,27,1991,15.2,3,1,0,2,1,1,6,16.7,5,3,1,2,2,5,6,0,2019
ENG-Premier League,2018,Watford,Ben Foster,ENG,GK,35,1983,38.0,2,2,2,0,0,2,6,33.3,4,0,0,0,2,4,34,3,2019
ENG-Premier League,2018,Watford,Ben Wilmot,ENG,"MF,DF",18,1999,0.3,0,0,0,0,0,0,1,0.0,1,2,1,1,0,0,1,0,2019
ENG-Premier League,2018,Watford,Christian Kabasele,BEL,DF,27,1991,17.6,25,14,20,5,0,10,23,43.5,13,21,16,5,38,63,111,0,2019
ENG-Premier League,2018,Watford,Craig Cathcart,NIR,DF,29,1989,34.4,50,31,36,11,3,21,37,56.8,16,42,30,12,38,88,184,4,2019
ENG-Premier League,2018,Watford,Daryl Janmaat,NED,DF,29,1989,16.9,36,24,23,11,2,20,29,69.0,9,16,6,10,33,69,71,0,2019
ENG-Premier League,2018,Watford,Domingos Quina,POR,MF,18,1999,3.8,9,7,3,5,1,3,11,27.3,8,6,0,6,3,12,1,0,2019
ENG-Premier League,2018,Watford,Gerard Deulofeu,ESP,"FW,MF",24,1994,23.0,11,6,5,3,3,4,26,15.4,22,16,0,16,14,25,3,0,2019
ENG-Premier League,2018,Watford,Isaac Success,NGA,"FW,MF",22,1996,11.7,15,12,4,8,3,2,5,40.0,3,6,0,6,2,17,11,0,2019
ENG-Premier League,2018,Watford,José Holebas,GRE,DF,34,1984,26.6,68,40,44,20,4,28,53,52.8,25,27,8,19,21,89,97,0,2019
ENG-Premier League,2018,Watford,Ken Sema,SWE,"MF,FW",24,1993,8.4,15,7,7,5,3,9,21,42.9,12,7,0,7,8,23,5,0,2019
ENG-Premier League,2018,Watford,Kiko Femenía,ESP,DF,27,1991,22.8,48,30,34,12,2,24,51,47.1,27,24,6,18,36,84,68,0,2019
ENG-Premier League,2018,Watford,Marc Navarro,ESP,DF,23,1995,0.9,4,2,3,1,0,3,4,75.0,1,0,0,0,0,4,4,0,2019
ENG-Premier League,2018,Watford,Miguel Britos,URU,DF,33,1985,2.1,4,2,4,0,0,2,4,50.0,2,1,1,0,3,7,11,1,2019
ENG-Premier League,2018,Watford,Nathaniel Chalobah,ENG,MF,23,1994,3.0,3,2,1,2,0,2,7,28.6,5,2,1,1,5,8,7,0,2019
ENG-Premier League,2018,Watford,Roberto Pereyra,ARG,MF,27,1991,31.3,21,12,10,10,1,7,24,29.2,17,26,0,26,24,45,27,2,2019
ENG-Premier League,2018,Watford,Sebastian Prödl,AUT,DF,31,1987,0.1,0,0,0,0,0,0,0,,0,0,0,0,0,0,0,0,2019
ENG-Premier League,2018,Watford,Stefano Okaka,ITA,"FW,MF",28,1989,0.3,0,0,0,0,0,0,0,,0,1,0,1,0,0,0,0,2019
ENG-Premier League,2018,Watford,Tom Cleverley,ENG,MF,28,1989,5.3,17,9,11,4,2,6,22,27.3,16,4,0,4,5,22,11,0,2019
ENG-Premier League,2018,Watford,Troy Deeney,ENG,FW,30,1988,28.3,24,14,8,10,6,7,32,21.9,25,22,4,18,7,31,29,0,2019
ENG-Premier League,2018,Watford,Will Hughes,ENG,MF,23,1995,26.9,74,43,27,35,12,25,59,42.4,34,55,6,49,25,99,30,0,2019
ENG-Premier League,2018,Watford,Étienne Capoue,FRA,MF,30,1988,32.7,91,56,36,48,7,33,87,37.9,54,50,13,37,85,176,96,1,2019
ENG-Premier League,2018,West Ham,Aaron Cresswell,ENG,DF,28,1989,17.7,29,16,14,11,4,13,25,52.0,12,28,7,21,23,52,58,0,2019
ENG-Premier League,2018,West Ham,Andriy Yarmolenko,UKR,"MF,FW",28,1989,5.1,4,1,2,1,1,4,6,66.7,2,4,1,3,2,6,4,2,2019
ENG-Premier League,2018,West Ham,Andy Carroll,ENG,FW,29,1989,5.1,4,2,1,3,0,1,4,25.0,3,3,2,1,1,5,8,0,2019
ENG-Premier League,2018,West Ham,Angelo Ogbonna,ITA,DF,30,1988,20.8,31,13,23,6,2,14,23,60.9,9,29,19,10,35,66,101,0,2019
ENG-Premier League,2018,West Ham,Arthur Masuaku,COD,DF,24,1993,19.5,57,25,38,13,6,31,56,55.4,25,27,6,21,36,93,72,0,2019
ENG-Premier League,2018,West Ham,Ben Johnson,ENG,DF,18,2000,0.7,1,0,1,0,0,0,1,0.0,1,0,0,0,1,2,5,0,2019
ENG-Premier League,2018,West Ham,Carlos Sánchez,COL,MF,32,1986,2.7,4,3,4,0,0,3,8,37.5,5,1,0,1,1,5,5,2,2019
ENG-Premier League,2018,West Ham,Declan Rice,ENG,MF,19,1999,33.4,98,60,35,58,5,38,88,43.2,50,51,12,39,52,150,56,0,2019
ENG-Premier League,2018,West Ham,Fabián Balbuena,PAR,DF,26,1991,22.4,40,20,34,6,0,16,42,38.1,26,23,15,8,53,93,175,0,2019
ENG-Premier League,2018,West Ham,Felipe Anderson,BRA,"MF,FW",25,1993,33.8,89,49,33,44,12,31,101,30.7,70,71,0,71,41,130,18,1,2019
ENG-Premier League,2018,West Ham,Grady Diangana,ENG,"MF,FW",20,1998,6.8,20,9,8,8,4,5,14,35.7,9,11,0,11,1,21,4,0,2019
ENG-Premier League,2018,West Ham,Issa Diop,FRA,DF,21,1997,33.0,68,38,47,21,0,37,57,64.9,20,58,36,22,64,132,161,4,2019
ENG-Premier League,2018,West Ham,Jack Wilshere,ENG,MF,26,1992,4.4,7,4,1,4,2,2,6,33.3,4,3,1,2,7,14,0,0,2019
ENG-Premier League,2018,West Ham,Javier Hernández,MEX,FW,30,1988,14.8,3,0,0,3,0,0,6,0.0,6,8,1,7,1,4,8,0,2019
ENG-Premier League,2018,West Ham,Lucas Pérez,ESP,"FW,MF",29,1988,5.3,6,4,3,2,1,1,3,33.3,2,2,1,1,2,8,2,0,2019
ENG-Premier League,2018,West Ham,Manuel Lanzini,ARG,MF,25,1993,7.6,12,7,5,6,1,5,18,27.8,13,3,1,2,9,21,7,1,2019
ENG-Premier League,2018,West Ham,Mark Noble,ENG,MF,31,1987,25.5,47,26,19,24,4,17,52,32.7,35,17,2,15,21,68,13,0,2019
ENG-Premier League,2018,West Ham,Marko Arnautović,AUT,FW,29,1989,22.1,9,5,4,3,2,1,7,14.3,6,4,2,2,3,12,6,0,2019
ENG-Premier League,2018,West Ham,Michail Antonio,JAM,"MF,FW",28,1990,23.4,23,14,12,6,5,6,12,50.0,6,38,3,35,18,41,26,1,2019
ENG-Premier League,2018,West Ham,Pablo Zabaleta,ARG,DF,33,1985,23.2,47,24,26,15,6,17,44,38.6,27,39,15,24,48,95,96,3,2019
ENG-Premier League,2018,West Ham,Pedro Obiang,EQG,MF,26,1992,12.5,41,23,23,16,2,18,43,41.9,25,27,9,18,12,53,18,0,2019
ENG-Premier League,2018,West Ham,Robert Snodgrass,SCO,MF,30,1987,24.7,44,27,18,24,2,13,46,28.3,33,24,4,20,11,55,23,0,2019
ENG-Premier League,2018,West Ham,Ryan Fredericks,ENG,DF,25,1992,12.1,38,23,33,5,0,21,32,65.6,11,15,5,10,13,51,49,1,2019
ENG-Premier League,2018,West Ham,Samir Nasri,FRA,MF,31,1987,2.7,0,0,0,0,0,0,0,,0,1,0,1,1,1,1,0,2019
ENG-Premier League,2018,West Ham,Xande Silva,POR,FW,21,1997,0.2,0,0,0,0,0,0,0,,0,1,0,1,0,0,0,0,2019
ENG-Premier League,2018,West Ham,Łukasz Fabiański,POL,GK,33,1985,38.0,1,0,1,0,0,1,3,33.3,2,0,0,0,1,2,10,1,2019
ENG-Premier League,2018,Wolves,Adama Traoré,ESP,"FW,MF",22,1996,10.0,16,13,11,3,2,4,9,44.4,5,11,0,11,6,22,7,0,2019
ENG-Premier League,2018,Wolves,Conor Coady,ENG,DF,25,1993,38.0,31,19,26,5,0,17,32,53.1,15,35,27,8,30,61,133,3,2019
ENG-Premier League,2018,Wolves,Diogo Jota,POR,"FW,MF",21,1996,26.2,28,16,11,11,6,10,38,26.3,28,20,1,19,13,41,11,0,2019
ENG-Premier League,2018,Wolves,Hélder Costa,ANG,"FW,MF",24,1994,14.9,18,14,7,7,4,7,23,30.4,16,15,0,15,9,27,6,0,2019
ENG-Premier League,2018,Wolves,Ivan Cavaleiro,POR,"FW,MF",24,1993,7.7,5,4,3,1,1,1,14,7.1,13,12,0,12,4,9,5,0,2019
ENG-Premier League,2018,Wolves,John Ruddy,ENG,GK,31,1986,1.0,0,0,0,0,0,0,0,,0,0,0,0,0,0,0,0,2019
ENG-Premier League,2018,Wolves,Jonny Castro,ESP,"DF,MF",24,1994,30.8,79,43,42,33,4,31,60,51.7,29,45,8,37,60,139,64,2,2019
ENG-Premier League,2018,Wolves,João Moutinho,POR,MF,31,1986,33.7,113,58,50,56,7,44,126,34.9,82,56,11,45,40,153,50,0,2019
ENG-Premier League,2018,Wolves,Leander Dendoncker,BEL,MF,23,1995,16.3,53,26,25,25,3,16,47,34.0,31,35,6,29,23,76,34,1,2019
ENG-Premier League,2018,Wolves,Léo Bonatini,BRA,FW,24,1994,1.5,1,1,0,0,1,1,5,20.0,4,1,0,1,0,1,0,0,2019
ENG-Premier League,2018,Wolves,Matt Doherty,IRL,"DF,MF",26,1992,34.9,67,42,48,15,4,35,58,60.3,23,49,7,42,60,127,107,2,2019
ENG-Premier League,2018,Wolves,Max Kilman,ENG,DF,21,1997,0.0,0,0,0,0,0,0,0,,0,0,0,0,0,0,0,0,2019
ENG-Premier League,2018,Wolves,Morgan Gibbs-White,ENG,"MF,FW",18,2000,7.4,6,3,2,4,0,1,4,25.0,3,6,0,6,1,7,0,0,2019
ENG-Premier League,2018,Wolves,Raúl Jiménez,MEX,FW,27,1991,34.6,30,18,5,17,8,6,23,26.1,17,25,3,22,26,56,40,0,2019
ENG-Premier League,2018,Wolves,Romain Saïss,MAR,"MF,DF",28,1990,12.8,39,26,23,14,2,20,37,54.1,17,25,12,13,26,65,61,0,2019
ENG-Premier League,2018,Wolves,Rui Patrício,POR,GK,30,1988,37.0,2,0,2,0,0,2,3,66.7,1,0,0,0,1,3,7,4,2019
ENG-Premier League,2018,Wolves,Ryan Bennett,ENG,DF,28,1990,34.0,58,32,41,16,1,25,41,61.0,16,42,21,21,43,101,131,1,2019
ENG-Premier League,2018,Wolves,Rúben Neves,POR,MF,21,1997,33.4,75,32,33,36,6,27,83,32.5,56,57,18,39,73,148,46,3,2019
ENG-Premier League,2018,Wolves,Rúben Vinagre,POR,"DF,MF",19,1999,7.9,14,9,7,7,0,2,5,40.0,3,10,2,8,14,28,16,1,2019
ENG-Premier League,2018,Wolves,Will Norris,ENG,GK,24,1993,0.0,0,0,0,0,0,0,0,,0,0,0,0,0,0,0,0,2019
ENG-Premier League,2018,Wolves,Willy Boly,CIV,DF,27,1991,35.2,85,52,49,34,2,34,56,60.7,22,55,32,23,72,157,177,6,2019
ENG-Premier League,2019,Arsenal,Ainsley Maitland-Niles,ENG,DF,21,1997,15.4,41,23,34,5,2,22,43,51.2,21,12,3,9,28,69,38,0,2020
ENG-Premier League,2019,Arsenal,Alexandre Lacazette,FRA,FW,28,1991,20.8,31,16,8,21,2,9,24,37.5,15,14,0,14,7,38,15,0,2020
ENG-Premier League,2019,Arsenal,Bernd Leno,GER,GK,27,1992,29.4,0,0,0,0,0,0,2,0.0,2,0,0,0,0,0,9,2,2020
ENG-Premier League,2019,Arsenal,Bukayo Saka,ENG,"DF,FW",17,2001,19.5,36,21,21,8,7,19,37,51.4,18,12,3,9,12,48,19,0,2020
ENG-Premier League,2019,Arsenal,Calum Chambers,ENG,DF,24,1995,12.2,26,10,12,8,6,11,16,68.8,5,13,7,6,16,42,43,1,2020
ENG-Premier League,2019,Arsenal,Cédric Soares,POR,"MF,DF",27,1991,2.8,8,6,2,6,0,1,3,33.3,2,3,0,3,3,11,4,0,2020
ENG-Premier League,2019,Arsenal,Dani Ceballos,ESP,MF,22,1996,18.8,45,23,26,14,5,18,61,29.5,43,14,3,11,32,77,16,1,2020
ENG-Premier League,2019,Arsenal,David Luiz,BRA,DF,32,1987,31.2,28,16,14,14,0,13,24,54.2,11,42,37,5,32,60,133,2,2020
ENG-Premier League,2019,Arsenal,Eddie Nketiah,ENG,FW,20,1999,7.0,7,5,3,4,0,2,6,33.3,4,9,0,9,2,9,5,0,2020
ENG-Premier League,2019,Arsenal,Emile Smith Rowe,ENG,MF,19,2000,1.1,1,1,1,0,0,1,3,33.3,2,0,0,0,1,2,2,0,2020
ENG-Premier League,2019,Arsenal,Emiliano Martínez,ARG,GK,26,1992,8.6,0,0,0,0,0,0,0,,0,0,0,0,0,0,1,0,2020
ENG-Premier League,2019,Arsenal,Granit Xhaka,SUI,MF,26,1992,28.7,45,25,20,19,6,25,55,45.5,30,32,16,16,21,66,59,3,2020
ENG-Premier League,2019,Arsenal,Henrikh Mkhitaryan,ARM,FW,30,1989,1.2,0,0,0,0,0,0,2,0.0,2,3,0,3,0,0,1,0,2020
ENG-Premier League,2019,Arsenal,Héctor Bellerín,ESP,"DF,MF",24,1995,12.9,20,13,7,11,2,11,29,37.9,18,20,4,16,19,39,27,1,2020
ENG-Premier League,2019,Arsenal,Joe Willock,ENG,"MF,FW",19,1999,9.5,25,16,9,12,4,8,21,38.1,13,16,2,14,4,29,11,2,2020
ENG-Premier League,2019,Arsenal,Kieran Tierney,SCO,"DF,MF",22,1997,11.0,20,16,13,6,1,11,15,73.3,4,10,4,6,9,29,37,1,2020
ENG-Premier League,2019,Arsenal,Lucas Torreira,URU,MF,23,1996,16.8,31,16,11,15,5,16,39,41.0,23,24,8,16,34,65,24,0,2020
ENG-Premier League,2019,Arsenal,Martinelli,BRA,FW,18,2001,7.4,20,15,10,6,4,7,20,35.0,13,15,1,14,3,23,8,0,2020
ENG-Premier League,2019,Arsenal,Mattéo Guendouzi,FRA,MF,20,1999,19.4,31,16,14,13,4,14,43,32.6,29,21,7,14,29,60,38,2,2020
ENG-Premier League,2019,Arsenal,Mesut Özil,GER,MF,30,1988,16.0,17,8,9,7,1,4,23,17.4,19,4,0,4,5,22,1,0,2020
ENG-Premier League,2019,Arsenal,Nacho Monreal,ESP,DF,33,1986,3.0,1,1,1,0,0,1,3,33.3,2,3,1,2,3,4,10,0,2020
ENG-Premier League,2019,Arsenal,Nicolas Pépé,CIV,FW,24,1995,22.3,32,17,15,13,4,8,16,50.0,8,15,2,13,8,40,5,0,2020
ENG-Premier League,2019,Arsenal,Pablo Marí,ESP,DF,25,1993,1.3,2,1,2,0,0,0,0,,0,0,0,0,1,3,10,0,2020
ENG-Premier League,2019,Arsenal,Pierre-Emerick Aubameyang,GAB,FW,30,1989,34.8,31,19,10,12,9,12,51,23.5,39,39,1,38,14,45,16,0,2020
ENG-Premier League,2019,Arsenal,Reiss Nelson,ENG,FW,19,1999,7.0,11,8,5,4,2,7,17,41.2,10,13,2,11,3,14,3,0,2020
ENG-Premier League,2019,Arsenal,Rob Holding,ENG,DF,23,1995,6.5,4,2,3,1,0,1,3,33.3,2,10,6,4,5,9,45,1,2020
ENG-Premier League,2019,Arsenal,Sead Kolašinac,BIH,DF,26,1993,18.9,29,16,18,6,5,12,23,52.2,11,14,4,10,25,54,34,1,2020
ENG-Premier League,2019,Arsenal,Shkodran Mustafi,GER,DF,27,1992,13.4,17,10,11,5,1,6,12,50.0,6,10,6,4,18,35,72,0,2020
ENG-Premier League,2019,Arsenal,Sokratis Papastathopoulos,GRE,DF,31,1988,18.8,25,16,17,7,1,10,21,47.6,11,30,24,6,17,42,68,1,2020
ENG-Premier League,2019,Aston Villa,Ahmed Elmohamady,EGY,DF,31,1987,11.5,19,9,10,7,2,10,21,47.6,11,11,5,6,13,32,25,1,2020
ENG-Premier League,2019,Aston Villa,Anwar El Ghazi,NED,"FW,MF",24,1995,22.8,20,11,12,5,3,8,26,30.8,18,10,1,9,13,33,16,1,2020
ENG-Premier League,2019,Aston Villa,Björn Engels,BEL,DF,24,1994,16.1,11,6,8,2,1,8,13,61.5,5,18,17,1,28,39,86,3,2020
ENG-Premier League,2019,Aston Villa,Borja Bastón,ESP,"MF,FW",26,1992,0.2,1,0,0,1,0,0,2,0.0,2,1,0,1,0,1,0,1,2020
ENG-Premier League,2019,Aston Villa,Conor Hourihane,IRL,MF,28,1991,17.0,16,10,4,8,4,10,25,40.0,15,19,4,15,9,25,31,0,2020
ENG-Premier League,2019,Aston Villa,Danny Drinkwater,ENG,MF,29,1990,2.9,5,3,3,2,0,2,18,11.1,16,5,0,5,5,10,5,1,2020
ENG-Premier League,2019,Aston Villa,Douglas Luiz,BRA,MF,21,1998,29.0,46,24,25,17,4,19,65,29.2,46,42,15,27,36,82,54,1,2020
ENG-Premier League,2019,Aston Villa,Ezri Konsa,ENG,DF,21,1997,22.7,18,9,12,6,0,7,16,43.8,9,34,24,10,25,43,70,2,2020
ENG-Premier League,2019,Aston Villa,Frederic Guilbert,FRA,"DF,MF",24,1994,22.7,74,43,48,20,6,36,67,53.7,31,33,10,23,49,123,74,2,2020
ENG-Premier League,2019,Aston Villa,Henri Lansbury,ENG,MF,28,1990,2.2,6,2,3,1,2,2,8,25.0,6,4,0,4,0,6,3,0,2020
ENG-Premier League,2019,Aston Villa,Indiana Vassilev,USA,"FW,MF",18,2001,0.6,0,0,0,0,0,0,0,,0,0,0,0,0,0,0,0,2020
ENG-Premier League,2019,Aston Villa,Jack Grealish,ENG,"FW,MF",23,1995,35.9,29,19,12,12,5,13,34,38.2,21,33,12,21,22,51,22,1,2020
ENG-Premier League,2019,Aston Villa,Jed Steer,ENG,GK,26,1992,0.1,0,0,0,0,0,0,0,,0,0,0,0,0,0,0,0,2020
ENG-Premier League,2019,Aston Villa,John McGinn,SCO,MF,24,1994,25.7,53,35,19,23,11,18,62,29.0,44,25,1,24,25,78,18,0,2020
ENG-Premier League,2019,Aston Villa,Jonathan Kodjia,CIV,FW,29,1989,1.3,0,0,0,0,0,0,1,0.0,1,0,0,0,0,0,1,0,2020
ENG-Premier League,2019,Aston Villa,Jota,ESP,"FW,MF",28,1991,3.7,3,1,2,0,1,2,5,40.0,3,1,0,1,3,6,6,0,2020
ENG-Premier League,2019,Aston Villa,Keinan Davis,ENG,FW,21,1998,6.1,1,1,0,1,0,0,3,0.0,3,4,0,4,0,1,3,0,2020
ENG-Premier League,2019,Aston Villa,Kortney Hause,ENG,DF,24,1995,17.2,21,9,15,5,1,8,15,53.3,7,27,19,8,20,41,98,4,2020
ENG-Premier League,2019,Aston Villa,Marvelous Nakamba,ZIM,MF,25,1994,20.4,55,28,28,20,7,24,67,35.8,43,50,11,39,39,94,38,3,2020
ENG-Premier League,2019,Aston Villa,Matt Targett,ENG,"DF,MF",23,1995,25.5,52,29,37,11,4,22,53,41.5,31,28,8,20,56,108,82,0,2020
ENG-Premier League,2019,Aston Villa,Mbwana Samatta,TAN,FW,26,1992,10.5,6,4,0,3,3,1,8,12.5,7,7,0,7,1,7,6,0,2020
ENG-Premier League,2019,Aston Villa,Neil Taylor,WAL,DF,30,1989,12.1,16,11,12,4,0,11,20,55.0,9,15,5,10,20,36,43,0,2020
ENG-Premier League,2019,Aston Villa,Pepe Reina,ESP,GK,36,1982,12.0,0,0,0,0,0,0,2,0.0,2,0,0,0,0,0,9,1,2020
ENG-Premier League,2019,Aston Villa,Tom Heaton,ENG,GK,33,1986,19.9,3,2,3,0,0,3,4,75.0,1,0,0,0,0,3,6,0,2020
ENG-Premier League,2019,Aston Villa,Trézéguet,EGY,"FW,MF",24,1994,21.7,38,16,18,15,5,9,44,20.5,35,23,2,21,25,63,18,0,2020
ENG-Premier League,2019,Aston Villa,Tyrone Mings,ENG,DF,26,1993,32.2,15,11,11,3,1,10,13,76.9,3,56,48,8,30,45,190,4,2020
ENG-Premier League,2019,Aston Villa,Wesley Moraes,BRA,FW,22,1996,19.8,15,8,3,8,4,0,5,0.0,5,10,2,8,4,19,23,0,2020
ENG-Premier League,2019,Aston Villa,Ørjan Nyland,NOR,GK,28,1990,6.0,0,0,0,0,0,0,0,,0,0,0,0,0,0,1,1,2020
ENG-Premier League,2019,Bournemouth,Aaron Ramsdale,ENG,GK,21,1998,37.0,4,3,4,0,0,3,3,100.0,0,0,0,0,0,4,25,1,2020
ENG-Premier League,2019,Bournemouth,Adam Smith,ENG,DF,28,1991,22.8,47,32,29,16,2,23,50,46.0,27,27,6,21,25,72,64,1,2020
ENG-Premier League,2019,Bournemouth,Andrew Surman,ENG,MF,32,1986,2.6,4,2,2,2,0,1,3,33.3,2,1,0,1,1,5,5,1,2020
ENG-Premier League,2019,Bournemouth,Arnaut Danjuma,NED,MF,22,1997,7.0,4,2,3,1,0,1,4,25.0,3,2,0,2,8,12,4,1,2020
ENG-Premier League,2019,Bournemouth,Callum Wilson,ENG,FW,27,1992,32.3,12,9,3,6,3,2,17,11.8,15,16,2,14,4,16,16,0,2020
ENG-Premier League,2019,Bournemouth,Charlie Daniels,ENG,DF,32,1986,1.4,1,1,0,1,0,0,1,0.0,1,2,0,2,1,2,5,1,2020
ENG-Premier League,2019,Bournemouth,Chris Mepham,WAL,DF,21,1997,10.1,20,9,13,7,0,11,14,78.6,3,17,11,6,17,37,62,1,2020
ENG-Premier League,2019,Bournemouth,Dan Gosling,ENG,MF,29,1990,14.0,26,10,14,9,3,6,27,22.2,21,31,11,20,20,46,26,0,2020
ENG-Premier League,2019,Bournemouth,David Brooks,WAL,"MF,FW",22,1997,5.6,5,5,1,2,2,2,14,14.3,12,5,1,4,2,7,1,0,2020
ENG-Premier League,2019,Bournemouth,Diego Rico,ESP,DF,26,1993,25.9,61,39,32,24,5,29,59,49.2,30,31,7,24,84,145,91,0,2020
ENG-Premier League,2019,Bournemouth,Dominic Solanke,ENG,FW,21,1997,18.3,8,4,2,5,1,5,33,15.2,28,9,1,8,8,16,18,1,2020
ENG-Premier League,2019,Bournemouth,Harry Wilson,WAL,"MF,FW",22,1997,18.3,23,13,8,10,5,11,34,32.4,23,26,2,24,11,34,15,1,2020
ENG-Premier League,2019,Bournemouth,Jack Simpson,ENG,DF,22,1996,2.7,5,2,4,1,0,2,8,25.0,6,1,0,1,2,7,12,1,2020
ENG-Premier League,2019,Bournemouth,Jack Stacey,ENG,DF,23,1996,17.2,21,11,9,11,1,8,22,36.4,14,27,11,16,18,39,64,1,2020
ENG-Premier League,2019,Bournemouth,Jefferson Lerma,COL,MF,24,1994,30.0,54,32,17,31,6,22,48,45.8,26,28,12,16,57,111,54,1,2020
ENG-Premier League,2019,Bournemouth,Jordon Ibe,ENG,DF,23,1995,0.6,2,2,2,0,0,1,1,100.0,0,0,0,0,0,2,1,0,2020
ENG-Premier League,2019,Bournemouth,Joshua King,NOR,"FW,MF",27,1992,22.3,16,6,4,8,4,4,16,25.0,12,20,3,17,8,24,9,0,2020
ENG-Premier League,2019,Bournemouth,Junior Stanislas,ENG,"MF,FW",29,1989,7.9,10,7,2,3,5,3,8,37.5,5,6,0,6,4,14,6,0,2020
ENG-Premier League,2019,Bournemouth,Lewis Cook,ENG,"MF,FW",22,1997,15.0,27,14,15,9,3,10,47,21.3,37,17,5,12,17,44,17,1,2020
ENG-Premier League,2019,Bournemouth,Lloyd Kelly,ENG,DF,20,1998,7.1,7,3,3,4,0,6,7,85.7,1,9,5,4,6,13,15,1,2020
ENG-Premier League,2019,Bournemouth,Mark Travers,IRL,GK,20,1999,1.0,0,0,0,0,0,0,0,,0,0,0,0,0,0,1,1,2020
ENG-Premier League,2019,Bournemouth,Nathan Aké,NED,DF,24,1995,27.8,31,21,23,8,0,14,23,60.9,9,40,29,11,36,67,152,0,2020
ENG-Premier League,2019,Bournemouth,Philip Billing,DEN,MF,23,1996,28.1,72,46,30,37,5,17,65,26.2,48,59,16,43,66,138,97,1,2020
ENG-Premier League,2019,Bournemouth,Ryan Fraser,SCO,"MF,FW",25,1994,23.0,12,6,5,5,2,7,22,31.8,15,15,3,12,15,27,24,0,2020
ENG-Premier League,2019,Bournemouth,Sam Surridge,ENG,"FW,MF",21,1998,0.3,0,0,0,0,0,0,0,,0,1,0,1,1,1,0,0,2020
ENG-Premier League,2019,Bournemouth,Simon Francis,ENG,DF,34,1985,10.8,13,9,11,2,0,11,21,52.4,10,17,12,5,20,33,71,0,2020
ENG-Premier League,2019,Bournemouth,Steve Cook,ENG,DF,28,1991,27.0,22,11,18,4,0,8,20,40.0,12,32,23,9,44,66,153,1,2020
ENG-Premier League,2019,Brighton,Aaron Connolly,IRL,FW,19,2000,14.0,7,6,1,4,2,3,10,30.0,7,11,0,11,0,7,3,0,2020
ENG-Premier League,2019,Brighton,Aaron Mooy,AUS,"MF,FW",28,1990,23.2,37,24,9,18,10,6,40,15.0,34,36,7,29,23,60,32,1,2020
ENG-Premier League,2019,Brighton,Adam Webster,ENG,DF,24,1995,29.6,30,17,21,8,1,14,32,43.8,18,43,26,17,45,75,110,2,2020
ENG-Premier League,2019,Brighton,Alexis Mac Allister,ARG,"MF,FW",20,1998,3.9,9,5,4,3,2,5,9,55.6,4,12,0,12,1,10,2,0,2020
ENG-Premier League,2019,Brighton,Alireza Jahanbakhsh,IRN,"FW,MF",25,1993,3.5,8,4,3,2,3,0,2,0.0,2,5,0,5,3,11,2,0,2020
ENG-Premier League,2019,Brighton,Bernardo,BRA,"DF,MF",24,1995,7.5,27,16,12,9,6,13,17,76.5,4,7,3,4,6,33,24,0,2020
ENG-Premier League,2019,Brighton,Dale Stephens,ENG,MF,30,1989,28.1,73,44,30,37,6,25,75,33.3,50,31,11,20,58,131,42,2,2020
ENG-Premier League,2019,Brighton,Dan Burn,ENG,DF,27,1992,32.0,67,42,35,27,5,25,53,47.2,28,44,20,24,42,109,130,0,2020
ENG-Premier League,2019,Brighton,Davy Pröpper,NED,MF,27,1991,31.4,64,35,28,28,8,23,74,31.1,51,27,8,19,38,102,36,4,2020
ENG-Premier League,2019,Brighton,Ezequiel Schelotto,ITA,DF,30,1989,4.0,4,3,1,2,1,2,8,25.0,6,3,0,3,7,11,14,0,2020
ENG-Premier League,2019,Brighton,Florin Andone,ROU,FW,26,1993,0.8,1,1,0,1,0,1,1,100.0,0,1,1,0,0,1,1,0,2020
ENG-Premier League,2019,Brighton,Gaëtan Bong,CMR,"DF,MF",31,1988,0.7,1,0,0,0,1,0,0,,0,1,1,0,0,1,0,0,2020
ENG-Premier League,2019,Brighton,Glenn Murray,ENG,FW,35,1983,8.9,5,2,0,3,2,2,9,22.2,7,6,2,4,1,6,12,0,2020
ENG-Premier League,2019,Brighton,Jürgen Locadia,NED,"FW,MF",25,1993,1.0,0,0,0,0,0,0,0,,0,0,0,0,0,0,0,0,2020
ENG-Premier League,2019,Brighton,Leandro Trossard,BEL,"FW,MF",24,1994,22.3,22,17,7,12,3,6,38,15.8,32,16,1,15,9,31,8,0,2020
ENG-Premier League,2019,Brighton,Lewis Dunk,ENG,DF,27,1991,35.9,40,24,23,17,0,15,34,44.1,19,55,33,22,55,95,125,2,2020
ENG-Premier League,2019,Brighton,Martín Montoya,ESP,"DF,MF",28,1991,21.1,57,29,31,20,6,30,56,53.6,26,19,5,14,24,81,40,0,2020
ENG-Premier League,2019,Brighton,Mathew Ryan,AUS,GK,27,1992,38.0,1,1,1,0,0,1,4,25.0,3,0,0,0,2,3,13,2,2020
ENG-Premier League,2019,Brighton,Neal Maupay,FRA,FW,22,1996,30.7,20,12,1,13,6,9,29,31.0,20,24,0,24,4,24,10,0,2020
ENG-Premier League,2019,Brighton,Pascal Groß,GER,"MF,FW",28,1991,20.0,36,13,8,21,7,14,39,35.9,25,25,3,22,9,45,7,0,2020
ENG-Premier League,2019,Brighton,Shane Duffy,IRL,DF,27,1992,13.8,18,9,14,4,0,6,17,35.3,11,13,7,6,21,39,72,0,2020
ENG-Premier League,2019,Brighton,Solly March,ENG,"FW,MF",25,1994,12.7,25,12,16,6,3,9,19,47.4,10,16,4,12,20,45,14,2,2020
ENG-Premier League,2019,Brighton,Steven Alzate,COL,"MF,DF",20,1998,13.2,33,19,20,11,2,17,27,63.0,10,18,3,15,14,47,13,0,2020
ENG-Premier League,2019,Brighton,Tariq Lamptey,GHA,DF,18,2000,6.5,7,6,6,1,0,2,9,22.2,7,6,0,6,16,23,17,0,2020
ENG-Premier League,2019,Brighton,Yves Bissouma,MLI,MF,22,1996,14.0,49,38,24,22,3,17,40,42.5,23,18,2,16,21,70,23,0,2020
ENG-Premier League,2019,Burnley,Aaron Lennon,ENG,MF,32,1987,5.5,14,8,7,4,3,7,10,70.0,3,6,1,5,8,22,3,0,2020
ENG-Premier League,2019,Burnley,Ashley Barnes,ENG,FW,29,1989,15.0,10,5,3,5,2,3,9,33.3,6,7,2,5,6,16,9,0,2020
ENG-Premier League,2019,Burnley,Ashley Westwood,ENG,MF,29,1990,35.0,54,33,15,32,7,17,48,35.4,31,23,11,12,32,86,32,3,2020
ENG-Premier League,2019,Burnley,Ben Mee,ENG,DF,29,1989,32.0,41,22,25,16,0,17,29,58.6,12,42,31,11,42,83,165,2,2020
ENG-Premier League,2019,Burnley,Charlie Taylor,ENG,DF,25,1993,21.6,39,24,26,9,4,19,39,48.7,20,29,9,20,29,68,78,1,2020
ENG-Premier League,2019,Burnley,Chris Wood,NZL,FW,27,1991,27.1,7,4,2,4,1,5,15,33.3,10,15,2,13,4,11,18,0,2020
ENG-Premier League,2019,Burnley,Danny Drinkwater,ENG,MF,29,1990,0.6,2,1,1,1,0,0,1,0.0,1,0,0,0,1,3,0,0,2020
ENG-Premier League,2019,Burnley,Dwight McNeil,ENG,MF,19,1999,37.1,47,33,18,22,7,23,71,32.4,48,60,8,52,30,77,34,0,2020
ENG-Premier League,2019,Burnley,Erik Pieters,NED,"DF,MF",30,1988,20.9,54,32,18,29,7,28,69,40.6,41,30,4,26,28,82,60,1,2020
ENG-Premier League,2019,Burnley,Jack Cork,ENG,MF,30,1989,29.0,35,24,10,20,5,12,62,19.4,50,34,12,22,28,63,49,0,2020
ENG-Premier League,2019,Burnley,James Tarkowski,ENG,DF,26,1992,38.0,66,43,47,19,0,31,54,57.4,23,63,47,16,63,129,204,4,2020
ENG-Premier League,2019,Burnley,Jay Rodriguez,ENG,FW,30,1989,22.4,29,19,4,13,12,8,33,24.2,25,33,6,27,5,34,12,0,2020
ENG-Premier League,2019,Burnley,Jeff Hendrick,IRL,MF,27,1992,21.5,18,10,7,8,3,7,27,25.9,20,21,8,13,20,38,20,0,2020
ENG-Premier League,2019,Burnley,Josh Brownhill,ENG,MF,23,1995,8.9,14,8,5,7,2,5,13,38.5,8,9,4,5,14,28,18,0,2020
ENG-Premier League,2019,Burnley,Jóhann Berg Guðmundsson,ISL,MF,28,1990,6.9,4,2,2,2,0,1,8,12.5,7,8,1,7,7,11,9,0,2020
ENG-Premier League,2019,Burnley,Kevin Long,IRL,DF,28,1990,6.3,7,5,6,1,0,4,9,44.4,5,9,7,2,4,11,31,0,2020
ENG-Premier League,2019,Burnley,Matthew Lowton,ENG,DF,30,1989,17.0,41,22,20,18,3,22,33,66.7,11,20,6,14,27,68,57,1,2020
ENG-Premier League,2019,Burnley,Matěj Vydra,CZE,FW,27,1992,9.1,4,3,0,3,1,3,6,50.0,3,7,3,4,1,5,6,0,2020
ENG-Premier League,2019,Burnley,Max Thompson,ENG,FW,17,2002,0.0,0,0,0,0,0,0,0,,0,0,0,0,0,0,0,0,2020
ENG-Premier League,2019,Burnley,Nick Pope,ENG,GK,27,1992,38.0,1,1,1,0,0,1,2,50.0,1,0,0,0,3,4,15,3,2020
ENG-Premier League,2019,Burnley,Phil Bardsley,SCO,DF,34,1985,21.0,49,36,16,24,9,24,37,64.9,13,24,11,13,30,79,73,0,2020
ENG-Premier League,2019,Burnley,Robbie Brady,IRL,MF,27,1992,5.0,11,9,5,4,2,3,10,30.0,7,10,2,8,5,16,8,0,2020
ENG-Premier League,2019,Chelsea,Andreas Christensen,DEN,DF,23,1996,19.5,38,21,25,12,1,15,21,71.4,6,12,8,4,29,67,56,0,2020
ENG-Premier League,2019,Chelsea,Antonio Rüdiger,GER,DF,26,1993,19.0,28,18,19,7,2,16,25,64.0,9,15,9,6,16,44,59,1,2020
ENG-Premier League,2019,Chelsea,Armando Broja,ALB,FW,17,2001,0.1,0,0,0,0,0,0,0,,0,0,0,0,0,0,0,0,2020
ENG-Premier League,2019,Chelsea,Billy Gilmour,SCO,MF,18,2001,2.2,5,2,3,2,0,2,4,50.0,2,2,0,2,3,8,3,1,2020
ENG-Premier League,2019,Chelsea,Callum Hudson-Odoi,ENG,"FW,MF",18,2000,9.6,10,4,4,5,1,1,7,14.3,6,9,0,9,5,15,4,1,2020
ENG-Premier League,2019,Chelsea,Christian Pulisic,USA,FW,20,1998,19.1,23,11,13,4,6,7,24,29.2,17,15,0,15,6,29,11,0,2020
ENG-Premier League,2019,Chelsea,César Azpilicueta,ESP,DF,29,1989,35.9,86,56,40,32,14,35,69,50.7,34,56,21,35,67,153,94,0,2020
ENG-Premier League,2019,Chelsea,Emerson Palmieri,ITA,DF,24,1994,11.4,23,12,8,11,4,10,15,66.7,5,13,1,12,18,41,19,0,2020
ENG-Premier League,2019,Chelsea,Faustino Anjorin,ENG,FW,17,2001,0.2,0,0,0,0,0,0,0,,0,1,0,1,0,0,0,0,2020
ENG-Premier League,2019,Chelsea,Fikayo Tomori,ENG,DF,21,1997,14.3,29,16,21,8,0,10,15,66.7,5,13,7,6,22,51,48,2,2020
ENG-Premier League,2019,Chelsea,Jorginho,ITA,MF,27,1991,26.4,66,40,24,34,8,35,91,38.5,56,30,5,25,64,130,27,2,2020
ENG-Premier League,2019,Chelsea,Kepa Arrizabalaga,ESP,GK,24,1994,33.0,1,1,1,0,0,1,2,50.0,1,0,0,0,1,2,7,2,2020
ENG-Premier League,2019,Chelsea,Kurt Zouma,FRA,DF,24,1994,26.0,23,14,17,6,0,9,16,56.3,7,22,14,8,58,81,116,2,2020
ENG-Premier League,2019,Chelsea,Marcos Alonso,ESP,DF,28,1990,15.9,28,16,20,6,2,14,33,42.4,19,18,2,16,20,48,32,0,2020
ENG-Premier League,2019,Chelsea,Mason Mount,ENG,"MF,FW",20,1999,31.9,37,17,8,19,10,9,42,21.4,33,25,3,22,16,53,18,0,2020
ENG-Premier League,2019,Chelsea,Mateo Kovačić,CRO,MF,25,1994,23.0,63,38,29,32,2,26,65,40.0,39,15,1,14,22,85,16,1,2020
ENG-Premier League,2019,Chelsea,Michy Batshuayi,BEL,FW,25,1993,2.7,4,1,2,2,0,0,5,0.0,5,1,1,0,0,4,1,0,2020
ENG-Premier League,2019,Chelsea,N'Golo Kanté,FRA,MF,28,1991,19.2,44,20,22,14,8,17,36,47.2,19,29,5,24,44,88,32,2,2020
ENG-Premier League,2019,Chelsea,Olivier Giroud,FRA,FW,32,1986,11.0,8,3,2,5,1,1,11,9.1,10,14,1,13,2,10,13,0,2020
ENG-Premier League,2019,Chelsea,Pedro,ESP,"FW,MF",32,1987,7.3,15,7,5,9,1,3,15,20.0,12,9,0,9,9,24,1,0,2020
ENG-Premier League,2019,Chelsea,Reece James,ENG,DF,19,1999,16.8,36,23,18,14,4,11,29,37.9,18,19,8,11,22,58,28,0,2020
ENG-Premier League,2019,Chelsea,Ross Barkley,ENG,MF,25,1993,12.3,16,9,6,6,4,5,18,27.8,13,7,2,5,7,23,7,0,2020
ENG-Premier League,2019,Chelsea,Ruben Loftus-Cheek,ENG,"MF,FW",23,1996,2.3,0,0,0,0,0,0,2,0.0,2,1,1,0,2,2,2,0,2020
ENG-Premier League,2019,Chelsea,Tammy Abraham,ENG,FW,21,1997,24.6,8,4,2,5,1,3,14,21.4,11,20,2,18,6,14,27,0,2020
ENG-Premier League,2019,Chelsea,Tariq Lamptey,GHA,DF,18,2000,0.4,2,2,1,1,0,2,2,100.0,0,0,0,0,0,2,0,0,2020
ENG-Premier League,2019,Chelsea,Willian,BRA,"FW,MF",30,1988,28.9,45,27,14,24,7,14,43,32.6,29,15,0,15,20,65,7,0,2020
ENG-Premier League,2019,Chelsea,Willy Caballero,ARG,GK,37,1981,5.0,0,0,0,0,0,0,0,,0,0,0,0,0,0,3,0,2020
ENG-Premier League,2019,Crystal Palace,Andros Townsend,ENG,"FW,MF",28,1991,14.4,34,21,12,17,5,15,37,40.5,22,18,0,18,15,49,10,1,2020
ENG-Premier League,2019,Crystal Palace,Brandon Pierrick,ENG,"MF,FW",17,2001,0.2,0,0,0,0,0,0,0,,0,0,0,0,0,0,1,0,2020
ENG-Premier League,2019,Crystal Palace,Cenk Tosun,TUR,FW,28,1991,2.0,2,2,2,0,0,0,2,0.0,2,0,0,0,0,2,1,0,2020
ENG-Premier League,2019,Crystal Palace,Cheikhou Kouyaté,SEN,"MF,DF",29,1989,28.1,67,32,43,20,4,26,48,54.2,22,35,11,24,43,110,58,1,2020
ENG-Premier League,2019,Crystal Palace,Christian Benteke,BEL,FW,28,1990,14.0,9,5,1,6,2,0,10,0.0,10,11,4,7,4,13,28,1,2020
ENG-Premier League,2019,Crystal Palace,Connor Wickham,ENG,"FW,MF",26,1993,1.1,1,1,1,0,0,0,0,,0,1,0,1,1,2,0,0,2020
ENG-Premier League,2019,Crystal Palace,Gary Cahill,ENG,DF,33,1985,24.1,15,8,11,4,0,7,15,46.7,8,34,25,9,18,33,114,1,2020
ENG-Premier League,2019,Crystal Palace,James McArthur,SCO,MF,31,1987,34.3,88,51,43,34,11,37,106,34.9,69,69,19,50,60,148,56,0,2020
ENG-Premier League,2019,Crystal Palace,James McCarthy,IRL,MF,28,1990,18.7,82,47,36,36,10,40,76,52.6,36,24,5,19,24,106,11,0,2020
ENG-Premier League,2019,Crystal Palace,James Tomkins,ENG,DF,30,1989,17.6,29,17,21,8,0,18,25,72.0,7,17,15,2,21,50,103,0,2020
ENG-Premier League,2019,Crystal Palace,Jaïro Riedewald,NED,"DF,MF",22,1996,8.5,14,10,4,10,0,7,11,63.6,4,7,2,5,17,31,23,1,2020
ENG-Premier League,2019,Crystal Palace,Jeffrey Schlupp,GHA,"FW,MF",26,1992,11.5,18,9,10,7,1,6,16,37.5,10,11,3,8,13,31,15,0,2020
ENG-Premier League,2019,Crystal Palace,Joel Ward,ENG,DF,29,1989,26.5,69,42,48,16,5,39,56,69.6,17,13,6,7,48,117,93,1,2020
ENG-Premier League,2019,Crystal Palace,Jordan Ayew,GHA,FW,27,1991,35.0,48,30,10,22,16,17,49,34.7,32,29,4,25,15,63,21,0,2020
ENG-Premier League,2019,Crystal Palace,Luka Milivojević,SRB,MF,28,1991,27.9,61,32,32,25,4,35,84,41.7,49,30,7,23,42,103,39,4,2020
ENG-Premier League,2019,Crystal Palace,Mamadou Sakho,FRA,DF,29,1990,10.3,7,5,5,1,1,2,5,40.0,3,12,5,7,20,27,46,2,2020
ENG-Premier League,2019,Crystal Palace,Martin Kelly,ENG,DF,29,1990,17.2,23,18,19,4,0,14,31,45.2,17,18,10,8,16,39,86,1,2020
ENG-Premier League,2019,Crystal Palace,Max Meyer,GER,"MF,FW",23,1995,7.3,19,11,10,9,0,8,18,44.4,10,6,1,5,7,26,4,0,2020
ENG-Premier League,2019,Crystal Palace,Patrick van Aanholt,NED,DF,28,1990,27.9,43,23,31,10,2,23,50,46.0,27,31,9,22,45,88,52,1,2020
ENG-Premier League,2019,Crystal Palace,Scott Dann,ENG,DF,32,1987,14.1,8,4,7,1,0,8,14,57.1,6,9,7,2,14,22,67,0,2020
ENG-Premier League,2019,Crystal Palace,Tyrick Mitchell,ENG,DF,19,1999,2.2,5,2,2,2,1,1,7,14.3,6,2,0,2,2,7,3,0,2020
ENG-Premier League,2019,Crystal Palace,Vicente Guaita,ESP,GK,32,1987,35.0,1,1,1,0,0,1,2,50.0,1,0,0,0,0,1,18,3,2020
ENG-Premier League,2019,Crystal Palace,Víctor Camarasa,ESP,FW,25,1994,0.1,0,0,0,0,0,0,0,,0,0,0,0,0,0,0,0,2020
ENG-Premier League,2019,Crystal Palace,Wayne Hennessey,WAL,GK,32,1987,3.0,0,0,0,0,0,0,0,,0,0,0,0,1,1,3,1,2020
ENG-Premier League,2019,Crystal Palace,Wilfried Zaha,CIV,"FW,MF",26,1992,36.4,43,19,18,12,13,12,49,24.5,37,22,2,20,18,61,4,0,2020
ENG-Premier League,2019,Everton,Alex Iwobi,NGA,"MF,FW",23,1996,17.7,25,17,8,15,2,12,33,36.4,21,18,2,16,14,39,10,1,2020
ENG-Premier League,2019,Everton,André Gomes,POR,MF,26,1993,16.2,22,15,7,11,4,8,62,12.9,54,20,3,17,7,29,7,0,2020
ENG-Premier League,2019,Everton,Anthony Gordon,ENG,"MF,FW",18,2001,4.9,11,7,5,6,0,5,15,33.3,10,6,2,4,8,19,4,0,2020
ENG-Premier League,2019,Everton,Bernard,BRA,"MF,FW",26,1992,14.2,32,22,12,14,6,13,44,29.5,31,22,2,20,16,48,7,0,2020
ENG-Premier League,2019,Everton,Cenk Tosun,TUR,FW,28,1991,3.2,2,0,0,0,2,0,1,0.0,1,1,0,1,0,2,1,0,2020
ENG-Premier League,2019,Everton,Djibril Sidibé,FRA,"DF,MF",27,1992,20.3,83,44,48,25,10,43,72,59.7,29,19,3,16,40,123,41,0,2020
ENG-Premier League,2019,Everton,Dominic Calvert-Lewin,ENG,FW,22,1997,29.2,7,5,1,4,2,1,10,10.0,9,15,2,13,6,13,36,0,2020
ENG-Premier League,2019,Everton,Fabian Delph,ENG,MF,29,1989,13.2,26,12,10,13,3,9,22,40.9,13,12,3,9,15,41,19,1,2020
ENG-Premier League,2019,Everton,Gylfi Sigurðsson,ISL,MF,29,1989,28.4,50,26,15,24,11,19,70,27.1,51,30,4,26,37,87,17,1,2020
ENG-Premier League,2019,Everton,Jarrad Branthwaite,ENG,DF,17,2002,3.3,8,7,5,3,0,3,5,60.0,2,6,3,3,2,10,12,0,2020
ENG-Premier League,2019,Everton,Jean-Philippe Gbamin,CIV,MF,23,1995,1.5,4,3,1,1,2,1,2,50.0,1,1,0,1,1,5,4,0,2020
ENG-Premier League,2019,Everton,Jordan Pickford,ENG,GK,25,1994,38.0,0,0,0,0,0,0,4,0.0,4,0,0,0,3,3,12,6,2020
ENG-Premier League,2019,Everton,Leighton Baines,ENG,DF,34,1984,4.5,10,6,6,2,2,8,10,80.0,2,5,2,3,5,15,14,0,2020
ENG-Premier League,2019,Everton,Lucas Digne,FRA,DF,26,1993,33.7,73,49,49,19,5,33,68,48.5,35,39,10,29,42,115,108,0,2020
ENG-Premier League,2019,Everton,Mason Holgate,ENG,DF,22,1996,22.8,44,26,30,13,1,21,31,67.7,10,26,13,13,34,78,97,0,2020
ENG-Premier League,2019,Everton,Michael Keane,ENG,DF,26,1993,28.4,31,16,18,12,1,14,24,58.3,10,35,28,7,44,75,152,0,2020
ENG-Premier League,2019,Everton,Moise Kean,ITA,FW,19,2000,9.5,6,6,5,1,0,0,0,,0,4,0,4,5,11,1,1,2020
ENG-Premier League,2019,Everton,Morgan Schneiderlin,FRA,MF,29,1989,11.1,31,22,13,16,2,8,24,33.3,16,13,3,10,21,52,20,1,2020
ENG-Premier League,2019,Everton,Oumar Niasse,SEN,FW,29,1990,0.2,4,0,0,2,2,0,0,,0,0,0,0,1,5,0,0,2020
ENG-Premier League,2019,Everton,Richarlison,BRA,"FW,MF",22,1997,34.1,70,47,28,28,14,27,56,48.2,29,34,4,30,12,82,42,0,2020
ENG-Premier League,2019,Everton,Séamus Coleman,IRL,DF,30,1988,20.4,42,31,24,14,4,19,25,76.0,6,21,9,12,24,66,43,1,2020
ENG-Premier League,2019,Everton,Theo Walcott,ENG,"MF,FW",30,1989,14.3,13,8,6,5,2,3,15,20.0,12,13,0,13,8,21,1,0,2020
ENG-Premier League,2019,Everton,Tom Davies,ENG,MF,21,1998,22.5,38,17,12,22,4,17,55,30.9,38,12,4,8,35,73,28,0,2020
ENG-Premier League,2019,Everton,Yerry Mina,COL,DF,24,1994,25.4,39,22,25,12,2,18,24,75.0,6,20,14,6,28,67,102,1,2020
ENG-Premier League,2019,Leicester City,Ayoze Pérez,ESP,"MF,FW",26,1993,22.3,45,28,14,26,5,8,54,14.8,46,33,1,32,14,59,9,1,2020
ENG-Premier League,2019,Leicester City,Ben Chilwell,ENG,DF,22,1996,26.4,43,26,28,13,2,23,52,44.2,29,30,6,24,28,71,68,2,2020
ENG-Premier League,2019,Leicester City,Christian Fuchs,AUT,DF,33,1986,8.6,14,9,8,6,0,8,19,42.1,11,8,3,5,17,31,33,1,2020
ENG-Premier League,2019,Leicester City,Demarai Gray,JAM,"MF,FW",23,1996,6.9,12,6,6,6,0,6,12,50.0,6,7,0,7,5,17,4,0,2020
ENG-Premier League,2019,Leicester City,Dennis Praet,BEL,MF,25,1994,12.6,33,18,8,21,4,9,29,31.0,20,19,1,18,17,50,12,0,2020
ENG-Premier League,2019,Leicester City,George Hirst,ENG,"MF,DF",20,1999,0.1,0,0,0,0,0,0,0,,0,0,0,0,0,0,0,0,2020
ENG-Premier League,2019,Leicester City,Hamza Choudhury,ENG,MF,21,1997,9.9,17,8,7,8,2,3,25,12.0,22,15,6,9,24,41,13,0,2020
ENG-Premier League,2019,Leicester City,Harvey Barnes,ENG,"MF,FW",21,1997,23.1,16,11,7,7,2,5,23,21.7,18,13,3,10,8,24,6,1,2020
ENG-Premier League,2019,Leicester City,James Justin,ENG,"DF,MF",21,1998,11.2,36,17,22,14,0,15,25,60.0,10,15,7,8,11,47,30,0,2020
ENG-Premier League,2019,Leicester City,James Maddison,ENG,MF,22,1996,29.2,59,30,13,31,15,23,68,33.8,45,16,0,16,9,68,7,1,2020
ENG-Premier League,2019,Leicester City,Jamie Vardy,ENG,FW,32,1987,33.7,15,12,0,9,6,2,4,50.0,2,22,4,18,2,17,22,0,2020
ENG-Premier League,2019,Leicester City,Jonny Evans,NIR,DF,31,1988,37.6,48,34,33,14,1,28,39,71.8,11,33,18,15,57,105,174,4,2020
ENG-Premier League,2019,Leicester City,Kasper Schmeichel,DEN,GK,32,1986,38.0,1,1,1,0,0,1,2,50.0,1,0,0,0,1,2,4,2,2020
ENG-Premier League,2019,Leicester City,Kelechi Iheanacho,NGA,FW,22,1996,10.7,3,1,1,2,0,1,9,11.1,8,8,1,7,3,6,8,0,2020
ENG-Premier League,2019,Leicester City,Luke Thomas,ENG,"MF,DF",18,2001,3.0,1,0,0,1,0,0,3,0.0,3,2,0,2,3,4,7,0,2020
ENG-Premier League,2019,Leicester City,Marc Albrighton,ENG,"MF,DF",29,1989,9.6,24,17,10,13,1,9,30,30.0,21,19,2,17,10,34,8,0,2020
ENG-Premier League,2019,Leicester City,Matty James,ENG,MF,28,1991,0.1,0,0,0,0,0,0,0,,0,0,0,0,0,0,0,0,2020
ENG-Premier League,2019,Leicester City,Nampalys Mendy,SEN,MF,27,1992,3.2,7,5,4,1,2,4,5,80.0,1,4,1,3,6,13,6,0,2020
ENG-Premier League,2019,Leicester City,Ricardo Pereira,POR,DF,25,1993,28.0,119,68,65,36,18,53,106,50.0,53,38,6,32,49,168,86,0,2020
ENG-Premier League,2019,Leicester City,Ryan Bennett,ENG,DF,29,1990,3.7,5,4,3,2,0,4,6,66.7,2,3,1,2,7,12,8,0,2020
ENG-Premier League,2019,Leicester City,Wes Morgan,JAM,DF,35,1984,4.8,4,1,3,1,0,0,3,0.0,3,5,3,2,7,11,19,0,2020
ENG-Premier League,2019,Leicester City,Wilfred Ndidi,NGA,MF,22,1996,29.7,128,67,56,61,11,45,91,49.5,46,52,6,46,80,208,69,3,2020
ENG-Premier League,2019,Leicester City,Youri Tielemans,BEL,MF,22,1997,31.4,52,29,17,30,5,24,74,32.4,50,43,4,39,22,74,18,0,2020
ENG-Premier League,2019,Leicester City,Çağlar Söyüncü,TUR,DF,23,1996,33.7,60,40,41,18,1,27,46,58.7,19,35,19,16,43,103,156,1,2020
ENG-Premier League,2019,Liverpool,Adam Lallana,ENG,"MF,FW",31,1988,4.2,19,9,7,9,3,6,21,28.6,15,7,0,7,5,24,3,0,2020
ENG-Premier League,2019,Liverpool,Adrián,ESP,GK,32,1987,9.7,1,1,1,0,0,1,1,100.0,0,0,0,0,0,1,8,3,2020
ENG-Premier League,2019,Liverpool,Alex Oxlade-Chamberlain,ENG,"MF,FW",25,1993,16.5,18,9,4,6,8,5,21,23.8,16,26,1,25,22,40,10,0,2020
ENG-Premier League,2019,Liverpool,Alisson,BRA,GK,26,1992,28.3,0,0,0,0,0,0,2,0.0,2,0,0,0,1,1,13,3,2020
ENG-Premier League,2019,Liverpool,Andrew Robertson,SCO,DF,25,1994,34.6,54,31,17,25,12,27,61,44.3,34,29,7,22,38,92,72,1,2020
ENG-Premier League,2019,Liverpool,Curtis Jones,ENG,MF,18,2001,1.4,4,4,0,1,3,3,4,75.0,1,2,0,2,2,6,1,0,2020
ENG-Premier League,2019,Liverpool,Dejan Lovren,CRO,DF,30,1989,8.6,13,8,10,3,0,7,12,58.3,5,9,6,3,10,23,42,0,2020
ENG-Premier League,2019,Liverpool,Divock Origi,BEL,FW,24,1995,8.0,12,9,2,5,5,4,9,44.4,5,2,0,2,4,16,5,0,2020
ENG-Premier League,2019,Liverpool,Fabinho,BRA,MF,25,1993,23.1,62,35,20,35,7,26,67,38.8,41,25,2,23,34,96,19,1,2020
ENG-Premier League,2019,Liverpool,Georginio Wijnaldum,NED,MF,28,1990,32.6,38,20,12,21,5,10,40,25.0,30,18,4,14,17,55,34,3,2020
ENG-Premier League,2019,Liverpool,Harvey Elliott,ENG,DF,16,2003,0.1,0,0,0,0,0,0,0,,0,0,0,0,0,0,0,0,2020
ENG-Premier League,2019,Liverpool,James Milner,ENG,"MF,DF",33,1986,10.4,16,10,3,10,3,6,26,23.1,20,12,3,9,7,23,17,1,2020
ENG-Premier League,2019,Liverpool,Joe Gomez,ENG,DF,22,1997,22.3,23,16,17,6,0,9,20,45.0,11,15,8,7,38,61,64,2,2020
ENG-Premier League,2019,Liverpool,Jordan Henderson,ENG,MF,29,1990,24.9,63,41,18,33,12,22,55,40.0,33,22,4,18,30,93,21,2,2020
ENG-Premier League,2019,Liverpool,Joël Matip,CMR,DF,27,1991,7.8,13,9,4,7,2,4,11,36.4,7,8,4,4,12,25,38,0,2020
ENG-Premier League,2019,Liverpool,Mohamed Salah,EGY,FW,27,1992,32.0,16,6,1,4,11,5,22,22.7,17,3,1,2,8,24,2,1,2020
ENG-Premier League,2019,Liverpool,Naby Keïta,GUI,MF,24,1995,9.1,30,14,8,16,6,11,26,42.3,15,18,0,18,10,40,4,0,2020
ENG-Premier League,2019,Liverpool,Neco Williams,WAL,DF,18,2001,2.6,5,3,1,3,1,4,5,80.0,1,3,1,2,9,14,6,0,2020
ENG-Premier League,2019,Liverpool,Roberto Firmino,BRA,FW,27,1991,33.2,37,19,8,14,15,10,43,23.3,33,34,3,31,7,44,11,1,2020
ENG-Premier League,2019,Liverpool,Sadio Mané,SEN,FW,27,1992,30.5,44,32,9,20,15,13,40,32.5,27,19,0,19,13,57,11,2,2020
ENG-Premier League,2019,Liverpool,Takumi Minamino,JPN,"FW,MF",24,1995,2.8,3,3,0,2,1,2,10,20.0,8,3,0,3,0,3,3,0,2020
ENG-Premier League,2019,Liverpool,Trent Alexander-Arnold,ENG,DF,20,1998,35.3,55,34,35,17,3,36,78,46.2,42,27,9,18,45,100,84,3,2020
ENG-Premier League,2019,Liverpool,Virgil van Dijk,NED,DF,28,1991,38.0,23,12,18,5,0,6,13,46.2,7,20,15,5,40,63,166,2,2020
ENG-Premier League,2019,Liverpool,Xherdan Shaqiri,SUI,"FW,MF",27,1991,2.1,1,0,0,1,0,0,1,0.0,1,0,0,0,0,1,0,0,2020
ENG-Premier League,2019,Manchester City,Angeliño,ESP,DF,22,1997,4.7,5,2,3,1,1,5,7,71.4,2,1,0,1,9,14,15,0,2020
ENG-Premier League,2019,Manchester City,Aymeric Laporte,ESP,DF,25,1994,12.2,13,6,6,7,0,4,9,44.4,5,6,5,1,20,33,26,1,2020
ENG-Premier League,2019,Manchester City,Benjamin Mendy,FRA,DF,25,1994,16.6,18,15,7,7,4,9,27,33.3,18,10,2,8,16,34,21,3,2020
ENG-Premier League,2019,Manchester City,Bernardo Silva,POR,"FW,MF",24,1994,22.6,36,18,8,21,7,13,44,29.5,31,25,1,24,24,60,13,0,2020
ENG-Premier League,2019,Manchester City,Claudio Bravo,CHI,GK,36,1983,3.9,0,0,0,0,0,0,0,,0,0,0,0,0,0,1,1,2020
ENG-Premier League,2019,Manchester City,David Silva,ESP,MF,33,1986,20.3,26,14,3,15,8,10,28,35.7,18,18,3,15,13,39,5,0,2020
ENG-Premier League,2019,Manchester City,Ederson,BRA,GK,25,1993,34.1,2,2,2,0,0,2,5,40.0,3,0,0,0,3,5,16,6,2020
ENG-Premier League,2019,Manchester City,Eric García,ESP,DF,18,2001,8.8,6,1,4,2,0,5,9,55.6,4,2,0,2,18,24,33,0,2020
ENG-Premier League,2019,Manchester City,Fernandinho,BRA,DF,34,1985,26.6,50,35,32,16,2,29,48,60.4,19,28,16,12,25,75,82,0,2020
ENG-Premier League,2019,Manchester City,Gabriel Jesus,BRA,FW,22,1997,22.6,17,10,4,5,8,7,25,28.0,18,26,1,25,11,28,6,0,2020
ENG-Premier League,2019,Manchester City,John Stones,ENG,DF,25,1994,12.5,16,10,8,7,1,3,5,60.0,2,5,3,2,9,25,32,2,2020
ENG-Premier League,2019,Manchester City,João Cancelo,POR,DF,25,1994,13.4,40,24,21,12,7,24,40,60.0,16,9,2,7,21,61,18,0,2020
ENG-Premier League,2019,Manchester City,Kevin De Bruyne,BEL,MF,28,1991,31.0,45,24,8,20,17,18,66,27.3,48,26,4,22,18,63,24,2,2020
ENG-Premier League,2019,Manchester City,Kyle Walker,ENG,DF,29,1990,26.6,28,18,12,15,1,12,29,41.4,17,15,6,9,28,56,42,1,2020
ENG-Premier League,2019,Manchester City,Leroy Sané,GER,FW,23,1996,0.1,0,0,0,0,0,0,0,,0,0,0,0,0,0,0,0,2020
ENG-Premier League,2019,Manchester City,Nicolás Otamendi,ARG,DF,31,1988,19.1,28,14,21,6,1,16,33,48.5,17,15,9,6,21,49,76,2,2020
ENG-Premier League,2019,Manchester City,Oleksandr Zinchenko,UKR,DF,22,1996,14.2,31,19,16,11,4,17,32,53.1,15,9,0,9,17,48,21,1,2020
ENG-Premier League,2019,Manchester City,Phil Foden,ENG,"FW,MF",19,2000,10.0,14,10,4,6,4,6,19,31.6,13,5,0,5,6,20,2,0,2020
ENG-Premier League,2019,Manchester City,Raheem Sterling,ENG,FW,24,1994,29.5,27,15,8,10,9,6,28,21.4,22,16,2,14,15,42,4,0,2020
ENG-Premier League,2019,Manchester City,Riyad Mahrez,ALG,"FW,MF",28,1991,21.6,28,14,11,9,8,11,38,28.9,27,31,1,30,18,46,8,2,2020
ENG-Premier League,2019,Manchester City,Rodri,ESP,MF,23,1996,27.6,50,30,17,25,8,23,63,36.5,40,19,5,14,26,76,35,0,2020
ENG-Premier League,2019,Manchester City,Sergio Agüero,ARG,FW,31,1988,16.1,7,4,0,4,3,1,8,12.5,7,9,1,8,3,10,2,0,2020
ENG-Premier League,2019,Manchester City,Thomas Doyle,ENG,MF,17,2001,0.2,0,0,0,0,0,0,1,0.0,1,0,0,0,0,0,0,0,2020
ENG-Premier League,2019,Manchester City,İlkay Gündoğan,GER,MF,28,1990,22.4,27,16,9,11,7,9,41,22.0,32,17,5,12,31,58,13,0,2020
ENG-Premier League,2019,Manchester Utd,Aaron Wan-Bissaka,ENG,DF,21,1997,34.1,129,80,71,50,8,64,86,74.4,22,46,13,33,66,195,83,0,2020
ENG-Premier League,2019,Manchester Utd,Andreas Pereira,BRA,"MF,FW",23,1996,16.5,24,13,8,9,7,10,39,25.6,29,13,0,13,7,31,7,0,2020
ENG-Premier League,2019,Manchester Utd,Angel Gomes,ENG,MF,18,2000,0.2,0,0,0,0,0,0,0,,0,1,0,1,0,0,0,0,2020
ENG-Premier League,2019,Manchester Utd,Anthony Martial,FRA,FW,23,1995,29.2,15,12,1,4,10,1,16,6.3,15,18,1,17,5,20,17,0,2020
ENG-Premier League,2019,Manchester Utd,Ashley Young,ENG,DF,34,1985,10.6,14,7,7,4,3,5,17,29.4,12,8,2,6,11,25,29,0,2020
ENG-Premier League,2019,Manchester Utd,Axel Tuanzebe,ENG,DF,21,1997,2.1,2,2,0,2,0,1,2,50.0,1,1,0,1,5,7,5,1,2020
ENG-Premier League,2019,Manchester Utd,Brandon Williams,ENG,DF,18,2000,11.2,21,15,11,6,4,9,29,31.0,20,9,4,5,16,37,27,0,2020
ENG-Premier League,2019,Manchester Utd,Bruno Fernandes,POR,MF,24,1994,13.2,22,12,9,9,4,5,38,13.2,33,6,0,6,11,33,16,0,2020
ENG-Premier League,2019,Manchester Utd,Daniel James,WAL,FW,21,1997,25.4,20,10,5,10,5,7,45,15.6,38,23,4,19,7,27,12,0,2020
ENG-Premier League,2019,Manchester Utd,David de Gea,ESP,GK,28,1990,38.0,0,0,0,0,0,0,0,,0,0,0,0,0,0,7,4,2020
ENG-Premier League,2019,Manchester Utd,Diogo Dalot,POR,"DF,MF",20,1999,0.7,3,2,3,0,0,3,4,75.0,1,1,0,1,2,5,1,0,2020
ENG-Premier League,2019,Manchester Utd,Eric Bailly,CIV,DF,25,1994,1.7,0,0,0,0,0,0,1,0.0,1,3,3,0,4,4,7,1,2020
ENG-Premier League,2019,Manchester Utd,Fred,BRA,MF,26,1993,24.0,60,32,33,22,5,25,100,25.0,75,44,8,36,38,98,32,0,2020
ENG-Premier League,2019,Manchester Utd,Harry Maguire,ENG,DF,26,1993,38.0,37,23,23,14,0,18,34,52.9,16,31,22,9,72,109,159,0,2020
ENG-Premier League,2019,Manchester Utd,James Garner,ENG,MF,18,2001,0.1,0,0,0,0,0,0,1,0.0,1,0,0,0,0,0,1,0,2020
ENG-Premier League,2019,Manchester Utd,Jesse Lingard,ENG,"MF,FW",26,1992,10.4,15,8,6,4,5,5,18,27.8,13,5,0,5,3,18,0,0,2020
ENG-Premier League,2019,Manchester Utd,Juan Mata,ESP,"MF,FW",31,1988,8.4,7,3,1,5,1,2,7,28.6,5,5,1,4,0,7,2,0,2020
ENG-Premier League,2019,Manchester Utd,Luke Shaw,ENG,DF,24,1995,19.3,34,18,19,11,4,19,33,57.6,14,26,6,20,24,58,56,1,2020
ENG-Premier League,2019,Manchester Utd,Marcos Rojo,ARG,DF,29,1990,1.4,3,1,2,1,0,1,2,50.0,1,2,1,1,0,3,6,0,2020
ENG-Premier League,2019,Manchester Utd,Marcus Rashford,ENG,FW,21,1997,29.4,13,9,1,6,6,9,23,39.1,14,23,0,23,10,23,19,0,2020
ENG-Premier League,2019,Manchester Utd,Mason Greenwood,ENG,FW,17,2001,14.7,17,11,5,6,6,5,20,25.0,15,9,0,9,6,23,6,1,2020
ENG-Premier League,2019,Manchester Utd,Nemanja Matić,SRB,MF,30,1988,17.6,46,24,23,19,4,20,43,46.5,23,21,8,13,22,68,28,1,2020
ENG-Premier League,2019,Manchester Utd,Odion Ighalo,NGA,FW,30,1989,1.1,2,2,0,2,0,1,3,33.3,2,1,1,0,0,2,0,0,2020
ENG-Premier League,2019,Manchester Utd,Paul Pogba,FRA,MF,26,1993,13.4,20,9,8,8,4,8,16,50.0,8,12,4,8,7,27,10,2,2020
ENG-Premier League,2019,Manchester Utd,Phil Jones,ENG,DF,27,1992,1.5,2,2,1,1,0,1,1,100.0,0,2,0,2,2,4,9,1,2020
ENG-Premier League,2019,Manchester Utd,Scott McTominay,SCO,MF,22,1996,19.7,43,22,14,25,4,17,32,53.1,15,25,5,20,31,74,34,2,2020
ENG-Premier League,2019,Manchester Utd,Tahith Chong,NED,"FW,DF",19,1999,0.4,0,0,0,0,0,0,0,,0,0,0,0,0,0,0,0,2020
ENG-Premier League,2019,Manchester Utd,Timothy Fosu-Mensah,NED,DF,21,1998,1.5,1,1,0,1,0,1,4,25.0,3,0,0,0,4,5,1,0,2020
ENG-Premier League,2019,Manchester Utd,Victor Lindelöf,SWE,DF,25,1994,34.4,29,15,16,12,1,17,20,85.0,3,25,16,9,26,55,129,0,2020
ENG-Premier League,2019,Newcastle Utd,Allan Saint-Maximin,FRA,"MF,FW",22,1997,20.7,13,8,7,4,2,4,18,22.2,14,5,2,3,9,22,6,0,2020
ENG-Premier League,2019,Newcastle Utd,Andy Carroll,ENG,FW,30,1989,7.0,5,3,3,2,0,2,8,25.0,6,2,1,1,2,7,24,1,2020
ENG-Premier League,2019,Newcastle Utd,Christian Atsu,GHA,"MF,FW",27,1992,8.3,10,8,5,5,0,5,14,35.7,9,19,0,19,5,15,9,0,2020
ENG-Premier League,2019,Newcastle Utd,Ciaran Clark,IRL,DF,29,1989,13.2,20,12,18,2,0,9,15,60.0,6,18,14,4,11,31,82,0,2020
ENG-Premier League,2019,Newcastle Utd,Danny Rose,ENG,DF,29,1990,9.6,21,12,11,8,2,12,21,57.1,9,11,4,7,10,31,14,1,2020
ENG-Premier League,2019,Newcastle Utd,DeAndre Yedlin,USA,DF,26,1993,10.4,18,13,10,6,2,8,16,50.0,8,13,7,6,10,28,20,0,2020
ENG-Premier League,2019,Newcastle Utd,Dwight Gayle,ENG,FW,28,1990,9.4,12,10,4,6,2,4,8,50.0,4,5,0,5,2,14,9,0,2020
ENG-Premier League,2019,Newcastle Utd,Emil Krafth,SWE,DF,24,1994,11.3,18,12,15,2,1,9,20,45.0,11,11,8,3,8,26,45,0,2020
ENG-Premier League,2019,Newcastle Utd,Fabian Schär,SUI,"DF,MF",27,1991,18.6,39,21,25,14,0,19,40,47.5,21,35,18,17,47,86,74,2,2020
ENG-Premier League,2019,Newcastle Utd,Federico Fernández,ARG,DF,30,1989,29.1,42,25,30,10,2,23,46,50.0,23,41,28,13,24,66,190,2,2020
ENG-Premier League,2019,Newcastle Utd,Florian Lejeune,FRA,DF,28,1991,4.9,8,2,6,2,0,4,7,57.1,3,6,2,4,10,18,15,2,2020
ENG-Premier League,2019,Newcastle Utd,Isaac Hayden,ENG,MF,24,1995,24.7,55,27,33,17,5,20,50,40.0,30,24,7,17,38,93,38,0,2020
ENG-Premier League,2019,Newcastle Utd,Jamaal Lascelles,ENG,DF,25,1993,23.1,14,3,10,4,0,4,9,44.4,5,23,20,3,28,42,116,1,2020
ENG-Premier League,2019,Newcastle Utd,Javier Manquillo,ESP,DF,25,1994,17.8,39,26,27,8,4,24,38,63.2,14,14,2,12,18,57,56,0,2020
ENG-Premier League,2019,Newcastle Utd,Jetro Willems,NED,DF,25,1994,16.6,37,19,29,6,2,18,39,46.2,21,20,5,15,17,54,42,1,2020
ENG-Premier League,2019,Newcastle Utd,Joelinton,BRA,FW,22,1996,29.8,34,20,7,22,5,9,32,28.1,23,32,6,26,11,45,30,0,2020
ENG-Premier League,2019,Newcastle Utd,Jonjo Shelvey,ENG,MF,27,1992,23.5,29,19,17,12,0,11,42,26.2,31,14,5,9,23,52,38,0,2020
ENG-Premier League,2019,Newcastle Utd,Kelland Watts,ENG,DF,19,1999,0.2,1,0,1,0,0,1,1,100.0,0,0,0,0,0,1,0,0,2020
ENG-Premier League,2019,Newcastle Utd,Ki Sung-yueng,KOR,MF,30,1989,1.5,1,1,0,1,0,1,3,33.3,2,1,0,1,3,4,2,0,2020
ENG-Premier League,2019,Newcastle Utd,Martin Dúbravka,SVK,GK,30,1989,38.0,1,1,1,0,0,1,2,50.0,1,2,0,2,1,2,17,5,2020
ENG-Premier League,2019,Newcastle Utd,Matt Ritchie,SCO,"DF,MF",29,1989,14.6,22,15,9,10,3,3,15,20.0,12,20,5,15,14,36,31,1,2020
ENG-Premier League,2019,Newcastle Utd,Matthew Longstaff,ENG,MF,19,2000,6.4,3,1,2,1,0,3,14,21.4,11,4,1,3,5,8,3,0,2020
ENG-Premier League,2019,Newcastle Utd,Miguel Almirón,PAR,"MF,FW",25,1994,33.6,60,39,32,20,8,19,52,36.5,33,25,1,24,31,91,25,0,2020
ENG-Premier League,2019,Newcastle Utd,Nabil Bentaleb,ALG,MF,24,1994,8.3,23,13,14,9,0,7,25,28.0,18,9,2,7,19,42,9,1,2020
ENG-Premier League,2019,Newcastle Utd,Paul Dummett,WAL,DF,27,1991,13.6,27,17,19,7,1,21,27,77.8,6,23,9,14,23,50,69,0,2020
ENG-Premier League,2019,Newcastle Utd,Sean Longstaff,ENG,MF,21,1997,15.3,35,19,17,16,2,20,50,40.0,30,23,5,18,19,54,20,2,2020
ENG-Premier League,2019,Newcastle Utd,Valentino Lazaro,AUT,"DF,MF",23,1996,5.3,13,9,11,2,0,11,18,61.1,7,2,0,2,3,16,4,0,2020
ENG-Premier League,2019,Newcastle Utd,Yoshinori Mutō,JPN,"MF,FW",27,1992,2.4,3,2,1,2,0,1,2,50.0,1,0,0,0,0,3,0,0,2020
ENG-Premier League,2019,Norwich City,Adam Idah,IRL,"FW,MF",18,2001,2.5,2,2,1,0,1,2,3,66.7,1,4,0,4,0,2,1,0,2020
ENG-Premier League,2019,Norwich City,Akin Famewo,ENG,MF,20,1998,0.0,0,0,0,0,0,0,0,,0,0,0,0,0,0,0,0,2020
ENG-Premier League,2019,Norwich City,Alexander Tettey,NOR,"MF,DF",33,1986,26.0,23,18,7,16,0,11,39,28.2,28,20,9,11,43,66,72,1,2020
ENG-Premier League,2019,Norwich City,Ben Godfrey,ENG,DF,21,1998,29.4,22,14,18,3,1,10,18,55.6,8,41,37,4,25,47,152,3,2020
ENG-Premier League,2019,Norwich City,Christoph Zimmermann,GER,DF,26,1993,15.9,32,21,26,6,0,21,30,70.0,9,22,18,4,19,51,87,2,2020
ENG-Premier League,2019,Norwich City,Dennis Srbeny,GER,"MF,FW",25,1994,0.5,5,5,3,2,0,1,3,33.3,2,1,0,1,0,5,1,0,2020
ENG-Premier League,2019,Norwich City,Emi Buendía,ARG,"FW,MF",22,1996,27.4,82,39,57,21,4,38,118,32.2,80,58,5,53,23,105,32,2,2020
ENG-Premier League,2019,Norwich City,Grant Hanley,SCO,DF,27,1991,14.0,24,15,17,7,0,8,14,57.1,6,25,18,7,31,55,77,1,2020
ENG-Premier League,2019,Norwich City,Ibrahim Amadou,FRA,"DF,MF",26,1993,8.4,18,11,9,8,1,3,11,27.3,8,8,5,3,16,34,55,1,2020
ENG-Premier League,2019,Norwich City,Jamal Lewis,NIR,DF,21,1998,25.6,51,35,42,6,3,22,36,61.1,14,27,12,15,25,76,68,0,2020
ENG-Premier League,2019,Norwich City,Jordan Thomas,ENG,FW,18,2001,0.0,0,0,0,0,0,0,0,,0,0,0,0,0,0,0,0,2020
ENG-Premier League,2019,Norwich City,Josh Martin,ENG,"FW,MF",17,2001,0.4,1,0,0,0,1,0,0,,0,1,0,1,1,2,0,0,2020
ENG-Premier League,2019,Norwich City,Josip Drmić,SUI,FW,26,1992,7.2,3,2,1,2,0,0,8,0.0,8,6,0,6,1,4,5,1,2020
ENG-Premier League,2019,Norwich City,Kenny McLean,SCO,MF,27,1992,33.0,44,29,20,18,6,14,42,33.3,28,32,7,25,38,82,67,2,2020
ENG-Premier League,2019,Norwich City,Lukas Rupp,GER,"FW,MF",28,1991,7.7,15,9,7,5,3,5,17,29.4,12,11,0,11,15,30,4,0,2020
ENG-Premier League,2019,Norwich City,Marco Stiepermann,GER,MF,28,1991,13.1,20,8,8,9,3,5,21,23.8,16,11,3,8,5,25,16,0,2020
ENG-Premier League,2019,Norwich City,Mario Vrančić,BIH,MF,30,1989,7.1,27,16,14,11,2,16,27,59.3,11,9,0,9,10,37,4,2,2020
ENG-Premier League,2019,Norwich City,Max Aarons,ENG,DF,19,2000,36.0,48,30,33,9,6,18,36,50.0,18,46,29,17,37,85,97,1,2020
ENG-Premier League,2019,Norwich City,Michael McGovern,NIR,GK,35,1984,1.8,0,0,0,0,0,0,0,,0,0,0,0,0,0,1,1,2020
ENG-Premier League,2019,Norwich City,Moritz Leitner,GER,MF,26,1992,7.6,16,9,8,7,1,9,25,36.0,16,14,4,10,9,25,10,1,2020
ENG-Premier League,2019,Norwich City,Ondrej Duda,SVK,MF,24,1994,8.0,18,11,9,6,3,7,16,43.8,9,10,2,8,6,24,8,0,2020
ENG-Premier League,2019,Norwich City,Onel Hernández,CUB,"FW,MF",26,1993,15.4,27,19,13,11,3,9,31,29.0,22,12,1,11,19,46,10,0,2020
ENG-Premier League,2019,Norwich City,Patrick Roberts,ENG,"FW,MF",22,1997,0.3,0,0,0,0,0,0,0,,0,0,0,0,0,0,0,0,2020
ENG-Premier League,2019,Norwich City,Ralf Fährmann,GER,GK,30,1988,0.2,0,0,0,0,0,0,0,,0,0,0,0,0,0,0,0,2020
ENG-Premier League,2019,Norwich City,Sam Byram,ENG,DF,25,1993,14.4,40,22,24,11,5,18,37,48.6,19,16,8,8,26,66,73,0,2020
ENG-Premier League,2019,Norwich City,Teemu Pukki,FIN,FW,29,1990,32.1,12,6,3,5,4,1,23,4.3,22,13,0,13,6,18,7,0,2020
ENG-Premier League,2019,Norwich City,Tim Krul,NED,GK,31,1988,36.0,0,0,0,0,0,0,1,0.0,1,2,0,2,1,1,13,1,2020
ENG-Premier League,2019,Norwich City,Timm Klose,SUI,DF,31,1988,6.5,8,2,5,2,1,7,11,63.6,4,6,6,0,7,15,29,0,2020
ENG-Premier League,2019,Norwich City,Todd Cantwell,ENG,"FW,MF",21,1998,27.7,51,31,19,27,5,26,73,35.6,47,38,2,36,18,69,35,1,2020
ENG-Premier League,2019,Norwich City,Tom Trybull,GER,MF,26,1993,12.6,39,25,15,18,6,16,60,26.7,44,20,5,15,16,55,35,0,2020
ENG-Premier League,2019,Sheffield Utd,Ben Osborn,ENG,"MF,DF",24,1994,6.6,15,10,11,3,1,3,16,18.8,13,6,1,5,6,21,7,0,2020
ENG-Premier League,2019,Sheffield Utd,Billy Sharp,ENG,FW,33,1986,11.7,6,5,2,1,3,1,6,16.7,5,2,0,2,1,7,2,0,2020
ENG-Premier League,2019,Sheffield Utd,Callum Robinson,IRL,"FW,MF",24,1995,7.5,6,3,2,2,2,2,7,28.6,5,3,0,3,7,13,3,0,2020
ENG-Premier League,2019,Sheffield Utd,Chris Basham,ENG,DF,31,1988,36.0,85,48,58,20,7,48,81,59.3,33,38,15,23,77,162,173,1,2020
ENG-Premier League,2019,Sheffield Utd,David McGoldrick,IRL,FW,31,1987,20.2,41,26,9,24,8,5,20,25.0,15,14,2,12,3,44,23,0,2020
ENG-Premier League,2019,Sheffield Utd,Dean Henderson,ENG,GK,22,1997,36.0,0,0,0,0,0,0,0,,0,0,0,0,1,1,13,1,2020
ENG-Premier League,2019,Sheffield Utd,Enda Stevens,IRL,DF,29,1990,37.2,81,46,48,26,7,42,96,43.8,54,27,8,19,35,116,71,3,2020
ENG-Premier League,2019,Sheffield Utd,George Baldock,GRE,DF,26,1993,38.0,62,43,35,17,10,27,47,57.4,20,26,3,23,34,96,83,3,2020
ENG-Premier League,2019,Sheffield Utd,Jack O'Connell,ENG,DF,25,1994,32.4,23,14,15,6,2,10,20,50.0,10,38,17,21,42,65,154,1,2020
ENG-Premier League,2019,Sheffield Utd,Jack Robinson,ENG,DF,25,1993,5.6,10,5,5,5,0,1,6,16.7,5,12,5,7,8,18,24,0,2020
ENG-Premier League,2019,Sheffield Utd,Jack Rodwell,ENG,MF,28,1991,0.2,0,0,0,0,0,0,0,,0,0,0,0,0,0,1,0,2020
ENG-Premier League,2019,Sheffield Utd,John Egan,IRL,DF,26,1992,35.4,44,27,34,10,0,25,45,55.6,20,39,27,12,58,102,171,4,2020
ENG-Premier League,2019,Sheffield Utd,John Fleck,SCO,MF,27,1991,28.0,36,25,13,14,9,22,64,34.4,42,25,3,22,24,60,26,0,2020
ENG-Premier League,2019,Sheffield Utd,John Lundstram,ENG,MF,25,1994,27.3,46,30,18,21,7,21,65,32.3,44,18,4,14,33,79,46,1,2020
ENG-Premier League,2019,Sheffield Utd,Kieron Freeman,WAL,FW,27,1992,0.1,0,0,0,0,0,0,0,,0,0,0,0,0,0,0,0,2020
ENG-Premier League,2019,Sheffield Utd,Leon Clarke,ENG,"FW,MF",34,1985,0.4,0,0,0,0,0,0,0,,0,0,0,0,0,0,2,0,2020
ENG-Premier League,2019,Sheffield Utd,Luke Freeman,ENG,MF,27,1992,4.1,6,4,2,2,2,2,8,25.0,6,1,0,1,10,16,6,0,2020
ENG-Premier League,2019,Sheffield Utd,Lys Mousset,FRA,FW,23,1996,13.8,9,5,0,5,4,3,7,42.9,4,3,0,3,4,13,2,0,2020
ENG-Premier League,2019,Sheffield Utd,Muhamed Bešić,BIH,MF,26,1992,2.8,8,6,4,4,0,2,5,40.0,3,4,0,4,1,9,6,0,2020
ENG-Premier League,2019,Sheffield Utd,Oliver McBurnie,SCO,FW,23,1996,23.5,37,22,6,27,4,11,40,27.5,29,25,3,22,15,52,43,0,2020
ENG-Premier League,2019,Sheffield Utd,Oliver Norwood,NIR,MF,28,1991,34.3,66,37,35,24,7,28,97,28.9,69,34,12,22,47,113,40,1,2020
ENG-Premier League,2019,Sheffield Utd,Phil Jagielka,ENG,DF,36,1982,2.7,5,4,3,2,0,1,3,33.3,2,5,5,0,4,9,19,0,2020
ENG-Premier League,2019,Sheffield Utd,Ravel Morrison,JAM,MF,26,1993,0.1,0,0,0,0,0,0,0,,0,0,0,0,0,0,0,0,2020
ENG-Premier League,2019,Sheffield Utd,Richairo Živković,CUW,FW,22,1996,1.2,2,2,0,2,0,1,2,50.0,1,1,0,1,0,2,0,0,2020
ENG-Premier League,2019,Sheffield Utd,Sander Berge,NOR,MF,21,1998,10.5,22,15,3,14,5,5,10,50.0,5,15,1,14,10,32,16,0,2020
ENG-Premier League,2019,Sheffield Utd,Simon Moore,ENG,GK,29,1990,2.0,1,0,1,0,0,1,1,100.0,0,0,0,0,0,1,0,1,2020
ENG-Premier League,2019,Southampton,Alex McCarthy,ENG,GK,29,1989,28.0,1,1,1,0,0,1,1,100.0,0,1,0,1,0,1,11,3,2020
ENG-Premier League,2019,Southampton,Angus Gunn,SCO,GK,23,1996,10.0,1,1,1,0,0,1,3,33.3,2,0,0,0,0,1,1,0,2020
ENG-Premier League,2019,Southampton,Che Adams,SCO,FW,23,1996,12.3,6,4,1,5,0,1,4,25.0,3,9,1,8,2,8,10,0,2020
ENG-Premier League,2019,Southampton,Cédric Soares,POR,DF,27,1991,14.5,45,26,19,24,2,25,41,61.0,16,18,4,14,19,64,51,0,2020
ENG-Premier League,2019,Southampton,Danny Ings,ENG,FW,27,1992,31.2,42,25,16,16,10,13,67,19.4,54,62,4,58,9,51,30,1,2020
ENG-Premier League,2019,Southampton,Jack Stephens,ENG,DF,25,1994,27.2,44,27,30,13,1,24,46,52.2,22,38,22,16,31,75,120,2,2020
ENG-Premier League,2019,Southampton,Jake Vokins,ENG,DF,19,2000,1.0,2,2,0,0,2,1,1,100.0,0,0,0,0,0,2,1,0,2020
ENG-Premier League,2019,Southampton,James Ward-Prowse,ENG,"MF,DF",24,1994,38.0,92,48,39,39,14,39,94,41.5,55,48,14,34,60,152,75,1,2020
ENG-Premier League,2019,Southampton,Jan Bednarek,POL,DF,23,1996,34.0,65,38,41,18,6,31,61,50.8,30,44,23,21,77,142,198,4,2020
ENG-Premier League,2019,Southampton,Jannik Vestergaard,DEN,DF,26,1992,16.6,19,12,14,5,0,11,28,39.3,17,15,9,6,26,45,99,2,2020
ENG-Premier League,2019,Southampton,Kevin Danso,AUT,DF,20,1998,3.1,6,4,3,3,0,4,7,57.1,3,7,3,4,2,8,7,0,2020
ENG-Premier League,2019,Southampton,Kyle Walker-Peters,ENG,DF,22,1997,7.8,13,8,5,6,2,6,16,37.5,10,10,3,7,14,27,21,1,2020
ENG-Premier League,2019,Southampton,Maya Yoshida,JPN,DF,30,1988,6.2,8,5,4,1,3,3,7,42.9,4,6,2,4,4,12,27,1,2020
ENG-Premier League,2019,Southampton,Michael Obafemi,IRL,FW,19,2000,7.4,7,3,1,3,3,2,14,14.3,12,3,0,3,6,13,0,0,2020
ENG-Premier League,2019,Southampton,Moussa Djenepo,MLI,"MF,DF",21,1998,10.3,27,21,13,9,5,11,21,52.4,10,15,1,14,9,36,9,0,2020
ENG-Premier League,2019,Southampton,Nathan Redmond,ENG,"MF,FW",25,1994,30.7,49,29,17,23,9,21,57,36.8,36,39,2,37,16,65,16,0,2020
ENG-Premier League,2019,Southampton,Nathan Tella,ENG,FW,20,1999,0.0,0,0,0,0,0,0,0,,0,0,0,0,0,0,0,0,2020
ENG-Premier League,2019,Southampton,Oriol Romeu,ESP,MF,27,1991,20.7,55,35,23,30,2,27,75,36.0,48,35,13,22,34,89,32,0,2020
ENG-Premier League,2019,Southampton,Pierre Højbjerg,DEN,MF,23,1995,30.6,80,49,34,38,8,39,91,42.9,52,44,5,39,46,126,54,2,2020
ENG-Premier League,2019,Southampton,Ryan Bertrand,ENG,DF,29,1989,30.5,47,29,22,15,10,26,58,44.8,32,27,12,15,37,84,31,1,2020
ENG-Premier League,2019,Southampton,Shane Long,IRL,FW,32,1987,15.5,19,10,5,8,6,7,19,36.8,12,12,0,12,4,23,16,0,2020
ENG-Premier League,2019,Southampton,Sofiane Boufal,MAR,"MF,FW",25,1993,8.5,16,8,6,5,5,6,15,40.0,9,17,0,17,4,20,1,0,2020
ENG-Premier League,2019,Southampton,Stuart Armstrong,SCO,MF,27,1992,19.1,32,19,19,11,2,9,38,23.7,29,22,4,18,11,43,23,1,2020
ENG-Premier League,2019,Southampton,William Smallbone,IRL,MF,19,2000,4.4,10,5,2,8,0,5,10,50.0,5,7,1,6,1,11,2,0,2020
ENG-Premier League,2019,Southampton,Yan Valery,TUN,DF,20,1999,8.7,20,7,9,7,4,11,19,57.9,8,9,1,8,13,33,32,2,2020
ENG-Premier League,2019,Tottenham,Ben Davies,WAL,DF,26,1993,15.9,28,15,13,11,4,7,21,33.3,14,28,12,16,22,50,47,0,2020
ENG-Premier League,2019,Tottenham,Christian Eriksen,DEN,"MF,FW",27,1992,12.2,19,9,10,8,1,7,24,29.2,17,10,1,9,12,31,16,0,2020
ENG-Premier League,2019,Tottenham,Danny Rose,ENG,DF,29,1990,9.9,18,11,6,10,2,9,20,45.0,11,14,6,8,8,26,34,2,2020
ENG-Premier League,2019,Tottenham,Davinson Sánchez,COL,DF,23,1996,27.0,44,27,32,12,0,22,44,50.0,22,40,28,12,34,78,128,5,2020
ENG-Premier League,2019,Tottenham,Dele Alli,ENG,"MF,FW",23,1996,20.5,34,16,11,20,3,13,37,35.1,24,35,3,32,17,51,17,2,2020
ENG-Premier League,2019,Tottenham,Eric Dier,ENG,"DF,MF",25,1994,14.9,21,12,10,10,1,10,20,50.0,10,14,9,5,21,42,65,0,2020
ENG-Premier League,2019,Tottenham,Gedson Fernandes,POR,"MF,DF",20,1999,0.8,2,0,2,0,0,0,2,0.0,2,2,0,2,1,3,0,0,2020
ENG-Premier League,2019,Tottenham,Georges-Kévin N'Koudou,CMR,FW,24,1995,0.0,0,0,0,0,0,0,1,0.0,1,0,0,0,0,0,0,0,2020
ENG-Premier League,2019,Tottenham,Giovani Lo Celso,ARG,"MF,FW",23,1996,16.6,51,29,12,33,6,12,59,20.3,47,20,4,16,9,60,19,0,2020
ENG-Premier League,2019,Tottenham,Harry Kane,ENG,FW,26,1993,28.7,18,12,3,12,3,4,17,23.5,13,17,7,10,6,24,30,0,2020
ENG-Premier League,2019,Tottenham,Harry Winks,ENG,MF,23,1996,24.7,40,24,18,20,2,17,54,31.5,37,27,8,19,36,76,32,1,2020
ENG-Premier League,2019,Tottenham,Hugo Lloris,FRA,GK,32,1986,20.1,0,0,0,0,0,0,0,,0,0,0,0,1,1,3,2,2020
ENG-Premier League,2019,Tottenham,Jan Vertonghen,BEL,DF,32,1987,18.3,40,24,25,14,1,20,31,64.5,11,18,10,8,33,73,68,0,2020
ENG-Premier League,2019,Tottenham,Japhet Tanganga,ENG,DF,20,1999,5.8,17,9,10,6,1,10,17,58.8,7,7,6,1,11,28,31,2,2020
ENG-Premier League,2019,Tottenham,Juan Foyth,ARG,DF,21,1998,0.8,7,3,5,2,0,3,4,75.0,1,1,0,1,1,8,3,1,2020
ENG-Premier League,2019,Tottenham,Kyle Walker-Peters,ENG,DF,22,1997,2.7,8,5,8,0,0,5,9,55.6,4,4,2,2,3,11,5,1,2020
ENG-Premier League,2019,Tottenham,Lucas Moura,BRA,"FW,MF",26,1992,24.9,57,33,25,22,10,16,58,27.6,42,29,2,27,15,72,27,0,2020
ENG-Premier League,2019,Tottenham,Moussa Sissoko,FRA,MF,29,1989,27.2,39,25,25,12,2,20,48,41.7,28,19,4,15,27,66,43,2,2020
ENG-Premier League,2019,Tottenham,Oliver Skipp,ENG,MF,18,2000,0.9,2,2,0,2,0,1,4,25.0,3,3,2,1,0,2,0,0,2020
ENG-Premier League,2019,Tottenham,Paulo Gazzaniga,ARG,GK,27,1992,17.9,0,0,0,0,0,0,0,,0,0,0,0,1,1,4,1,2020
ENG-Premier League,2019,Tottenham,Ryan Sessegnon,ENG,"DF,FW",19,2000,3.8,6,4,2,4,0,3,6,50.0,3,0,0,0,3,9,12,0,2020
ENG-Premier League,2019,Tottenham,Serge Aurier,CIV,DF,26,1992,30.0,93,69,58,27,8,39,69,56.5,30,38,6,32,47,140,98,2,2020
ENG-Premier League,2019,Tottenham,Son Heung-min,KOR,FW,27,1992,27.5,23,15,10,11,2,9,57,15.8,48,23,0,23,19,42,18,1,2020
ENG-Premier League,2019,Tottenham,Steven Bergwijn,NED,"FW,MF",21,1997,7.8,10,6,3,6,1,4,12,33.3,8,12,0,12,1,11,5,0,2020
ENG-Premier League,2019,Tottenham,Tanguy Ndombele,FRA,MF,22,1996,11.2,24,16,10,13,1,9,22,40.9,13,20,3,17,14,38,7,0,2020
ENG-Premier League,2019,Tottenham,Toby Alderweireld,BEL,DF,30,1989,32.9,40,29,24,13,3,11,24,45.8,13,48,32,16,31,71,172,2,2020
ENG-Premier League,2019,Tottenham,Troy Parrott,IRL,FW,17,2002,0.1,0,0,0,0,0,0,0,,0,0,0,0,0,0,0,0,2020
ENG-Premier League,2019,Tottenham,Victor Wanyama,KEN,MF,28,1991,0.3,0,0,0,0,0,0,0,,0,0,0,0,0,0,0,0,2020
ENG-Premier League,2019,Tottenham,Érik Lamela,ARG,"MF,FW",27,1992,13.5,24,20,9,13,2,2,21,9.5,19,12,3,9,8,32,10,0,2020
ENG-Premier League,2019,Watford,Abdoulaye Doucouré,MLI,MF,26,1993,35.1,64,30,29,29,6,16,57,28.1,41,46,8,38,31,95,32,0,2020
ENG-Premier League,2019,Watford,Adam Masina,MAR,DF,25,1994,20.2,38,22,24,11,3,14,37,37.8,23,26,12,14,28,66,66,0,2020
ENG-Premier League,2019,Watford,Adrian Mariappa,JAM,DF,32,1986,16.8,20,14,15,4,1,11,30,36.7,19,22,7,15,11,31,73,0,2020
ENG-Premier League,2019,Watford,Andre Gray,JAM,FW,28,1991,8.4,4,3,0,2,2,1,3,33.3,2,4,1,3,1,5,2,0,2020
ENG-Premier League,2019,Watford,Ben Foster,ENG,GK,36,1983,38.0,1,0,1,0,0,1,3,33.3,2,1,0,1,0,1,16,2,2020
ENG-Premier League,2019,Watford,Christian Kabasele,BEL,DF,28,1991,25.0,37,24,26,11,0,17,32,53.1,15,31,23,8,36,73,127,0,2020
ENG-Premier League,2019,Watford,Craig Cathcart,NIR,DF,30,1989,27.6,41,26,25,15,1,10,24,41.7,14,19,16,3,25,66,136,1,2020
ENG-Premier League,2019,Watford,Craig Dawson,ENG,DF,29,1990,26.2,29,18,16,13,0,17,31,54.8,14,41,32,9,34,63,116,0,2020
ENG-Premier League,2019,Watford,Danny Welbeck,ENG,"FW,MF",28,1990,9.1,14,6,6,5,3,3,11,27.3,8,12,1,11,5,19,7,0,2020
ENG-Premier League,2019,Watford,Daryl Janmaat,NED,DF,30,1989,6.7,14,10,8,6,0,6,13,46.2,7,7,2,5,7,21,23,0,2020
ENG-Premier League,2019,Watford,Dimitri Foulquier,FRA,"DF,MF",26,1993,0.7,1,0,1,0,0,0,0,,0,1,0,1,2,3,2,0,2020
ENG-Premier League,2019,Watford,Domingos Quina,POR,"MF,FW",19,1999,0.2,2,0,1,1,0,1,2,50.0,1,3,0,3,0,2,0,0,2020
ENG-Premier League,2019,Watford,Gerard Deulofeu,ESP,FW,25,1994,23.3,33,16,18,9,6,12,59,20.3,47,10,0,10,25,58,6,0,2020
ENG-Premier League,2019,Watford,Ignacio Pussetto,ARG,"FW,MF",23,1995,0.8,7,4,4,2,1,3,8,37.5,5,2,1,1,3,10,4,0,2020
ENG-Premier League,2019,Watford,Isaac Success,NGA,"FW,MF",23,1996,0.8,0,0,0,0,0,0,0,,0,0,0,0,1,1,0,0,2020
ENG-Premier League,2019,Watford,Ismaila Sarr,SEN,"FW,MF",21,1998,22.5,11,10,5,2,4,5,23,21.7,18,9,1,8,18,29,10,0,2020
ENG-Premier League,2019,Watford,José Holebas,GRE,DF,35,1984,11.4,26,15,19,7,0,9,28,32.1,19,11,4,7,3,29,33,0,2020
ENG-Premier League,2019,Watford,João Pedro,BRA,"FW,MF",17,2001,0.3,0,0,0,0,0,0,0,,0,0,0,0,0,0,0,0,2020
ENG-Premier League,2019,Watford,Kiko Femenía,ESP,DF,28,1991,24.9,68,38,49,17,2,43,80,53.8,37,16,2,14,36,104,49,0,2020
ENG-Premier League,2019,Watford,Nathaniel Chalobah,ENG,MF,24,1994,10.3,30,11,13,13,4,12,27,44.4,15,10,4,6,18,48,20,0,2020
ENG-Premier League,2019,Watford,Roberto Pereyra,ARG,"FW,MF",28,1991,18.3,20,8,11,7,2,9,28,32.1,19,21,0,21,14,34,12,1,2020
ENG-Premier League,2019,Watford,Sebastian Prödl,AUT,DF,32,1987,0.6,0,0,0,0,0,0,0,,0,0,0,0,0,0,4,0,2020
ENG-Premier League,2019,Watford,Tom Cleverley,ENG,MF,29,1989,10.8,28,15,8,14,6,9,36,25.0,27,13,1,12,10,38,15,0,2020
ENG-Premier League,2019,Watford,Troy Deeney,ENG,FW,31,1988,24.7,19,12,6,10,3,6,29,20.7,23,13,1,12,11,30,27,0,2020
ENG-Premier League,2019,Watford,Will Hughes,ENG,MF,24,1995,25.0,75,47,24,41,10,25,67,37.3,42,48,8,40,37,112,28,0,2020
ENG-Premier League,2019,Watford,Étienne Capoue,FRA,MF,31,1988,29.2,75,40,38,30,7,37,85,43.5,48,30,11,19,68,143,61,0,2020
ENG-Premier League,2019,West Ham,Aaron Cresswell,ENG,DF,29,1989,30.3,43,26,21,18,4,23,46,50.0,23,33,10,23,35,78,75,2,2020
ENG-Premier League,2019,West Ham,Albian Ajeti,SUI,FW,22,1997,1.5,1,0,0,0,1,0,0,,0,0,0,0,0,1,0,0,2020
ENG-Premier League,2019,West Ham,Andriy Yarmolenko,UKR,"MF,FW",29,1989,11.0,13,8,5,6,2,5,20,25.0,15,3,1,2,6,19,4,0,2020
ENG-Premier League,2019,West Ham,Angelo Ogbonna,ITA,DF,31,1988,31.0,38,24,20,14,4,18,32,56.3,14,50,32,18,27,65,134,1,2020
ENG-Premier League,2019,West Ham,Arthur Masuaku,COD,DF,25,1993,10.4,41,23,24,13,4,23,39,59.0,16,19,5,14,14,55,23,0,2020
ENG-Premier League,2019,West Ham,Ben Johnson,ENG,DF,19,2000,3.0,8,4,7,1,0,7,10,70.0,3,5,2,3,3,11,11,0,2020
ENG-Premier League,2019,West Ham,Carlos Sánchez,COL,MF,33,1986,1.3,1,0,0,1,0,1,1,100.0,0,1,0,1,2,3,1,0,2020
ENG-Premier League,2019,West Ham,Darren Randolph,IRL,GK,32,1987,2.0,0,0,0,0,0,0,0,,0,0,0,0,0,0,2,0,2020
ENG-Premier League,2019,West Ham,David Martin,ENG,GK,33,1986,4.8,0,0,0,0,0,0,0,,0,0,0,0,0,0,1,1,2020
ENG-Premier League,2019,West Ham,Declan Rice,ENG,MF,20,1999,38.0,116,60,64,48,4,47,98,48.0,51,41,9,32,77,193,55,0,2020
ENG-Premier League,2019,West Ham,Fabián Balbuena,PAR,DF,27,1991,13.1,17,12,13,3,1,9,25,36.0,16,15,5,10,26,43,75,3,2020
ENG-Premier League,2019,West Ham,Felipe Anderson,BRA,"MF,FW",26,1993,16.6,46,32,20,21,5,11,47,23.4,36,19,1,18,22,68,11,0,2020
ENG-Premier League,2019,West Ham,Issa Diop,FRA,DF,22,1997,30.7,27,15,18,9,0,16,25,64.0,9,37,21,16,47,74,166,2,2020
ENG-Premier League,2019,West Ham,Jack Wilshere,ENG,MF,27,1992,2.4,1,0,1,0,0,0,4,0.0,4,3,0,3,1,2,0,0,2020
ENG-Premier League,2019,West Ham,Jarrod Bowen,ENG,"FW,MF",22,1996,10.2,19,15,7,9,3,4,17,23.5,13,6,0,6,16,35,8,0,2020
ENG-Premier League,2019,West Ham,Javier Hernández,MEX,FW,31,1988,1.2,0,0,0,0,0,0,1,0.0,1,0,0,0,1,1,0,0,2020
ENG-Premier League,2019,West Ham,Jeremy Ngakia,ENG,DF,18,2000,4.9,15,7,10,5,0,9,21,42.9,12,6,1,5,7,22,16,0,2020
ENG-Premier League,2019,West Ham,Manuel Lanzini,ARG,"MF,FW",26,1993,15.3,14,9,6,6,2,7,39,17.9,32,9,1,8,10,24,3,0,2020
ENG-Premier League,2019,West Ham,Mark Noble,ENG,MF,32,1987,29.7,52,30,19,28,5,22,64,34.4,42,20,6,14,20,72,10,1,2020
ENG-Premier League,2019,West Ham,Michail Antonio,JAM,FW,29,1990,19.6,13,9,5,4,4,4,14,28.6,10,17,2,15,9,22,5,0,2020
ENG-Premier League,2019,West Ham,Nathan Holland,ENG,MF,21,1998,0.4,3,1,2,1,0,0,0,,0,1,0,1,0,3,0,0,2020
ENG-Premier League,2019,West Ham,Pablo Fornals,ESP,"MF,FW",23,1996,24.1,46,28,21,18,7,19,64,29.7,45,35,1,34,25,71,15,0,2020
ENG-Premier League,2019,West Ham,Pablo Zabaleta,ARG,DF,34,1985,6.6,18,10,12,5,1,6,13,46.2,7,5,3,2,14,32,21,0,2020
ENG-Premier League,2019,West Ham,Robert Snodgrass,SCO,"MF,FW",31,1987,16.8,29,16,17,10,2,13,44,29.5,31,12,1,11,4,33,11,0,2020
ENG-Premier League,2019,West Ham,Roberto,ESP,GK,33,1986,7.6,0,0,0,0,0,0,0,,0,0,0,0,0,0,2,2,2020
ENG-Premier League,2019,West Ham,Ryan Fredericks,ENG,DF,26,1992,24.9,82,56,59,18,5,41,64,64.1,23,20,10,10,24,106,73,1,2020
ENG-Premier League,2019,West Ham,Sébastien Haller,CIV,FW,25,1994,25.2,22,15,8,10,4,3,30,10.0,27,19,5,14,8,30,27,0,2020
ENG-Premier League,2019,West Ham,Tomáš Souček,CZE,MF,24,1995,11.6,29,15,13,15,1,10,23,43.5,13,7,1,6,22,51,35,0,2020
ENG-Premier League,2019,West Ham,Łukasz Fabiański,POL,GK,34,1985,23.5,2,2,2,0,0,2,4,50.0,2,0,0,0,1,3,5,3,2020
ENG-Premier League,2019,Wolves,Adama Traoré,ESP,"FW,DF",23,1996,28.9,33,21,6,14,13,8,23,34.8,15,19,3,16,13,46,14,2,2020
ENG-Premier League,2019,Wolves,Bruno Jordão,POR,FW,20,1998,0.1,0,0,0,0,0,0,0,,0,1,0,1,0,0,0,0,2020
ENG-Premier League,2019,Wolves,Conor Coady,ENG,DF,26,1993,38.0,36,23,30,6,0,15,30,50.0,15,22,15,7,28,64,119,2,2020
ENG-Premier League,2019,Wolves,Daniel Podence,POR,"FW,MF",23,1995,3.2,3,3,2,0,1,0,2,0.0,2,4,1,3,2,5,1,0,2020
ENG-Premier League,2019,Wolves,Diogo Jota,POR,FW,22,1996,25.4,28,15,16,10,2,12,48,25.0,36,17,0,17,9,37,10,2,2020
ENG-Premier League,2019,Wolves,Jesús Vallejo,ESP,DF,22,1997,1.8,1,1,1,0,0,1,2,50.0,1,4,3,1,2,3,8,1,2020
ENG-Premier League,2019,Wolves,Jonny Castro,ESP,"MF,DF",25,1994,32.1,91,55,54,26,11,29,82,35.4,53,45,10,35,53,144,45,2,2020
ENG-Premier League,2019,Wolves,João Moutinho,POR,MF,32,1986,34.5,93,50,43,41,9,46,139,33.1,93,43,13,30,50,143,18,1,2020
ENG-Premier League,2019,Wolves,Leander Dendoncker,BEL,"MF,DF",24,1995,31.1,68,31,41,19,8,28,67,41.8,39,39,12,27,38,106,64,2,2020
ENG-Premier League,2019,Wolves,Matt Doherty,IRL,"MF,DF",27,1992,31.5,55,29,34,17,4,27,41,65.9,14,34,4,30,40,95,52,1,2020
ENG-Premier League,2019,Wolves,Max Kilman,ENG,DF,22,1997,2.1,4,2,1,3,0,2,2,100.0,0,1,1,0,4,8,7,0,2020
ENG-Premier League,2019,Wolves,Morgan Gibbs-White,ENG,"MF,FW",19,2000,1.4,0,0,0,0,0,0,0,,0,0,0,0,2,2,0,0,2020
ENG-Premier League,2019,Wolves,Patrick Cutrone,ITA,FW,21,1998,3.3,4,2,2,1,1,1,5,20.0,4,1,1,0,2,6,1,0,2020
ENG-Premier League,2019,Wolves,Pedro Neto,POR,"FW,MF",19,2000,10.4,9,4,3,6,0,4,15,26.7,11,2,0,2,6,15,4,0,2020
ENG-Premier League,2019,Wolves,Raúl Jiménez,MEX,FW,28,1991,36.0,20,12,6,10,4,3,31,9.7,28,26,0,26,16,36,34,1,2020
ENG-Premier League,2019,Wolves,Romain Saïss,MAR,DF,29,1990,30.1,55,38,37,15,3,32,46,69.6,14,31,16,15,55,110,127,3,2020
ENG-Premier League,2019,Wolves,Rui Patrício,POR,GK,31,1988,38.0,0,0,0,0,0,0,2,0.0,2,2,0,2,2,2,5,2,2020
ENG-Premier League,2019,Wolves,Ryan Bennett,ENG,DF,29,1990,6.7,4,2,4,0,0,2,6,33.3,4,14,8,6,9,13,29,0,2020
ENG-Premier League,2019,Wolves,Rúben Neves,POR,MF,22,1997,34.0,62,33,27,32,3,34,86,39.5,52,38,9,29,56,118,34,1,2020
ENG-Premier League,2019,Wolves,Rúben Vinagre,POR,"MF,DF",20,1999,7.2,23,13,15,6,2,12,15,80.0,3,7,2,5,11,34,22,0,2020
ENG-Premier League,2019,Wolves,Willy Boly,CIV,DF,28,1991,22.0,57,33,36,21,0,25,43,58.1,18,28,11,17,39,96,108,3,2020
ENG-Premier League,2020,Arsenal,Ainsley Maitland-Niles,ENG,"MF,DF",22,1997,5.4,11,7,6,5,0,8,12,66.7,4,12,2,10,14,25,7,1,2021
ENG-Premier League,2020,Arsenal,Alexandre Lacazette,FRA,FW,29,1991,21.4,18,10,4,11,3,4,22,18.2,18,20,1,19,12,30,13,0,2021
ENG-Premier League,2020,Arsenal,Bernd Leno,GER,GK,28,1992,34.8,1,0,1,0,0,1,1,100.0,0,1,0,1,0,1,11,2,2021
ENG-Premier League,2020,Arsenal,Bukayo Saka,ENG,"FW,MF",18,2001,28.4,25,16,10,13,2,11,40,27.5,29,21,2,19,25,50,24,0,2021
ENG-Premier League,2020,Arsenal,Calum Chambers,ENG,DF,25,1995,8.4,7,3,3,2,2,3,8,37.5,5,6,2,4,10,17,37,0,2021
ENG-Premier League,2020,Arsenal,Cédric Soares,POR,DF,28,1991,8.3,12,8,6,4,2,6,21,28.6,15,6,1,5,8,20,16,1,2021
ENG-Premier League,2020,Arsenal,Dani Ceballos,ESP,MF,23,1996,17.9,37,22,20,11,6,21,51,41.2,30,23,6,17,35,72,14,1,2021
ENG-Premier League,2020,Arsenal,David Luiz,BRA,DF,33,1987,15.5,12,9,5,7,0,4,4,100.0,0,16,9,7,16,28,50,2,2021
ENG-Premier League,2020,Arsenal,Eddie Nketiah,ENG,FW,21,1999,4.7,3,1,0,2,1,0,2,0.0,2,6,0,6,0,3,5,0,2021
ENG-Premier League,2020,Arsenal,Emile Smith Rowe,ENG,"MF,FW",20,2000,16.0,14,7,5,5,4,6,17,35.3,11,15,1,14,10,24,12,0,2021
ENG-Premier League,2020,Arsenal,Gabriel Dos Santos,BRA,DF,22,1997,22.2,25,15,19,5,1,13,19,68.4,6,27,19,8,26,51,74,2,2021
ENG-Premier League,2020,Arsenal,Granit Xhaka,SUI,"MF,DF",27,1992,28.0,50,26,18,17,15,30,58,51.7,28,23,7,16,24,74,38,3,2021
ENG-Premier League,2020,Arsenal,Héctor Bellerín,ESP,"DF,MF",25,1995,23.2,29,19,14,12,3,12,41,29.3,29,26,8,18,33,62,33,0,2021
ENG-Premier League,2020,Arsenal,Joe Willock,ENG,MF,20,1999,2.6,6,3,1,4,1,3,7,42.9,4,6,1,5,3,9,0,0,2021
ENG-Premier League,2020,Arsenal,Kieran Tierney,SCO,DF,23,1997,25.5,27,15,5,14,8,11,31,35.5,20,31,10,21,16,43,63,0,2021
ENG-Premier League,2020,Arsenal,Martin Ødegaard,NOR,MF,21,1998,9.6,9,3,2,6,1,4,14,28.6,10,2,0,2,2,11,5,0,2021
ENG-Premier League,2020,Arsenal,Martinelli,BRA,FW,19,2001,6.5,7,1,2,3,2,4,10,40.0,6,6,0,6,8,15,4,0,2021
ENG-Premier League,2020,Arsenal,Mathew Ryan,AUS,GK,28,1992,3.0,0,0,0,0,0,0,0,,0,0,0,0,0,0,1,0,2021
ENG-Premier League,2020,Arsenal,Mohamed Elneny,EGY,MF,28,1992,17.2,14,6,7,7,0,7,28,25.0,21,11,4,7,24,38,20,2,2021
ENG-Premier League,2020,Arsenal,Nicolas Pépé,CIV,FW,25,1995,18.0,20,15,8,6,6,8,23,34.8,15,16,1,15,12,32,19,0,2021
ENG-Premier League,2020,Arsenal,Pablo Marí,ESP,DF,26,1993,10.0,15,9,12,3,0,5,10,50.0,5,8,7,1,9,24,30,2,2021
ENG-Premier League,2020,Arsenal,Pierre-Emerick Aubameyang,GAB,FW,31,1989,25.9,12,8,7,4,1,3,20,15.0,17,18,0,18,7,19,17,0,2021
ENG-Premier League,2020,Arsenal,Reiss Nelson,ENG,"FW,MF",20,1999,0.8,1,0,0,0,1,0,0,,0,0,0,0,1,2,1,0,2021
ENG-Premier League,2020,Arsenal,Rob Holding,ENG,DF,24,1995,28.4,43,20,28,13,2,17,35,48.6,18,37,27,10,24,67,120,0,2021
ENG-Premier League,2020,Arsenal,Rúnar Alex Rúnarsson,ISL,GK,25,1995,0.2,0,0,0,0,0,0,0,,0,0,0,0,0,0,0,0,2021
ENG-Premier League,2020,Arsenal,Sead Kolašinac,BIH,DF,27,1993,1.0,0,0,0,0,0,0,0,,0,0,0,0,1,1,0,0,2021
ENG-Premier League,2020,Arsenal,Shkodran Mustafi,GER,DF,28,1992,0.5,1,1,1,0,0,1,1,100.0,0,1,0,1,0,1,3,0,2021
ENG-Premier League,2020,Arsenal,Thomas Partey,GHA,MF,27,1993,17.0,44,21,16,24,4,24,56,42.9,32,17,5,12,23,67,18,0,2021
ENG-Premier League,2020,Arsenal,Willian,BRA,FW,31,1988,15.6,13,7,6,6,1,6,16,37.5,10,13,0,13,8,21,8,0,2021
ENG-Premier League,2020,Aston Villa,Ahmed Elmohamady,EGY,DF,32,1987,9.3,17,13,12,4,1,9,14,64.3,5,6,3,3,17,34,26,0,2021
ENG-Premier League,2020,Aston Villa,Anwar El Ghazi,NED,FW,25,1995,17.9,16,13,6,7,3,7,23,30.4,16,11,0,11,6,22,11,0,2021
ENG-Premier League,2020,Aston Villa,Bertrand Traoré,BFA,FW,24,1995,25.7,26,10,8,10,8,10,34,29.4,24,23,1,22,15,41,14,1,2021
ENG-Premier League,2020,Aston Villa,Carney Chukwuemeka,ENG,"MF,FW",16,2003,0.2,2,2,1,0,1,1,3,33.3,2,0,0,0,0,2,0,0,2021
ENG-Premier League,2020,Aston Villa,Conor Hourihane,IRL,MF,29,1991,2.5,0,0,0,0,0,0,2,0.0,2,3,0,3,0,0,2,0,2021
ENG-Premier League,2020,Aston Villa,Douglas Luiz,BRA,MF,22,1998,30.9,49,18,22,26,1,20,58,34.5,38,52,17,35,43,92,44,2,2021
ENG-Premier League,2020,Aston Villa,Emiliano Martínez,ARG,GK,27,1992,38.0,3,3,3,0,0,3,4,75.0,1,0,0,0,2,5,10,2,2021
ENG-Premier League,2020,Aston Villa,Ezri Konsa,ENG,DF,22,1997,35.5,25,13,18,6,1,9,13,69.2,4,53,47,6,29,54,162,1,2021
ENG-Premier League,2020,Aston Villa,Jack Grealish,ENG,"FW,MF",24,1995,24.3,31,14,8,16,7,15,24,62.5,9,20,3,17,12,43,5,3,2021
ENG-Premier League,2020,Aston Villa,Jacob Ramsey,ENG,MF,19,2001,7.0,10,5,3,4,3,2,12,16.7,10,13,6,7,4,14,5,0,2021
ENG-Premier League,2020,Aston Villa,Jaden Philogene Bidace,ENG,FW,18,2002,0.0,0,0,0,0,0,0,0,,0,0,0,0,0,0,0,0,2021
ENG-Premier League,2020,Aston Villa,John McGinn,SCO,MF,25,1994,37.0,61,37,23,31,7,27,84,32.1,57,38,6,32,43,104,23,2,2021
ENG-Premier League,2020,Aston Villa,Keinan Davis,ENG,"FW,MF",22,1998,3.1,2,1,1,0,1,0,1,0.0,1,1,0,1,0,2,2,0,2021
ENG-Premier League,2020,Aston Villa,Kortney Hause,ENG,DF,25,1995,7.0,4,2,3,1,0,0,3,0.0,3,4,2,2,8,12,53,0,2021
ENG-Premier League,2020,Aston Villa,Marvelous Nakamba,ZIM,MF,26,1994,8.3,22,14,10,11,1,7,12,58.3,5,16,5,11,17,39,9,1,2021
ENG-Premier League,2020,Aston Villa,Matt Targett,ENG,DF,24,1995,37.8,83,39,52,20,11,56,88,63.6,32,40,14,26,55,138,102,1,2021
ENG-Premier League,2020,Aston Villa,Matty Cash,POL,DF,22,1997,26.4,71,40,43,22,6,41,74,55.4,33,50,11,39,60,131,95,0,2021
ENG-Premier League,2020,Aston Villa,Morgan Sanson,FRA,MF,25,1994,3.3,7,4,4,2,1,1,4,25.0,3,5,0,5,4,11,1,0,2021
ENG-Premier League,2020,Aston Villa,Neil Taylor,WAL,DF,31,1989,0.2,1,1,1,0,0,0,0,,0,1,0,1,0,1,0,0,2021
ENG-Premier League,2020,Aston Villa,Ollie Watkins,ENG,FW,24,1995,37.0,29,17,5,16,8,10,33,30.3,23,21,2,19,7,36,24,0,2021
ENG-Premier League,2020,Aston Villa,Ross Barkley,ENG,MF,26,1993,17.0,6,2,2,4,0,3,15,20.0,12,9,1,8,5,11,6,1,2021
ENG-Premier League,2020,Aston Villa,Trézéguet,EGY,FW,25,1994,13.0,33,18,14,15,4,13,45,28.9,32,13,1,12,19,52,17,0,2021
ENG-Premier League,2020,Aston Villa,Tyrone Mings,ENG,DF,27,1993,35.5,32,16,23,7,2,16,24,66.7,8,59,40,19,41,73,172,3,2021
ENG-Premier League,2020,Aston Villa,Wesley Moraes,BRA,FW,23,1996,0.2,0,0,0,0,0,0,1,0.0,1,0,0,0,0,0,0,0,2021
ENG-Premier League,2020,Brighton,Aaron Connolly,IRL,FW,20,2000,8.8,6,3,1,3,2,0,2,0.0,2,4,0,4,0,6,2,0,2021
ENG-Premier League,2020,Brighton,Adam Lallana,ENG,"MF,FW",32,1988,17.7,28,13,11,13,4,8,39,20.5,31,18,3,15,15,43,13,0,2021
ENG-Premier League,2020,Brighton,Adam Webster,ENG,DF,25,1995,28.8,29,16,15,10,4,12,25,48.0,13,29,16,13,47,76,92,3,2021
ENG-Premier League,2020,Brighton,Alexis Mac Allister,ARG,"MF,FW",21,1998,12.4,26,12,6,16,4,11,38,28.9,27,25,4,21,9,35,4,0,2021
ENG-Premier League,2020,Brighton,Alireza Jahanbakhsh,IRN,"FW,MF",26,1993,5.9,9,7,3,5,1,2,12,16.7,10,8,0,8,8,17,1,0,2021
ENG-Premier League,2020,Brighton,Andi Zeqiri,SUI,"FW,DF",21,1999,1.9,3,2,0,2,1,1,2,50.0,1,1,0,1,0,3,2,0,2021
ENG-Premier League,2020,Brighton,Ben White,ENG,"DF,MF",22,1997,35.5,49,26,21,24,4,24,57,42.1,33,46,22,24,62,111,56,0,2021
ENG-Premier League,2020,Brighton,Bernardo,BRA,"DF,MF",25,1995,2.3,10,8,8,1,1,4,6,66.7,2,2,0,2,1,11,1,0,2021
ENG-Premier League,2020,Brighton,Dan Burn,ENG,DF,28,1992,22.9,50,26,33,14,3,27,53,50.9,26,30,7,23,31,81,75,0,2021
ENG-Premier League,2020,Brighton,Danny Welbeck,ENG,FW,29,1990,17.2,12,6,2,6,4,7,19,36.8,12,17,0,17,7,19,13,0,2021
ENG-Premier League,2020,Brighton,Davy Pröpper,NED,MF,28,1991,2.4,6,5,0,6,0,2,5,40.0,3,3,0,3,1,7,0,0,2021
ENG-Premier League,2020,Brighton,Jakub Moder,POL,"DF,MF",21,1999,7.2,15,7,5,7,3,7,20,35.0,13,12,1,11,3,18,9,0,2021
ENG-Premier League,2020,Brighton,Jayson Molumby,IRL,MF,20,1999,0.0,0,0,0,0,0,0,0,,0,0,0,0,0,0,0,0,2021
ENG-Premier League,2020,Brighton,José Izquierdo,COL,DF,28,1992,0.1,0,0,0,0,0,0,0,,0,0,0,0,0,0,0,0,2021
ENG-Premier League,2020,Brighton,Joël Veltman,NED,DF,28,1992,25.3,67,33,34,25,8,29,57,50.9,28,24,5,19,33,100,64,0,2021
ENG-Premier League,2020,Brighton,Leandro Trossard,BEL,"MF,FW",25,1994,29.0,33,14,11,16,6,10,36,27.8,26,34,2,32,26,59,7,1,2021
ENG-Premier League,2020,Brighton,Lewis Dunk,ENG,DF,28,1991,32.6,30,15,20,8,2,16,23,69.6,7,29,20,9,32,62,106,0,2021
ENG-Premier League,2020,Brighton,Mathew Ryan,AUS,GK,28,1992,11.0,1,0,1,0,0,0,0,,0,0,0,0,0,1,4,0,2021
ENG-Premier League,2020,Brighton,Neal Maupay,FRA,"FW,MF",23,1996,27.9,20,8,9,7,4,4,24,16.7,20,20,0,20,13,33,6,0,2021
ENG-Premier League,2020,Brighton,Pascal Groß,GER,"MF,DF",29,1991,27.6,45,24,24,15,6,24,53,45.3,29,25,4,21,23,68,18,1,2021
ENG-Premier League,2020,Brighton,Percy Tau,RSA,FW,26,1994,1.1,1,1,1,0,0,0,2,0.0,2,1,0,1,0,1,1,0,2021
ENG-Premier League,2020,Brighton,Reda Khadra,GER,MF,19,2001,0.1,0,0,0,0,0,0,0,,0,0,0,0,0,0,0,0,2021
ENG-Premier League,2020,Brighton,Robert Sánchez,ESP,GK,22,1997,27.0,1,0,1,0,0,1,1,100.0,0,1,0,1,1,2,11,2,2021
ENG-Premier League,2020,Brighton,Solly March,ENG,"DF,MF",26,1994,18.6,49,23,24,15,10,18,34,52.9,16,30,5,25,22,71,30,0,2021
ENG-Premier League,2020,Brighton,Steven Alzate,COL,MF,21,1998,10.0,17,8,10,4,3,6,15,40.0,9,8,1,7,8,25,10,0,2021
ENG-Premier League,2020,Brighton,Tariq Lamptey,GHA,"DF,MF",19,2000,9.8,17,9,7,6,4,6,13,46.2,7,8,1,7,19,36,12,1,2021
ENG-Premier League,2020,Brighton,Yves Bissouma,MLI,MF,23,1996,34.6,104,68,50,48,6,33,67,49.3,34,42,6,36,64,168,67,0,2021
ENG-Premier League,2020,Burnley,Ashley Barnes,ENG,FW,30,1989,14.8,12,6,2,6,4,3,13,23.1,10,14,2,12,5,17,11,0,2021
ENG-Premier League,2020,Burnley,Ashley Westwood,ENG,MF,30,1990,37.9,23,15,6,12,5,10,42,23.8,32,26,9,17,44,67,33,0,2021
ENG-Premier League,2020,Burnley,Bailey Peacock-Farrell,NIR,GK,23,1996,4.0,0,0,0,0,0,0,0,,0,0,0,0,0,0,0,0,2021
ENG-Premier League,2020,Burnley,Ben Mee,ENG,DF,30,1989,29.9,32,15,16,14,2,14,29,48.3,15,54,45,9,43,75,148,2,2021
ENG-Premier League,2020,Burnley,Charlie Taylor,ENG,DF,26,1993,27.0,48,28,30,15,3,25,46,54.3,21,36,19,17,29,77,87,2,2021
ENG-Premier League,2020,Burnley,Chris Wood,NZL,FW,28,1991,30.5,12,7,2,4,6,5,18,27.8,13,14,3,11,1,13,21,0,2021
ENG-Premier League,2020,Burnley,Dale Stephens,ENG,MF,31,1989,2.9,11,6,2,7,2,3,6,50.0,3,3,0,3,8,19,2,0,2021
ENG-Premier League,2020,Burnley,Dwight McNeil,ENG,MF,20,1999,34.1,47,24,24,18,5,18,56,32.1,38,44,6,38,32,79,32,1,2021
ENG-Premier League,2020,Burnley,Erik Pieters,NED,"DF,MF",31,1988,14.1,30,21,18,9,3,19,39,48.7,20,30,9,21,12,42,34,0,2021
ENG-Premier League,2020,Burnley,Jack Cork,ENG,MF,31,1989,15.0,26,10,5,17,4,11,31,35.5,20,15,4,11,16,42,20,0,2021
ENG-Premier League,2020,Burnley,James Tarkowski,ENG,DF,27,1992,36.0,66,39,52,11,3,25,49,51.0,24,54,42,12,44,110,163,1,2021
ENG-Premier League,2020,Burnley,Jay Rodriguez,ENG,FW,31,1989,14.1,25,16,5,15,5,13,28,46.4,15,25,4,21,2,27,7,0,2021
ENG-Premier League,2020,Burnley,Jimmy Dunne,IRL,DF,22,1997,3.0,3,3,2,1,0,1,2,50.0,1,3,2,1,6,9,16,1,2021
ENG-Premier League,2020,Burnley,Joel Mumbongo,SWE,FW,21,1999,0.4,0,0,0,0,0,0,0,,0,1,0,1,0,0,0,0,2021
ENG-Premier League,2020,Burnley,Josh Benson,ENG,MF,20,1999,2.9,5,1,3,0,2,1,6,16.7,5,3,0,3,3,8,2,0,2021
ENG-Premier League,2020,Burnley,Josh Brownhill,ENG,MF,24,1995,31.3,45,27,9,29,7,15,44,34.1,29,33,11,22,69,114,39,0,2021
ENG-Premier League,2020,Burnley,Jóhann Berg Guðmundsson,ISL,MF,29,1990,15.1,19,11,6,9,4,11,23,47.8,12,11,2,9,17,36,19,0,2021
ENG-Premier League,2020,Burnley,Kevin Long,IRL,DF,29,1990,7.1,11,6,9,2,0,7,9,77.8,2,11,7,4,6,17,24,0,2021
ENG-Premier League,2020,Burnley,Lewis Richardson,ENG,"FW,MF",17,2003,0.0,0,0,0,0,0,0,0,,0,0,0,0,0,0,0,0,2021
ENG-Premier League,2020,Burnley,Matthew Lowton,ENG,DF,31,1989,34.0,54,32,31,22,1,32,73,43.8,41,36,13,23,56,110,91,1,2021
ENG-Premier League,2020,Burnley,Matěj Vydra,CZE,FW,28,1992,15.2,9,5,2,4,3,1,8,12.5,7,8,1,7,6,15,5,0,2021
ENG-Premier League,2020,Burnley,Nick Pope,ENG,GK,28,1992,32.0,1,1,1,0,0,0,1,0.0,1,0,0,0,2,3,29,2,2021
ENG-Premier League,2020,Burnley,Phil Bardsley,SCO,DF,35,1985,3.0,6,5,4,2,0,3,6,50.0,3,3,1,2,6,12,12,0,2021
ENG-Premier League,2020,Burnley,Robbie Brady,IRL,MF,28,1992,11.7,22,15,12,6,4,12,35,34.3,23,16,0,16,9,31,29,1,2021
ENG-Premier League,2020,Burnley,Will Norris,ENG,GK,26,1993,2.0,0,0,0,0,0,0,0,,0,0,0,0,0,0,0,0,2021
ENG-Premier League,2020,Chelsea,Andreas Christensen,DEN,DF,24,1996,15.2,11,6,8,3,0,0,8,0.0,8,19,14,5,20,31,51,1,2021
ENG-Premier League,2020,Chelsea,Antonio Rüdiger,GER,DF,27,1993,19.0,31,23,16,14,1,12,15,80.0,3,17,10,7,18,49,51,0,2021
ENG-Premier League,2020,Chelsea,Ben Chilwell,ENG,DF,23,1996,25.4,42,22,16,22,4,15,33,45.5,18,28,3,25,24,66,58,0,2021
ENG-Premier League,2020,Chelsea,Billy Gilmour,SCO,MF,19,2001,2.9,4,2,1,2,1,2,7,28.6,5,3,2,1,3,7,1,0,2021
ENG-Premier League,2020,Chelsea,Callum Hudson-Odoi,ENG,"FW,DF",19,2000,11.8,23,15,11,7,5,8,21,38.1,13,15,1,14,6,29,6,0,2021
ENG-Premier League,2020,Chelsea,Christian Pulisic,USA,"FW,MF",21,1998,19.3,19,11,8,10,1,8,21,38.1,13,25,2,23,12,31,9,0,2021
ENG-Premier League,2020,Chelsea,César Azpilicueta,ESP,DF,30,1989,24.3,53,28,22,24,7,19,37,51.4,18,30,5,25,28,81,62,2,2021
ENG-Premier League,2020,Chelsea,Edouard Mendy,SEN,GK,28,1992,30.5,0,0,0,0,0,0,1,0.0,1,0,0,0,1,1,9,3,2021
ENG-Premier League,2020,Chelsea,Emerson Palmieri,ITA,DF,25,1994,1.0,3,3,2,0,1,1,3,33.3,2,0,0,0,1,4,6,0,2021
ENG-Premier League,2020,Chelsea,Fikayo Tomori,ENG,DF,22,1997,0.5,2,1,2,0,0,0,0,,0,1,1,0,2,4,8,0,2021
ENG-Premier League,2020,Chelsea,Hakim Ziyech,MAR,"MF,FW",27,1993,13.0,14,10,5,7,2,5,19,26.3,14,9,1,8,10,24,2,0,2021
ENG-Premier League,2020,Chelsea,Jorginho,ITA,MF,28,1991,22.3,57,30,22,31,4,31,76,40.8,45,33,5,28,40,97,21,3,2021
ENG-Premier League,2020,Chelsea,Kai Havertz,GER,"MF,FW",21,1999,16.9,18,9,6,10,2,6,27,22.2,21,25,0,25,4,22,22,1,2021
ENG-Premier League,2020,Chelsea,Kepa Arrizabalaga,ESP,GK,25,1994,6.5,0,0,0,0,0,0,1,0.0,1,0,0,0,0,0,0,3,2021
ENG-Premier League,2020,Chelsea,Kurt Zouma,FRA,DF,25,1994,22.5,16,10,8,6,2,4,8,50.0,4,13,9,4,28,44,93,0,2021
ENG-Premier League,2020,Chelsea,Marcos Alonso,ESP,DF,29,1990,10.7,13,3,6,4,3,7,14,50.0,7,12,1,11,12,25,30,0,2021
ENG-Premier League,2020,Chelsea,Mason Mount,ENG,MF,21,1999,32.1,75,35,22,38,15,25,69,36.2,44,40,2,38,31,106,14,0,2021
ENG-Premier League,2020,Chelsea,Mateo Kovačić,CRO,MF,26,1994,20.2,46,28,19,24,3,17,32,53.1,15,18,1,17,15,61,11,2,2021
ENG-Premier League,2020,Chelsea,N'Golo Kanté,FRA,MF,29,1991,23.8,79,42,39,35,5,27,56,48.2,29,42,4,38,59,138,34,0,2021
ENG-Premier League,2020,Chelsea,Olivier Giroud,FRA,FW,33,1986,8.3,4,2,0,1,3,1,7,14.3,6,4,1,3,5,9,10,0,2021
ENG-Premier League,2020,Chelsea,Reece James,ENG,DF,20,1999,26.4,55,35,24,22,9,21,44,47.7,23,36,7,29,17,72,52,0,2021
ENG-Premier League,2020,Chelsea,Ross Barkley,ENG,"FW,MF",26,1993,0.5,0,0,0,0,0,0,0,,0,0,0,0,0,0,0,0,2021
ENG-Premier League,2020,Chelsea,Ruben Loftus-Cheek,ENG,FW,24,1996,0.7,0,0,0,0,0,0,0,,0,0,0,0,0,0,0,0,2021
ENG-Premier League,2020,Chelsea,Tammy Abraham,ENG,FW,22,1997,11.6,7,5,3,3,1,1,7,14.3,6,6,0,6,5,12,17,0,2021
ENG-Premier League,2020,Chelsea,Thiago Silva,BRA,DF,35,1984,21.5,20,12,11,8,1,14,21,66.7,7,21,13,8,33,53,86,1,2021
ENG-Premier League,2020,Chelsea,Timo Werner,GER,"FW,MF",24,1996,28.9,20,9,6,11,3,7,43,16.3,36,23,1,22,8,28,8,0,2021
ENG-Premier League,2020,Chelsea,Willy Caballero,ARG,GK,38,1981,1.0,0,0,0,0,0,0,0,,0,0,0,0,0,0,0,0,2021
ENG-Premier League,2020,Crystal Palace,Andros Townsend,ENG,"MF,FW",29,1991,25.1,78,41,45,20,13,30,79,38.0,49,48,2,46,41,119,19,0,2021
ENG-Premier League,2020,Crystal Palace,Cheikhou Kouyaté,SEN,DF,30,1989,34.7,58,37,44,12,2,25,43,58.1,18,42,26,16,32,90,125,2,2021
ENG-Premier League,2020,Crystal Palace,Christian Benteke,BEL,FW,29,1990,20.2,15,7,1,7,7,2,9,22.2,7,17,6,11,4,19,39,0,2021
ENG-Premier League,2020,Crystal Palace,Eberechi Eze,ENG,MF,22,1998,28.4,27,14,11,13,3,16,35,45.7,19,19,3,16,24,51,9,1,2021
ENG-Premier League,2020,Crystal Palace,Gary Cahill,ENG,DF,34,1985,20.0,13,9,10,3,0,7,11,63.6,4,27,22,5,13,26,88,0,2021
ENG-Premier League,2020,Crystal Palace,Jack Butland,ENG,GK,27,1993,1.0,0,0,0,0,0,0,0,,0,0,0,0,0,0,0,0,2021
ENG-Premier League,2020,Crystal Palace,James McArthur,SCO,MF,32,1987,16.3,57,32,25,27,5,15,39,38.5,24,28,3,25,23,80,31,0,2021
ENG-Premier League,2020,Crystal Palace,James McCarthy,IRL,MF,29,1990,9.1,16,12,9,7,0,8,21,38.1,13,15,7,8,8,24,12,0,2021
ENG-Premier League,2020,Crystal Palace,James Tomkins,ENG,DF,31,1989,6.1,4,2,4,0,0,3,4,75.0,1,4,3,1,4,8,45,0,2021
ENG-Premier League,2020,Crystal Palace,Jaïro Riedewald,NED,MF,23,1996,20.2,34,15,13,17,4,16,36,44.4,20,39,7,32,29,63,25,0,2021
ENG-Premier League,2020,Crystal Palace,Jean-Philippe Mateta,FRA,FW,23,1997,2.5,1,1,0,1,0,1,3,33.3,2,1,0,1,0,1,2,0,2021
ENG-Premier League,2020,Crystal Palace,Jeffrey Schlupp,GHA,MF,27,1992,15.9,29,16,14,12,3,6,23,26.1,17,24,8,16,22,51,16,0,2021
ENG-Premier League,2020,Crystal Palace,Joel Ward,ENG,DF,30,1989,25.1,43,25,29,14,0,24,42,57.1,18,27,8,19,41,84,87,2,2021
ENG-Premier League,2020,Crystal Palace,Jordan Ayew,GHA,"FW,MF",28,1991,23.3,38,26,8,16,14,16,44,36.4,28,28,2,26,16,54,12,0,2021
ENG-Premier League,2020,Crystal Palace,Luka Milivojević,SRB,MF,29,1991,26.2,65,34,25,31,9,42,77,54.5,35,29,6,23,35,100,47,2,2021
ENG-Premier League,2020,Crystal Palace,Mamadou Sakho,FRA,DF,30,1990,3.1,3,2,1,2,0,3,3,100.0,0,3,2,1,3,6,11,0,2021
ENG-Premier League,2020,Crystal Palace,Martin Kelly,ENG,DF,30,1990,0.0,1,0,1,0,0,1,1,100.0,0,0,0,0,0,1,0,0,2021
ENG-Premier League,2020,Crystal Palace,Michy Batshuayi,BEL,FW,26,1993,8.1,5,3,1,2,2,1,9,11.1,8,5,1,4,4,9,5,0,2021
ENG-Premier League,2020,Crystal Palace,Nathaniel Clyne,ENG,DF,29,1991,12.7,17,10,8,8,1,9,16,56.3,7,7,2,5,18,35,25,1,2021
ENG-Premier League,2020,Crystal Palace,Patrick van Aanholt,NED,DF,29,1990,19.7,35,22,18,17,0,19,43,44.2,24,18,6,12,30,65,40,2,2021
ENG-Premier League,2020,Crystal Palace,Scott Dann,ENG,DF,33,1987,15.0,6,4,5,1,0,4,11,36.4,7,16,14,2,18,24,59,1,2021
ENG-Premier League,2020,Crystal Palace,Tyrick Mitchell,ENG,DF,20,1999,19.0,64,35,48,9,7,23,40,57.5,17,29,10,19,21,85,62,1,2021
ENG-Premier League,2020,Crystal Palace,Vicente Guaita,ESP,GK,33,1987,37.0,1,1,1,0,0,1,1,100.0,0,0,0,0,1,2,11,1,2021
ENG-Premier League,2020,Crystal Palace,Wilfried Zaha,CIV,FW,27,1992,29.0,26,18,8,15,3,11,30,36.7,19,21,0,21,9,35,4,0,2021
ENG-Premier League,2020,Everton,Abdoulaye Doucouré,MLI,MF,27,1993,27.1,52,32,25,19,8,14,43,32.6,29,24,7,17,39,91,31,1,2021
ENG-Premier League,2020,Everton,Alex Iwobi,NGA,"FW,MF",24,1996,17.1,27,10,10,14,3,13,25,52.0,12,20,1,19,16,43,14,0,2021
ENG-Premier League,2020,Everton,Allan,BRA,MF,29,1991,22.8,80,45,39,37,4,28,95,29.5,67,31,12,19,19,99,25,1,2021
ENG-Premier League,2020,Everton,André Gomes,POR,MF,27,1993,17.4,35,23,16,16,3,17,58,29.3,41,19,1,18,10,45,12,1,2021
ENG-Premier League,2020,Everton,Anthony Gordon,ENG,"FW,MF",19,2001,1.0,3,3,3,0,0,0,2,0.0,2,1,0,1,1,4,3,0,2021
ENG-Premier League,2020,Everton,Ben Godfrey,ENG,DF,22,1998,29.8,55,33,37,15,3,27,41,65.9,14,56,37,19,33,88,120,0,2021
ENG-Premier League,2020,Everton,Bernard,BRA,"MF,FW",27,1992,5.1,8,3,3,3,2,7,15,46.7,8,5,0,5,8,16,6,0,2021
ENG-Premier League,2020,Everton,Cenk Tosun,TUR,FW,29,1991,0.5,0,0,0,0,0,0,1,0.0,1,0,0,0,0,0,0,0,2021
ENG-Premier League,2020,Everton,Dominic Calvert-Lewin,ENG,FW,23,1997,31.9,17,8,1,8,8,6,12,50.0,6,22,6,16,6,23,33,0,2021
ENG-Premier League,2020,Everton,Fabian Delph,ENG,"MF,DF",30,1989,3.0,5,2,3,2,0,1,3,33.3,2,2,0,2,4,9,8,1,2021
ENG-Premier League,2020,Everton,Gylfi Sigurðsson,ISL,"MF,FW",30,1989,25.0,30,20,9,14,7,13,44,29.5,31,31,2,29,34,64,21,1,2021
ENG-Premier League,2020,Everton,James Rodríguez,COL,"FW,MF",29,1991,19.6,28,17,8,15,5,11,46,23.9,35,17,0,17,15,43,3,0,2021
ENG-Premier League,2020,Everton,Jean-Philippe Gbamin,CIV,MF,24,1995,0.1,1,0,0,1,0,0,0,,0,1,0,1,0,1,1,0,2021
ENG-Premier League,2020,Everton,Jonjoe Kenny,ENG,DF,23,1997,0.9,2,1,1,0,1,2,2,100.0,0,0,0,0,1,3,3,0,2021
ENG-Premier League,2020,Everton,Jordan Pickford,ENG,GK,26,1994,30.5,0,0,0,0,0,0,2,0.0,2,2,0,2,3,3,16,4,2021
ENG-Premier League,2020,Everton,Joshua King,NOR,"MF,FW",28,1992,1.6,4,1,2,1,1,0,0,,0,3,0,3,1,5,1,0,2021
ENG-Premier League,2020,Everton,João Virgínia,POR,GK,20,1999,0.5,0,0,0,0,0,0,0,,0,0,0,0,0,0,0,0,2021
ENG-Premier League,2020,Everton,Lucas Digne,FRA,"DF,MF",27,1993,29.8,63,38,40,16,7,29,54,53.7,25,42,4,38,31,94,87,0,2021
ENG-Premier League,2020,Everton,Mason Holgate,ENG,DF,23,1996,25.4,56,36,31,18,7,20,50,40.0,30,37,13,24,35,91,90,3,2021
ENG-Premier League,2020,Everton,Michael Keane,ENG,DF,27,1993,33.2,28,15,20,8,0,14,31,45.2,17,46,33,13,51,79,161,0,2021
ENG-Premier League,2020,Everton,Moise Kean,ITA,"FW,MF",20,2000,0.2,0,0,0,0,0,0,0,,0,0,0,0,0,0,0,0,2021
ENG-Premier League,2020,Everton,Nathan Broadhead,WAL,FW,22,1998,0.0,1,1,0,1,0,0,0,,0,0,0,0,0,1,0,0,2021
ENG-Premier League,2020,Everton,Niels Nkounkou,FRA,"DF,FW",19,2000,0.9,4,3,1,2,1,3,8,37.5,5,4,0,4,0,4,4,0,2021
ENG-Premier League,2020,Everton,Richarlison,BRA,FW,23,1997,31.8,50,32,21,22,7,16,51,31.4,35,28,3,25,14,64,36,1,2021
ENG-Premier League,2020,Everton,Robin Olsen,SWE,GK,30,1990,7.0,0,0,0,0,0,0,0,,0,0,0,0,0,0,4,1,2021
ENG-Premier League,2020,Everton,Séamus Coleman,IRL,"DF,MF",31,1988,17.9,39,26,21,14,4,21,30,70.0,9,22,6,16,13,52,37,2,2021
ENG-Premier League,2020,Everton,Theo Walcott,ENG,FW,31,1989,0.1,0,0,0,0,0,0,0,,0,0,0,0,0,0,0,0,2021
ENG-Premier League,2020,Everton,Tom Davies,ENG,MF,22,1998,15.8,31,18,17,12,2,16,39,41.0,23,15,9,6,34,65,21,2,2021
ENG-Premier League,2020,Everton,Yerry Mina,COL,DF,25,1994,21.5,21,14,17,4,0,8,12,66.7,4,30,23,7,24,45,110,1,2021
ENG-Premier League,2020,Fulham,Aboubakar Kamara,MTN,"FW,MF",25,1995,3.5,2,2,1,1,0,0,5,0.0,5,6,0,6,1,3,0,0,2021
ENG-Premier League,2020,Fulham,Ademola Lookman,NGA,"FW,MF",22,1997,30.5,35,11,18,9,8,13,44,29.5,31,31,1,30,20,55,9,0,2021
ENG-Premier League,2020,Fulham,Aleksandar Mitrović,SRB,FW,25,1994,15.6,7,4,0,3,4,2,8,25.0,6,12,3,9,3,10,8,0,2021
ENG-Premier League,2020,Fulham,Alphonse Areola,FRA,GK,27,1993,36.0,1,0,1,0,0,1,5,20.0,4,0,0,0,1,2,13,3,2021
ENG-Premier League,2020,Fulham,Andre-Frank Zambo Anguissa,CMR,MF,24,1995,28.7,78,37,27,38,13,27,68,39.7,41,35,6,29,56,134,17,2,2021
ENG-Premier League,2020,Fulham,Antonee Robinson,USA,DF,22,1997,24.0,45,28,24,16,5,27,44,61.4,17,21,4,17,37,82,68,0,2021
ENG-Premier League,2020,Fulham,Bobby Reid,JAM,"MF,FW",27,1993,26.4,31,15,17,10,4,18,39,46.2,21,19,5,14,21,52,39,0,2021
ENG-Premier League,2020,Fulham,Denis Odoi,GHA,DF,32,1988,3.0,3,3,2,1,0,1,4,25.0,3,3,1,2,5,8,5,0,2021
ENG-Premier League,2020,Fulham,Fabio Carvalho,POR,"MF,FW",17,2002,2.8,9,6,4,4,1,5,9,55.6,4,2,0,2,1,10,1,1,2021
ENG-Premier League,2020,Fulham,Harrison Reed,ENG,MF,25,1995,25.0,63,38,28,28,7,29,73,39.7,44,34,11,23,50,113,31,1,2021
ENG-Premier League,2020,Fulham,Ivan Cavaleiro,POR,FW,26,1993,27.5,23,14,9,11,3,12,34,35.3,22,25,1,24,19,42,14,0,2021
ENG-Premier League,2020,Fulham,Joachim Andersen,DEN,DF,24,1996,30.3,33,19,18,11,4,15,28,53.6,13,24,13,11,44,77,151,1,2021
ENG-Premier League,2020,Fulham,Joe Bryan,ENG,"DF,MF",26,1993,7.4,15,8,7,5,3,7,12,58.3,5,8,2,6,14,29,16,0,2021
ENG-Premier League,2020,Fulham,Josh Maja,NGA,FW,21,1998,9.0,7,4,0,3,4,4,10,40.0,6,3,1,2,4,11,1,0,2021
ENG-Premier League,2020,Fulham,Josh Onomah,ENG,MF,23,1997,4.2,11,8,1,6,4,0,5,0.0,5,4,2,2,2,13,1,0,2021
ENG-Premier League,2020,Fulham,Kenny Tete,NED,"DF,MF",24,1995,16.5,48,30,27,16,5,10,18,55.6,8,14,5,9,27,75,49,0,2021
ENG-Premier League,2020,Fulham,Marek Rodák,SVK,GK,23,1996,2.0,0,0,0,0,0,0,0,,0,0,0,0,0,0,0,0,2021
ENG-Premier League,2020,Fulham,Mario Lemina,GAB,MF,26,1993,18.9,62,35,25,30,7,23,44,52.3,21,26,5,21,30,92,21,0,2021
ENG-Premier League,2020,Fulham,Maxime Le Marchand,FRA,DF,30,1989,1.4,2,2,2,0,0,2,2,100.0,0,0,0,0,0,2,3,0,2021
ENG-Premier League,2020,Fulham,Michael Hector,JAM,DF,28,1992,2.9,3,2,1,2,0,1,6,16.7,5,4,2,2,0,3,6,0,2021
ENG-Premier League,2020,Fulham,Neeskens Kebano,COD,"FW,MF",28,1992,1.3,0,0,0,0,0,0,1,0.0,1,3,0,3,0,0,0,0,2021
ENG-Premier League,2020,Fulham,Ola Aina,NGA,DF,23,1996,29.6,37,20,22,7,8,21,43,48.8,22,22,6,16,45,82,94,2,2021
ENG-Premier League,2020,Fulham,Ruben Loftus-Cheek,ENG,"MF,FW",24,1996,21.2,25,14,7,15,3,7,23,30.4,16,20,2,18,7,32,18,0,2021
ENG-Premier League,2020,Fulham,Terence Kongolo,NED,DF,26,1994,1.0,3,2,1,2,0,1,1,100.0,0,0,0,0,2,5,3,0,2021
ENG-Premier League,2020,Fulham,Tim Ream,USA,DF,32,1987,7.0,12,5,9,3,0,8,11,72.7,3,8,5,3,6,18,26,1,2021
ENG-Premier League,2020,Fulham,Tom Cairney,SCO,MF,29,1991,8.4,9,3,1,4,4,1,4,25.0,3,6,0,6,0,9,3,0,2021
ENG-Premier League,2020,Fulham,Tosin Adarabioyo,ENG,DF,22,1997,32.8,37,19,30,6,1,19,40,47.5,21,26,20,6,42,79,197,2,2021
ENG-Premier League,2020,Fulham,Tyrese Francois,AUS,DF,20,2000,0.2,0,0,0,0,0,0,0,,0,0,0,0,0,0,0,0,2021
ENG-Premier League,2020,Leeds United,Diego Llorente,ESP,DF,26,1993,13.4,34,21,21,13,0,19,32,59.4,13,18,13,5,20,54,40,2,2021
ENG-Premier League,2020,Leeds United,Ezgjan Alioski,MKD,"DF,MF",28,1992,27.3,74,31,38,28,8,32,74,43.2,42,17,2,15,23,97,50,2,2021
ENG-Premier League,2020,Leeds United,Gaetano Berardi,SUI,DF,31,1988,1.3,2,2,1,0,1,0,0,,0,2,1,1,1,3,2,0,2021
ENG-Premier League,2020,Leeds United,Hélder Costa,ANG,"MF,FW",26,1994,12.8,25,11,12,5,8,11,32,34.4,21,11,0,11,3,28,5,1,2021
ENG-Premier League,2020,Leeds United,Ian Carlo Poveda,ENG,MF,20,2000,3.9,5,4,3,0,2,1,7,14.3,6,5,1,4,1,6,2,0,2021
ENG-Premier League,2020,Leeds United,Illan Meslier,FRA,GK,20,2000,35.0,0,0,0,0,0,0,1,0.0,1,0,0,0,0,0,17,8,2021
ENG-Premier League,2020,Leeds United,Jack Harrison,ENG,"MF,FW",23,1996,31.6,63,38,20,30,13,26,59,44.1,33,30,2,28,15,78,21,0,2021
ENG-Premier League,2020,Leeds United,Jamie Shackleton,ENG,"MF,DF",20,1999,5.1,10,6,6,4,0,4,11,36.4,7,3,1,2,9,19,3,0,2021
ENG-Premier League,2020,Leeds United,Kalvin Phillips,ENG,MF,24,1995,27.0,74,38,38,29,7,26,62,41.9,36,49,14,35,45,119,53,3,2021
ENG-Premier League,2020,Leeds United,Kiko Casilla,ESP,GK,33,1986,3.0,0,0,0,0,0,0,0,,0,0,0,0,0,0,0,0,2021
ENG-Premier League,2020,Leeds United,Leif Davis,ENG,DF,20,2000,0.4,0,0,0,0,0,0,3,0.0,3,1,0,1,1,1,0,0,2021
ENG-Premier League,2020,Leeds United,Liam Cooper,SCO,DF,28,1991,24.3,68,45,39,27,2,37,59,62.7,22,39,32,7,61,129,70,1,2021
ENG-Premier League,2020,Leeds United,Luke Ayling,ENG,DF,28,1991,37.8,108,61,69,30,9,49,87,56.3,38,53,36,17,36,144,96,5,2021
ENG-Premier League,2020,Leeds United,Mateusz Klich,POL,MF,30,1990,26.6,38,20,14,20,4,14,61,23.0,47,13,4,9,11,49,16,0,2021
ENG-Premier League,2020,Leeds United,Niall Huggins,WAL,DF,19,2000,0.4,0,0,0,0,0,0,1,0.0,1,0,0,0,0,0,1,0,2021
ENG-Premier League,2020,Leeds United,Pablo Hernández,ESP,MF,35,1985,4.7,5,3,2,1,2,5,16,31.3,11,2,0,2,0,5,0,1,2021
ENG-Premier League,2020,Leeds United,Pascal Struijk,NED,"DF,MF",20,1999,23.1,49,30,28,19,2,17,28,60.7,11,35,21,14,47,96,92,0,2021
ENG-Premier League,2020,Leeds United,Patrick Bamford,ENG,FW,26,1993,33.9,21,9,2,11,8,8,27,29.6,19,14,4,10,10,31,37,0,2021
ENG-Premier League,2020,Leeds United,Raphinha,BRA,"MF,FW",23,1996,26.2,34,17,13,16,5,12,58,20.7,46,31,1,30,29,63,27,0,2021
ENG-Premier League,2020,Leeds United,Robin Koch,GER,"DF,MF",24,1996,12.6,27,16,17,10,0,10,19,52.6,9,18,12,6,27,54,34,2,2021
ENG-Premier League,2020,Leeds United,Rodrigo,ESP,"MF,FW",29,1991,14.3,14,7,8,3,3,4,22,18.2,18,7,0,7,5,19,16,0,2021
ENG-Premier League,2020,Leeds United,Stuart Dallas,NIR,"MF,DF",29,1991,37.9,74,45,46,22,6,30,88,34.1,58,41,3,38,44,118,52,1,2021
ENG-Premier League,2020,Leeds United,Tyler Roberts,WAL,"MF,FW",21,1999,14.9,15,13,1,11,3,5,22,22.7,17,17,2,15,9,24,12,0,2021
ENG-Premier League,2020,Leicester City,Ayoze Pérez,ESP,"MF,FW",27,1993,14.8,32,15,6,20,6,13,48,27.1,35,28,0,28,10,42,7,0,2021
ENG-Premier League,2020,Leicester City,Cengiz Ünder,TUR,"FW,MF",23,1997,3.1,4,1,0,3,1,3,5,60.0,2,3,0,3,2,6,0,0,2021
ENG-Premier League,2020,Leicester City,Christian Fuchs,AUT,DF,34,1986,7.8,18,7,15,2,1,8,15,53.3,7,6,4,2,16,34,34,1,2021
ENG-Premier League,2020,Leicester City,Daniel Amartey,GHA,DF,25,1994,8.0,11,7,6,4,1,8,12,66.7,4,8,4,4,12,23,26,0,2021
ENG-Premier League,2020,Leicester City,Demarai Gray,JAM,FW,24,1996,0.2,1,1,1,0,0,0,0,,0,0,0,0,0,1,0,0,2021
ENG-Premier League,2020,Leicester City,Dennis Praet,BEL,MF,26,1994,8.0,14,7,4,7,3,6,15,40.0,9,12,2,10,7,21,3,0,2021
ENG-Premier League,2020,Leicester City,Hamza Choudhury,ENG,MF,22,1997,3.5,8,7,3,5,0,4,10,40.0,6,4,1,3,4,12,9,1,2021
ENG-Premier League,2020,Leicester City,Harvey Barnes,ENG,"FW,MF",22,1997,21.6,19,9,11,3,5,5,22,22.7,17,16,3,13,8,27,11,0,2021
ENG-Premier League,2020,Leicester City,Islam Slimani,ALG,FW,32,1988,0.2,0,0,0,0,0,0,0,,0,0,0,0,0,0,0,0,2021
ENG-Premier League,2020,Leicester City,James Justin,ENG,DF,22,1998,23.0,61,37,38,18,5,20,41,48.8,21,36,10,26,30,91,58,1,2021
ENG-Premier League,2020,Leicester City,James Maddison,ENG,MF,23,1996,23.3,32,16,5,16,11,14,41,34.1,27,14,1,13,9,41,5,0,2021
ENG-Premier League,2020,Leicester City,Jamie Vardy,ENG,FW,33,1987,31.6,18,12,1,8,9,2,15,13.3,13,14,5,9,4,22,32,0,2021
ENG-Premier League,2020,Leicester City,Jonny Evans,NIR,DF,32,1988,27.5,25,12,22,2,1,14,20,70.0,6,8,3,5,46,71,98,1,2021
ENG-Premier League,2020,Leicester City,Kasper Schmeichel,DEN,GK,33,1986,38.0,0,0,0,0,0,0,0,,0,0,0,0,0,0,10,0,2021
ENG-Premier League,2020,Leicester City,Kelechi Iheanacho,NGA,FW,23,1996,16.2,12,5,2,4,6,4,17,23.5,13,14,0,14,2,14,1,1,2021
ENG-Premier League,2020,Leicester City,Khanya Leshabela,RSA,MF,20,1999,0.1,0,0,0,0,0,0,0,,0,0,0,0,0,0,0,0,2021
ENG-Premier League,2020,Leicester City,Luke Thomas,ENG,DF,19,2001,10.8,23,14,11,5,7,14,21,66.7,7,15,2,13,17,40,21,0,2021
ENG-Premier League,2020,Leicester City,Marc Albrighton,ENG,"DF,FW",30,1989,19.4,33,19,14,15,4,16,45,35.6,29,29,3,26,17,50,27,1,2021
ENG-Premier League,2020,Leicester City,Nampalys Mendy,SEN,MF,28,1992,16.2,26,17,18,6,2,7,20,35.0,13,12,1,11,14,40,8,0,2021
ENG-Premier League,2020,Leicester City,Ricardo Pereira,POR,"DF,FW",26,1993,10.7,31,22,16,8,7,14,35,40.0,21,24,1,23,15,46,23,0,2021
ENG-Premier League,2020,Leicester City,Sidnei Tavares,POR,MF,18,2001,0.9,1,1,0,1,0,0,0,,0,1,1,0,0,1,0,0,2021
ENG-Premier League,2020,Leicester City,Timothy Castagne,BEL,DF,24,1995,26.1,52,32,29,18,5,24,44,54.5,20,29,5,24,29,81,62,1,2021
ENG-Premier League,2020,Leicester City,Wes Morgan,JAM,DF,36,1984,0.2,0,0,0,0,0,0,0,,0,0,0,0,0,0,1,0,2021
ENG-Premier League,2020,Leicester City,Wesley Fofana,FRA,DF,19,2000,25.1,51,37,27,22,2,31,46,67.4,15,28,16,12,61,112,94,0,2021
ENG-Premier League,2020,Leicester City,Wilfred Ndidi,NGA,"MF,DF",23,1996,24.2,96,63,45,44,7,26,66,39.4,40,38,11,27,61,157,55,0,2021
ENG-Premier League,2020,Leicester City,Youri Tielemans,BEL,MF,23,1997,37.3,86,45,32,38,16,45,108,41.7,63,35,8,27,46,132,20,1,2021
ENG-Premier League,2020,Leicester City,Çağlar Söyüncü,TUR,DF,24,1996,20.2,27,17,13,14,0,17,30,56.7,13,12,9,3,28,55,80,1,2021
ENG-Premier League,2020,Liverpool,Adrián,ESP,GK,33,1987,3.0,0,0,0,0,0,0,0,,0,0,0,0,0,0,3,1,2021
ENG-Premier League,2020,Liverpool,Alex Oxlade-Chamberlain,ENG,"MF,FW",26,1993,2.8,4,0,0,3,1,0,2,0.0,2,1,0,1,2,6,0,0,2021
ENG-Premier League,2020,Liverpool,Alisson,BRA,GK,27,1992,33.0,3,2,3,0,0,3,4,75.0,1,0,0,0,2,5,26,7,2021
ENG-Premier League,2020,Liverpool,Andrew Robertson,SCO,DF,26,1994,37.6,46,34,23,18,5,28,57,49.1,29,39,9,30,21,67,79,1,2021
ENG-Premier League,2020,Liverpool,Caoimhín Kelleher,IRL,GK,21,1998,2.0,0,0,0,0,0,0,0,,0,0,0,0,0,0,2,0,2021
ENG-Premier League,2020,Liverpool,Curtis Jones,ENG,MF,19,2001,13.1,16,6,6,7,3,12,25,48.0,13,13,0,13,19,35,11,1,2021
ENG-Premier League,2020,Liverpool,Diogo Jota,POR,FW,23,1996,12.4,12,6,4,7,1,2,29,6.9,27,9,0,9,5,17,3,0,2021
ENG-Premier League,2020,Liverpool,Divock Origi,BEL,FW,25,1995,2.1,3,2,0,2,1,1,3,33.3,2,5,1,4,1,4,2,0,2021
ENG-Premier League,2020,Liverpool,Fabinho,BRA,"DF,MF",26,1993,28.5,58,31,21,29,8,27,54,50.0,27,28,10,18,44,102,66,1,2021
ENG-Premier League,2020,Liverpool,Georginio Wijnaldum,NED,MF,29,1990,32.7,23,7,6,14,3,7,31,22.6,24,18,3,15,26,49,18,1,2021
ENG-Premier League,2020,Liverpool,James Milner,ENG,"MF,DF",34,1986,11.9,26,19,9,14,3,11,33,33.3,22,30,3,27,14,40,16,1,2021
ENG-Premier League,2020,Liverpool,Joe Gomez,ENG,DF,23,1997,6.6,3,2,1,1,1,0,4,0.0,4,3,2,1,4,7,29,0,2021
ENG-Premier League,2020,Liverpool,Jordan Henderson,ENG,"MF,DF",30,1990,18.9,24,15,12,9,3,10,26,38.5,16,12,1,11,34,58,30,0,2021
ENG-Premier League,2020,Liverpool,Joël Matip,CMR,DF,28,1991,7.7,14,9,7,7,0,7,8,87.5,1,6,0,6,7,21,22,0,2021
ENG-Premier League,2020,Liverpool,Kostas Tsimikas,GRE,"DF,FW",24,1996,0.1,0,0,0,0,0,0,0,,0,0,0,0,0,0,0,0,2021
ENG-Premier League,2020,Liverpool,Mohamed Salah,EGY,FW,28,1992,34.2,18,9,4,4,10,7,16,43.8,9,10,0,10,1,19,10,1,2021
ENG-Premier League,2020,Liverpool,Naby Keïta,GUI,MF,25,1995,5.8,11,5,1,8,2,7,17,41.2,10,10,0,10,9,20,6,0,2021
ENG-Premier League,2020,Liverpool,Nathaniel Phillips,ENG,DF,23,1997,16.2,22,14,15,7,0,11,24,45.8,13,17,14,3,20,42,81,0,2021
ENG-Premier League,2020,Liverpool,Neco Williams,WAL,DF,19,2001,2.8,6,5,4,2,0,5,9,55.6,4,3,1,2,6,12,6,0,2021
ENG-Premier League,2020,Liverpool,Ozan Kabak,TUR,DF,20,2000,8.9,19,10,11,4,4,6,9,66.7,3,2,2,0,12,31,28,1,2021
ENG-Premier League,2020,Liverpool,Rhys Williams,ENG,DF,19,2001,7.3,6,4,3,3,0,3,3,100.0,0,4,3,1,6,12,27,1,2021
ENG-Premier League,2020,Liverpool,Roberto Firmino,BRA,FW,28,1991,31.5,33,15,3,17,13,6,32,18.8,26,42,5,37,11,44,12,0,2021
ENG-Premier League,2020,Liverpool,Sadio Mané,SEN,FW,28,1992,31.2,48,30,6,22,20,12,33,36.4,21,30,0,30,15,63,11,0,2021
ENG-Premier League,2020,Liverpool,Takumi Minamino,JPN,"MF,FW",25,1995,3.3,4,3,1,2,1,0,12,0.0,12,1,0,1,2,6,3,0,2021
ENG-Premier League,2020,Liverpool,Thiago Alcántara,ESP,MF,29,1991,20.6,61,36,20,30,11,17,49,34.7,32,26,0,26,30,91,14,0,2021
ENG-Premier League,2020,Liverpool,Trent Alexander-Arnold,ENG,DF,21,1998,33.7,56,33,31,18,7,36,56,64.3,20,24,3,21,49,105,50,3,2021
ENG-Premier League,2020,Liverpool,Virgil van Dijk,NED,DF,29,1991,4.1,3,2,1,2,0,0,0,,0,1,1,0,5,8,8,1,2021
ENG-Premier League,2020,Liverpool,Xherdan Shaqiri,SUI,"MF,FW",28,1991,6.2,7,4,3,1,3,2,7,28.6,5,4,0,4,2,9,0,0,2021
ENG-Premier League,2020,Manchester City,Aymeric Laporte,ESP,DF,26,1994,14.9,13,6,10,3,0,7,11,63.6,4,12,7,5,11,24,28,0,2021
ENG-Premier League,2020,Manchester City,Benjamin Mendy,FRA,DF,26,1994,10.6,13,9,1,8,4,5,21,23.8,16,12,5,7,5,18,14,1,2021
ENG-Premier League,2020,Manchester City,Bernardo Silva,POR,"MF,FW",25,1994,22.9,26,14,7,12,7,11,52,21.2,41,17,1,16,17,43,8,0,2021
ENG-Premier League,2020,Manchester City,Ederson,BRA,GK,26,1993,36.0,3,1,3,0,0,3,4,75.0,1,0,0,0,0,3,11,4,2021
ENG-Premier League,2020,Manchester City,Eric García,ESP,DF,19,2001,4.3,8,7,5,3,0,5,7,71.4,2,4,1,3,4,12,10,0,2021
ENG-Premier League,2020,Manchester City,Fernandinho,BRA,MF,35,1985,13.2,31,17,8,14,9,20,43,46.5,23,11,2,9,23,54,17,0,2021
ENG-Premier League,2020,Manchester City,Ferrán Torres,ESP,"FW,MF",20,2000,14.5,12,5,4,6,2,5,16,31.3,11,16,0,16,3,15,8,0,2021
ENG-Premier League,2020,Manchester City,Gabriel Jesus,BRA,FW,23,1997,22.9,17,6,5,5,7,11,28,39.3,17,16,0,16,15,32,5,0,2021
ENG-Premier League,2020,Manchester City,John Stones,ENG,DF,26,1994,21.5,21,10,13,5,3,9,14,64.3,5,23,15,8,18,39,56,1,2021
ENG-Premier League,2020,Manchester City,João Cancelo,POR,"DF,MF",26,1994,25.5,68,41,42,19,7,43,83,51.8,40,23,2,21,41,109,33,2,2021
ENG-Premier League,2020,Manchester City,Kevin De Bruyne,BEL,MF,29,1991,22.2,34,21,6,18,10,13,48,27.1,35,26,1,25,9,43,10,0,2021
ENG-Premier League,2020,Manchester City,Kyle Walker,ENG,DF,30,1990,21.6,29,19,15,12,2,16,24,66.7,8,19,7,12,14,43,28,0,2021
ENG-Premier League,2020,Manchester City,Liam Delap,ENG,FW,17,2003,0.4,0,0,0,0,0,0,0,,0,0,0,0,0,0,0,0,2021
ENG-Premier League,2020,Manchester City,Nathan Aké,NED,DF,25,1995,8.9,10,5,3,6,1,3,4,75.0,1,2,1,1,9,19,23,0,2021
ENG-Premier League,2020,Manchester City,Oleksandr Zinchenko,UKR,DF,23,1996,16.4,25,15,12,9,4,14,24,58.3,10,17,4,13,23,48,28,0,2021
ENG-Premier League,2020,Manchester City,Phil Foden,ENG,"FW,MF",20,2000,18.0,22,11,12,8,2,9,23,39.1,14,9,0,9,11,33,11,0,2021
ENG-Premier League,2020,Manchester City,Raheem Sterling,ENG,FW,25,1994,28.2,21,10,5,12,4,5,12,41.7,7,15,0,15,15,36,4,0,2021
ENG-Premier League,2020,Manchester City,Riyad Mahrez,ALG,FW,29,1991,21.7,20,5,2,10,8,6,30,20.0,24,19,0,19,8,28,4,0,2021
ENG-Premier League,2020,Manchester City,Rodri,ESP,MF,24,1996,30.5,72,40,24,40,8,33,66,50.0,33,23,9,14,36,108,54,3,2021
ENG-Premier League,2020,Manchester City,Rúben Dias,POR,DF,23,1997,31.6,24,13,13,8,3,4,16,25.0,12,31,23,8,35,59,92,0,2021
ENG-Premier League,2020,Manchester City,Scott Carson,ENG,GK,34,1985,1.0,0,0,0,0,0,0,0,,0,0,0,0,0,0,0,0,2021
ENG-Premier League,2020,Manchester City,Sergio Agüero,ARG,FW,32,1988,6.2,4,1,0,2,2,2,11,18.2,9,2,0,2,2,6,0,0,2021
ENG-Premier League,2020,Manchester City,Zack Steffen,USA,GK,25,1995,1.0,0,0,0,0,0,0,0,,0,0,0,0,0,0,0,0,2021
ENG-Premier League,2020,Manchester City,İlkay Gündoğan,GER,MF,29,1990,22.5,25,15,8,12,5,10,39,25.6,29,13,4,9,20,45,9,0,2021
ENG-Premier League,2020,Manchester Utd,Aaron Wan-Bissaka,ENG,DF,22,1997,34.0,88,54,53,29,6,32,45,71.1,13,65,17,48,62,150,84,2,2021
ENG-Premier League,2020,Manchester Utd,Alex Telles,BRA,DF,27,1992,7.7,14,7,10,3,1,8,17,47.1,9,7,2,5,16,30,20,0,2021
ENG-Premier League,2020,Manchester Utd,Amad Diallo,CIV,FW,18,2002,1.8,3,3,1,2,0,0,0,,0,2,1,1,0,3,1,0,2021
ENG-Premier League,2020,Manchester Utd,Anthony Elanga,SWE,FW,18,2002,1.7,4,2,3,1,0,4,5,80.0,1,1,1,0,1,5,1,0,2021
ENG-Premier League,2020,Manchester Utd,Anthony Martial,FRA,FW,24,1995,16.4,2,1,1,1,0,0,10,0.0,10,17,3,14,1,3,8,0,2021
ENG-Premier League,2020,Manchester Utd,Axel Tuanzebe,ENG,DF,22,1997,4.5,13,7,5,7,1,8,9,88.9,1,7,5,2,3,16,18,0,2021
ENG-Premier League,2020,Manchester Utd,Brandon Williams,ENG,DF,19,2000,2.1,0,0,0,0,0,0,1,0.0,1,1,0,1,1,1,7,0,2021
ENG-Premier League,2020,Manchester Utd,Bruno Fernandes,POR,MF,25,1994,34.4,57,30,16,29,12,26,100,26.0,74,38,0,38,26,83,29,0,2021
ENG-Premier League,2020,Manchester Utd,Daniel James,WAL,FW,22,1997,10.1,15,9,4,7,4,3,18,16.7,15,10,1,9,0,15,6,0,2021
ENG-Premier League,2020,Manchester Utd,David de Gea,ESP,GK,29,1990,25.5,0,0,0,0,0,0,0,,0,0,0,0,0,0,8,3,2021
ENG-Premier League,2020,Manchester Utd,Dean Henderson,ENG,GK,23,1997,12.5,1,1,1,0,0,1,2,50.0,1,0,0,0,0,1,3,2,2021
ENG-Premier League,2020,Manchester Utd,Donny van de Beek,NED,"MF,FW",23,1997,5.8,15,10,2,11,2,7,15,46.7,8,10,1,9,6,21,7,0,2021
ENG-Premier League,2020,Manchester Utd,Edinson Cavani,URU,FW,33,1987,15.3,12,8,1,8,3,2,13,15.4,11,2,0,2,6,18,11,0,2021
ENG-Premier League,2020,Manchester Utd,Eric Bailly,CIV,DF,26,1994,10.2,5,5,3,1,1,0,1,0.0,1,13,11,2,13,18,36,2,2021
ENG-Premier League,2020,Manchester Utd,Fred,BRA,MF,27,1993,26.6,81,39,39,38,4,29,89,32.6,60,49,9,40,45,126,26,1,2021
ENG-Premier League,2020,Manchester Utd,Hannibal Mejbri,TUN,MF,17,2003,0.1,0,0,0,0,0,0,0,,0,0,0,0,0,0,0,0,2021
ENG-Premier League,2020,Manchester Utd,Harry Maguire,ENG,DF,27,1993,33.9,29,17,19,10,0,18,29,62.1,11,28,23,5,60,89,122,4,2021
ENG-Premier League,2020,Manchester Utd,Juan Mata,ESP,"FW,MF",32,1988,5.7,1,0,1,0,0,0,7,0.0,7,3,0,3,3,4,3,0,2021
ENG-Premier League,2020,Manchester Utd,Luke Shaw,ENG,DF,25,1995,29.5,44,28,21,16,7,21,36,58.3,15,34,9,25,20,64,44,2,2021
ENG-Premier League,2020,Manchester Utd,Marcus Rashford,ENG,FW,22,1997,32.4,18,9,2,8,8,7,27,25.9,20,22,2,20,8,26,10,0,2021
ENG-Premier League,2020,Manchester Utd,Mason Greenwood,ENG,FW,18,2001,20.2,13,10,6,4,3,5,22,22.7,17,9,0,9,5,18,1,0,2021
ENG-Premier League,2020,Manchester Utd,Nemanja Matić,SRB,MF,31,1988,12.3,25,11,13,12,0,13,31,41.9,18,19,5,14,22,47,10,3,2021
ENG-Premier League,2020,Manchester Utd,Odion Ighalo,NGA,FW,31,1989,0.1,0,0,0,0,0,0,1,0.0,1,0,0,0,0,0,0,0,2021
ENG-Premier League,2020,Manchester Utd,Paul Pogba,FRA,"MF,FW",27,1993,21.1,36,26,15,16,5,11,33,33.3,22,24,2,22,26,62,37,0,2021
ENG-Premier League,2020,Manchester Utd,Scott McTominay,SCO,MF,23,1996,23.7,51,24,23,25,3,23,36,63.9,13,35,10,25,29,80,46,0,2021
ENG-Premier League,2020,Manchester Utd,Shola Shoretire,ENG,FW,16,2004,0.1,0,0,0,0,0,0,0,,0,0,0,0,0,0,0,0,2021
ENG-Premier League,2020,Manchester Utd,Timothy Fosu-Mensah,NED,DF,22,1998,0.9,2,0,1,1,0,1,1,100.0,0,0,0,0,3,5,1,0,2021
ENG-Premier League,2020,Manchester Utd,Victor Lindelöf,SWE,DF,26,1994,28.7,22,10,12,10,0,12,24,50.0,12,22,14,8,30,52,95,1,2021
ENG-Premier League,2020,Manchester Utd,William Thomas Fish,ENG,FW,17,2003,0.0,0,0,0,0,0,0,0,,0,0,0,0,0,0,0,0,2021
ENG-Premier League,2020,Newcastle Utd,Allan Saint-Maximin,FRA,"FW,MF",23,1997,17.3,16,9,6,9,1,4,9,44.4,5,10,0,10,4,20,2,0,2021
ENG-Premier League,2020,Newcastle Utd,Andy Carroll,ENG,FW,31,1989,4.4,3,1,1,1,1,1,8,12.5,7,1,0,1,0,3,14,0,2021
ENG-Premier League,2020,Newcastle Utd,Callum Wilson,ENG,FW,28,1992,23.2,12,5,1,6,5,2,12,16.7,10,10,3,7,7,19,14,0,2021
ENG-Premier League,2020,Newcastle Utd,Ciaran Clark,IRL,DF,30,1989,21.0,24,14,15,6,3,6,13,46.2,7,27,20,7,29,53,104,1,2021
ENG-Premier League,2020,Newcastle Utd,DeAndre Yedlin,USA,DF,27,1993,4.8,9,4,8,1,0,4,10,40.0,6,5,1,4,7,16,17,0,2021
ENG-Premier League,2020,Newcastle Utd,Dwight Gayle,ENG,"FW,MF",29,1990,5.7,2,0,1,1,0,0,7,0.0,7,3,1,2,1,3,2,0,2021
ENG-Premier League,2020,Newcastle Utd,Elliot Anderson,SCO,MF,17,2002,0.0,0,0,0,0,0,0,0,,0,0,0,0,0,0,0,0,2021
ENG-Premier League,2020,Newcastle Utd,Emil Krafth,SWE,DF,25,1994,14.3,19,8,9,9,1,12,25,48.0,13,15,9,6,15,34,52,2,2021
ENG-Premier League,2020,Newcastle Utd,Fabian Schär,SUI,DF,28,1991,13.8,13,4,8,5,0,7,19,36.8,12,19,12,7,27,40,52,1,2021
ENG-Premier League,2020,Newcastle Utd,Federico Fernández,ARG,DF,31,1989,23.1,29,22,23,5,1,17,21,81.0,4,41,31,10,17,46,147,0,2021
ENG-Premier League,2020,Newcastle Utd,Isaac Hayden,ENG,"MF,DF",25,1995,21.6,52,29,23,22,7,14,35,40.0,21,32,9,23,43,95,47,0,2021
ENG-Premier League,2020,Newcastle Utd,Jacob Murphy,ENG,"DF,MF",25,1995,18.1,39,24,25,12,2,24,49,49.0,25,27,3,24,14,53,29,0,2021
ENG-Premier League,2020,Newcastle Utd,Jamaal Lascelles,ENG,DF,26,1993,18.1,14,7,5,9,0,3,6,50.0,3,27,17,10,12,26,86,0,2021
ENG-Premier League,2020,Newcastle Utd,Jamal Lewis,NIR,DF,22,1998,20.4,37,20,23,13,1,16,38,42.1,22,21,7,14,11,48,44,1,2021
ENG-Premier League,2020,Newcastle Utd,Javier Manquillo,ESP,DF,26,1994,9.2,24,14,8,14,2,11,17,64.7,6,8,1,7,9,33,15,1,2021
ENG-Premier League,2020,Newcastle Utd,Jeff Hendrick,IRL,MF,28,1992,15.8,8,3,5,3,0,1,13,7.7,12,14,9,5,19,27,18,0,2021
ENG-Premier League,2020,Newcastle Utd,Joe Willock,ENG,MF,20,1999,10.9,26,13,16,7,3,9,42,21.4,33,21,3,18,17,43,15,1,2021
ENG-Premier League,2020,Newcastle Utd,Joelinton,BRA,"FW,MF",23,1996,22.0,33,21,7,21,5,14,37,37.8,23,30,2,28,9,42,24,0,2021
ENG-Premier League,2020,Newcastle Utd,Jonjo Shelvey,ENG,MF,28,1992,29.1,39,14,18,19,2,10,37,27.0,27,26,14,12,36,75,42,0,2021
ENG-Premier League,2020,Newcastle Utd,Karl Darlow,ENG,GK,29,1990,25.0,0,0,0,0,0,0,0,,0,0,0,0,0,0,17,0,2021
ENG-Premier League,2020,Newcastle Utd,Martin Dúbravka,SVK,GK,31,1989,13.0,0,0,0,0,0,0,0,,0,0,0,0,0,0,3,0,2021
ENG-Premier League,2020,Newcastle Utd,Matt Ritchie,SCO,"DF,MF",30,1989,15.0,10,3,5,3,2,3,17,17.6,14,17,2,15,12,22,47,0,2021
ENG-Premier League,2020,Newcastle Utd,Matthew Longstaff,ENG,MF,20,2000,4.2,3,2,2,1,0,2,8,25.0,6,7,0,7,7,10,2,0,2021
ENG-Premier League,2020,Newcastle Utd,Miguel Almirón,PAR,"MF,FW",26,1994,27.0,49,29,21,25,3,14,56,25.0,42,23,4,19,25,74,20,1,2021
ENG-Premier League,2020,Newcastle Utd,Paul Dummett,WAL,DF,28,1991,13.9,16,7,11,5,0,13,21,61.9,8,12,7,5,16,32,74,0,2021
ENG-Premier League,2020,Newcastle Utd,Ryan Fraser,SCO,"FW,MF",26,1994,10.3,4,1,3,1,0,2,5,40.0,3,1,0,1,6,10,7,0,2021
ENG-Premier League,2020,Newcastle Utd,Sean Longstaff,ENG,MF,22,1997,15.7,31,14,13,15,3,18,42,42.9,24,26,5,21,19,50,14,2,2021
ENG-Premier League,2020,Sheffield Utd,Aaron Ramsdale,ENG,GK,22,1998,38.0,1,1,1,0,0,1,1,100.0,0,0,0,0,2,3,22,6,2021
ENG-Premier League,2020,Sheffield Utd,Antwoine Hackford,ENG,DF,16,2004,0.1,0,0,0,0,0,0,0,,0,0,0,0,0,0,0,0,2021
ENG-Premier League,2020,Sheffield Utd,Ben Osborn,ENG,"MF,DF",25,1994,17.8,33,18,15,10,8,13,40,32.5,27,20,3,17,12,45,17,0,2021
ENG-Premier League,2020,Sheffield Utd,Billy Sharp,ENG,FW,34,1986,8.2,5,1,0,3,2,2,9,22.2,7,2,0,2,0,5,2,0,2021
ENG-Premier League,2020,Sheffield Utd,Chris Basham,ENG,"DF,MF",32,1988,28.6,69,42,41,23,5,41,67,61.2,26,36,15,21,49,118,105,1,2021
ENG-Premier League,2020,Sheffield Utd,Daniel Jebbison,ENG,FW,16,2003,3.2,6,2,1,3,2,3,7,42.9,4,6,1,5,1,7,0,0,2021
ENG-Premier League,2020,Sheffield Utd,David McGoldrick,IRL,"FW,MF",32,1987,26.6,33,21,8,15,10,13,31,41.9,18,19,3,16,2,35,25,0,2021
ENG-Premier League,2020,Sheffield Utd,Enda Stevens,IRL,DF,30,1990,30.0,59,26,32,19,8,33,58,56.9,25,41,12,29,22,81,81,1,2021
ENG-Premier League,2020,Sheffield Utd,Ethan Ampadu,WAL,"DF,MF",19,2000,23.2,57,36,31,24,2,20,46,43.5,26,40,19,21,49,106,87,3,2021
ENG-Premier League,2020,Sheffield Utd,Femi Seriki,ENG,MF,18,2002,0.0,0,0,0,0,0,0,0,,0,0,0,0,0,0,0,0,2021
ENG-Premier League,2020,Sheffield Utd,George Baldock,GRE,DF,27,1993,31.0,47,34,28,14,5,21,50,42.0,29,26,7,19,25,72,70,1,2021
ENG-Premier League,2020,Sheffield Utd,Iliman Ndiaye,SEN,MF,20,2000,0.1,1,1,0,1,0,1,1,100.0,0,0,0,0,0,1,0,0,2021
ENG-Premier League,2020,Sheffield Utd,Jack O'Connell,ENG,DF,26,1994,2.0,3,1,1,1,1,0,1,0.0,1,4,3,1,2,5,7,0,2021
ENG-Premier League,2020,Sheffield Utd,Jack Robinson,ENG,DF,26,1993,9.7,14,6,8,5,1,6,11,54.5,5,10,4,6,9,23,42,0,2021
ENG-Premier League,2020,Sheffield Utd,Jayden Bogle,ENG,"DF,MF",20,2000,12.3,33,23,21,10,2,20,39,51.3,19,14,4,10,14,47,22,0,2021
ENG-Premier League,2020,Sheffield Utd,John Egan,IRL,DF,27,1992,29.2,41,21,29,12,0,22,39,56.4,17,43,31,12,41,82,131,0,2021
ENG-Premier League,2020,Sheffield Utd,John Fleck,SCO,MF,28,1991,28.6,51,33,28,18,5,26,83,31.3,57,26,4,22,28,79,12,1,2021
ENG-Premier League,2020,Sheffield Utd,John Lundstram,ENG,MF,26,1994,22.6,25,16,12,11,2,13,47,27.7,34,26,8,18,14,39,29,1,2021
ENG-Premier League,2020,Sheffield Utd,Kean Bryan,ENG,DF,23,1996,11.2,20,10,9,11,0,9,19,47.4,10,16,10,6,13,33,39,1,2021
ENG-Premier League,2020,Sheffield Utd,Lys Mousset,FRA,"FW,MF",24,1996,3.3,1,0,0,0,1,0,2,0.0,2,1,0,1,0,1,1,1,2021
ENG-Premier League,2020,Sheffield Utd,Max Lowe,ENG,DF,23,1997,6.1,26,11,18,6,2,9,21,42.9,12,12,4,8,5,31,11,0,2021
ENG-Premier League,2020,Sheffield Utd,Oliver Burke,SCO,FW,23,1997,14.1,16,8,6,9,1,5,24,20.8,19,24,0,24,2,18,6,0,2021
ENG-Premier League,2020,Sheffield Utd,Oliver McBurnie,SCO,FW,24,1996,14.7,15,7,7,7,1,5,17,29.4,12,10,3,7,6,21,30,0,2021
ENG-Premier League,2020,Sheffield Utd,Oliver Norwood,NIR,MF,29,1991,24.7,49,22,16,28,5,21,72,29.2,51,29,12,17,36,85,51,1,2021
ENG-Premier League,2020,Sheffield Utd,Phil Jagielka,ENG,DF,37,1982,5.8,5,4,4,0,1,2,7,28.6,5,11,5,6,10,15,26,2,2021
ENG-Premier League,2020,Sheffield Utd,Rhian Brewster,ENG,"FW,MF",20,2000,12.5,8,5,1,4,3,1,13,7.7,12,15,2,13,5,13,5,0,2021
ENG-Premier League,2020,Sheffield Utd,Sander Berge,NOR,MF,22,1998,12.4,16,7,8,5,3,7,15,46.7,8,11,2,9,4,20,18,0,2021
ENG-Premier League,2020,Southampton,Alex McCarthy,ENG,GK,30,1989,30.0,1,0,1,0,0,1,4,25.0,3,0,0,0,0,1,11,1,2021
ENG-Premier League,2020,Southampton,Alexandre Jankewitz,SUI,MF,18,2001,0.0,2,1,2,0,0,1,1,100.0,0,0,0,0,0,2,0,0,2021
ENG-Premier League,2020,Southampton,Allan Tchaptchet,FRA,DF,18,2001,0.1,0,0,0,0,0,0,0,,0,0,0,0,0,0,0,0,2021
ENG-Premier League,2020,Southampton,Caleb Watts,AUS,MF,18,2002,0.4,2,1,2,0,0,1,2,50.0,1,0,0,0,0,2,0,0,2021
ENG-Premier League,2020,Southampton,Che Adams,SCO,FW,24,1996,29.6,25,16,4,15,6,6,17,35.3,11,20,2,18,4,29,19,1,2021
ENG-Premier League,2020,Southampton,Dan Nlundulu,ENG,"FW,MF",21,1999,1.2,0,0,0,0,0,0,1,0.0,1,2,0,2,0,0,2,0,2021
ENG-Premier League,2020,Southampton,Danny Ings,ENG,FW,28,1992,24.1,22,13,3,16,3,12,28,42.9,16,39,2,37,3,25,27,1,2021
ENG-Premier League,2020,Southampton,Fraser Forster,ENG,GK,32,1988,8.0,1,0,1,0,0,1,2,50.0,1,0,0,0,0,1,9,0,2021
ENG-Premier League,2020,Southampton,Ibrahima Diallo,FRA,MF,21,1999,11.3,29,16,11,17,1,9,16,56.3,7,10,1,9,10,39,12,2,2021
ENG-Premier League,2020,Southampton,Jack Stephens,ENG,DF,26,1994,17.1,34,19,19,15,0,17,38,44.7,21,25,14,11,28,62,64,2,2021
ENG-Premier League,2020,Southampton,Jake Vokins,ENG,DF,20,2000,0.7,0,0,0,0,0,0,1,0.0,1,0,0,0,0,0,0,0,2021
ENG-Premier League,2020,Southampton,James Ward-Prowse,ENG,MF,25,1994,38.0,75,49,30,41,4,29,70,41.4,41,36,4,32,42,117,60,0,2021
ENG-Premier League,2020,Southampton,Jan Bednarek,POL,DF,24,1996,34.4,37,19,25,11,1,25,49,51.0,24,44,27,17,84,121,132,0,2021
ENG-Premier League,2020,Southampton,Jannik Vestergaard,DEN,DF,27,1992,28.6,50,31,31,15,4,35,52,67.3,17,29,16,13,42,92,122,0,2021
ENG-Premier League,2020,Southampton,Kayne Ramsey,ENG,DF,19,2000,1.0,5,2,4,1,0,3,3,100.0,0,0,0,0,0,5,3,0,2021
ENG-Premier League,2020,Southampton,Kyle Walker-Peters,ENG,DF,23,1997,29.4,83,53,56,25,2,34,57,59.6,23,41,10,31,38,121,66,2,2021
ENG-Premier League,2020,Southampton,Michael Obafemi,IRL,FW,20,2000,0.7,1,0,0,1,0,0,1,0.0,1,1,0,1,0,1,0,0,2021
ENG-Premier League,2020,Southampton,Mohammed Salisu,GHA,DF,21,1999,9.4,38,21,20,16,2,25,34,73.5,9,22,5,17,17,55,30,0,2021
ENG-Premier League,2020,Southampton,Moussa Djenepo,MLI,MF,22,1998,13.8,52,27,27,17,8,28,63,44.4,35,24,2,22,10,62,14,0,2021
ENG-Premier League,2020,Southampton,Nathan Redmond,ENG,"MF,FW",26,1994,19.3,30,17,14,12,4,8,24,33.3,16,24,2,22,11,41,9,0,2021
ENG-Premier League,2020,Southampton,Nathan Tella,ENG,"FW,MF",21,1999,8.3,8,5,1,4,3,6,15,40.0,9,13,0,13,3,11,2,0,2021
ENG-Premier League,2020,Southampton,Oriol Romeu,ESP,MF,28,1991,19.6,69,35,25,39,5,26,68,38.2,42,28,7,21,30,99,18,0,2021
ENG-Premier League,2020,Southampton,Ryan Bertrand,ENG,DF,30,1989,28.9,60,32,26,27,7,30,48,62.5,18,19,1,18,30,90,41,1,2021
ENG-Premier League,2020,Southampton,Shane Long,IRL,FW,33,1987,2.3,2,1,0,0,2,2,3,66.7,1,0,0,0,3,5,1,0,2021
ENG-Premier League,2020,Southampton,Stuart Armstrong,SCO,MF,28,1992,30.7,60,41,19,32,9,27,75,36.0,48,26,1,25,24,84,19,0,2021
ENG-Premier League,2020,Southampton,Takumi Minamino,JPN,MF,25,1995,7.9,7,3,2,5,0,2,19,10.5,17,13,1,12,4,11,9,0,2021
ENG-Premier League,2020,Southampton,Theo Walcott,ENG,"MF,FW",31,1989,18.0,23,11,8,9,6,11,32,34.4,21,16,0,16,14,37,5,0,2021
ENG-Premier League,2020,Southampton,William Smallbone,IRL,MF,20,2000,1.9,6,3,2,4,0,1,3,33.3,2,5,0,5,2,8,1,0,2021
ENG-Premier League,2020,Southampton,Yan Valery,TUN,"DF,MF",21,1999,1.1,5,3,2,3,0,1,5,20.0,4,2,0,2,2,7,5,0,2021
ENG-Premier League,2020,Tottenham,Ben Davies,WAL,DF,27,1993,15.0,27,17,10,11,6,13,30,43.3,17,10,5,5,18,45,49,2,2021
ENG-Premier League,2020,Tottenham,Carlos Vinícius,BRA,FW,25,1995,3.4,3,1,2,1,0,1,1,100.0,0,0,0,0,2,5,5,0,2021
ENG-Premier League,2020,Tottenham,Dane Scarlett,ENG,FW,16,2004,0.0,0,0,0,0,0,0,0,,0,0,0,0,0,0,0,0,2021
ENG-Premier League,2020,Tottenham,Davinson Sánchez,COL,DF,24,1996,16.5,40,20,31,9,0,21,32,65.6,11,18,13,5,14,54,85,2,2021
ENG-Premier League,2020,Tottenham,Dele Alli,ENG,MF,24,1996,6.9,18,11,8,6,4,7,19,36.8,12,9,0,9,7,25,3,0,2021
ENG-Premier League,2020,Tottenham,Eric Dier,ENG,DF,26,1994,28.0,23,14,13,10,0,11,18,61.1,7,37,31,6,23,46,123,3,2021
ENG-Premier League,2020,Tottenham,Gareth Bale,WAL,FW,31,1989,10.2,17,10,4,9,4,7,14,50.0,7,13,2,11,8,25,16,0,2021
ENG-Premier League,2020,Tottenham,Giovani Lo Celso,ARG,MF,24,1996,10.5,28,22,12,11,5,10,29,34.5,19,12,1,11,7,35,5,0,2021
ENG-Premier League,2020,Tottenham,Harry Kane,ENG,FW,27,1993,34.2,22,12,1,17,4,8,26,30.8,18,28,11,17,11,33,40,0,2021
ENG-Premier League,2020,Tottenham,Harry Winks,ENG,MF,24,1996,9.6,16,9,11,5,0,5,20,25.0,15,16,4,12,11,27,12,1,2021
ENG-Premier League,2020,Tottenham,Hugo Lloris,FRA,GK,33,1986,38.0,0,0,0,0,0,0,1,0.0,1,0,0,0,0,0,10,1,2021
ENG-Premier League,2020,Tottenham,Japhet Tanganga,ENG,DF,21,1999,5.4,5,4,3,2,0,1,3,33.3,2,6,5,1,3,8,15,0,2021
ENG-Premier League,2020,Tottenham,Joe Rodon,WAL,DF,22,1997,8.1,14,9,11,2,1,3,4,75.0,1,10,8,2,21,35,36,2,2021
ENG-Premier League,2020,Tottenham,Lucas Moura,BRA,"FW,MF",27,1992,15.7,32,16,12,16,4,8,29,27.6,21,12,0,12,18,50,10,0,2021
ENG-Premier League,2020,Tottenham,Matt Doherty,IRL,DF,28,1992,13.8,29,15,15,10,4,13,33,39.4,20,20,5,15,23,52,46,0,2021
ENG-Premier League,2020,Tottenham,Moussa Sissoko,FRA,MF,30,1989,17.6,22,16,19,3,0,8,20,40.0,12,11,4,7,23,45,25,0,2021
ENG-Premier League,2020,Tottenham,Pierre Højbjerg,DEN,MF,24,1995,38.0,98,51,45,42,11,54,129,41.9,75,51,9,42,48,146,66,0,2021
ENG-Premier League,2020,Tottenham,Serge Aurier,CIV,DF,27,1992,17.8,55,33,33,17,5,15,40,37.5,25,28,5,23,19,74,44,3,2021
ENG-Premier League,2020,Tottenham,Sergio Reguilón,ESP,DF,23,1996,24.9,47,25,30,13,4,23,48,47.9,25,39,7,32,32,79,50,1,2021
ENG-Premier League,2020,Tottenham,Son Heung-min,KOR,FW,28,1992,34.6,32,18,11,14,7,18,72,25.0,54,28,3,25,14,46,8,0,2021
ENG-Premier League,2020,Tottenham,Steven Bergwijn,NED,"FW,MF",22,1997,13.4,15,7,8,3,4,7,20,35.0,13,7,1,6,5,20,9,0,2021
ENG-Premier League,2020,Tottenham,Tanguy Ndombele,FRA,MF,23,1996,23.2,41,20,11,21,9,18,44,40.9,26,28,4,24,19,60,15,0,2021
ENG-Premier League,2020,Tottenham,Toby Alderweireld,BEL,DF,31,1989,24.9,35,22,22,11,2,18,30,60.0,12,40,28,12,10,45,121,0,2021
ENG-Premier League,2020,Tottenham,Érik Lamela,ARG,"FW,MF",28,1992,8.0,17,9,1,11,5,8,21,38.1,13,11,1,10,6,23,2,0,2021
ENG-Premier League,2020,West Brom,Ahmed Hegazi,EGY,DF,29,1991,1.0,0,0,0,0,0,0,0,,0,2,0,2,1,1,7,0,2021
ENG-Premier League,2020,West Brom,Ainsley Maitland-Niles,ENG,MF,22,1997,13.7,22,10,7,8,7,9,28,32.1,19,12,1,11,17,39,24,0,2021
ENG-Premier League,2020,West Brom,Branislav Ivanović,SRB,DF,36,1984,8.5,14,5,11,3,0,7,13,53.8,6,11,5,6,8,22,25,0,2021
ENG-Premier League,2020,West Brom,Callum Robinson,IRL,"FW,MF",25,1995,17.3,7,5,5,1,1,3,19,15.8,16,9,0,9,7,14,8,0,2021
ENG-Premier League,2020,West Brom,Charlie Austin,ENG,"FW,MF",31,1989,1.5,4,2,1,2,1,1,3,33.3,2,0,0,0,3,7,4,0,2021
ENG-Premier League,2020,West Brom,Conor Gallagher,ENG,MF,20,2000,28.1,81,41,30,39,12,29,97,29.9,68,47,8,39,27,108,31,0,2021
ENG-Premier League,2020,West Brom,Conor Townsend,ENG,DF,27,1993,24.8,44,28,32,9,3,30,49,61.2,19,38,15,23,36,80,55,2,2021
ENG-Premier League,2020,West Brom,Dara O'Shea,IRL,DF,21,1999,23.4,45,25,30,13,2,21,45,46.7,24,32,17,15,45,90,108,0,2021
ENG-Premier League,2020,West Brom,Darnell Furlong,ENG,DF,24,1995,32.6,45,27,27,12,6,21,44,47.7,23,39,16,23,49,94,90,0,2021
ENG-Premier League,2020,West Brom,David Button,ENG,GK,31,1989,1.0,0,0,0,0,0,0,0,,0,0,0,0,0,0,0,0,2021
ENG-Premier League,2020,West Brom,Filip Krovinović,CRO,MF,24,1995,6.1,13,10,6,5,2,6,18,33.3,12,2,0,2,4,17,2,0,2021
ENG-Premier League,2020,West Brom,Grady Diangana,ENG,"MF,FW",22,1998,13.7,35,19,19,9,7,19,43,44.2,24,16,2,14,16,51,9,0,2021
ENG-Premier League,2020,West Brom,Hal Robson-Kanu,WAL,FW,31,1989,6.2,2,1,1,0,1,0,1,0.0,1,2,0,2,2,4,7,0,2021
ENG-Premier League,2020,West Brom,Jake Livermore,ENG,MF,30,1989,13.8,33,18,14,16,3,14,31,45.2,17,21,6,15,16,49,26,0,2021
ENG-Premier League,2020,West Brom,Kamil Grosicki,POL,"MF,FW",32,1988,1.6,2,1,2,0,0,2,8,25.0,6,1,0,1,2,4,1,0,2021
ENG-Premier League,2020,West Brom,Karlan Grant,ENG,"FW,MF",22,1997,12.5,5,3,3,2,0,2,4,50.0,2,7,0,7,5,10,17,0,2021
ENG-Premier League,2020,West Brom,Kieran Gibbs,ENG,DF,30,1989,9.0,15,11,11,3,1,8,10,80.0,2,8,6,2,16,31,30,1,2021
ENG-Premier League,2020,West Brom,Kyle Bartley,ENG,DF,29,1991,28.7,27,16,14,10,3,11,23,47.8,12,50,35,15,38,65,159,1,2021
ENG-Premier League,2020,West Brom,Kyle Edwards,ENG,"MF,FW",22,1998,1.3,3,2,1,1,1,0,0,,0,2,0,2,1,4,0,0,2021
ENG-Premier League,2020,West Brom,Lee Peltier,ENG,DF,33,1986,2.5,9,4,8,1,0,4,4,100.0,0,1,1,0,1,10,11,0,2021
ENG-Premier League,2020,West Brom,Matheus Pereira,POR,"MF,FW",24,1996,28.6,26,15,14,10,2,12,54,22.2,42,18,0,18,29,55,16,0,2021
ENG-Premier League,2020,West Brom,Matt Phillips,SCO,MF,29,1991,20.3,15,8,4,11,0,7,23,30.4,16,32,4,28,10,25,32,1,2021
ENG-Premier League,2020,West Brom,Mbaye Diagne,SEN,FW,28,1991,13.2,4,3,3,0,1,1,4,25.0,3,2,1,1,1,5,16,0,2021
ENG-Premier League,2020,West Brom,Okay Yokuşlu,TUR,MF,26,1994,14.6,38,25,21,13,4,17,35,48.6,18,15,3,12,35,73,33,1,2021
ENG-Premier League,2020,West Brom,Rekeem Harper,ENG,MF,20,2000,0.4,0,0,0,0,0,0,0,,0,2,0,2,1,1,0,0,2021
ENG-Premier League,2020,West Brom,Robert Snodgrass,SCO,"MF,FW",32,1987,5.8,17,12,12,4,1,10,16,62.5,6,11,2,9,1,18,12,0,2021
ENG-Premier League,2020,West Brom,Romaine Sawyers,SKN,MF,28,1991,16.5,30,18,16,12,2,14,43,32.6,29,20,4,16,18,48,12,3,2021
ENG-Premier League,2020,West Brom,Sam Field,ENG,MF,22,1998,0.7,5,5,3,2,0,0,0,,0,4,1,3,2,7,4,0,2021
ENG-Premier League,2020,West Brom,Sam Johnstone,ENG,GK,27,1993,37.0,0,0,0,0,0,0,0,,0,0,0,0,2,2,15,2,2021
ENG-Premier League,2020,West Brom,Semi Ajayi,NGA,DF,26,1993,30.9,40,14,34,6,0,23,41,56.1,18,51,32,19,42,82,122,2,2021
ENG-Premier League,2020,West Ham,Aaron Cresswell,ENG,DF,30,1989,35.2,32,13,15,15,2,18,32,56.3,14,29,14,15,32,64,79,2,2021
ENG-Premier League,2020,West Ham,Andriy Yarmolenko,UKR,"FW,MF",30,1989,4.2,5,4,2,2,1,2,8,25.0,6,1,0,1,1,6,2,0,2021
ENG-Premier League,2020,West Ham,Angelo Ogbonna,ITA,DF,32,1988,27.7,26,13,20,5,1,9,17,52.9,8,25,11,14,30,56,119,0,2021
ENG-Premier League,2020,West Ham,Arthur Masuaku,COD,"DF,MF",26,1993,11.2,20,12,14,6,0,11,34,32.4,23,12,0,12,8,28,28,2,2021
ENG-Premier League,2020,West Ham,Ben Johnson,ENG,"DF,FW",20,2000,5.8,11,5,5,3,3,7,9,77.8,2,5,1,4,11,22,9,0,2021
ENG-Premier League,2020,West Ham,Craig Dawson,ENG,DF,30,1990,21.4,11,8,7,4,0,5,12,41.7,7,26,22,4,32,43,88,3,2021
ENG-Premier League,2020,West Ham,Darren Randolph,IRL,GK,33,1987,3.0,0,0,0,0,0,0,0,,0,0,0,0,0,0,1,0,2021
ENG-Premier League,2020,West Ham,Declan Rice,ENG,MF,21,1999,32.0,59,35,33,25,1,21,51,41.2,30,39,11,28,59,118,41,0,2021
ENG-Premier League,2020,West Ham,Fabián Balbuena,PAR,DF,28,1991,13.3,24,12,23,1,0,14,23,60.9,9,23,6,17,25,49,63,0,2021
ENG-Premier League,2020,West Ham,Felipe Anderson,BRA,"FW,MF",27,1993,0.0,1,1,0,1,0,0,0,,0,0,0,0,0,1,0,0,2021
ENG-Premier League,2020,West Ham,Issa Diop,FRA,DF,23,1997,15.3,20,14,12,8,0,7,18,38.9,11,32,22,10,22,42,59,0,2021
ENG-Premier League,2020,West Ham,Jarrod Bowen,ENG,"FW,MF",23,1996,28.5,26,15,12,7,7,10,29,34.5,19,19,1,18,22,48,10,0,2021
ENG-Premier League,2020,West Ham,Jesse Lingard,ENG,"MF,FW",27,1992,15.8,12,6,4,8,0,5,14,35.7,9,7,1,6,4,16,0,0,2021
ENG-Premier League,2020,West Ham,Manuel Lanzini,ARG,"MF,FW",27,1993,6.3,9,2,3,4,2,3,10,30.0,7,9,0,9,7,16,5,0,2021
ENG-Premier League,2020,West Ham,Mark Noble,ENG,MF,33,1987,7.9,8,4,2,5,1,4,14,28.6,10,7,3,4,13,21,3,0,2021
ENG-Premier League,2020,West Ham,Michail Antonio,JAM,FW,30,1990,21.9,7,4,1,5,1,1,7,14.3,6,20,3,17,7,14,7,0,2021
ENG-Premier League,2020,West Ham,Pablo Fornals,ESP,"FW,MF",24,1996,28.6,44,26,14,24,6,11,73,15.1,62,43,1,42,36,80,9,0,2021
ENG-Premier League,2020,West Ham,Robert Snodgrass,SCO,"FW,MF",32,1987,0.1,0,0,0,0,0,0,0,,0,0,0,0,0,0,0,0,2021
ENG-Premier League,2020,West Ham,Ryan Fredericks,ENG,"DF,FW",27,1992,6.3,9,5,5,4,0,3,7,42.9,4,6,2,4,11,20,20,0,2021
ENG-Premier League,2020,West Ham,Saïd Benrahma,ALG,"FW,MF",24,1995,15.5,24,15,8,11,5,8,28,28.6,20,10,0,10,8,32,8,0,2021
ENG-Premier League,2020,West Ham,Sébastien Haller,CIV,FW,26,1994,10.4,14,9,1,6,7,4,20,20.0,16,7,1,6,5,19,7,0,2021
ENG-Premier League,2020,West Ham,Tomáš Souček,CZE,MF,25,1995,38.0,78,41,37,36,5,28,77,36.4,49,43,18,25,62,140,107,0,2021
ENG-Premier League,2020,West Ham,Vladimír Coufal,CZE,DF,27,1992,33.9,73,36,50,15,8,52,89,58.4,37,41,7,34,41,114,102,1,2021
ENG-Premier League,2020,West Ham,Łukasz Fabiański,POL,GK,35,1985,35.0,1,0,1,0,0,1,1,100.0,0,1,0,1,1,2,12,3,2021
ENG-Premier League,2020,Wolves,Adama Traoré,ESP,"FW,MF",24,1996,29.4,28,16,11,13,4,13,21,61.9,8,23,1,22,7,35,12,1,2021
ENG-Premier League,2020,Wolves,Conor Coady,ENG,DF,27,1993,36.7,35,23,25,10,0,19,35,54.3,16,40,32,8,27,62,134,2,2021
ENG-Premier League,2020,Wolves,Daniel Podence,POR,"MF,FW",24,1995,18.5,12,6,5,5,2,2,19,10.5,17,5,1,4,13,25,2,0,2021
ENG-Premier League,2020,Wolves,Fernando Marçal,BRA,"DF,MF",31,1989,6.9,13,5,6,7,0,6,11,54.5,5,11,2,9,12,25,25,0,2021
ENG-Premier League,2020,Wolves,Fábio Silva,POR,FW,18,2002,15.2,6,4,1,4,1,4,12,33.3,8,12,1,11,4,10,5,1,2021
ENG-Premier League,2020,Wolves,John Ruddy,ENG,GK,33,1986,1.0,0,0,0,0,0,0,0,,0,0,0,0,0,0,0,0,2021
ENG-Premier League,2020,Wolves,Jonny Castro,ESP,"MF,DF",26,1994,5.5,11,5,6,4,1,6,13,46.2,7,9,3,6,9,20,7,0,2021
ENG-Premier League,2020,Wolves,João Moutinho,POR,MF,33,1986,28.1,75,40,34,35,6,35,91,38.5,56,18,3,15,47,122,28,0,2021
ENG-Premier League,2020,Wolves,Ki-Jana Hoever,NED,"DF,MF",18,2002,6.4,14,6,11,2,1,10,22,45.5,12,2,0,2,9,23,23,0,2021
ENG-Premier League,2020,Wolves,Leander Dendoncker,BEL,"MF,DF",25,1995,27.8,54,29,29,22,3,31,60,51.7,29,38,15,23,27,81,52,2,2021
ENG-Premier League,2020,Wolves,Max Kilman,ENG,DF,23,1997,14.6,21,14,13,4,4,8,14,57.1,6,17,8,9,19,40,46,0,2021
ENG-Premier League,2020,Wolves,Morgan Gibbs-White,ENG,"MF,FW",20,2000,4.6,9,7,3,4,2,5,12,41.7,7,6,0,6,3,12,1,0,2021
ENG-Premier League,2020,Wolves,Nélson Semedo,POR,"DF,MF",26,1993,33.1,85,48,53,23,9,42,72,58.3,30,30,10,20,41,126,78,2,2021
ENG-Premier League,2020,Wolves,Oskar Buur,DEN,DF,22,1998,0.2,0,0,0,0,0,0,2,0.0,2,0,0,0,0,0,0,0,2021
ENG-Premier League,2020,Wolves,Owen Otasowie,USA,"MF,FW",19,2001,2.1,5,5,3,2,0,1,2,50.0,1,1,1,0,3,8,4,0,2021
ENG-Premier League,2020,Wolves,Patrick Cutrone,ITA,FW,22,1998,0.3,0,0,0,0,0,0,0,,0,0,0,0,0,0,0,0,2021
ENG-Premier League,2020,Wolves,Pedro Neto,POR,"FW,MF",20,2000,28.3,16,9,4,6,6,6,28,21.4,22,18,2,16,31,47,8,0,2021
ENG-Premier League,2020,Wolves,Rayan Aït Nouri,ALG,DF,19,2001,15.6,29,16,18,10,1,13,27,48.1,14,14,1,13,15,44,25,0,2021
ENG-Premier League,2020,Wolves,Raúl Jiménez,MEX,FW,29,1991,9.1,3,2,1,2,0,0,7,0.0,7,2,0,2,8,11,12,0,2021
ENG-Premier League,2020,Wolves,Romain Saïss,MAR,DF,30,1990,26.7,35,24,23,12,0,19,33,57.6,14,28,13,15,52,87,115,1,2021
ENG-Premier League,2020,Wolves,Rui Patrício,POR,GK,32,1988,37.0,0,0,0,0,0,0,1,0.0,1,0,0,0,1,1,3,3,2021
ENG-Premier League,2020,Wolves,Rúben Neves,POR,MF,23,1997,29.7,86,46,42,38,6,36,88,40.9,52,55,11,44,65,151,46,2,2021
ENG-Premier League,2020,Wolves,Rúben Vinagre,POR,"MF,DF",21,1999,1.9,7,5,5,2,0,3,4,75.0,1,3,0,3,2,9,4,0,2021
ENG-Premier League,2020,Wolves,Theo Corbeanu,CAN,FW,18,2002,0.1,2,1,0,2,0,1,1,100.0,0,0,0,0,1,3,0,0,2021
ENG-Premier League,2020,Wolves,Vitinha,POR,MF,20,2000,5.8,7,3,2,5,0,3,8,37.5,5,3,0,3,3,10,1,0,2021
ENG-Premier League,2020,Wolves,Willian José,BRA,FW,28,1991,12.3,2,1,1,1,0,1,4,25.0,3,6,1,5,1,3,12,0,2021
ENG-Premier League,2020,Wolves,Willy Boly,CIV,DF,29,1991,20.9,33,20,26,7,0,13,24,54.2,11,18,12,6,32,65,84,1,2021
ENG-Premier League,2021,Arsenal,Aaron Ramsdale,ENG,GK,23,1998,34.0,2,1,2,0,0,1,2,50.0,1,0,0,0,0,2,26,3,2022
ENG-Premier League,2021,Arsenal,Ainsley Maitland-Niles,ENG,MF,23,1997,3.0,8,4,5,3,0,2,4,50.0,2,2,0,2,4,12,4,0,2022
ENG-Premier League,2021,Arsenal,Albert Sambi Lokonga,BEL,MF,21,1999,12.6,22,18,11,9,2,12,14,85.7,2,12,7,5,13,35,12,4,2022
ENG-Premier League,2021,Arsenal,Alexandre Lacazette,FRA,FW,30,1991,19.8,27,10,8,13,6,7,21,33.3,14,12,1,11,5,32,6,0,2022
ENG-Premier League,2021,Arsenal,Ben White,ENG,DF,23,1997,32.0,44,23,30,8,6,28,45,62.2,17,42,24,18,42,86,102,0,2022
ENG-Premier League,2021,Arsenal,Bernd Leno,GER,GK,29,1992,4.0,1,1,1,0,0,1,1,100.0,0,0,0,0,0,1,1,0,2022
ENG-Premier League,2021,Arsenal,Bukayo Saka,ENG,"FW,MF",19,2001,33.1,40,21,12,17,11,13,39,33.3,26,28,2,26,22,62,23,0,2022
ENG-Premier League,2021,Arsenal,Calum Chambers,ENG,DF,26,1995,1.9,5,3,3,1,1,3,4,75.0,1,6,3,3,0,5,10,0,2022
ENG-Premier League,2021,Arsenal,Cédric Soares,POR,DF,29,1991,16.5,38,26,23,9,6,16,25,64.0,9,18,7,11,16,54,31,1,2022
ENG-Premier League,2021,Arsenal,Eddie Nketiah,ENG,FW,22,1999,9.3,9,4,1,4,4,1,4,25.0,3,9,2,7,4,13,5,0,2022
ENG-Premier League,2021,Arsenal,Emile Smith Rowe,ENG,"MF,FW",21,2000,21.3,14,7,7,7,0,4,20,20.0,16,18,1,17,15,29,10,1,2022
ENG-Premier League,2021,Arsenal,Folarin Balogun,USA,FW,20,2001,0.8,1,1,0,0,1,0,0,,0,1,0,1,0,1,1,0,2022
ENG-Premier League,2021,Arsenal,Gabriel Dos Santos,BRA,DF,23,1997,34.0,50,30,36,12,2,30,41,73.2,11,34,26,8,13,63,112,4,2022
ENG-Premier League,2021,Arsenal,Granit Xhaka,SUI,"MF,DF",28,1992,25.9,32,18,16,12,4,16,41,39.0,25,21,6,15,21,53,31,0,2022
ENG-Premier League,2021,Arsenal,Kieran Tierney,SCO,DF,24,1997,21.3,18,14,11,7,0,10,11,90.9,1,23,5,18,15,33,54,0,2022
ENG-Premier League,2021,Arsenal,Martin Ødegaard,NOR,"MF,FW",22,1998,30.9,49,21,6,24,19,22,61,36.1,39,18,1,17,11,60,11,1,2022
ENG-Premier League,2021,Arsenal,Martinelli,BRA,"FW,MF",20,2001,20.7,27,19,7,14,6,10,29,34.5,19,26,1,25,20,47,15,0,2022
ENG-Premier League,2021,Arsenal,Mohamed Elneny,EGY,MF,29,1992,9.0,16,8,10,5,1,7,12,58.3,5,7,1,6,14,30,13,0,2022
ENG-Premier League,2021,Arsenal,Nicolas Pépé,CIV,"FW,MF",26,1995,7.7,8,5,3,5,0,3,9,33.3,6,9,1,8,8,16,2,0,2022
ENG-Premier League,2021,Arsenal,Nuno Tavares,POR,DF,21,2000,13.1,21,14,10,7,4,8,18,44.4,10,15,5,10,9,30,33,1,2022
ENG-Premier League,2021,Arsenal,Pablo Marí,ESP,DF,27,1993,2.0,5,3,1,3,1,3,6,50.0,3,5,4,1,3,8,10,0,2022
ENG-Premier League,2021,Arsenal,Pierre-Emerick Aubameyang,GAB,FW,32,1989,11.5,11,5,6,4,1,3,10,30.0,7,12,1,11,0,11,4,0,2022
ENG-Premier League,2021,Arsenal,Reiss Nelson,ENG,FW,21,1999,0.2,1,0,0,0,1,0,1,0.0,1,1,0,1,0,1,0,0,2022
ENG-Premier League,2021,Arsenal,Rob Holding,ENG,DF,25,1995,9.4,13,9,11,1,1,5,6,83.3,1,23,18,5,10,23,42,1,2022
ENG-Premier League,2021,Arsenal,Sead Kolašinac,BIH,DF,28,1993,1.0,0,0,0,0,0,0,0,,0,0,0,0,4,4,1,0,2022
ENG-Premier League,2021,Arsenal,Takehiro Tomiyasu,JPN,DF,22,1998,18.7,35,17,19,13,3,21,32,65.6,11,22,3,19,24,59,64,2,2022
ENG-Premier League,2021,Arsenal,Thomas Partey,GHA,MF,28,1993,22.5,43,29,22,17,4,18,44,40.9,26,22,4,18,23,66,35,2,2022
ENG-Premier League,2021,Aston Villa,Anwar El Ghazi,NED,"FW,MF",26,1995,4.3,4,4,2,2,0,2,7,28.6,5,6,0,6,1,5,2,0,2022
ENG-Premier League,2021,Aston Villa,Ashley Young,ENG,"DF,FW",36,1985,13.9,18,6,9,6,3,11,16,68.8,5,10,4,6,13,31,25,1,2022
ENG-Premier League,2021,Aston Villa,Axel Tuanzebe,ENG,DF,23,1997,5.6,5,3,3,2,0,2,5,40.0,3,5,4,1,5,10,12,1,2022
ENG-Premier League,2021,Aston Villa,Bertrand Traoré,BFA,"MF,FW",25,1995,2.4,3,3,0,1,2,1,2,50.0,1,0,0,0,0,3,1,0,2022
ENG-Premier League,2021,Aston Villa,Calum Chambers,ENG,DF,26,1995,9.2,16,8,10,6,0,4,6,66.7,2,14,8,6,5,21,42,0,2022
ENG-Premier League,2021,Aston Villa,Cameron Archer,ENG,"FW,MF",20,2001,0.3,0,0,0,0,0,0,0,,0,0,0,0,0,0,0,0,2022
ENG-Premier League,2021,Aston Villa,Carney Chukwuemeka,ENG,"MF,FW",17,2003,3.3,7,1,2,5,0,3,5,60.0,2,3,0,3,1,8,2,1,2022
ENG-Premier League,2021,Aston Villa,Danny Ings,ENG,FW,29,1992,21.1,23,16,2,16,5,13,37,35.1,24,31,2,29,6,29,22,0,2022
ENG-Premier League,2021,Aston Villa,Douglas Luiz,BRA,MF,23,1998,30.2,59,39,30,24,5,21,72,29.2,51,30,7,23,34,93,28,1,2022
ENG-Premier League,2021,Aston Villa,Emi Buendía,ARG,"MF,FW",24,1996,21.1,38,18,16,13,9,21,51,41.2,30,21,3,18,9,47,11,0,2022
ENG-Premier League,2021,Aston Villa,Emiliano Martínez,ARG,GK,28,1992,36.0,1,1,1,0,0,1,3,33.3,2,0,0,0,0,1,6,1,2022
ENG-Premier League,2021,Aston Villa,Ezri Konsa,ENG,DF,23,1997,27.5,25,15,13,11,1,10,13,76.9,3,31,22,9,15,40,86,2,2022
ENG-Premier League,2021,Aston Villa,Jacob Ramsey,ENG,MF,20,2001,27.4,67,44,31,28,8,30,69,43.5,39,36,7,29,24,91,28,0,2022
ENG-Premier League,2021,Aston Villa,Jaden Philogene Bidace,ENG,FW,19,2002,0.1,0,0,0,0,0,0,0,,0,0,0,0,0,0,0,0,2022
ENG-Premier League,2021,Aston Villa,Jed Steer,ENG,GK,28,1992,1.0,0,0,0,0,0,0,0,,0,0,0,0,0,0,0,0,2022
ENG-Premier League,2021,Aston Villa,John McGinn,SCO,MF,26,1994,34.3,106,64,35,55,16,54,104,51.9,50,53,6,47,35,141,34,0,2022
ENG-Premier League,2021,Aston Villa,Keinan Davis,ENG,FW,23,1998,0.1,0,0,0,0,0,0,0,,0,0,0,0,0,0,0,0,2022
ENG-Premier League,2021,Aston Villa,Kortney Hause,ENG,DF,26,1995,4.4,3,3,2,0,1,3,4,75.0,1,8,5,3,6,9,13,0,2022
ENG-Premier League,2021,Aston Villa,Leon Bailey,JAM,"FW,MF",23,1997,8.5,17,11,6,8,3,6,13,46.2,7,10,1,9,1,18,2,0,2022
ENG-Premier League,2021,Aston Villa,Lucas Digne,FRA,DF,28,1993,14.1,13,10,8,3,2,9,19,47.4,10,15,8,7,23,36,40,0,2022
ENG-Premier League,2021,Aston Villa,Marvelous Nakamba,ZIM,MF,27,1994,10.0,32,19,18,14,0,12,34,35.3,22,14,4,10,12,44,17,1,2022
ENG-Premier League,2021,Aston Villa,Matt Targett,ENG,DF,25,1995,15.9,34,18,28,5,1,24,45,53.3,21,16,9,7,23,57,35,0,2022
ENG-Premier League,2021,Aston Villa,Matty Cash,POL,DF,23,1997,37.5,89,50,52,34,3,47,78,60.3,31,54,16,38,49,138,100,2,2022
ENG-Premier League,2021,Aston Villa,Morgan Sanson,FRA,MF,26,1994,4.0,12,8,7,2,3,3,7,42.9,4,13,0,13,10,22,2,1,2022
ENG-Premier League,2021,Aston Villa,Ollie Watkins,ENG,FW,25,1995,32.8,17,13,2,7,8,2,15,13.3,13,25,3,22,12,29,27,0,2022
ENG-Premier League,2021,Aston Villa,Philippe Coutinho,BRA,"MF,FW",29,1992,14.8,17,12,4,11,2,6,21,28.6,15,11,1,10,7,24,4,0,2022
ENG-Premier League,2021,Aston Villa,Robin Olsen,SWE,GK,31,1990,1.0,0,0,0,0,0,0,0,,0,0,0,0,0,0,0,0,2022
ENG-Premier League,2021,Aston Villa,Tim Iroegbunam,ENG,MF,18,2003,1.0,5,4,2,3,0,1,1,100.0,0,0,0,0,2,7,1,0,2022
ENG-Premier League,2021,Aston Villa,Trézéguet,EGY,FW,26,1994,0.1,0,0,0,0,0,0,0,,0,0,0,0,0,0,0,0,2022
ENG-Premier League,2021,Aston Villa,Tyrone Mings,ENG,DF,28,1993,35.4,23,12,17,3,3,14,22,63.6,8,47,30,17,46,69,153,2,2022
ENG-Premier League,2021,Aston Villa,Wesley Moraes,BRA,FW,24,1996,0.0,0,0,0,0,0,0,0,,0,0,0,0,0,0,0,0,2022
ENG-Premier League,2021,Brentford,Bryan Mbeumo,CMR,FW,21,1999,32.3,28,16,1,12,15,6,20,30.0,14,21,6,15,11,39,20,0,2022
ENG-Premier League,2021,Brentford,Charlie Goode,ENG,DF,25,1995,5.0,7,5,5,2,0,4,4,100.0,0,4,2,2,2,9,8,0,2022
ENG-Premier League,2021,Brentford,Christian Eriksen,DEN,MF,29,1992,10.4,13,6,4,5,4,8,17,47.1,9,9,1,8,9,22,14,0,2022
ENG-Premier League,2021,Brentford,Christian Nørgaard,DEN,MF,27,1994,33.9,109,60,42,58,9,52,101,51.5,49,48,9,39,64,173,58,1,2022
ENG-Premier League,2021,Brentford,David Raya,ESP,GK,25,1995,24.0,0,0,0,0,0,0,0,,0,1,0,1,0,0,10,1,2022
ENG-Premier League,2021,Brentford,Dominic Thompson,ENG,DF,21,2000,1.6,1,0,1,0,0,0,1,0.0,1,2,2,0,2,3,3,0,2022
ENG-Premier League,2021,Brentford,Ethan Pinnock,JAM,DF,28,1993,29.9,51,35,37,12,2,25,38,65.8,13,30,11,19,44,95,154,1,2022
ENG-Premier League,2021,Brentford,Finley Stevens,WAL,DF,18,2003,0.2,3,1,0,3,0,1,1,100.0,0,0,0,0,0,3,0,0,2022
ENG-Premier League,2021,Brentford,Frank Onyeka,NGA,MF,23,1998,11.6,25,17,13,9,3,8,27,29.6,19,16,2,14,14,39,13,0,2022
ENG-Premier League,2021,Brentford,Ivan Toney,ENG,FW,25,1996,32.3,33,21,5,20,8,12,38,31.6,26,16,2,14,14,47,44,1,2022
ENG-Premier League,2021,Brentford,Jonas Lössl,DEN,GK,32,1989,2.0,0,0,0,0,0,0,0,,0,0,0,0,0,0,1,0,2022
ENG-Premier League,2021,Brentford,Josh Dasilva,ENG,"MF,FW",22,1998,2.9,2,1,0,1,1,1,2,50.0,1,3,0,3,1,3,7,0,2022
ENG-Premier League,2021,Brentford,Kristoffer Ajer,NOR,DF,23,1998,22.2,29,18,21,6,2,13,21,61.9,8,19,11,8,26,55,74,0,2022
ENG-Premier League,2021,Brentford,Mads Bech Sørensen,DEN,DF,22,1999,9.3,8,7,6,2,0,6,7,85.7,1,9,6,3,6,14,25,0,2022
ENG-Premier League,2021,Brentford,Mads Bidstrup,DEN,MF,20,2001,0.5,1,0,0,1,0,0,3,0.0,3,0,0,0,1,2,2,0,2022
ENG-Premier League,2021,Brentford,Mads Roerslev,DEN,DF,22,1999,13.8,23,12,19,2,2,14,32,43.8,18,14,5,9,16,39,29,0,2022
ENG-Premier League,2021,Brentford,Marcus Forss,FIN,"FW,MF",22,1999,2.3,3,3,0,2,1,2,4,50.0,2,5,0,5,1,4,0,0,2022
ENG-Premier League,2021,Brentford,Mathias Jensen,DEN,MF,25,1996,17.8,33,18,12,16,5,22,63,34.9,41,32,3,29,22,55,13,0,2022
ENG-Premier League,2021,Brentford,Mathias Jørgensen,DEN,DF,31,1990,5.8,10,4,3,5,2,7,10,70.0,3,6,1,5,10,20,13,0,2022
ENG-Premier League,2021,Brentford,Nathan Young-Coombes,ENG,MF,18,2003,0.0,0,0,0,0,0,0,0,,0,0,0,0,0,0,0,0,2022
ENG-Premier League,2021,Brentford,Pontus Jansson,SWE,DF,30,1991,36.9,40,21,32,8,0,22,34,64.7,12,37,27,10,52,92,187,0,2022
ENG-Premier League,2021,Brentford,Rico Henry,ENG,DF,24,1997,30.8,28,20,18,8,2,12,34,35.3,22,31,10,21,26,54,76,1,2022
ENG-Premier League,2021,Brentford,Saman Ghoddos,IRN,"MF,DF",27,1993,6.0,17,10,8,6,3,9,15,60.0,6,2,0,2,3,20,16,0,2022
ENG-Premier League,2021,Brentford,Sergi Canós,ESP,"DF,FW",24,1997,23.1,56,25,32,15,9,33,60,55.0,27,32,3,29,22,78,38,0,2022
ENG-Premier League,2021,Brentford,Shandon Baptiste,GRN,MF,23,1998,10.1,14,4,9,4,1,6,15,40.0,9,10,0,10,11,25,12,0,2022
ENG-Premier League,2021,Brentford,Tariqe Fosu,GHA,DF,25,1995,0.2,0,0,0,0,0,0,0,,0,1,0,1,0,0,0,0,2022
ENG-Premier League,2021,Brentford,Vitaly Janelt,GER,MF,23,1998,25.5,61,32,26,27,8,27,53,50.9,26,23,7,16,28,89,35,0,2022
ENG-Premier League,2021,Brentford,Yoane Wissa,COD,FW,24,1996,14.3,12,6,5,4,3,1,16,6.3,15,12,5,7,8,20,6,0,2022
ENG-Premier League,2021,Brentford,Álvaro Fernández,ESP,GK,23,1998,12.0,0,0,0,0,0,0,0,,0,0,0,0,0,0,5,2,2022
ENG-Premier League,2021,Brighton,Aaron Connolly,IRL,"FW,MF",21,2000,1.7,0,0,0,0,0,0,1,0.0,1,2,0,2,0,0,0,0,2022
ENG-Premier League,2021,Brighton,Adam Lallana,ENG,MF,33,1988,17.3,34,17,14,14,6,12,41,29.3,29,16,6,10,16,50,13,1,2022
ENG-Premier League,2021,Brighton,Adam Webster,ENG,DF,26,1995,15.9,26,8,17,7,2,13,20,65.0,7,25,17,8,17,43,66,2,2022
ENG-Premier League,2021,Brighton,Alexis Mac Allister,ARG,"MF,FW",22,1998,23.6,65,40,23,30,12,29,68,42.6,39,37,7,30,13,78,22,0,2022
ENG-Premier League,2021,Brighton,Dan Burn,ENG,DF,29,1992,11.4,22,12,13,8,1,6,15,40.0,9,14,10,4,24,46,51,0,2022
ENG-Premier League,2021,Brighton,Danny Welbeck,ENG,"FW,MF",30,1990,16.4,14,7,2,8,4,3,10,30.0,7,18,2,16,5,19,18,0,2022
ENG-Premier League,2021,Brighton,Enock Mwepu,ZAM,MF,23,1998,11.1,22,12,10,10,2,5,27,18.5,22,20,2,18,12,34,19,0,2022
ENG-Premier League,2021,Brighton,Evan Ferguson,IRL,MF,16,2004,0.3,0,0,0,0,0,0,0,,0,0,0,0,0,0,0,0,2022
ENG-Premier League,2021,Brighton,Jakub Moder,POL,MF,22,1999,18.9,42,25,18,17,7,23,42,54.8,19,25,2,23,10,52,22,1,2022
ENG-Premier League,2021,Brighton,Jason Steele,ENG,GK,30,1990,1.0,0,0,0,0,0,0,0,,0,0,0,0,0,0,0,0,2022
ENG-Premier League,2021,Brighton,Jeremy Sarmiento,ECU,"FW,MF",19,2002,0.5,1,1,0,0,1,0,2,0.0,2,2,0,2,0,1,0,0,2022
ENG-Premier League,2021,Brighton,Joël Veltman,NED,DF,29,1992,31.9,74,48,47,21,6,21,53,39.6,32,46,16,30,45,119,89,0,2022
ENG-Premier League,2021,Brighton,Jürgen Locadia,NED,"MF,FW",27,1993,0.3,0,0,0,0,0,0,0,,0,0,0,0,0,0,0,0,2022
ENG-Premier League,2021,Brighton,Leandro Trossard,BEL,"FW,MF",26,1994,31.2,34,20,12,9,13,4,31,12.9,27,33,4,29,15,49,10,0,2022
ENG-Premier League,2021,Brighton,Lewis Dunk,ENG,DF,29,1991,28.6,10,8,5,5,0,5,11,45.5,6,32,28,4,27,37,113,3,2022
ENG-Premier League,2021,Brighton,Marc Cucurella,ESP,DF,23,1998,34.3,93,62,43,32,18,44,71,62.0,27,42,14,28,30,123,74,0,2022
ENG-Premier League,2021,Brighton,Moisés Caicedo,ECU,MF,19,2001,7.3,16,10,7,7,2,5,12,41.7,7,18,4,14,10,26,7,0,2022
ENG-Premier League,2021,Brighton,Neal Maupay,FRA,FW,24,1996,25.3,17,10,2,6,9,4,18,22.2,14,21,2,19,2,19,2,0,2022
ENG-Premier League,2021,Brighton,Pascal Groß,GER,"MF,DF",30,1991,22.6,28,15,15,11,2,12,33,36.4,21,34,8,26,18,46,23,0,2022
ENG-Premier League,2021,Brighton,Robert Sánchez,ESP,GK,23,1997,37.0,2,1,2,0,0,1,1,100.0,0,1,0,1,0,2,11,4,2022
ENG-Premier League,2021,Brighton,Shane Duffy,IRL,DF,29,1992,16.0,15,12,12,3,0,8,14,57.1,6,24,18,6,16,31,76,1,2022
ENG-Premier League,2021,Brighton,Solly March,ENG,"DF,FW",27,1994,19.4,30,17,11,9,10,7,22,31.8,15,22,3,19,17,47,25,0,2022
ENG-Premier League,2021,Brighton,Steven Alzate,COL,MF,22,1998,4.5,10,4,4,5,1,4,7,57.1,3,2,1,1,10,20,10,0,2022
ENG-Premier League,2021,Brighton,Tariq Lamptey,GHA,"DF,FW",20,2000,17.3,36,25,14,17,5,15,25,60.0,10,13,3,10,21,57,23,0,2022
ENG-Premier League,2021,Brighton,Taylor Richards,ENG,MF,20,2000,0.3,1,0,0,1,0,1,2,50.0,1,0,0,0,0,1,0,0,2022
ENG-Premier League,2021,Brighton,Yves Bissouma,MLI,MF,24,1996,23.5,76,49,35,37,4,21,37,56.8,16,33,3,30,50,126,49,0,2022
ENG-Premier League,2021,Burnley,Aaron Lennon,ENG,"MF,FW",34,1987,17.2,33,17,10,13,10,10,34,29.4,24,26,4,22,9,42,14,0,2022
ENG-Premier League,2021,Burnley,Ashley Barnes,ENG,FW,31,1989,9.0,11,2,2,7,2,2,9,22.2,7,8,1,7,2,13,5,0,2022
ENG-Premier League,2021,Burnley,Ashley Westwood,ENG,MF,31,1990,25.4,21,12,8,12,1,10,31,32.3,21,21,9,12,30,51,16,1,2022
ENG-Premier League,2021,Burnley,Ben Mee,ENG,DF,31,1989,20.4,26,12,16,7,3,12,19,63.2,7,28,22,6,24,50,94,1,2022
ENG-Premier League,2021,Burnley,Charlie Taylor,ENG,DF,27,1993,30.3,45,26,31,11,3,26,44,59.1,18,42,20,22,58,103,95,2,2022
ENG-Premier League,2021,Burnley,Chris Wood,NZL,FW,29,1991,15.2,7,5,0,3,4,3,10,30.0,7,13,4,9,0,7,3,0,2022
ENG-Premier League,2021,Burnley,Connor Roberts,WAL,DF,25,1995,18.8,20,13,10,7,3,10,15,66.7,5,25,5,20,22,42,62,1,2022
ENG-Premier League,2021,Burnley,Dale Stephens,ENG,MF,32,1989,1.4,4,1,0,3,1,3,8,37.5,5,4,1,3,1,5,1,0,2022
ENG-Premier League,2021,Burnley,Dwight McNeil,ENG,MF,21,1999,34.5,78,49,27,38,13,33,73,45.2,40,64,11,53,35,113,31,1,2022
ENG-Premier League,2021,Burnley,Erik Pieters,NED,DF,32,1988,8.1,28,15,15,11,2,17,28,60.7,11,18,7,11,10,38,38,0,2022
ENG-Premier League,2021,Burnley,Jack Cork,ENG,MF,32,1989,18.6,20,6,6,11,3,7,20,35.0,13,17,4,13,17,37,29,1,2022
ENG-Premier League,2021,Burnley,James Tarkowski,ENG,DF,28,1992,34.5,65,45,47,17,1,33,47,70.2,14,75,61,14,48,113,186,4,2022
ENG-Premier League,2021,Burnley,Jay Rodriguez,ENG,FW,32,1989,15.4,20,12,8,8,4,4,14,28.6,10,19,1,18,4,24,12,0,2022
ENG-Premier League,2021,Burnley,Josh Brownhill,ENG,MF,25,1995,32.8,73,37,25,42,6,21,53,39.6,32,37,12,25,68,141,42,1,2022
ENG-Premier League,2021,Burnley,Jóhann Berg Guðmundsson,ISL,MF,30,1990,12.2,16,6,7,7,2,5,20,25.0,15,11,2,9,12,28,22,0,2022
ENG-Premier League,2021,Burnley,Kevin Long,IRL,DF,30,1990,4.6,3,2,1,2,0,1,2,50.0,1,4,1,3,1,4,20,0,2022
ENG-Premier League,2021,Burnley,Matthew Lowton,ENG,DF,32,1989,19.7,38,24,20,10,8,20,37,54.1,17,25,11,14,26,64,68,0,2022
ENG-Premier League,2021,Burnley,Matěj Vydra,CZE,FW,29,1992,7.5,12,7,3,4,5,3,7,42.9,4,5,1,4,0,12,9,0,2022
ENG-Premier League,2021,Burnley,Maxwel Cornet,CIV,"FW,MF",24,1996,19.6,16,9,7,5,4,7,15,46.7,8,13,4,9,10,26,14,0,2022
ENG-Premier League,2021,Burnley,Nathan Collins,IRL,DF,20,2001,18.6,37,15,27,8,2,17,27,63.0,10,38,25,13,24,61,83,2,2022
ENG-Premier League,2021,Burnley,Nick Pope,ENG,GK,29,1992,36.0,0,0,0,0,0,0,2,0.0,2,0,0,0,2,2,30,3,2022
ENG-Premier League,2021,Burnley,Wayne Hennessey,WAL,GK,34,1987,2.0,0,0,0,0,0,0,0,,0,0,0,0,1,1,0,1,2022
ENG-Premier League,2021,Burnley,Wout Weghorst,NED,FW,28,1992,16.1,17,9,3,9,5,6,19,31.6,13,16,5,11,6,23,13,0,2022
ENG-Premier League,2021,Chelsea,Andreas Christensen,DEN,DF,25,1996,16.6,14,8,9,4,1,4,7,57.1,3,14,6,8,29,43,57,1,2022
ENG-Premier League,2021,Chelsea,Antonio Rüdiger,GER,DF,28,1993,33.7,48,28,29,15,4,36,48,75.0,12,20,11,9,28,76,91,1,2022
ENG-Premier League,2021,Chelsea,Ben Chilwell,ENG,DF,24,1996,6.0,8,3,2,6,0,2,5,40.0,3,7,0,7,4,12,14,1,2022
ENG-Premier League,2021,Chelsea,Callum Hudson-Odoi,ENG,"MF,FW",20,2000,10.7,14,10,5,6,3,8,23,34.8,15,8,0,8,2,16,6,1,2022
ENG-Premier League,2021,Chelsea,Christian Pulisic,USA,"MF,FW",22,1998,14.3,10,7,6,3,1,3,17,17.6,14,12,0,12,5,15,10,0,2022
ENG-Premier League,2021,Chelsea,César Azpilicueta,ESP,DF,31,1989,23.0,51,28,18,27,6,16,35,45.7,19,32,9,23,23,74,65,1,2022
ENG-Premier League,2021,Chelsea,Edouard Mendy,SEN,GK,29,1992,34.0,1,0,1,0,0,1,3,33.3,2,0,0,0,0,1,13,4,2022
ENG-Premier League,2021,Chelsea,Emerson Palmieri,ITA,DF,26,1994,0.1,0,0,0,0,0,0,0,,0,0,0,0,0,0,0,0,2022
ENG-Premier League,2021,Chelsea,Hakim Ziyech,MAR,"MF,FW",28,1993,14.7,19,10,5,12,2,10,36,27.8,26,11,1,10,10,29,10,0,2022
ENG-Premier League,2021,Chelsea,Jorginho,ITA,MF,29,1991,25.3,64,33,27,31,6,29,83,34.9,54,27,4,23,36,100,21,1,2022
ENG-Premier League,2021,Chelsea,Kai Havertz,GER,"FW,MF",22,1999,20.1,17,8,5,7,5,4,14,28.6,10,28,1,27,4,21,32,1,2022
ENG-Premier League,2021,Chelsea,Kenedy,BRA,DF,25,1996,0.6,5,2,1,2,2,2,3,66.7,1,0,0,0,0,5,0,0,2022
ENG-Premier League,2021,Chelsea,Kepa Arrizabalaga,ESP,GK,26,1994,4.0,0,0,0,0,0,0,0,,0,0,0,0,0,0,4,0,2022
ENG-Premier League,2021,Chelsea,Malang Sarr,FRA,DF,22,1999,6.1,14,7,10,2,2,7,12,58.3,5,6,3,3,11,25,20,0,2022
ENG-Premier League,2021,Chelsea,Marcos Alonso,ESP,DF,30,1990,24.1,41,29,20,12,9,17,36,47.2,19,29,5,24,43,84,53,0,2022
ENG-Premier League,2021,Chelsea,Mason Mount,ENG,MF,22,1999,26.3,41,16,10,17,14,10,34,29.4,24,18,1,17,13,54,12,0,2022
ENG-Premier League,2021,Chelsea,Mateo Kovačić,CRO,MF,27,1994,17.3,51,31,14,26,11,17,35,48.6,18,19,4,15,7,58,9,1,2022
ENG-Premier League,2021,Chelsea,N'Golo Kanté,FRA,MF,30,1991,19.7,59,31,20,27,12,25,40,62.5,15,37,2,35,31,90,8,0,2022
ENG-Premier League,2021,Chelsea,Reece James,ENG,DF,21,1999,20.7,33,25,14,18,1,9,22,40.9,13,20,2,18,17,50,22,0,2022
ENG-Premier League,2021,Chelsea,Romelu Lukaku,BEL,FW,28,1993,17.7,2,1,0,1,1,1,5,20.0,4,11,1,10,0,2,20,0,2022
ENG-Premier League,2021,Chelsea,Ross Barkley,ENG,"MF,FW",27,1993,2.0,0,0,0,0,0,0,1,0.0,1,1,0,1,1,1,0,0,2022
ENG-Premier League,2021,Chelsea,Ruben Loftus-Cheek,ENG,"MF,DF",25,1996,15.5,29,10,16,11,2,10,19,52.6,9,15,6,9,11,40,17,0,2022
ENG-Premier League,2021,Chelsea,Saúl Ñíguez,ESP,"DF,MF",26,1994,5.3,20,9,11,9,0,9,16,56.3,7,14,3,11,7,27,10,1,2022
ENG-Premier League,2021,Chelsea,Thiago Silva,BRA,DF,36,1984,29.4,32,21,19,12,1,11,22,50.0,11,54,31,23,44,76,100,0,2022
ENG-Premier League,2021,Chelsea,Timo Werner,GER,"FW,MF",25,1996,14.3,8,4,3,3,2,2,20,10.0,18,9,0,9,2,10,4,0,2022
ENG-Premier League,2021,Chelsea,Trevoh Chalobah,ENG,DF,22,1999,16.1,40,27,22,18,0,24,31,77.4,7,16,6,10,19,59,43,2,2022
ENG-Premier League,2021,Crystal Palace,Cheikhou Kouyaté,SEN,MF,31,1989,21.9,52,38,28,22,2,18,39,46.2,21,40,14,26,38,90,39,0,2022
ENG-Premier League,2021,Crystal Palace,Christian Benteke,BEL,FW,30,1990,12.7,3,2,1,2,0,2,6,33.3,4,7,3,4,2,5,33,0,2022
ENG-Premier League,2021,Crystal Palace,Conor Gallagher,ENG,MF,21,2000,31.6,69,38,35,20,14,21,69,30.4,48,58,9,49,29,98,26,0,2022
ENG-Premier League,2021,Crystal Palace,Eberechi Eze,ENG,"MF,FW",23,1998,6.7,10,6,5,2,3,6,11,54.5,5,4,1,3,5,15,1,0,2022
ENG-Premier League,2021,Crystal Palace,Jack Butland,ENG,GK,28,1993,8.5,0,0,0,0,0,0,0,,0,0,0,0,0,0,1,0,2022
ENG-Premier League,2021,Crystal Palace,James McArthur,SCO,MF,33,1987,16.0,33,23,13,19,1,16,44,36.4,28,23,9,14,30,63,27,0,2022
ENG-Premier League,2021,Crystal Palace,James Tomkins,ENG,DF,32,1989,6.1,8,3,6,2,0,6,8,75.0,2,8,8,0,4,12,18,0,2022
ENG-Premier League,2021,Crystal Palace,Jaïro Riedewald,NED,MF,24,1996,1.3,1,1,0,1,0,1,2,50.0,1,1,0,1,1,2,2,0,2022
ENG-Premier League,2021,Crystal Palace,Jean-Philippe Mateta,FRA,FW,24,1997,12.7,8,4,2,5,1,3,18,16.7,15,11,3,8,4,12,13,0,2022
ENG-Premier League,2021,Crystal Palace,Jeffrey Schlupp,GHA,"MF,FW",28,1992,20.6,46,25,16,23,7,24,50,48.0,26,39,9,30,18,64,32,0,2022
ENG-Premier League,2021,Crystal Palace,Jesuran Rak Sakyi,ENG,"FW,MF",18,2002,0.9,0,0,0,0,0,0,1,0.0,1,3,0,3,1,1,0,0,2022
ENG-Premier League,2021,Crystal Palace,Joachim Andersen,DEN,DF,25,1996,32.4,30,23,21,9,0,16,27,59.3,11,29,19,10,37,67,125,3,2022
ENG-Premier League,2021,Crystal Palace,Joel Ward,ENG,DF,31,1989,27.6,44,26,30,11,3,30,57,52.6,27,24,11,13,32,76,107,1,2022
ENG-Premier League,2021,Crystal Palace,Jordan Ayew,GHA,FW,29,1991,22.4,47,30,20,20,7,17,31,54.8,14,33,3,30,15,62,15,0,2022
ENG-Premier League,2021,Crystal Palace,Luka Milivojević,SRB,MF,30,1991,8.6,18,9,9,6,3,10,16,62.5,6,6,1,5,11,29,15,0,2022
ENG-Premier League,2021,Crystal Palace,Marc Guéhi,ENG,DF,21,2000,35.8,35,17,24,10,1,15,16,93.8,1,34,26,8,30,65,127,0,2022
ENG-Premier League,2021,Crystal Palace,Michael Olise,FRA,"FW,MF",19,2001,12.7,22,18,8,11,3,7,24,29.2,17,17,0,17,6,28,6,0,2022
ENG-Premier League,2021,Crystal Palace,Nathan Ferguson,ENG,DF,20,2000,0.1,0,0,0,0,0,0,0,,0,0,0,0,0,0,0,0,2022
ENG-Premier League,2021,Crystal Palace,Nathaniel Clyne,ENG,DF,30,1991,15.0,21,10,11,9,1,10,20,50.0,10,7,2,5,15,36,32,0,2022
ENG-Premier League,2021,Crystal Palace,Odsonne Édouard,FRA,FW,23,1998,17.4,16,10,2,7,7,7,21,33.3,14,20,5,15,0,16,18,0,2022
ENG-Premier League,2021,Crystal Palace,Tyrick Mitchell,ENG,DF,21,1999,34.5,104,57,67,26,11,46,67,68.7,21,47,5,42,41,145,101,0,2022
ENG-Premier League,2021,Crystal Palace,Vicente Guaita,ESP,GK,34,1987,29.5,1,0,1,0,0,1,1,100.0,0,0,0,0,1,2,8,1,2022
ENG-Premier League,2021,Crystal Palace,Wilfried Zaha,CIV,FW,28,1992,30.7,40,20,14,15,11,10,31,32.3,21,28,0,28,5,45,5,0,2022
ENG-Premier League,2021,Crystal Palace,Will Hughes,ENG,MF,26,1995,11.7,29,14,10,16,3,7,16,43.8,9,13,7,6,8,37,10,0,2022
ENG-Premier League,2021,Everton,Abdoulaye Doucouré,MLI,MF,28,1993,28.2,75,43,30,37,8,32,71,45.1,39,33,8,25,28,103,32,0,2022
ENG-Premier League,2021,Everton,Alex Iwobi,NGA,"MF,DF",25,1996,22.6,40,19,23,12,5,21,52,40.4,31,39,3,36,20,60,25,2,2022
ENG-Premier League,2021,Everton,Allan,BRA,MF,30,1991,24.3,74,44,28,39,7,34,105,32.4,71,40,9,31,23,97,39,1,2022
ENG-Premier League,2021,Everton,Andros Townsend,ENG,"MF,FW",30,1991,16.2,31,17,15,6,10,15,40,37.5,25,28,2,26,14,45,6,1,2022
ENG-Premier League,2021,Everton,André Gomes,POR,MF,28,1993,6.9,16,4,6,6,4,8,32,25.0,24,8,2,6,1,17,7,1,2022
ENG-Premier League,2021,Everton,Anthony Gordon,ENG,"MF,FW",20,2001,25.4,54,32,20,30,4,21,59,35.6,38,49,3,46,22,76,17,0,2022
ENG-Premier League,2021,Everton,Anwar El Ghazi,NED,"FW,MF",26,1995,0.1,1,1,1,0,0,1,1,100.0,0,3,0,3,0,1,0,0,2022
ENG-Premier League,2021,Everton,Asmir Begović,BIH,GK,34,1987,3.0,0,0,0,0,0,0,0,,0,0,0,0,0,0,3,0,2022
ENG-Premier League,2021,Everton,Ben Godfrey,ENG,DF,23,1998,22.5,47,32,29,14,4,24,39,61.5,15,41,19,22,15,62,100,2,2022
ENG-Premier League,2021,Everton,Cenk Tosun,TUR,MF,30,1991,0.1,0,0,0,0,0,0,0,,0,0,0,0,0,0,0,0,2022
ENG-Premier League,2021,Everton,Dele Alli,ENG,"MF,FW",25,1996,3.8,7,2,3,4,0,0,4,0.0,4,7,2,5,6,13,10,0,2022
ENG-Premier League,2021,Everton,Demarai Gray,JAM,"MF,FW",25,1996,26.0,30,19,13,10,7,10,22,45.5,12,30,2,28,15,45,21,1,2022
ENG-Premier League,2021,Everton,Dominic Calvert-Lewin,ENG,FW,24,1997,14.3,11,8,1,6,4,3,8,37.5,5,5,2,3,3,14,12,0,2022
ENG-Premier League,2021,Everton,Donny van de Beek,NED,MF,24,1997,5.4,15,7,8,6,1,6,13,46.2,7,6,2,4,6,21,4,0,2022
ENG-Premier League,2021,Everton,Ellis Simms,ENG,FW,20,2001,0.7,0,0,0,0,0,0,0,,0,1,1,0,0,0,1,0,2022
ENG-Premier League,2021,Everton,Fabian Delph,ENG,MF,31,1989,7.4,18,15,10,7,1,8,21,38.1,13,12,5,7,14,32,10,0,2022
ENG-Premier League,2021,Everton,Isaac Price,NIR,MF,17,2003,0.2,0,0,0,0,0,0,0,,0,1,0,1,0,0,0,0,2022
ENG-Premier League,2021,Everton,Jarrad Branthwaite,ENG,DF,19,2002,4.3,4,1,3,1,0,3,8,37.5,5,3,2,1,1,5,20,0,2022
ENG-Premier League,2021,Everton,Jean-Philippe Gbamin,CIV,MF,25,1995,0.7,1,1,1,0,0,0,2,0.0,2,0,0,0,1,2,1,0,2022
ENG-Premier League,2021,Everton,Jonjoe Kenny,ENG,DF,24,1997,11.3,17,7,11,6,0,13,21,61.9,8,8,1,7,20,37,31,0,2022
ENG-Premier League,2021,Everton,Jordan Pickford,ENG,GK,27,1994,35.0,1,1,1,0,0,0,1,0.0,1,1,0,1,1,2,14,1,2022
ENG-Premier League,2021,Everton,Lewis Dobbin,ENG,"FW,MF",18,2003,0.4,2,1,0,1,1,1,2,50.0,1,0,0,0,0,2,0,0,2022
ENG-Premier League,2021,Everton,Lucas Digne,FRA,DF,28,1993,13.0,33,19,26,4,3,21,28,75.0,7,16,5,11,14,47,30,0,2022
ENG-Premier League,2021,Everton,Mason Holgate,ENG,DF,24,1996,23.7,35,18,26,9,0,11,26,42.3,15,25,17,8,26,61,95,1,2022
ENG-Premier League,2021,Everton,Michael Keane,ENG,DF,28,1993,31.0,46,25,32,13,1,28,45,62.2,17,33,28,5,62,108,128,2,2022
ENG-Premier League,2021,Everton,Moise Kean,ITA,FW,21,2000,0.0,0,0,0,0,0,0,0,,0,0,0,0,0,0,0,0,2022
ENG-Premier League,2021,Everton,Richarlison,BRA,FW,24,1997,28.0,40,23,18,15,7,15,31,48.4,16,42,4,38,12,52,34,0,2022
ENG-Premier League,2021,Everton,Salomón Rondón,VEN,FW,31,1989,8.8,6,1,1,2,3,4,14,28.6,10,5,0,5,0,6,10,0,2022
ENG-Premier League,2021,Everton,Séamus Coleman,IRL,DF,32,1988,29.5,61,36,35,16,10,33,51,64.7,18,30,11,19,32,93,80,2,2022
ENG-Premier League,2021,Everton,Tom Davies,ENG,MF,23,1998,2.6,3,1,1,1,1,2,5,40.0,3,2,1,1,2,5,9,0,2022
ENG-Premier League,2021,Everton,Tyler Onyango,ENG,MF,18,2003,0.3,0,0,0,0,0,0,0,,0,0,0,0,0,0,1,0,2022
ENG-Premier League,2021,Everton,Vitaliy Mykolenko,UKR,DF,22,1999,11.7,25,15,15,7,3,12,21,57.1,9,15,2,13,16,41,37,0,2022
ENG-Premier League,2021,Everton,Yerry Mina,COL,DF,26,1994,9.4,12,10,12,0,0,10,13,76.9,3,13,9,4,11,23,38,1,2022
ENG-Premier League,2021,Leeds United,Adam Forshaw,ENG,MF,29,1991,17.0,53,23,21,27,5,21,54,38.9,33,17,1,16,19,72,12,2,2022
ENG-Premier League,2021,Leeds United,Charlie Cresswell,ENG,DF,18,2002,1.6,5,2,1,4,0,3,3,100.0,0,1,1,0,2,7,6,0,2022
ENG-Premier League,2021,Leeds United,Cody Drameh,ENG,"DF,MF",19,2001,1.4,4,2,3,1,0,1,3,33.3,2,0,0,0,1,5,4,0,2022
ENG-Premier League,2021,Leeds United,Crysencio Summerville,NED,"MF,FW",19,2001,1.4,5,3,1,1,3,2,3,66.7,1,2,0,2,2,7,0,0,2022
ENG-Premier League,2021,Leeds United,Daniel James,WAL,"FW,MF",23,1997,26.3,24,14,8,8,8,10,23,43.5,13,18,1,17,8,32,12,0,2022
ENG-Premier League,2021,Leeds United,Diego Llorente,ESP,DF,27,1993,26.0,53,31,32,19,2,33,47,70.2,14,35,17,18,40,93,77,2,2022
ENG-Premier League,2021,Leeds United,Hélder Costa,ANG,MF,27,1994,0.2,0,0,0,0,0,0,0,,0,1,0,1,0,0,0,0,2022
ENG-Premier League,2021,Leeds United,Illan Meslier,FRA,GK,21,2000,37.6,1,1,1,0,0,1,1,100.0,0,0,0,0,0,1,27,1,2022
ENG-Premier League,2021,Leeds United,Jack Harrison,ENG,"FW,MF",24,1996,29.3,57,37,22,22,13,31,76,40.8,45,35,1,34,21,78,19,0,2022
ENG-Premier League,2021,Leeds United,Jamie Shackleton,ENG,"DF,MF",21,1999,7.9,27,16,19,7,1,13,25,52.0,12,11,7,4,8,35,12,1,2022
ENG-Premier League,2021,Leeds United,Joe Gelhardt,ENG,"FW,MF",19,2002,8.3,4,3,1,0,3,2,10,20.0,8,9,0,9,0,4,3,0,2022
ENG-Premier League,2021,Leeds United,Junior Firpo,ESP,"DF,MF",24,1996,19.0,61,29,30,26,5,31,59,52.5,28,22,6,16,24,85,37,0,2022
ENG-Premier League,2021,Leeds United,Kalvin Phillips,ENG,MF,25,1995,17.7,54,25,24,25,5,24,57,42.1,33,37,9,28,24,78,18,0,2022
ENG-Premier League,2021,Leeds United,Kristoffer Klaesson,NOR,GK,20,2000,0.4,0,0,0,0,0,0,0,,0,0,0,0,0,0,0,0,2022
ENG-Premier League,2021,Leeds United,Leo Fuhr Hjelde,NOR,"MF,DF",17,2003,1.7,5,4,3,2,0,3,3,100.0,0,3,3,0,4,9,7,0,2022
ENG-Premier League,2021,Leeds United,Lewis Bate,ENG,MF,18,2002,1.6,1,0,0,0,1,0,8,0.0,8,1,0,1,1,2,1,0,2022
ENG-Premier League,2021,Leeds United,Liam Cooper,SCO,DF,29,1991,20.2,41,23,27,13,1,23,33,69.7,10,29,18,11,43,84,72,2,2022
ENG-Premier League,2021,Leeds United,Liam McCarron,SCO,FW,20,2001,0.1,0,0,0,0,0,0,0,,0,1,0,1,0,0,0,0,2022
ENG-Premier League,2021,Leeds United,Luke Ayling,ENG,DF,29,1991,25.2,74,42,46,23,5,51,97,52.6,46,46,25,21,28,102,52,1,2022
ENG-Premier League,2021,Leeds United,Mateusz Klich,POL,MF,31,1990,23.0,47,25,18,23,6,25,66,37.9,41,22,4,18,11,58,20,0,2022
ENG-Premier League,2021,Leeds United,Pascal Struijk,NED,"DF,MF",21,1999,22.8,61,39,34,23,4,30,50,60.0,20,35,23,12,33,94,60,2,2022
ENG-Premier League,2021,Leeds United,Patrick Bamford,ENG,FW,27,1993,6.2,1,0,0,1,0,0,3,0.0,3,8,2,6,2,3,8,0,2022
ENG-Premier League,2021,Leeds United,Raphinha,BRA,"FW,MF",24,1996,32.4,51,29,25,14,12,22,71,31.0,49,43,0,43,29,80,28,1,2022
ENG-Premier League,2021,Leeds United,Robin Koch,GER,"MF,DF",25,1996,17.5,21,13,9,10,2,9,34,26.5,25,26,10,16,20,41,44,0,2022
ENG-Premier League,2021,Leeds United,Rodrigo,ESP,"MF,FW",30,1991,25.2,20,9,7,6,7,4,32,12.5,28,12,0,12,11,31,27,1,2022
ENG-Premier League,2021,Leeds United,Sam Greenwood,ENG,"MF,FW",19,2002,2.6,8,5,0,5,3,4,7,57.1,3,3,0,3,2,10,1,0,2022
ENG-Premier League,2021,Leeds United,Stuart Dallas,NIR,"DF,MF",30,1991,32.4,93,55,58,31,4,56,105,53.3,49,45,14,31,57,150,63,2,2022
ENG-Premier League,2021,Leeds United,Stuart McKinstry,SCO,MF,18,2002,0.0,0,0,0,0,0,0,0,,0,0,0,0,0,0,0,0,2022
ENG-Premier League,2021,Leeds United,Tyler Roberts,WAL,"MF,FW",22,1999,11.0,16,7,6,7,3,9,16,56.3,7,11,1,10,5,21,11,0,2022
ENG-Premier League,2021,Leicester City,Ademola Lookman,NGA,"FW,MF",23,1997,16.1,32,14,10,13,9,10,28,35.7,18,19,1,18,10,42,4,0,2022
ENG-Premier League,2021,Leicester City,Ayoze Pérez,ESP,"MF,FW",28,1993,4.9,4,2,0,3,1,0,13,0.0,13,11,1,10,2,6,5,0,2022
ENG-Premier League,2021,Leicester City,Boubakary Soumaré,FRA,MF,22,1999,12.2,19,13,10,8,1,8,17,47.1,9,13,1,12,14,33,18,0,2022
ENG-Premier League,2021,Leicester City,Daniel Amartey,GHA,DF,26,1994,23.6,26,13,19,7,0,19,29,65.5,10,30,22,8,21,47,93,4,2022
ENG-Premier League,2021,Leicester City,Danny Ward,WAL,GK,28,1993,1.0,0,0,0,0,0,0,0,,0,0,0,0,0,0,1,0,2022
ENG-Premier League,2021,Leicester City,Hamza Choudhury,ENG,"DF,MF",23,1997,3.2,9,3,4,4,1,3,5,60.0,2,0,0,0,12,21,10,0,2022
ENG-Premier League,2021,Leicester City,Harvey Barnes,ENG,"FW,MF",23,1997,23.3,31,16,9,11,11,7,23,30.4,16,24,1,23,5,36,7,0,2022
ENG-Premier League,2021,Leicester City,James Justin,ENG,DF,23,1998,11.1,22,13,11,8,3,7,15,46.7,8,16,4,12,17,39,34,0,2022
ENG-Premier League,2021,Leicester City,James Maddison,ENG,"MF,FW",24,1996,27.3,40,20,8,24,8,14,46,30.4,32,18,3,15,11,51,12,0,2022
ENG-Premier League,2021,Leicester City,Jamie Vardy,ENG,FW,34,1987,20.1,6,5,0,4,2,1,7,14.3,6,9,0,9,1,7,17,0,2022
ENG-Premier League,2021,Leicester City,Jannik Vestergaard,DEN,DF,28,1992,6.3,15,10,12,3,0,8,15,53.3,7,10,8,2,7,22,36,0,2022
ENG-Premier League,2021,Leicester City,Jonny Evans,NIR,DF,33,1988,15.0,24,14,14,8,2,14,22,63.6,8,17,13,4,20,44,59,0,2022
ENG-Premier League,2021,Leicester City,Kasey McAteer,ENG,FW,19,2001,0.0,0,0,0,0,0,0,0,,0,0,0,0,0,0,0,0,2022
ENG-Premier League,2021,Leicester City,Kasper Schmeichel,DEN,GK,34,1986,37.0,0,0,0,0,0,0,2,0.0,2,0,0,0,1,1,15,2,2022
ENG-Premier League,2021,Leicester City,Kelechi Iheanacho,NGA,FW,24,1996,14.0,10,7,2,5,3,3,14,21.4,11,19,0,19,4,14,10,0,2022
ENG-Premier League,2021,Leicester City,Kiernan Dewsbury-Hall,ENG,MF,22,1998,23.4,39,24,20,14,5,19,40,47.5,21,37,8,29,21,60,26,1,2022
ENG-Premier League,2021,Leicester City,Lewis Brunt,ENG,MF,20,2000,0.3,0,0,0,0,0,0,0,,0,1,0,1,0,0,0,0,2022
ENG-Premier League,2021,Leicester City,Luke Thomas,ENG,DF,20,2001,21.2,50,31,33,13,4,28,65,43.1,37,35,14,21,40,90,55,0,2022
ENG-Premier League,2021,Leicester City,Marc Albrighton,ENG,"FW,DF",31,1989,12.6,31,19,16,9,6,10,47,21.3,37,15,3,12,14,45,20,0,2022
ENG-Premier League,2021,Leicester City,Nampalys Mendy,SEN,MF,29,1992,11.5,12,6,8,4,0,6,17,35.3,11,7,4,3,11,23,11,1,2022
ENG-Premier League,2021,Leicester City,Patson Daka,ZAM,FW,22,1998,12.9,15,10,2,8,5,2,19,10.5,17,7,0,7,2,17,8,0,2022
ENG-Premier League,2021,Leicester City,Ricardo Pereira,POR,DF,27,1993,11.0,37,20,19,13,5,21,40,52.5,19,13,1,12,17,54,39,0,2022
ENG-Premier League,2021,Leicester City,Ryan Bertrand,ENG,DF,31,1989,3.7,8,5,3,4,1,2,5,40.0,3,8,3,5,1,9,7,0,2022
ENG-Premier League,2021,Leicester City,Timothy Castagne,BEL,DF,25,1995,23.6,67,31,38,22,7,27,43,62.8,16,28,9,19,29,96,54,1,2022
ENG-Premier League,2021,Leicester City,Wesley Fofana,FRA,DF,20,2000,7.0,12,8,11,1,0,7,11,63.6,4,5,2,3,12,24,26,1,2022
ENG-Premier League,2021,Leicester City,Wilfred Ndidi,NGA,"MF,DF",24,1996,18.0,60,32,32,27,1,22,55,40.0,33,36,8,28,42,102,54,1,2022
ENG-Premier League,2021,Leicester City,Youri Tielemans,BEL,MF,24,1997,29.2,74,38,23,45,6,42,100,42.0,58,47,13,34,21,95,41,3,2022
ENG-Premier League,2021,Leicester City,Çağlar Söyüncü,TUR,DF,25,1996,27.7,47,30,32,12,3,26,42,61.9,16,44,27,17,32,79,115,1,2022
ENG-Premier League,2021,Liverpool,Alex Oxlade-Chamberlain,ENG,"MF,FW",27,1993,8.7,15,11,2,8,5,3,14,21.4,11,12,2,10,6,21,5,0,2022
ENG-Premier League,2021,Liverpool,Alisson,BRA,GK,28,1992,36.0,3,1,3,0,0,3,5,60.0,2,1,0,1,0,3,28,1,2022
ENG-Premier League,2021,Liverpool,Andrew Robertson,SCO,DF,27,1994,28.2,36,21,16,15,5,20,35,57.1,15,24,3,21,23,59,61,0,2022
ENG-Premier League,2021,Liverpool,Caoimhín Kelleher,IRL,GK,22,1998,2.0,1,1,1,0,0,1,1,100.0,0,0,0,0,0,1,1,0,2022
ENG-Premier League,2021,Liverpool,Curtis Jones,ENG,MF,20,2001,9.5,11,9,3,6,2,1,10,10.0,9,4,0,4,6,17,4,0,2022
ENG-Premier League,2021,Liverpool,Diogo Jota,POR,FW,24,1996,26.3,39,18,12,18,9,13,55,23.6,42,19,2,17,6,45,6,0,2022
ENG-Premier League,2021,Liverpool,Divock Origi,BEL,FW,26,1995,1.5,0,0,0,0,0,0,2,0.0,2,1,0,1,1,1,2,0,2022
ENG-Premier League,2021,Liverpool,Fabinho,BRA,MF,27,1993,25.7,46,25,17,23,6,24,70,34.3,46,33,10,23,39,85,25,1,2022
ENG-Premier League,2021,Liverpool,Harvey Elliott,ENG,MF,18,2003,3.8,3,0,1,1,1,0,6,0.0,6,8,1,7,4,7,2,0,2022
ENG-Premier League,2021,Liverpool,Ibrahima Konaté,FRA,DF,22,1999,11.0,16,10,9,6,1,7,10,70.0,3,13,9,4,16,32,37,1,2022
ENG-Premier League,2021,Liverpool,James Milner,ENG,"MF,DF",35,1986,9.5,28,16,12,11,5,12,29,41.4,17,19,5,14,17,45,20,0,2022
ENG-Premier League,2021,Liverpool,Joe Gomez,ENG,DF,24,1997,3.7,10,6,5,2,3,5,9,55.6,4,4,1,3,5,15,6,0,2022
ENG-Premier League,2021,Liverpool,Jordan Henderson,ENG,MF,31,1990,28.9,36,20,9,25,2,17,44,38.6,27,25,1,24,23,59,14,0,2022
ENG-Premier League,2021,Liverpool,Joël Matip,CMR,DF,29,1991,31.0,47,34,23,19,5,20,31,64.5,11,26,14,12,44,91,93,1,2022
ENG-Premier League,2021,Liverpool,Kaide Gordon,ENG,FW,16,2004,0.1,1,0,0,0,1,0,0,,0,0,0,0,0,1,0,0,2022
ENG-Premier League,2021,Liverpool,Kostas Tsimikas,GRE,DF,25,1996,9.7,27,12,12,8,7,12,16,75.0,4,6,2,4,10,37,22,2,2022
ENG-Premier League,2021,Liverpool,Luis Díaz,COL,FW,24,1997,10.6,9,7,3,5,1,2,8,25.0,6,7,0,7,4,13,2,0,2022
ENG-Premier League,2021,Liverpool,Mohamed Salah,EGY,FW,29,1992,30.7,17,8,5,9,3,6,19,31.6,13,7,1,6,6,23,5,0,2022
ENG-Premier League,2021,Liverpool,Naby Keïta,GUI,MF,26,1995,13.0,46,23,17,19,10,26,42,61.9,16,33,2,31,14,60,8,0,2022
ENG-Premier League,2021,Liverpool,Neco Williams,WAL,DF,20,2001,0.1,0,0,0,0,0,0,0,,0,0,0,0,0,0,0,0,2022
ENG-Premier League,2021,Liverpool,Roberto Firmino,BRA,FW,29,1991,11.0,23,14,5,8,10,3,16,18.8,13,20,0,20,4,27,3,0,2022
ENG-Premier League,2021,Liverpool,Sadio Mané,SEN,FW,29,1992,31.3,33,20,7,14,12,8,26,30.8,18,30,1,29,8,41,15,0,2022
ENG-Premier League,2021,Liverpool,Takumi Minamino,JPN,"FW,MF",26,1995,2.1,3,2,1,1,1,2,8,25.0,6,2,0,2,1,4,2,0,2022
ENG-Premier League,2021,Liverpool,Thiago Alcántara,ESP,MF,30,1991,17.0,48,29,14,24,10,10,42,23.8,32,22,2,20,26,74,13,2,2022
ENG-Premier League,2021,Liverpool,Trent Alexander-Arnold,ENG,DF,22,1998,31.7,40,23,19,13,8,27,60,45.0,33,22,4,18,43,83,40,0,2022
ENG-Premier League,2021,Liverpool,Tyler Morton,ENG,MF,18,2002,0.7,0,0,0,0,0,0,2,0.0,2,0,0,0,3,3,0,0,2022
ENG-Premier League,2021,Liverpool,Virgil van Dijk,NED,DF,30,1991,34.0,16,10,11,5,0,11,16,68.8,5,21,14,7,31,47,109,0,2022
ENG-Premier League,2021,Manchester City,Aymeric Laporte,ESP,DF,27,1994,31.4,33,15,22,10,1,14,20,70.0,6,15,10,5,20,53,64,2,2022
ENG-Premier League,2021,Manchester City,Benjamin Mendy,FRA,DF,27,1994,0.9,2,2,1,1,0,2,6,33.3,4,0,0,0,0,2,0,0,2022
ENG-Premier League,2021,Manchester City,Bernardo Silva,POR,"MF,FW",26,1994,31.7,57,29,19,19,19,31,67,46.3,36,24,2,22,20,77,19,0,2022
ENG-Premier League,2021,Manchester City,CJ Egan-Riley,ENG,DF,18,2003,0.0,1,1,1,0,0,1,1,100.0,0,0,0,0,0,1,0,0,2022
ENG-Premier League,2021,Manchester City,Cole Palmer,ENG,"FW,MF",19,2002,1.4,2,1,1,1,0,0,2,0.0,2,3,0,3,1,3,0,0,2022
ENG-Premier League,2021,Manchester City,Ederson,BRA,GK,27,1993,37.0,2,1,2,0,0,0,2,0.0,2,0,0,0,0,2,12,0,2022
ENG-Premier League,2021,Manchester City,Fernandinho,BRA,"MF,DF",36,1985,10.7,21,10,7,10,4,9,27,33.3,18,8,2,6,8,29,13,1,2022
ENG-Premier League,2021,Manchester City,Ferrán Torres,ESP,FW,21,2000,3.4,2,2,0,1,1,0,3,0.0,3,2,0,2,0,2,1,0,2022
ENG-Premier League,2021,Manchester City,Gabriel Jesus,BRA,FW,24,1997,20.9,18,12,2,4,12,6,26,23.1,20,18,0,18,15,33,8,0,2022
ENG-Premier League,2021,Manchester City,Jack Grealish,ENG,FW,25,1995,21.3,18,17,4,10,4,5,13,38.5,8,11,1,10,8,26,7,0,2022
ENG-Premier League,2021,Manchester City,James Mcatee,ENG,"MF,FW",18,2002,0.2,0,0,0,0,0,0,2,0.0,2,0,0,0,0,0,0,0,2022
ENG-Premier League,2021,Manchester City,John Stones,ENG,DF,27,1994,12.4,5,3,3,2,0,2,3,66.7,1,3,3,0,11,16,27,1,2022
ENG-Premier League,2021,Manchester City,João Cancelo,POR,DF,27,1994,35.9,83,54,33,35,15,46,91,50.5,45,25,3,22,59,142,45,1,2022
ENG-Premier League,2021,Manchester City,Kayky Chagas,BRA,FW,18,2003,0.1,0,0,0,0,0,0,0,,0,0,0,0,0,0,0,0,2022
ENG-Premier League,2021,Manchester City,Kevin De Bruyne,BEL,MF,30,1991,24.5,32,16,4,15,13,12,37,32.4,25,32,2,30,6,38,16,0,2022
ENG-Premier League,2021,Manchester City,Kyle Walker,ENG,DF,31,1990,19.5,15,6,7,7,1,8,17,47.1,9,14,4,10,14,29,16,1,2022
ENG-Premier League,2021,Manchester City,Liam Delap,ENG,FW,18,2003,0.1,0,0,0,0,0,0,0,,0,0,0,0,0,0,0,0,2022
ENG-Premier League,2021,Manchester City,Nathan Aké,NED,DF,26,1995,10.3,16,9,7,8,1,6,8,75.0,2,7,5,2,8,24,23,0,2022
ENG-Premier League,2021,Manchester City,Oleksandr Zinchenko,UKR,DF,24,1996,11.6,20,14,7,10,3,11,20,55.0,9,11,3,8,14,34,15,1,2022
ENG-Premier League,2021,Manchester City,Phil Foden,ENG,FW,21,2000,23.6,16,8,10,4,2,7,17,41.2,10,9,0,9,11,27,5,0,2022
ENG-Premier League,2021,Manchester City,Raheem Sterling,ENG,FW,26,1994,23.6,23,10,3,11,9,10,23,43.5,13,12,0,12,12,35,3,0,2022
ENG-Premier League,2021,Manchester City,Riyad Mahrez,ALG,FW,30,1991,16.6,11,3,5,4,2,5,19,26.3,14,15,1,14,6,17,6,0,2022
ENG-Premier League,2021,Manchester City,Rodri,ESP,MF,25,1996,32.0,72,43,24,38,10,32,59,54.2,27,28,5,23,28,100,45,0,2022
ENG-Premier League,2021,Manchester City,Rúben Dias,POR,DF,24,1997,26.7,26,19,11,12,3,8,15,53.3,7,19,13,6,23,49,66,0,2022
ENG-Premier League,2021,Manchester City,Zack Steffen,USA,GK,26,1995,1.0,0,0,0,0,0,0,0,,0,0,0,0,0,0,2,0,2022
ENG-Premier League,2021,Manchester City,İlkay Gündoğan,GER,MF,30,1990,20.6,23,9,10,12,1,12,31,38.7,19,11,1,10,15,38,10,0,2022
ENG-Premier League,2021,Manchester Utd,Aaron Wan-Bissaka,ENG,DF,23,1997,19.9,49,36,25,18,6,14,20,70.0,6,24,14,10,34,83,41,2,2022
ENG-Premier League,2021,Manchester Utd,Alejandro Garnacho,ARG,"FW,MF",17,2004,0.1,0,0,0,0,0,0,1,0.0,1,0,0,0,0,0,0,0,2022
ENG-Premier League,2021,Manchester Utd,Alex Telles,BRA,DF,28,1992,18.4,48,27,35,9,4,27,43,62.8,16,17,4,13,26,74,45,0,2022
ENG-Premier League,2021,Manchester Utd,Anthony Elanga,SWE,FW,19,2002,13.5,26,20,12,12,2,15,29,51.7,14,17,1,16,9,35,7,0,2022
ENG-Premier League,2021,Manchester Utd,Anthony Martial,FRA,FW,25,1995,2.4,0,0,0,0,0,0,1,0.0,1,1,0,1,0,0,1,0,2022
ENG-Premier League,2021,Manchester Utd,Bruno Fernandes,POR,MF,26,1994,34.6,54,28,26,22,6,26,91,28.6,65,36,0,36,17,71,42,2,2022
ENG-Premier League,2021,Manchester Utd,Cristiano Ronaldo,POR,FW,36,1985,27.3,8,6,1,5,2,2,6,33.3,4,8,0,8,2,10,29,0,2022
ENG-Premier League,2021,Manchester Utd,Daniel James,WAL,FW,23,1997,1.4,2,1,0,2,0,0,0,,0,2,0,2,0,2,1,0,2022
ENG-Premier League,2021,Manchester Utd,David de Gea,ESP,GK,30,1990,38.0,0,0,0,0,0,0,0,,0,0,0,0,0,0,11,2,2022
ENG-Premier League,2021,Manchester Utd,Diogo Dalot,POR,DF,22,1999,20.0,55,41,35,12,8,31,57,54.4,26,24,13,11,29,84,59,0,2022
ENG-Premier League,2021,Manchester Utd,Donny van de Beek,NED,MF,24,1997,0.8,6,4,4,1,1,1,2,50.0,1,5,1,4,2,8,1,0,2022
ENG-Premier League,2021,Manchester Utd,Edinson Cavani,URU,FW,34,1987,8.5,4,1,0,3,1,2,8,25.0,6,6,0,6,2,6,8,0,2022
ENG-Premier League,2021,Manchester Utd,Eric Bailly,CIV,DF,27,1994,2.4,5,4,4,0,1,3,4,75.0,1,4,2,2,3,8,11,0,2022
ENG-Premier League,2021,Manchester Utd,Fred,BRA,MF,28,1993,22.5,63,27,32,24,7,22,79,27.8,57,38,11,27,32,95,24,0,2022
ENG-Premier League,2021,Manchester Utd,Hannibal Mejbri,TUN,FW,18,2003,0.8,2,1,1,1,0,1,1,100.0,0,0,0,0,0,2,0,0,2022
ENG-Premier League,2021,Manchester Utd,Harry Maguire,ENG,DF,28,1993,27.9,34,21,22,8,4,19,31,61.3,12,36,29,7,32,66,101,3,2022
ENG-Premier League,2021,Manchester Utd,Jadon Sancho,ENG,"FW,MF",21,2000,21.1,14,8,9,4,1,8,22,36.4,14,19,0,19,15,29,5,3,2022
ENG-Premier League,2021,Manchester Utd,Jesse Lingard,ENG,"FW,MF",28,1992,4.1,9,7,4,3,2,2,6,33.3,4,4,0,4,0,9,1,0,2022
ENG-Premier League,2021,Manchester Utd,Juan Mata,ESP,MF,33,1988,2.6,6,4,2,3,1,3,5,60.0,2,1,0,1,1,7,1,0,2022
ENG-Premier League,2021,Manchester Utd,Luke Shaw,ENG,DF,26,1995,17.8,21,13,9,9,3,12,21,57.1,9,22,11,11,9,30,22,2,2022
ENG-Premier League,2021,Manchester Utd,Marcus Rashford,ENG,"FW,MF",23,1997,13.7,6,5,1,4,1,2,13,15.4,11,10,1,9,5,11,5,1,2022
ENG-Premier League,2021,Manchester Utd,Mason Greenwood,ENG,"FW,MF",19,2001,14.1,15,9,9,1,5,3,9,33.3,6,5,0,5,1,16,6,0,2022
ENG-Premier League,2021,Manchester Utd,Nemanja Matić,SRB,MF,32,1988,15.4,31,18,19,11,1,15,31,48.4,16,21,6,15,31,62,21,3,2022
ENG-Premier League,2021,Manchester Utd,Paul Pogba,FRA,"MF,FW",28,1993,15.0,13,9,5,7,1,6,28,21.4,22,11,0,11,13,26,16,0,2022
ENG-Premier League,2021,Manchester Utd,Phil Jones,ENG,DF,29,1992,1.8,5,5,3,1,1,2,3,66.7,1,4,4,0,3,8,8,0,2022
ENG-Premier League,2021,Manchester Utd,Raphaël Varane,FRA,DF,28,1993,20.3,28,19,21,6,1,10,22,45.5,12,18,9,9,18,46,82,1,2022
ENG-Premier League,2021,Manchester Utd,Scott McTominay,SCO,MF,24,1996,26.5,65,33,32,24,9,30,61,49.2,31,45,10,35,31,96,60,1,2022
ENG-Premier League,2021,Manchester Utd,Shola Shoretire,ENG,MF,17,2004,0.2,0,0,0,0,0,0,0,,0,0,0,0,0,0,0,0,2022
ENG-Premier League,2021,Manchester Utd,Victor Lindelöf,SWE,DF,27,1994,26.2,16,11,9,7,0,9,14,64.3,5,26,17,9,25,41,96,0,2022
ENG-Premier League,2021,Newcastle Utd,Allan Saint-Maximin,FRA,"FW,MF",24,1997,31.2,13,8,6,4,3,3,17,17.6,14,13,2,11,11,24,3,0,2022
ENG-Premier League,2021,Newcastle Utd,Bruno Guimarães,BRA,MF,23,1997,11.5,44,23,18,22,4,21,38,55.3,17,25,6,19,9,53,13,0,2022
ENG-Premier League,2021,Newcastle Utd,Callum Wilson,ENG,FW,29,1992,15.4,9,8,1,5,3,1,4,25.0,3,7,2,5,3,12,10,0,2022
ENG-Premier League,2021,Newcastle Utd,Chris Wood,NZL,FW,29,1991,14.7,2,0,1,1,0,1,2,50.0,1,5,2,3,2,4,9,0,2022
ENG-Premier League,2021,Newcastle Utd,Ciaran Clark,IRL,DF,31,1989,11.3,13,10,4,7,2,9,14,64.3,5,14,11,3,13,26,43,1,2022
ENG-Premier League,2021,Newcastle Utd,Dan Burn,ENG,DF,29,1992,16.0,16,11,11,4,1,7,11,63.6,4,22,14,8,20,36,101,0,2022
ENG-Premier League,2021,Newcastle Utd,Dwight Gayle,ENG,"FW,DF",30,1990,0.4,1,0,0,1,0,0,1,0.0,1,0,0,0,1,2,0,0,2022
ENG-Premier League,2021,Newcastle Utd,Emil Krafth,SWE,DF,26,1994,18.2,37,16,25,11,1,27,36,75.0,9,16,10,6,25,62,56,0,2022
ENG-Premier League,2021,Newcastle Utd,Fabian Schär,SUI,DF,29,1991,24.0,16,11,11,3,2,8,16,50.0,8,27,18,9,32,48,95,2,2022
ENG-Premier League,2021,Newcastle Utd,Federico Fernández,ARG,DF,32,1989,5.8,3,0,3,0,0,2,5,40.0,3,10,10,0,4,7,28,0,2022
ENG-Premier League,2021,Newcastle Utd,Freddie Woodman,ENG,GK,24,1997,4.0,0,0,0,0,0,0,0,,0,0,0,0,0,0,0,1,2022
ENG-Premier League,2021,Newcastle Utd,Isaac Hayden,ENG,"MF,DF",26,1995,11.1,28,14,11,14,3,12,29,41.4,17,17,8,9,14,42,24,0,2022
ENG-Premier League,2021,Newcastle Utd,Jacob Murphy,ENG,"FW,DF",26,1995,16.4,49,26,34,11,4,26,41,63.4,15,20,2,18,23,72,17,0,2022
ENG-Premier League,2021,Newcastle Utd,Jamaal Lascelles,ENG,DF,27,1993,22.9,15,7,9,5,1,4,12,33.3,8,38,28,10,22,37,121,1,2022
ENG-Premier League,2021,Newcastle Utd,Jamal Lewis,NIR,DF,23,1998,2.9,8,6,6,1,1,3,4,75.0,1,3,2,1,3,11,8,0,2022
ENG-Premier League,2021,Newcastle Utd,Javier Manquillo,ESP,DF,27,1994,14.0,39,29,28,10,1,21,36,58.3,15,15,6,9,10,49,32,0,2022
ENG-Premier League,2021,Newcastle Utd,Jeff Hendrick,IRL,MF,29,1992,0.8,1,1,0,1,0,1,1,100.0,0,0,0,0,0,1,1,0,2022
ENG-Premier League,2021,Newcastle Utd,Joe Willock,ENG,MF,21,1999,22.6,64,37,30,28,6,29,68,42.6,39,37,6,31,21,85,10,1,2022
ENG-Premier League,2021,Newcastle Utd,Joelinton,BRA,"MF,FW",24,1996,28.4,72,38,30,33,9,26,61,42.6,35,46,11,35,34,106,50,2,2022
ENG-Premier League,2021,Newcastle Utd,Jonjo Shelvey,ENG,MF,29,1992,22.0,30,17,12,18,0,14,34,41.2,20,22,7,15,22,52,20,2,2022
ENG-Premier League,2021,Newcastle Utd,Karl Darlow,ENG,GK,30,1990,8.0,0,0,0,0,0,0,0,,0,0,0,0,0,0,5,1,2022
ENG-Premier League,2021,Newcastle Utd,Kieran Trippier,ENG,DF,30,1990,4.8,17,10,8,8,1,10,16,62.5,6,10,3,7,10,27,10,0,2022
ENG-Premier League,2021,Newcastle Utd,Martin Dúbravka,SVK,GK,32,1989,26.0,1,1,1,0,0,0,1,0.0,1,0,0,0,0,1,8,2,2022
ENG-Premier League,2021,Newcastle Utd,Matt Ritchie,SCO,DF,31,1989,14.9,22,15,10,10,2,10,27,37.0,17,10,2,8,13,35,26,0,2022
ENG-Premier League,2021,Newcastle Utd,Matt Targett,ENG,DF,25,1995,16.0,41,26,26,14,1,24,37,64.9,13,15,4,11,25,66,39,1,2022
ENG-Premier League,2021,Newcastle Utd,Miguel Almirón,PAR,"MF,FW",27,1994,19.1,47,29,23,17,7,11,44,25.0,33,14,1,13,20,67,13,0,2022
ENG-Premier League,2021,Newcastle Utd,Paul Dummett,WAL,DF,29,1991,2.2,7,3,3,4,0,5,8,62.5,3,5,0,5,3,10,5,0,2022
ENG-Premier League,2021,Newcastle Utd,Ryan Fraser,SCO,"FW,MF",27,1994,16.3,10,3,5,3,2,5,13,38.5,8,11,1,10,11,21,11,0,2022
ENG-Premier League,2021,Newcastle Utd,Sean Longstaff,ENG,MF,23,1997,16.3,54,34,18,31,5,24,65,36.9,41,18,6,12,9,63,18,0,2022
ENG-Premier League,2021,Norwich City,Adam Idah,IRL,"FW,MF",20,2001,6.9,9,6,2,5,2,2,3,66.7,1,4,2,2,3,12,7,0,2022
ENG-Premier League,2021,Norwich City,Andrew Omobamidele,IRL,DF,19,2002,4.2,8,6,5,3,0,5,11,45.5,6,8,8,0,5,13,13,0,2022
ENG-Premier League,2021,Norwich City,Angus Gunn,SCO,GK,25,1996,9.0,0,0,0,0,0,0,0,,0,0,0,0,0,0,11,0,2022
ENG-Premier League,2021,Norwich City,Bali Mumba,ENG,DF,19,2001,0.5,1,1,1,0,0,0,0,,0,0,0,0,0,1,5,0,2022
ENG-Premier League,2021,Norwich City,Ben Gibson,ENG,DF,28,1993,27.7,23,16,17,6,0,7,12,58.3,5,36,30,6,27,50,139,2,2022
ENG-Premier League,2021,Norwich City,Billy Gilmour,SCO,MF,20,2001,20.6,41,21,16,21,4,14,52,26.9,38,21,4,17,17,58,29,0,2022
ENG-Premier League,2021,Norwich City,Brandon Williams,ENG,DF,20,2000,23.6,55,37,35,18,2,36,64,56.3,28,26,6,20,44,99,50,0,2022
ENG-Premier League,2021,Norwich City,Christoph Zimmermann,GER,DF,28,1993,1.7,6,3,5,1,0,3,4,75.0,1,0,0,0,1,7,4,0,2022
ENG-Premier League,2021,Norwich City,Christos Tzolis,GRE,"FW,MF",19,2002,3.7,5,3,3,1,1,2,9,22.2,7,3,0,3,1,6,1,0,2022
ENG-Premier League,2021,Norwich City,Dimitris Giannoulis,GRE,DF,25,1995,13.0,36,21,17,17,2,24,36,66.7,12,22,6,16,19,55,41,1,2022
ENG-Premier League,2021,Norwich City,Grant Hanley,SCO,DF,29,1991,32.2,44,25,28,14,2,18,35,51.4,17,56,45,11,56,100,176,2,2022
ENG-Premier League,2021,Norwich City,Jakob Sørensen,DEN,"MF,DF",23,1998,6.7,22,11,6,14,2,10,20,50.0,10,7,3,4,10,32,19,0,2022
ENG-Premier League,2021,Norwich City,Jon Rowe,ENG,"FW,MF",18,2003,2.5,3,2,2,1,0,2,3,66.7,1,7,0,7,3,6,1,0,2022
ENG-Premier League,2021,Norwich City,Josh Sargent,USA,"FW,MF",21,2000,17.5,26,14,15,7,4,14,39,35.9,25,29,2,27,11,37,18,2,2022
ENG-Premier League,2021,Norwich City,Kenny McLean,SCO,MF,29,1992,30.1,42,22,18,20,4,17,59,28.8,42,29,7,22,34,76,54,0,2022
ENG-Premier League,2021,Norwich City,Kieran Dowell,ENG,"FW,MF",23,1997,10.1,18,7,8,7,3,9,32,28.1,23,10,1,9,7,25,4,0,2022
ENG-Premier League,2021,Norwich City,Lukas Rupp,GER,MF,30,1991,8.5,9,4,5,3,1,4,15,26.7,11,11,1,10,9,18,7,0,2022
ENG-Premier League,2021,Norwich City,Mathias Normann,NOR,MF,25,1996,18.3,34,21,19,14,1,17,46,37.0,29,17,8,9,19,53,43,1,2022
ENG-Premier League,2021,Norwich City,Max Aarons,ENG,DF,21,2000,32.0,64,44,49,15,0,37,55,67.3,18,39,19,20,28,92,96,1,2022
ENG-Premier League,2021,Norwich City,Milot Rashica,KVX,"FW,MF",25,1996,24.8,31,19,12,12,7,11,30,36.7,19,22,3,19,15,46,23,0,2022
ENG-Premier League,2021,Norwich City,Ozan Kabak,TUR,DF,21,2000,10.2,10,5,4,6,0,5,9,55.6,4,19,11,8,16,26,26,0,2022
ENG-Premier League,2021,Norwich City,Pierre Lees-Melou,FRA,MF,28,1993,25.2,58,36,23,29,6,25,92,27.2,67,37,11,26,25,83,23,0,2022
ENG-Premier League,2021,Norwich City,Przemysław Płacheta,POL,"FW,MF",23,1998,5.6,4,3,3,1,0,2,7,28.6,5,3,1,2,2,6,5,1,2022
ENG-Premier League,2021,Norwich City,Sam Byram,ENG,DF,27,1993,11.4,24,15,17,6,1,19,27,70.4,8,21,11,10,22,46,48,0,2022
ENG-Premier League,2021,Norwich City,Teemu Pukki,FIN,FW,31,1990,36.1,23,11,2,14,7,6,29,20.7,23,21,1,20,4,27,3,0,2022
ENG-Premier League,2021,Norwich City,Tim Krul,NED,GK,33,1988,29.0,1,1,1,0,0,1,4,25.0,3,0,0,0,0,1,10,4,2022
ENG-Premier League,2021,Norwich City,Todd Cantwell,ENG,"FW,MF",23,1998,4.9,15,13,8,6,1,6,17,35.3,11,2,0,2,3,18,2,0,2022
ENG-Premier League,2021,Norwich City,Tony Springett,ENG,"MF,FW",18,2002,1.6,2,1,1,1,0,1,4,25.0,3,0,0,0,0,2,2,0,2022
ENG-Premier League,2021,Southampton,Adam Armstrong,ENG,FW,24,1997,15.7,10,4,2,2,6,0,6,0.0,6,13,1,12,3,13,6,0,2022
ENG-Premier League,2021,Southampton,Alex McCarthy,ENG,GK,31,1989,17.0,0,0,0,0,0,0,0,,0,0,0,0,0,0,4,0,2022
ENG-Premier League,2021,Southampton,Armando Broja,ALB,FW,19,2001,21.9,12,5,2,7,3,2,9,22.2,7,17,1,16,3,15,11,0,2022
ENG-Premier League,2021,Southampton,Che Adams,SCO,FW,25,1996,22.7,13,6,5,5,3,2,16,12.5,14,18,2,16,8,21,18,0,2022
ENG-Premier League,2021,Southampton,Fraser Forster,ENG,GK,33,1988,19.0,1,0,1,0,0,0,1,0.0,1,0,0,0,0,1,23,2,2022
ENG-Premier League,2021,Southampton,Ibrahima Diallo,FRA,MF,22,1999,11.4,22,11,10,9,3,10,24,41.7,14,7,0,7,9,31,10,0,2022
ENG-Premier League,2021,Southampton,Jack Stephens,ENG,DF,27,1994,9.0,19,12,13,5,1,6,16,37.5,10,12,7,5,19,38,42,0,2022
ENG-Premier League,2021,Southampton,James Ward-Prowse,ENG,MF,26,1994,35.7,41,24,12,24,5,19,70,27.1,51,43,15,28,40,81,45,1,2022
ENG-Premier League,2021,Southampton,Jan Bednarek,POL,DF,25,1996,29.2,32,15,18,13,1,19,33,57.6,14,48,27,21,72,104,141,0,2022
ENG-Premier League,2021,Southampton,Kyle Walker-Peters,ENG,DF,24,1997,29.3,57,33,28,21,8,26,38,68.4,12,29,8,21,37,94,53,1,2022
ENG-Premier League,2021,Southampton,Lyanco,BRA,DF,24,1997,10.1,18,15,11,7,0,10,18,55.6,8,18,13,5,13,31,50,1,2022
ENG-Premier League,2021,Southampton,Mohamed Elyounoussi,NOR,"MF,FW",26,1994,22.7,36,17,14,15,7,11,39,28.2,28,23,2,21,12,48,28,0,2022
ENG-Premier League,2021,Southampton,Mohammed Salisu,GHA,DF,22,1999,33.0,80,47,54,22,4,40,65,61.5,25,49,26,23,78,158,158,4,2022
ENG-Premier League,2021,Southampton,Moussa Djenepo,MLI,MF,23,1998,5.1,9,3,3,5,1,3,11,27.3,8,6,1,5,2,11,6,1,2022
ENG-Premier League,2021,Southampton,Nathan Redmond,ENG,"MF,FW",27,1994,20.4,22,14,9,9,4,7,30,23.3,23,21,2,19,8,30,16,0,2022
ENG-Premier League,2021,Southampton,Nathan Tella,ENG,"MF,FW",22,1999,8.9,13,9,5,7,1,6,17,35.3,11,13,0,13,6,19,9,0,2022
ENG-Premier League,2021,Southampton,Oriol Romeu,ESP,MF,29,1991,32.1,77,39,25,45,7,28,73,38.4,45,39,8,31,51,128,43,0,2022
ENG-Premier League,2021,Southampton,Romain Perraud,FRA,DF,23,1997,18.0,34,22,18,14,2,16,29,55.2,13,24,6,18,17,51,42,0,2022
ENG-Premier League,2021,Southampton,Shane Long,IRL,FW,34,1987,3.4,9,5,2,4,3,1,1,100.0,0,4,0,4,0,9,2,0,2022
ENG-Premier League,2021,Southampton,Stuart Armstrong,SCO,MF,29,1992,16.4,27,19,15,6,6,9,23,39.1,14,10,1,9,8,35,15,0,2022
ENG-Premier League,2021,Southampton,Theo Walcott,ENG,"MF,FW",32,1989,4.2,4,2,2,0,2,1,5,20.0,4,3,0,3,5,9,2,0,2022
ENG-Premier League,2021,Southampton,Valentino Livramento,ENG,DF,18,2002,24.5,54,28,30,18,6,27,45,60.0,18,23,9,14,47,101,50,1,2022
ENG-Premier League,2021,Southampton,William Smallbone,IRL,"MF,FW",21,2000,1.5,4,4,2,2,0,1,3,33.3,2,4,0,4,2,6,0,0,2022
ENG-Premier League,2021,Southampton,Willy Caballero,ARG,GK,39,1981,2.0,0,0,0,0,0,0,0,,0,0,0,0,0,0,2,1,2022
ENG-Premier League,2021,Southampton,Yan Valery,TUN,DF,22,1999,4.1,8,6,4,3,1,4,9,44.4,5,6,3,3,6,14,19,1,2022
ENG-Premier League,2021,Tottenham,Ben Davies,WAL,DF,28,1993,28.2,36,21,20,12,4,13,26,50.0,13,32,19,13,30,66,75,1,2022
ENG-Premier League,2021,Tottenham,Bryan,ESP,"FW,MF",20,2001,1.0,3,0,1,0,2,1,2,50.0,1,2,0,2,0,3,0,0,2022
ENG-Premier League,2021,Tottenham,Cristian Romero,ARG,DF,23,1998,20.5,62,39,39,21,2,22,34,64.7,12,46,21,25,33,95,74,1,2022
ENG-Premier League,2021,Tottenham,Dane Scarlett,ENG,MF,17,2004,0.0,0,0,0,0,0,0,0,,0,0,0,0,0,0,0,0,2022
ENG-Premier League,2021,Tottenham,Davinson Sánchez,COL,DF,25,1996,18.1,41,22,25,14,2,19,28,67.9,9,24,16,8,30,71,54,3,2022
ENG-Premier League,2021,Tottenham,Dejan Kulusevski,SWE,"MF,FW",21,2000,14.0,19,13,7,10,2,5,23,21.7,18,14,0,14,13,32,3,0,2022
ENG-Premier League,2021,Tottenham,Dele Alli,ENG,MF,25,1996,7.3,14,8,10,3,1,5,17,29.4,12,22,5,17,6,20,16,0,2022
ENG-Premier League,2021,Tottenham,Emerson,BRA,"DF,MF",22,1999,25.4,72,47,50,16,6,36,67,53.7,31,25,2,23,22,94,92,1,2022
ENG-Premier League,2021,Tottenham,Eric Dier,ENG,DF,27,1994,34.1,15,9,6,8,1,7,14,50.0,7,37,32,5,27,42,142,1,2022
ENG-Premier League,2021,Tottenham,Giovani Lo Celso,ARG,"MF,FW",25,1996,2.6,8,4,4,2,2,4,10,40.0,6,6,1,5,1,9,0,1,2022
ENG-Premier League,2021,Tottenham,Harry Kane,ENG,FW,28,1993,35.9,15,5,2,10,3,7,18,38.9,11,26,8,18,3,18,39,0,2022
ENG-Premier League,2021,Tottenham,Harry Winks,ENG,MF,25,1996,10.1,15,10,4,9,2,8,21,38.1,13,14,3,11,16,31,10,2,2022
ENG-Premier League,2021,Tottenham,Hugo Lloris,FRA,GK,34,1986,38.0,1,1,1,0,0,1,2,50.0,1,0,0,0,1,2,24,3,2022
ENG-Premier League,2021,Tottenham,Japhet Tanganga,ENG,DF,22,1999,8.2,14,8,7,6,1,9,19,47.4,10,13,5,8,9,23,31,0,2022
ENG-Premier League,2021,Tottenham,Joe Rodon,WAL,DF,23,1997,1.0,0,0,0,0,0,0,0,,0,2,1,1,0,0,7,0,2022
ENG-Premier League,2021,Tottenham,Lucas Moura,BRA,"FW,MF",28,1992,19.7,25,10,7,14,4,8,35,22.9,27,19,0,19,18,43,19,0,2022
ENG-Premier League,2021,Tottenham,Matt Doherty,IRL,DF,29,1992,9.7,18,12,5,11,2,8,14,57.1,6,11,2,9,13,31,20,0,2022
ENG-Premier League,2021,Tottenham,Oliver Skipp,ENG,MF,20,2000,15.0,33,19,14,18,1,15,31,48.4,16,19,7,12,12,45,10,1,2022
ENG-Premier League,2021,Tottenham,Pierre Højbjerg,DEN,MF,25,1995,35.5,78,45,31,38,9,38,85,44.7,47,61,13,48,48,126,54,0,2022
ENG-Premier League,2021,Tottenham,Rodrigo Bentancur,URU,MF,24,1997,15.1,36,18,14,14,8,16,32,50.0,16,24,9,15,20,56,35,0,2022
ENG-Premier League,2021,Tottenham,Ryan Sessegnon,ENG,"DF,MF",21,2000,11.6,25,19,14,7,4,11,22,50.0,11,18,3,15,7,32,26,0,2022
ENG-Premier League,2021,Tottenham,Sergio Reguilón,ESP,"DF,MF",24,1996,21.3,40,24,15,18,7,22,43,51.2,21,20,8,12,31,71,45,1,2022
ENG-Premier League,2021,Tottenham,Son Heung-min,KOR,"MF,FW",29,1992,33.4,15,6,5,7,3,5,23,21.7,18,27,6,21,13,28,8,0,2022
ENG-Premier League,2021,Tottenham,Steven Bergwijn,NED,"FW,MF",23,1997,6.3,3,2,2,1,0,1,10,10.0,9,3,0,3,1,4,8,0,2022
ENG-Premier League,2021,Tottenham,Tanguy Ndombele,FRA,MF,24,1996,5.4,10,7,3,5,2,1,8,12.5,7,5,0,5,1,11,1,0,2022
ENG-Premier League,2021,Watford,Adam Masina,MAR,DF,27,1994,12.0,24,13,11,10,3,12,29,41.4,17,18,6,12,18,42,45,0,2022
ENG-Premier League,2021,Watford,Ashley Fletcher,ENG,FW,25,1995,0.3,2,1,1,1,0,1,1,100.0,0,1,1,0,0,2,0,0,2022
ENG-Premier League,2021,Watford,Ben Foster,ENG,GK,38,1983,26.0,0,0,0,0,0,0,3,0.0,3,0,0,0,0,0,9,4,2022
ENG-Premier League,2021,Watford,Christian Kabasele,BEL,DF,30,1991,13.3,11,5,10,1,0,7,10,70.0,3,20,16,4,14,25,67,1,2022
ENG-Premier League,2021,Watford,Craig Cathcart,NIR,DF,32,1989,26.6,32,15,25,6,1,16,30,53.3,14,39,29,10,28,60,132,3,2022
ENG-Premier League,2021,Watford,Cucho,COL,"FW,MF",22,1999,12.7,13,5,5,5,3,5,27,18.5,22,13,1,12,5,18,9,0,2022
ENG-Premier League,2021,Watford,Dan Gosling,ENG,MF,31,1990,1.8,2,1,1,1,0,2,6,33.3,4,2,0,2,0,2,3,0,2022
ENG-Premier League,2021,Watford,Daniel Bachmann,AUT,GK,27,1994,12.0,0,0,0,0,0,0,0,,0,0,0,0,1,1,5,0,2022
ENG-Premier League,2021,Watford,Danny Rose,ENG,DF,31,1990,7.7,16,10,11,4,1,10,24,41.7,14,8,5,3,14,30,11,1,2022
ENG-Premier League,2021,Watford,Edo Kayembe,COD,MF,23,1998,8.9,21,13,11,9,1,8,16,50.0,8,6,1,5,9,30,13,0,2022
ENG-Premier League,2021,Watford,Emmanuel Dennis,NGA,"FW,MF",23,1997,28.7,51,35,20,22,9,17,52,32.7,35,36,2,34,15,66,13,0,2022
ENG-Premier League,2021,Watford,Francisco Sierralta,CHI,DF,24,1997,4.7,7,3,7,0,0,5,8,62.5,3,7,2,5,6,13,35,0,2022
ENG-Premier League,2021,Watford,Hassane Kamara,CIV,DF,27,1994,18.0,53,34,31,16,6,27,43,62.8,16,20,4,16,69,122,67,0,2022
ENG-Premier League,2021,Watford,Imran Louza,MAR,MF,22,1999,15.7,41,21,18,20,3,16,38,42.1,22,28,6,22,42,83,20,1,2022
ENG-Premier League,2021,Watford,Ismaila Sarr,SEN,"FW,MF",23,1998,20.7,12,7,4,3,5,5,19,26.3,14,10,1,9,9,21,10,0,2022
ENG-Premier League,2021,Watford,Jeremy Ngakia,ENG,DF,20,2000,10.0,31,18,23,5,3,11,26,42.3,15,11,4,7,12,43,32,0,2022
ENG-Premier League,2021,Watford,Joshua King,NOR,FW,29,1992,25.0,19,15,7,6,6,4,17,23.5,13,15,4,11,8,27,31,0,2022
ENG-Premier League,2021,Watford,João Pedro,BRA,"FW,MF",19,2001,18.3,20,14,7,8,5,6,23,26.1,17,23,3,20,15,35,17,0,2022
ENG-Premier League,2021,Watford,Juraj Kucka,SVK,MF,34,1987,21.3,59,39,32,25,2,27,73,37.0,46,30,9,21,27,86,46,2,2022
ENG-Premier League,2021,Watford,Ken Sema,SWE,"MF,FW",27,1993,9.5,16,6,11,4,1,9,20,45.0,11,10,0,10,5,21,11,0,2022
ENG-Premier League,2021,Watford,Kiko Femenía,ESP,DF,30,1991,23.8,35,22,23,10,2,21,37,56.8,16,24,8,16,37,72,51,0,2022
ENG-Premier League,2021,Watford,Moussa Sissoko,FRA,MF,31,1989,35.8,53,27,27,20,6,28,42,66.7,14,42,13,29,30,83,64,0,2022
ENG-Premier League,2021,Watford,Nicolas Nkoulou,CMR,DF,31,1990,1.9,1,0,0,1,0,0,0,,0,2,1,1,2,3,8,0,2022
ENG-Premier League,2021,Watford,Oghenekaro Etebo,NGA,MF,25,1995,4.5,11,8,7,4,0,3,8,37.5,5,3,1,2,5,16,5,0,2022
ENG-Premier League,2021,Watford,Ozan Tufan,TUR,MF,26,1995,3.7,3,2,1,1,1,1,5,20.0,4,2,0,2,2,5,4,0,2022
ENG-Premier League,2021,Watford,Samir Santos,BRA,DF,26,1994,18.6,24,11,18,6,0,8,19,42.1,11,21,11,10,43,67,85,3,2022
ENG-Premier League,2021,Watford,Samuel Kalu,NGA,FW,23,1997,2.5,2,2,0,2,0,1,1,100.0,0,2,0,2,3,5,3,0,2022
ENG-Premier League,2021,Watford,Tom Cleverley,ENG,MF,31,1989,18.0,37,20,19,17,1,18,33,54.5,15,23,6,17,18,55,19,3,2022
ENG-Premier League,2021,Watford,Troy Deeney,ENG,FW,33,1988,0.3,0,0,0,0,0,0,1,0.0,1,0,0,0,0,0,2,0,2022
ENG-Premier League,2021,Watford,William Troost-Ekong,NGA,DF,27,1993,15.4,18,9,11,6,1,10,15,66.7,5,24,14,10,7,25,82,1,2022
ENG-Premier League,2021,West Ham,Aaron Cresswell,ENG,DF,31,1989,30.3,28,18,18,6,4,13,25,52.0,12,31,18,13,35,63,66,0,2022
ENG-Premier League,2021,West Ham,Alex Král,CZE,MF,23,1998,0.0,0,0,0,0,0,0,0,,0,0,0,0,0,0,0,0,2022
ENG-Premier League,2021,West Ham,Alphonse Areola,FRA,GK,28,1993,1.0,0,0,0,0,0,0,0,,0,0,0,0,0,0,1,0,2022
ENG-Premier League,2021,West Ham,Andriy Yarmolenko,UKR,"FW,MF",31,1989,3.5,4,2,2,2,0,2,8,25.0,6,4,2,2,0,4,2,0,2022
ENG-Premier League,2021,West Ham,Angelo Ogbonna,ITA,DF,33,1988,10.2,7,4,5,2,0,3,7,42.9,4,5,4,1,11,18,29,0,2022
ENG-Premier League,2021,West Ham,Arthur Masuaku,COD,"DF,FW",27,1993,7.2,31,23,19,11,1,14,23,60.9,9,9,1,8,9,40,17,0,2022
ENG-Premier League,2021,West Ham,Ben Johnson,ENG,DF,21,2000,15.5,33,16,15,15,3,21,28,75.0,7,16,8,8,22,55,55,0,2022
ENG-Premier League,2021,West Ham,Craig Dawson,ENG,DF,31,1990,30.6,29,17,20,8,1,14,25,56.0,11,59,52,7,29,58,139,0,2022
ENG-Premier League,2021,West Ham,Daniel Chesters,ENG,MF,19,2002,0.0,0,0,0,0,0,0,0,,0,0,0,0,0,0,0,0,2022
ENG-Premier League,2021,West Ham,Declan Rice,ENG,MF,22,1999,35.3,80,42,45,32,3,38,71,53.5,33,45,21,24,63,143,52,1,2022
ENG-Premier League,2021,West Ham,Harrison Ashby,SCO,DF,19,2001,0.1,0,0,0,0,0,0,0,,0,1,0,1,1,1,1,0,2022
ENG-Premier League,2021,West Ham,Issa Diop,FRA,DF,24,1997,10.7,10,8,5,5,0,4,11,36.4,7,14,13,1,7,17,44,0,2022
ENG-Premier League,2021,West Ham,Jarrod Bowen,ENG,FW,24,1996,33.1,36,20,20,11,5,17,44,38.6,27,29,2,27,21,57,14,0,2022
ENG-Premier League,2021,West Ham,Kurt Zouma,FRA,DF,26,1994,23.1,11,6,8,3,0,4,7,57.1,3,31,26,5,34,45,132,0,2022
ENG-Premier League,2021,West Ham,Manuel Lanzini,ARG,"MF,FW",28,1993,19.8,28,15,10,11,7,10,35,28.6,25,16,0,16,19,47,10,0,2022
ENG-Premier League,2021,West Ham,Mark Noble,ENG,MF,34,1987,3.7,8,2,7,1,0,5,11,45.5,6,4,1,3,4,12,2,1,2022
ENG-Premier League,2021,West Ham,Michail Antonio,JAM,FW,31,1990,33.0,23,17,5,9,9,7,18,38.9,11,19,1,18,3,26,13,0,2022
ENG-Premier League,2021,West Ham,Nikola Vlašić,CRO,"FW,MF",23,1997,6.2,11,7,4,6,1,5,20,25.0,15,4,0,4,2,13,1,0,2022
ENG-Premier League,2021,West Ham,Pablo Fornals,ESP,"FW,MF",25,1996,31.1,54,28,21,21,12,22,84,26.2,62,49,2,47,27,81,16,1,2022
ENG-Premier League,2021,West Ham,Ryan Fredericks,ENG,DF,28,1992,3.4,2,2,2,0,0,0,1,0.0,1,2,1,1,4,6,6,0,2022
ENG-Premier League,2021,West Ham,Saïd Benrahma,ALG,"FW,MF",25,1995,24.1,28,17,16,9,3,15,38,39.5,23,17,1,16,9,37,8,0,2022
ENG-Premier League,2021,West Ham,Sonny Perkins,ENG,FW,17,2004,0.0,,0,,,,,,,,,,,0,,,,2022
ENG-Premier League,2021,West Ham,Tomáš Souček,CZE,MF,26,1995,34.0,66,32,27,33,6,28,65,43.1,37,34,13,21,52,118,98,1,2022
ENG-Premier League,2021,West Ham,Vladimír Coufal,CZE,DF,28,1992,24.5,45,25,24,14,7,18,36,50.0,18,31,9,22,22,67,64,1,2022
ENG-Premier League,2021,West Ham,Łukasz Fabiański,POL,GK,36,1985,37.0,0,0,0,0,0,0,0,,0,0,0,0,0,0,11,0,2022
ENG-Premier League,2021,Wolves,Adama Traoré,ESP,"FW,MF",25,1996,11.9,8,3,6,0,2,3,7,42.9,4,4,1,3,2,10,1,0,2022
ENG-Premier League,2021,Wolves,Chem Campbell,WAL,MF,18,2002,0.1,1,1,0,1,0,0,0,,0,0,0,0,0,1,0,0,2022
ENG-Premier League,2021,Wolves,Chiquinho,POR,"DF,FW",21,2000,2.3,9,6,4,5,0,4,5,80.0,1,5,0,5,2,11,1,0,2022
ENG-Premier League,2021,Wolves,Conor Coady,ENG,DF,28,1993,37.3,31,14,23,7,1,16,28,57.1,12,46,40,6,28,59,140,0,2022
ENG-Premier League,2021,Wolves,Daniel Podence,POR,"FW,MF",25,1995,16.5,18,11,10,5,3,4,17,23.5,13,8,1,7,10,28,1,0,2022
ENG-Premier League,2021,Wolves,Fernando Marçal,BRA,"MF,DF",32,1989,16.1,42,22,27,14,1,21,37,56.8,16,25,4,21,28,70,52,0,2022
ENG-Premier League,2021,Wolves,Francisco Trincão,POR,"FW,MF",21,1999,14.8,28,15,9,13,6,3,19,15.8,16,17,1,16,12,40,1,1,2022
ENG-Premier League,2021,Wolves,Fábio Silva,POR,FW,19,2002,6.4,3,2,0,2,1,0,8,0.0,8,2,0,2,1,4,1,0,2022
ENG-Premier League,2021,Wolves,Hwang Hee-chan,KOR,"FW,MF",25,1996,20.2,27,13,9,16,2,14,44,31.8,30,10,0,10,13,40,7,1,2022
ENG-Premier League,2021,Wolves,John Ruddy,ENG,GK,34,1986,1.5,0,0,0,0,0,0,0,,0,0,0,0,0,0,3,0,2022
ENG-Premier League,2021,Wolves,Jonny Castro,ESP,DF,27,1994,11.4,25,15,13,11,1,11,20,55.0,9,14,3,11,13,38,11,0,2022
ENG-Premier League,2021,Wolves,José Sá,POR,GK,28,1993,36.5,2,1,2,0,0,2,4,50.0,2,0,0,0,2,4,19,5,2022
ENG-Premier League,2021,Wolves,João Moutinho,POR,MF,34,1986,33.0,74,39,34,27,13,30,106,28.3,76,48,8,40,34,108,36,2,2022
ENG-Premier League,2021,Wolves,Ki-Jana Hoever,NED,"DF,MF",19,2002,3.4,10,6,5,5,0,7,12,58.3,5,6,0,6,6,16,8,0,2022
ENG-Premier League,2021,Wolves,Leander Dendoncker,BEL,MF,26,1995,21.7,42,17,25,14,3,22,50,44.0,28,37,10,27,9,51,38,1,2022
ENG-Premier League,2021,Wolves,Luke Cundle,ENG,MF,19,2002,2.0,4,3,0,4,0,1,1,100.0,0,0,0,0,1,5,1,0,2022
ENG-Premier League,2021,Wolves,Max Kilman,ENG,DF,24,1997,29.9,50,26,38,10,2,24,37,64.9,13,36,21,15,45,95,113,3,2022
ENG-Premier League,2021,Wolves,Morgan Gibbs-White,ENG,"DF,FW",21,2000,0.1,0,0,0,0,0,0,0,,0,1,0,1,0,0,0,0,2022
ENG-Premier League,2021,Wolves,Nélson Semedo,POR,"MF,DF",27,1993,23.7,58,39,39,17,2,25,49,51.0,24,23,4,19,21,79,64,1,2022
ENG-Premier League,2021,Wolves,Pedro Neto,POR,"FW,MF",21,2000,5.2,4,4,2,0,2,0,9,0.0,9,0,0,0,6,10,1,0,2022
ENG-Premier League,2021,Wolves,Rayan Aït Nouri,ALG,"DF,MF",20,2001,20.3,64,36,46,15,3,22,44,50.0,22,24,2,22,22,86,39,1,2022
ENG-Premier League,2021,Wolves,Raúl Jiménez,MEX,FW,30,1991,29.2,29,14,6,16,7,6,30,20.0,24,31,5,26,13,42,26,0,2022
ENG-Premier League,2021,Wolves,Romain Saïss,MAR,DF,31,1990,30.1,40,27,28,11,1,19,33,57.6,14,41,21,20,58,98,158,2,2022
ENG-Premier League,2021,Wolves,Rúben Neves,POR,MF,24,1997,29.6,68,37,23,41,4,24,87,27.6,63,39,5,34,41,109,49,3,2022
ENG-Premier League,2021,Wolves,Toti Gomes,POR,DF,22,1999,4.0,11,7,10,1,0,7,9,77.8,2,6,3,3,8,19,15,0,2022
ENG-Premier League,2021,Wolves,Willy Boly,CIV,DF,30,1991,10.0,25,19,18,7,0,8,15,53.3,7,14,6,8,14,39,35,0,2022
ENG-Premier League,2022,Arsenal,Aaron Ramsdale,ENG,GK,24,1998,38.0,1,1,1,0,0,1,1,100.0,0,0,0,0,0,1,20,6,2023
ENG-Premier League,2022,Arsenal,Albert Sambi Lokonga,BEL,MF,22,1999,2.2,1,1,0,0,1,0,2,0.0,2,1,0,1,5,6,2,0,2023
ENG-Premier League,2022,Arsenal,Ben White,ENG,DF,24,1997,33.9,60,31,23,30,7,42,70,60.0,28,47,11,36,22,82,79,1,2023
ENG-Premier League,2022,Arsenal,Bukayo Saka,ENG,FW,20,2001,35.3,63,34,22,15,26,20,44,45.5,24,38,0,38,14,77,19,0,2023
ENG-Premier League,2022,Arsenal,Cédric Soares,POR,DF,30,1991,0.3,0,0,0,0,0,0,1,0.0,1,1,0,1,0,0,1,0,2023
ENG-Premier League,2022,Arsenal,Eddie Nketiah,ENG,FW,23,1999,12.1,13,9,6,2,5,2,8,25.0,6,7,1,6,1,14,7,0,2023
ENG-Premier League,2022,Arsenal,Emile Smith Rowe,ENG,"MF,FW",22,2000,1.9,1,1,1,0,0,1,3,33.3,2,1,0,1,0,1,2,0,2023
ENG-Premier League,2022,Arsenal,Ethan Nwaneri,ENG,FW,15,2007,0.0,0,0,0,0,0,0,0,,0,1,0,1,0,0,0,0,2023
ENG-Premier League,2022,Arsenal,Fabio Vieira,POR,"MF,FW",22,2000,5.7,6,4,3,0,3,3,5,60.0,2,5,0,5,4,10,2,0,2023
ENG-Premier League,2022,Arsenal,Gabriel Dos Santos,BRA,DF,24,1997,37.9,48,30,29,15,4,18,27,66.7,9,49,26,23,32,80,125,2,2023
ENG-Premier League,2022,Arsenal,Gabriel Jesus,BRA,FW,25,1997,22.9,33,25,16,8,9,15,31,48.4,16,27,3,24,11,44,15,1,2023
ENG-Premier League,2022,Arsenal,Granit Xhaka,SUI,MF,29,1992,33.3,34,27,11,18,5,16,41,39.0,25,28,10,18,15,49,45,1,2023
ENG-Premier League,2022,Arsenal,Jakub Kiwior,POL,DF,22,2000,4.7,7,5,6,1,0,5,8,62.5,3,5,3,2,6,13,10,0,2023
ENG-Premier League,2022,Arsenal,Jorginho,ITA,MF,30,1991,9.5,18,13,6,10,2,5,24,20.8,19,7,2,5,9,27,8,0,2023
ENG-Premier League,2022,Arsenal,Kieran Tierney,SCO,DF,25,1997,8.8,20,11,9,9,2,12,16,75.0,4,8,2,6,11,31,25,0,2023
ENG-Premier League,2022,Arsenal,Leandro Trossard,BEL,FW,27,1994,10.3,12,7,4,2,6,6,18,33.3,12,18,0,18,6,18,3,1,2023
ENG-Premier League,2022,Arsenal,Marquinhos,BRA,MF,19,2003,0.0,0,0,0,0,0,0,0,,0,0,0,0,0,0,0,0,2023
ENG-Premier League,2022,Arsenal,Martin Ødegaard,NOR,MF,23,1998,34.7,36,23,12,14,10,14,47,29.8,33,20,5,15,6,42,12,1,2023
ENG-Premier League,2022,Arsenal,Martinelli,BRA,FW,21,2001,31.0,31,18,13,12,6,9,22,40.9,13,24,1,23,9,40,14,0,2023
ENG-Premier League,2022,Arsenal,Mohamed Elneny,EGY,MF,30,1992,1.3,1,1,1,0,0,1,1,100.0,0,0,0,0,0,1,0,0,2023
ENG-Premier League,2022,Arsenal,Oleksandr Zinchenko,UKR,DF,25,1996,23.5,40,18,14,17,9,21,39,53.8,18,20,2,18,22,62,38,2,2023
ENG-Premier League,2022,Arsenal,Reiss Nelson,ENG,FW,22,1999,2.4,4,1,2,1,1,2,4,50.0,2,3,0,3,0,4,4,0,2023
ENG-Premier League,2022,Arsenal,Rob Holding,ENG,DF,26,1995,6.3,8,5,4,4,0,3,6,50.0,3,6,5,1,3,11,27,1,2023
ENG-Premier League,2022,Arsenal,Takehiro Tomiyasu,JPN,DF,23,1998,7.4,27,18,12,10,5,13,18,72.2,5,7,0,7,14,41,15,1,2023
ENG-Premier League,2022,Arsenal,Thomas Partey,GHA,MF,29,1993,27.6,70,40,20,35,15,25,52,48.1,27,26,5,21,28,98,41,1,2023
ENG-Premier League,2022,Arsenal,William Saliba,FRA,DF,21,2001,26.8,34,20,23,9,2,15,18,83.3,3,13,10,3,19,53,85,4,2023
ENG-Premier League,2022,Aston Villa,Ashley Young,ENG,DF,37,1985,22.6,50,27,34,15,1,37,49,75.5,12,25,11,14,21,71,65,0,2023
ENG-Premier League,2022,Aston Villa,Bertrand Traoré,BFA,"FW,MF",26,1995,2.6,1,1,1,0,0,1,4,25.0,3,5,0,5,2,3,0,0,2023
ENG-Premier League,2022,Aston Villa,Boubacar Kamara,FRA,MF,22,1999,19.7,58,25,25,23,10,27,56,48.2,29,38,12,26,19,77,24,2,2023
ENG-Premier League,2022,Aston Villa,Calum Chambers,ENG,"DF,MF",27,1995,3.9,9,6,7,2,0,6,8,75.0,2,5,4,1,7,16,10,1,2023
ENG-Premier League,2022,Aston Villa,Cameron Archer,ENG,"FW,MF",21,2001,0.5,0,0,0,0,0,0,0,,0,0,0,0,0,0,0,0,2023
ENG-Premier League,2022,Aston Villa,Danny Ings,ENG,FW,30,1992,9.2,10,5,1,6,3,1,6,16.7,5,12,1,11,1,11,11,0,2023
ENG-Premier League,2022,Aston Villa,Diego Carlos,BRA,DF,29,1993,2.3,1,0,0,1,0,0,1,0.0,1,2,2,0,1,2,2,0,2023
ENG-Premier League,2022,Aston Villa,Douglas Luiz,BRA,MF,24,1998,32.5,73,42,31,32,10,30,63,47.6,33,36,7,29,40,113,27,2,2023
ENG-Premier League,2022,Aston Villa,Emi Buendía,ARG,"MF,FW",25,1996,26.8,52,23,20,20,12,21,74,28.4,53,20,2,18,20,72,17,0,2023
ENG-Premier League,2022,Aston Villa,Emiliano Martínez,ARG,GK,29,1992,34.9,0,0,0,0,0,0,2,0.0,2,0,0,0,1,1,23,1,2023
ENG-Premier League,2022,Aston Villa,Ezri Konsa,ENG,DF,24,1997,36.9,42,20,25,15,2,18,26,69.2,8,41,23,18,26,68,120,3,2023
ENG-Premier League,2022,Aston Villa,Jacob Ramsey,ENG,"MF,FW",21,2001,29.3,69,39,23,35,11,32,69,46.4,37,48,8,40,23,92,34,0,2023
ENG-Premier League,2022,Aston Villa,Jan Bednarek,POL,DF,26,1996,1.1,3,3,0,3,0,1,1,100.0,0,3,1,2,2,5,5,0,2023
ENG-Premier League,2022,Aston Villa,Jhon Durán,COL,"FW,MF",18,2003,1.5,2,2,0,1,1,1,4,25.0,3,0,0,0,2,4,2,0,2023
ENG-Premier League,2022,Aston Villa,John McGinn,SCO,"MF,FW",27,1994,29.9,66,36,27,29,10,34,71,47.9,37,43,4,39,24,90,19,0,2023
ENG-Premier League,2022,Aston Villa,Leander Dendoncker,BEL,MF,27,1995,7.7,19,9,11,6,2,11,21,52.4,10,19,4,15,10,29,12,0,2023
ENG-Premier League,2022,Aston Villa,Leon Bailey,JAM,"FW,MF",24,1997,21.9,14,6,6,7,1,5,20,25.0,15,13,0,13,6,20,12,0,2023
ENG-Premier League,2022,Aston Villa,Lucas Digne,FRA,DF,29,1993,16.7,30,12,20,9,1,20,33,60.6,13,18,5,13,18,48,45,0,2023
ENG-Premier League,2022,Aston Villa,Ludwig Augustinsson,SWE,DF,28,1994,0.9,1,1,1,0,0,0,0,,0,0,0,0,0,1,1,0,2023
ENG-Premier League,2022,Aston Villa,Matty Cash,POL,DF,24,1997,20.2,55,32,36,15,4,26,37,70.3,11,20,5,15,26,81,43,0,2023
ENG-Premier League,2022,Aston Villa,Morgan Sanson,FRA,MF,27,1994,0.1,2,1,1,1,0,1,1,100.0,0,0,0,0,0,2,0,0,2023
ENG-Premier League,2022,Aston Villa,Ollie Watkins,ENG,FW,26,1995,34.7,19,13,3,13,3,10,27,37.0,17,21,4,17,10,29,39,0,2023
ENG-Premier League,2022,Aston Villa,Philippe Coutinho,BRA,"MF,FW",30,1992,8.8,19,14,8,8,3,9,15,60.0,6,11,1,10,4,23,2,0,2023
ENG-Premier League,2022,Aston Villa,Robin Olsen,SWE,GK,32,1990,3.1,0,0,0,0,0,0,2,0.0,2,0,0,0,0,0,1,0,2023
ENG-Premier League,2022,Aston Villa,Tyrone Mings,ENG,DF,29,1993,35.0,15,7,10,5,0,9,20,45.0,11,40,21,19,54,69,163,2,2023
ENG-Premier League,2022,Aston Villa,Álex Moreno,ESP,DF,29,1993,14.8,23,14,15,5,3,13,36,36.1,23,18,3,15,7,30,37,2,2023
ENG-Premier League,2022,Bournemouth,Adam Smith,ENG,DF,31,1991,32.7,49,29,27,19,3,29,60,48.3,31,30,13,17,25,74,81,1,2023
ENG-Premier League,2022,Bournemouth,Antoine Semenyo,GHA,"FW,MF",22,2000,2.9,1,0,0,0,1,1,6,16.7,5,10,1,9,2,3,4,0,2023
ENG-Premier League,2022,Bournemouth,Ben Pearson,ENG,MF,27,1995,3.2,7,3,3,3,1,1,3,33.3,2,4,0,4,2,9,6,0,2023
ENG-Premier League,2022,Bournemouth,Chris Mepham,WAL,DF,24,1997,24.4,45,22,37,8,0,19,30,63.3,11,40,27,13,30,75,152,0,2023
ENG-Premier League,2022,Bournemouth,Dango Ouattara,BFA,"MF,FW",20,2002,13.8,28,15,20,6,2,13,32,40.6,19,20,3,17,13,41,29,1,2023
ENG-Premier League,2022,Bournemouth,David Brooks,WAL,"FW,MF",25,1997,1.9,1,0,1,0,0,0,1,0.0,1,2,0,2,2,3,5,0,2023
ENG-Premier League,2022,Bournemouth,Dominic Solanke,ENG,"FW,MF",24,1997,31.8,15,9,8,3,4,5,22,22.7,17,26,7,19,6,21,46,0,2023
ENG-Premier League,2022,Bournemouth,Emiliano Marcondes,DEN,MF,27,1995,0.1,0,0,0,0,0,0,0,,0,0,0,0,0,0,1,0,2023
ENG-Premier League,2022,Bournemouth,Hamed Junior Traorè,CIV,"FW,MF",22,2000,4.7,17,11,5,9,3,6,18,33.3,12,9,0,9,2,19,1,0,2023
ENG-Premier League,2022,Bournemouth,Illia Zabarnyi,UKR,DF,19,2002,3.3,4,2,4,0,0,3,7,42.9,4,7,2,5,3,7,14,0,2023
ENG-Premier League,2022,Bournemouth,Jack Stacey,ENG,DF,26,1996,3.3,5,4,3,1,1,2,5,40.0,3,3,1,2,5,10,15,0,2023
ENG-Premier League,2022,Bournemouth,Jack Stephens,ENG,DF,28,1994,13.0,15,11,10,4,1,6,10,60.0,4,23,16,7,16,31,53,0,2023
ENG-Premier League,2022,Bournemouth,Jaidon Anthony,ENG,"MF,FW",22,1999,14.0,30,17,15,9,6,8,24,33.3,16,30,3,27,10,40,19,0,2023
ENG-Premier League,2022,Bournemouth,Jamal Lowe,JAM,"MF,FW",28,1994,0.1,0,0,0,0,0,0,0,,0,0,0,0,0,0,0,0,2023
ENG-Premier League,2022,Bournemouth,Jefferson Lerma,COL,MF,27,1994,36.1,50,30,23,23,4,20,45,44.4,25,32,15,17,47,97,91,1,2023
ENG-Premier League,2022,Bournemouth,Joe Rothwell,ENG,MF,27,1995,11.3,20,13,7,12,1,7,21,33.3,14,14,3,11,9,29,7,0,2023
ENG-Premier League,2022,Bournemouth,Jordan Zemura,ZIM,DF,22,1999,16.2,39,24,24,14,1,23,43,53.5,20,31,9,22,16,55,32,0,2023
ENG-Premier League,2022,Bournemouth,Junior Stanislas,ENG,MF,32,1989,0.7,0,0,0,0,0,0,0,,0,2,1,1,0,0,0,0,2023
ENG-Premier League,2022,Bournemouth,Kieffer Moore,WAL,FW,29,1992,14.2,14,11,2,9,3,5,16,31.3,11,12,5,7,1,15,26,0,2023
ENG-Premier League,2022,Bournemouth,Lewis Cook,ENG,MF,25,1997,19.1,37,22,10,22,5,18,42,42.9,24,29,10,19,23,60,31,0,2023
ENG-Premier League,2022,Bournemouth,Lloyd Kelly,ENG,DF,23,1998,22.7,33,18,23,9,1,13,19,68.4,6,26,15,11,26,59,101,1,2023
ENG-Premier League,2022,Bournemouth,Marcos Senesi,ARG,DF,25,1997,27.7,50,35,28,22,0,23,43,53.5,20,38,20,18,43,93,146,2,2023
ENG-Premier League,2022,Bournemouth,Marcus Tavernier,ENG,"MF,FW",23,1999,19.4,33,22,19,11,3,11,32,34.4,21,25,4,21,9,42,23,0,2023
ENG-Premier League,2022,Bournemouth,Mark Travers,IRL,GK,23,1999,11.5,0,0,0,0,0,0,0,,0,1,0,1,0,0,6,0,2023
ENG-Premier League,2022,Bournemouth,Matías Viña,URU,DF,24,1997,5.1,19,11,9,8,2,14,30,46.7,16,13,1,12,4,23,22,0,2023
ENG-Premier League,2022,Bournemouth,Neto,BRA,GK,33,1989,26.5,3,1,3,0,0,3,3,100.0,0,0,0,0,0,3,10,3,2023
ENG-Premier League,2022,Bournemouth,Owen Bevan,WAL,DF,18,2003,0.1,0,0,0,0,0,0,0,,0,0,0,0,0,0,0,0,2023
ENG-Premier League,2022,Bournemouth,Philip Billing,DEN,"MF,FW",26,1996,30.7,63,36,21,33,9,11,40,27.5,29,48,8,40,31,94,58,1,2023
ENG-Premier League,2022,Bournemouth,Ryan Christie,SCO,"MF,FW",27,1995,20.4,34,22,10,23,1,14,49,28.6,35,16,4,12,26,60,20,0,2023
ENG-Premier League,2022,Bournemouth,Ryan Fredericks,ENG,DF,29,1992,5.9,3,2,2,0,1,1,4,25.0,3,7,2,5,1,4,27,0,2023
ENG-Premier League,2022,Bournemouth,Siriki Dembélé,CIV,"FW,MF",25,1996,1.2,3,1,2,1,0,0,1,0.0,1,1,0,1,1,4,1,0,2023
ENG-Premier League,2022,Brentford,Aaron Hickey,SCO,DF,20,2002,21.3,38,26,27,11,0,18,32,56.3,14,18,7,11,17,55,32,1,2023
ENG-Premier League,2022,Brentford,Ben Mee,ENG,DF,32,1989,36.3,45,24,28,13,4,20,37,54.1,17,54,42,12,48,93,122,1,2023
ENG-Premier League,2022,Brentford,Bryan Mbeumo,CMR,FW,22,1999,32.3,26,18,5,13,8,8,42,19.0,34,24,1,23,13,39,21,0,2023
ENG-Premier League,2022,Brentford,Christian Nørgaard,DEN,MF,28,1994,19.6,52,30,21,29,2,18,48,37.5,30,32,9,23,34,86,41,2,2023
ENG-Premier League,2022,Brentford,David Raya,ESP,GK,26,1995,38.0,0,0,0,0,0,0,2,0.0,2,1,0,1,1,1,10,2,2023
ENG-Premier League,2022,Brentford,Ethan Pinnock,JAM,DF,29,1993,30.0,52,28,33,12,7,18,24,75.0,6,41,31,10,35,87,215,2,2023
ENG-Premier League,2022,Brentford,Frank Onyeka,NGA,MF,24,1998,9.4,19,14,11,7,1,10,25,40.0,15,16,3,13,10,29,16,0,2023
ENG-Premier League,2022,Brentford,Halil Dervişoğlu,TUR,MF,22,1999,0.1,0,0,0,0,0,0,1,0.0,1,0,0,0,0,0,0,0,2023
ENG-Premier League,2022,Brentford,Ivan Toney,ENG,FW,26,1996,32.8,23,13,4,9,10,7,23,30.4,16,24,9,15,14,37,36,0,2023
ENG-Premier League,2022,Brentford,Josh Dasilva,ENG,MF,23,1998,15.4,18,9,6,6,6,6,16,37.5,10,22,6,16,5,23,7,1,2023
ENG-Premier League,2022,Brentford,Keane Lewis-Potter,ENG,"FW,MF",21,2001,3.6,1,0,0,1,0,0,0,,0,5,1,4,0,1,2,0,2023
ENG-Premier League,2022,Brentford,Kevin Schade,GER,FW,20,2001,8.1,12,8,7,2,3,5,10,50.0,5,7,0,7,4,16,6,0,2023
ENG-Premier League,2022,Brentford,Kristoffer Ajer,NOR,DF,24,1998,8.5,11,8,5,4,2,9,16,56.3,7,6,5,1,7,18,22,0,2023
ENG-Premier League,2022,Brentford,Mads Bech Sørensen,DEN,"DF,MF",23,1999,0.2,0,0,0,0,0,0,0,,0,0,0,0,1,1,1,0,2023
ENG-Premier League,2022,Brentford,Mads Roerslev,DEN,DF,23,1999,12.3,22,12,19,3,0,16,33,48.5,17,14,5,9,9,31,38,0,2023
ENG-Premier League,2022,Brentford,Mathias Jensen,DEN,MF,26,1996,31.1,70,35,28,30,12,34,97,35.1,63,54,5,49,32,102,24,1,2023
ENG-Premier League,2022,Brentford,Mathias Jørgensen,DEN,DF,32,1990,12.3,17,8,9,8,0,9,21,42.9,12,19,12,7,16,33,39,1,2023
ENG-Premier League,2022,Brentford,Mikkel Damsgaard,DEN,"MF,FW",22,2000,11.0,31,21,13,13,5,15,42,35.7,27,20,2,18,10,41,14,0,2023
ENG-Premier League,2022,Brentford,Pontus Jansson,SWE,DF,31,1991,8.0,5,3,4,1,0,3,5,60.0,2,13,9,4,9,14,38,0,2023
ENG-Premier League,2022,Brentford,Rico Henry,ENG,DF,25,1997,36.0,57,31,20,28,9,22,41,53.7,19,29,8,21,30,87,84,1,2023
ENG-Premier League,2022,Brentford,Saman Ghoddos,IRN,"MF,FW",28,1993,1.5,2,1,0,1,1,1,3,33.3,2,5,1,4,4,6,2,0,2023
ENG-Premier League,2022,Brentford,Sergi Canós,ESP,"FW,DF",25,1997,0.9,0,0,0,0,0,0,2,0.0,2,3,1,2,0,0,1,0,2023
ENG-Premier League,2022,Brentford,Shandon Baptiste,GRN,MF,24,1998,6.9,15,9,6,6,3,7,17,41.2,10,10,2,8,7,22,10,0,2023
ENG-Premier League,2022,Brentford,Vitaly Janelt,GER,"MF,DF",24,1998,24.5,54,27,20,24,10,21,49,42.9,28,29,9,20,29,83,26,0,2023
ENG-Premier League,2022,Brentford,Yoane Wissa,COD,FW,25,1996,17.8,17,12,4,7,6,6,13,46.2,7,10,0,10,6,23,15,0,2023
ENG-Premier League,2022,Brighton,Adam Lallana,ENG,"MF,FW",34,1988,8.0,9,4,6,2,1,0,7,0.0,7,6,0,6,2,11,1,0,2023
ENG-Premier League,2022,Brighton,Adam Webster,ENG,DF,27,1995,22.1,22,12,10,9,3,11,19,57.9,8,30,19,11,19,41,55,4,2023
ENG-Premier League,2022,Brighton,Alexis Mac Allister,ARG,MF,23,1998,32.1,70,39,22,40,8,34,70,48.6,36,26,2,24,22,92,10,1,2023
ENG-Premier League,2022,Brighton,Andrew Moran,IRL,FW,18,2003,0.1,0,0,0,0,0,0,0,,0,1,0,1,0,0,0,0,2023
ENG-Premier League,2022,Brighton,Billy Gilmour,SCO,MF,21,2001,5.6,5,2,2,2,1,2,8,25.0,6,5,2,3,6,11,5,0,2023
ENG-Premier League,2022,Brighton,Cameron Peupion,AUS,MF,19,2002,0.1,0,0,0,0,0,0,0,,0,0,0,0,0,0,0,0,2023
ENG-Premier League,2022,Brighton,Danny Welbeck,ENG,FW,31,1990,20.6,15,7,0,7,8,4,11,36.4,7,24,2,22,5,20,20,0,2023
ENG-Premier League,2022,Brighton,Deniz Undav,GER,"FW,MF",26,1996,7.0,7,4,2,2,3,2,8,25.0,6,4,1,3,0,7,1,0,2023
ENG-Premier League,2022,Brighton,Enock Mwepu,ZAM,"FW,MF",24,1998,2.4,10,5,1,6,3,3,4,75.0,1,3,1,2,1,11,1,0,2023
ENG-Premier League,2022,Brighton,Evan Ferguson,IRL,FW,17,2004,10.6,6,3,1,3,2,1,7,14.3,6,11,1,10,2,8,6,0,2023
ENG-Premier League,2022,Brighton,Facundo Buonanotte,ARG,"FW,MF",17,2004,6.3,2,1,1,1,0,1,22,4.5,21,5,2,3,4,6,3,0,2023
ENG-Premier League,2022,Brighton,Jack Hinshelwood,ENG,FW,17,2005,0.0,1,0,1,0,0,0,0,,0,0,0,0,0,1,0,0,2023
ENG-Premier League,2022,Brighton,Jan Paul van Hecke,NED,DF,22,2000,3.3,8,6,3,4,1,5,5,100.0,0,8,5,3,6,14,9,0,2023
ENG-Premier League,2022,Brighton,Jason Steele,ENG,GK,31,1990,15.0,0,0,0,0,0,0,1,0.0,1,0,0,0,0,0,6,1,2023
ENG-Premier League,2022,Brighton,Jeremy Sarmiento,ECU,MF,20,2002,2.0,6,3,4,1,1,2,5,40.0,3,2,0,2,1,7,0,0,2023
ENG-Premier League,2022,Brighton,Joël Veltman,NED,DF,30,1992,24.3,62,32,44,14,4,37,57,64.9,20,27,8,19,19,81,51,0,2023
ENG-Premier League,2022,Brighton,Julio César Enciso,PAR,"FW,MF",18,2004,9.0,13,4,3,6,4,8,13,61.5,5,9,0,9,4,17,2,0,2023
ENG-Premier League,2022,Brighton,Kaoru Mitoma,JPN,"FW,MF",25,1997,25.8,44,27,15,16,13,20,41,48.8,21,25,0,25,17,61,10,0,2023
ENG-Premier League,2022,Brighton,Leandro Trossard,BEL,"FW,MF",27,1994,14.6,10,6,7,1,2,1,8,12.5,7,17,0,17,6,16,1,0,2023
ENG-Premier League,2022,Brighton,Levi Colwill,ENG,DF,19,2003,13.6,8,7,4,4,0,4,9,44.4,5,5,3,2,15,23,37,1,2023
ENG-Premier League,2022,Brighton,Lewis Dunk,ENG,DF,30,1991,36.0,30,19,19,9,2,18,41,43.9,23,37,27,10,34,64,81,1,2023
ENG-Premier League,2022,Brighton,Moisés Caicedo,ECU,MF,20,2001,34.9,100,50,41,47,12,40,68,58.8,28,43,7,36,56,156,31,3,2023
ENG-Premier League,2022,Brighton,Odeluga Offiah,ENG,DF,19,2002,0.3,1,1,1,0,0,0,2,0.0,2,0,0,0,0,1,1,0,2023
ENG-Premier League,2022,Brighton,Pascal Groß,GER,"MF,DF",31,1991,36.0,59,38,23,27,9,25,55,45.5,30,32,10,22,13,72,21,1,2023
ENG-Premier League,2022,Brighton,Pervis Estupiñán,ECU,DF,24,1998,29.7,61,31,36,19,6,35,60,58.3,25,30,8,22,37,98,37,1,2023
ENG-Premier League,2022,Brighton,Robert Sánchez,ESP,GK,24,1997,23.0,1,0,1,0,0,0,0,,0,0,0,0,3,4,9,2,2023
ENG-Premier League,2022,Brighton,Solly March,ENG,"FW,DF",28,1994,30.2,53,31,16,17,20,8,28,28.6,20,34,3,31,24,77,32,0,2023
ENG-Premier League,2022,Brighton,Tariq Lamptey,GHA,DF,21,2000,5.0,11,6,6,4,1,5,7,71.4,2,7,3,4,7,18,2,0,2023
ENG-Premier League,2022,Brighton,Yasin Ayari,SWE,MF,18,2003,0.7,2,2,1,1,0,0,4,0.0,4,1,0,1,0,2,0,0,2023
ENG-Premier League,2022,Chelsea,Armando Broja,ALB,FW,20,2001,3.3,4,1,0,3,1,1,1,100.0,0,10,1,9,1,5,1,0,2023
ENG-Premier League,2022,Chelsea,Ben Chilwell,ENG,"DF,MF",25,1996,15.6,21,17,12,8,1,13,25,52.0,12,21,2,19,18,39,26,0,2023
ENG-Premier League,2022,Chelsea,Benoît Badiashile,FRA,DF,21,2001,10.1,14,8,10,4,0,9,14,64.3,5,5,2,3,16,30,34,1,2023
ENG-Premier League,2022,Chelsea,Carney Chukwuemeka,ENG,"MF,FW",18,2003,3.9,13,7,7,6,0,3,5,60.0,2,7,0,7,6,19,1,0,2023
ENG-Premier League,2022,Chelsea,Christian Pulisic,USA,"FW,DF",23,1998,9.1,11,6,3,6,2,3,5,60.0,2,8,1,7,4,15,4,0,2023
ENG-Premier League,2022,Chelsea,Conor Gallagher,ENG,MF,22,2000,18.0,46,33,17,19,10,10,37,27.0,27,41,10,31,23,69,18,1,2023
ENG-Premier League,2022,Chelsea,César Azpilicueta,ESP,DF,32,1989,17.0,43,25,23,15,5,22,37,59.5,15,26,5,21,19,62,54,1,2023
ENG-Premier League,2022,Chelsea,Datro Fofana,CIV,FW,19,2002,0.8,3,1,1,1,1,1,1,100.0,0,1,0,1,0,3,0,0,2023
ENG-Premier League,2022,Chelsea,Denis Zakaria,SUI,MF,25,1996,4.6,9,5,5,2,2,2,8,25.0,6,4,1,3,3,12,10,0,2023
ENG-Premier League,2022,Chelsea,Edouard Mendy,SEN,GK,30,1992,9.5,0,0,0,0,0,0,0,,0,0,0,0,0,0,3,3,2023
ENG-Premier League,2022,Chelsea,Enzo Fernández,ARG,MF,21,2001,17.2,45,27,25,17,3,21,56,37.5,35,32,2,30,16,61,12,1,2023
ENG-Premier League,2022,Chelsea,Hakim Ziyech,MAR,"FW,MF",29,1993,7.3,20,12,12,5,3,4,9,44.4,5,8,0,8,5,25,5,1,2023
ENG-Premier League,2022,Chelsea,Jorginho,ITA,MF,30,1991,14.2,42,23,22,14,6,22,46,47.8,24,18,3,15,21,63,7,0,2023
ENG-Premier League,2022,Chelsea,João Félix,POR,"FW,MF",22,1999,10.5,14,7,5,6,3,4,12,33.3,8,3,0,3,1,15,1,1,2023
ENG-Premier League,2022,Chelsea,Kai Havertz,GER,"FW,MF",23,1999,28.5,34,16,4,20,10,10,30,33.3,20,28,0,28,7,41,41,0,2023
ENG-Premier League,2022,Chelsea,Kalidou Koulibaly,SEN,DF,31,1991,20.0,45,31,34,8,3,26,40,65.0,14,30,13,17,29,74,77,0,2023
ENG-Premier League,2022,Chelsea,Kepa Arrizabalaga,ESP,GK,27,1994,28.5,2,2,2,0,0,2,3,66.7,1,0,0,0,1,3,16,2,2023
ENG-Premier League,2022,Chelsea,Lewis Hall,ENG,DF,17,2004,7.3,23,12,19,4,0,15,22,68.2,7,8,0,8,11,34,11,1,2023
ENG-Premier League,2022,Chelsea,Marc Cucurella,ESP,DF,24,1998,18.6,66,33,40,15,11,30,60,50.0,30,28,8,20,16,82,48,1,2023
ENG-Premier League,2022,Chelsea,Mason Mount,ENG,"MF,FW",23,1999,18.3,33,19,6,16,11,14,27,51.9,13,24,6,18,8,41,9,0,2023
ENG-Premier League,2022,Chelsea,Mateo Kovačić,CRO,MF,28,1994,19.0,36,24,16,14,6,14,36,38.9,22,10,1,9,19,55,16,0,2023
ENG-Premier League,2022,Chelsea,Mykhailo Mudryk,UKR,"FW,MF",21,2001,7.3,11,9,2,4,5,4,13,30.8,9,7,1,6,0,11,3,0,2023
ENG-Premier League,2022,Chelsea,N'Golo Kanté,FRA,MF,31,1991,5.8,16,10,4,10,2,4,8,50.0,4,11,0,11,6,22,2,0,2023
ENG-Premier League,2022,Chelsea,Noni Madueke,ENG,FW,20,2002,7.1,12,8,5,4,3,6,13,46.2,7,13,2,11,4,16,7,0,2023
ENG-Premier League,2022,Chelsea,Omari Hutchinson,ENG,FW,18,2003,0.3,0,0,0,0,0,0,0,,0,0,0,0,1,1,0,0,2023
ENG-Premier League,2022,Chelsea,Pierre-Emerick Aubameyang,GAB,FW,33,1989,6.2,1,0,1,0,0,0,1,0.0,1,2,0,2,2,3,4,2,2023
ENG-Premier League,2022,Chelsea,Raheem Sterling,ENG,"FW,MF",27,1994,21.0,18,10,5,4,9,8,14,57.1,6,17,0,17,2,20,5,0,2023
ENG-Premier League,2022,Chelsea,Reece James,ENG,"DF,MF",22,1999,13.8,31,20,10,18,3,15,19,78.9,4,17,2,15,12,43,23,0,2023
ENG-Premier League,2022,Chelsea,Ruben Loftus-Cheek,ENG,"MF,DF",26,1996,17.1,25,14,8,14,3,12,21,57.1,9,15,2,13,12,37,23,0,2023
ENG-Premier League,2022,Chelsea,Thiago Silva,BRA,DF,37,1984,26.1,41,27,24,17,0,21,31,67.7,10,38,29,9,34,75,111,2,2023
ENG-Premier League,2022,Chelsea,Trevoh Chalobah,ENG,DF,23,1999,17.9,31,20,22,6,3,24,34,70.6,10,17,7,10,24,55,56,1,2023
ENG-Premier League,2022,Chelsea,Wesley Fofana,FRA,DF,21,2000,13.1,30,18,19,7,4,13,26,50.0,13,17,10,7,20,50,33,2,2023
ENG-Premier League,2022,Crystal Palace,Albert Sambi Lokonga,BEL,MF,22,1999,6.0,13,10,7,4,2,8,12,66.7,4,8,3,5,7,20,10,0,2023
ENG-Premier League,2022,Crystal Palace,Cheick Doucouré,MLI,MF,22,2000,30.8,77,46,40,33,4,29,52,55.8,23,47,13,34,56,133,48,0,2023
ENG-Premier League,2022,Crystal Palace,Chris Richards,USA,DF,22,2000,5.0,9,6,8,1,0,5,7,71.4,2,10,1,9,8,17,31,0,2023
ENG-Premier League,2022,Crystal Palace,David Ozoh,,FW,17,2005,0.0,0,0,0,0,0,0,0,,0,0,0,0,0,0,0,0,2023
ENG-Premier League,2022,Crystal Palace,Eberechi Eze,ENG,"MF,FW",24,1998,29.3,42,24,17,18,7,18,38,47.4,20,22,0,22,13,55,10,0,2023
ENG-Premier League,2022,Crystal Palace,James McArthur,SCO,MF,34,1987,0.6,1,1,1,0,0,1,1,100.0,0,2,1,1,1,2,2,0,2023
ENG-Premier League,2022,Crystal Palace,James Tomkins,ENG,DF,33,1989,3.8,4,2,2,1,1,1,3,33.3,2,3,2,1,5,9,19,0,2023
ENG-Premier League,2022,Crystal Palace,Jaïro Riedewald,NED,"DF,MF",25,1996,0.7,2,1,2,0,0,0,1,0.0,1,2,0,2,0,2,4,0,2023
ENG-Premier League,2022,Crystal Palace,Jean-Philippe Mateta,FRA,FW,25,1997,8.6,7,1,2,4,1,1,3,33.3,2,3,1,2,3,10,18,0,2023
ENG-Premier League,2022,Crystal Palace,Jeffrey Schlupp,GHA,"MF,FW",29,1992,28.1,66,46,28,29,9,22,43,51.2,21,39,8,31,23,89,38,0,2023
ENG-Premier League,2022,Crystal Palace,Joachim Andersen,DEN,DF,26,1996,30.9,42,22,30,12,0,16,32,50.0,16,28,13,15,24,66,188,0,2023
ENG-Premier League,2022,Crystal Palace,Joel Ward,ENG,DF,32,1989,25.1,50,36,30,11,9,30,41,73.2,11,32,16,16,25,75,80,1,2023
ENG-Premier League,2022,Crystal Palace,Jordan Ayew,GHA,"FW,MF",30,1991,30.2,66,41,23,20,23,21,53,39.6,32,35,4,31,15,81,31,0,2023
ENG-Premier League,2022,Crystal Palace,Joseph Whitworth,ENG,GK,18,2004,2.0,0,0,0,0,0,0,0,,0,0,0,0,0,0,1,0,2023
ENG-Premier League,2022,Crystal Palace,Luka Milivojević,SRB,MF,31,1991,5.7,13,7,7,4,2,7,10,70.0,3,13,4,9,12,25,10,0,2023
ENG-Premier League,2022,Crystal Palace,Malcolm Ebiowei,ENG,"MF,FW",18,2003,0.4,1,1,1,0,0,0,1,0.0,1,2,0,2,0,1,0,0,2023
ENG-Premier League,2022,Crystal Palace,Marc Guéhi,ENG,DF,22,2000,37.0,52,27,39,11,2,26,42,61.9,16,45,24,21,45,97,134,3,2023
ENG-Premier League,2022,Crystal Palace,Michael Olise,FRA,"FW,MF",20,2001,30.5,58,34,28,26,4,25,60,41.7,35,46,1,45,26,84,17,0,2023
ENG-Premier League,2022,Crystal Palace,Naouirou Ahamada,FRA,"MF,FW",20,2002,1.0,3,2,3,0,0,1,3,33.3,2,2,0,2,0,3,0,0,2023
ENG-Premier League,2022,Crystal Palace,Nathaniel Clyne,ENG,DF,31,1991,18.2,27,16,13,9,5,14,23,60.9,9,22,4,18,19,46,34,0,2023
ENG-Premier League,2022,Crystal Palace,Odsonne Édouard,FRA,FW,24,1998,20.0,25,13,7,12,6,7,13,53.8,6,17,5,12,3,28,22,0,2023
ENG-Premier League,2022,Crystal Palace,Sam Johnstone,ENG,GK,29,1993,9.0,0,0,0,0,0,0,0,,0,0,0,0,0,0,5,0,2023
ENG-Premier League,2022,Crystal Palace,Tyrick Mitchell,ENG,DF,22,1999,32.1,71,49,43,23,5,30,53,56.6,23,48,11,37,42,113,78,0,2023
ENG-Premier League,2022,Crystal Palace,Vicente Guaita,ESP,GK,35,1987,27.0,0,0,0,0,0,0,0,,0,0,0,0,0,0,9,1,2023
ENG-Premier League,2022,Crystal Palace,Wilfried Zaha,CIV,"FW,MF",29,1992,25.4,32,20,12,12,8,8,21,38.1,13,21,1,20,16,48,9,0,2023
ENG-Premier League,2022,Crystal Palace,Will Hughes,ENG,MF,27,1995,9.4,29,16,11,16,2,11,20,55.0,9,16,7,9,16,45,9,0,2023
ENG-Premier League,2022,Everton,Abdoulaye Doucouré,MLI,MF,29,1993,17.0,31,20,9,15,7,12,37,32.4,25,26,3,23,13,44,11,0,2023
ENG-Premier League,2022,Everton,Alex Iwobi,NGA,"MF,FW",26,1996,37.5,69,37,37,28,4,33,65,50.8,32,41,2,39,25,94,29,0,2023
ENG-Premier League,2022,Everton,Amadou Onana,BEL,MF,20,2001,27.6,72,43,24,42,6,30,42,71.4,12,25,6,19,37,109,39,0,2023
ENG-Premier League,2022,Everton,Anthony Gordon,ENG,FW,21,2001,12.2,34,22,17,10,7,8,23,34.8,15,19,0,19,4,38,11,0,2023
ENG-Premier League,2022,Everton,Asmir Begović,BIH,GK,35,1987,1.0,0,0,0,0,0,0,0,,0,0,0,0,0,0,1,0,2023
ENG-Premier League,2022,Everton,Ben Godfrey,ENG,DF,24,1998,8.9,20,11,13,5,2,11,29,37.9,18,12,6,6,8,28,33,1,2023
ENG-Premier League,2022,Everton,Conor Coady,ENG,DF,29,1993,23.3,14,9,8,6,0,7,15,46.7,8,21,17,4,14,28,88,3,2023
ENG-Premier League,2022,Everton,Dele Alli,ENG,MF,26,1996,0.4,0,0,0,0,0,0,0,,0,0,0,0,0,0,0,0,2023
ENG-Premier League,2022,Everton,Demarai Gray,JAM,"FW,MF",26,1996,27.9,33,24,9,14,10,17,31,54.8,14,23,3,20,13,46,18,0,2023
ENG-Premier League,2022,Everton,Dominic Calvert-Lewin,ENG,FW,25,1997,12.9,4,2,1,0,3,1,5,20.0,4,5,1,4,3,7,18,0,2023
ENG-Premier League,2022,Everton,Dwight McNeil,ENG,"FW,MF",22,1999,27.8,64,41,35,14,15,27,62,43.5,35,46,7,39,31,95,41,0,2023
ENG-Premier League,2022,Everton,Ellis Simms,ENG,FW,21,2001,2.5,0,0,0,0,0,0,0,,0,0,0,0,0,0,1,0,2023
ENG-Premier League,2022,Everton,Idrissa Gana Gueye,SEN,MF,32,1989,28.6,97,57,49,35,13,31,60,51.7,29,50,12,38,56,153,34,3,2023
ENG-Premier League,2022,Everton,Isaac Price,NIR,MF,18,2003,0.4,0,0,0,0,0,0,1,0.0,1,1,1,0,0,0,0,0,2023
ENG-Premier League,2022,Everton,James Garner,ENG,"MF,DF",21,2001,8.9,16,13,4,8,4,9,19,47.4,10,9,1,8,12,28,13,0,2023
ENG-Premier League,2022,Everton,James Tarkowski,ENG,DF,29,1992,38.0,51,26,36,13,2,20,38,52.6,18,99,78,21,51,102,201,3,2023
ENG-Premier League,2022,Everton,Jordan Pickford,ENG,GK,28,1994,37.0,0,0,0,0,0,0,1,0.0,1,0,0,0,4,4,15,3,2023
ENG-Premier League,2022,Everton,Mason Holgate,ENG,DF,25,1996,5.6,11,7,8,3,0,3,11,27.3,8,7,3,4,7,18,28,0,2023
ENG-Premier League,2022,Everton,Michael Keane,ENG,DF,29,1993,10.9,7,4,5,2,0,5,8,62.5,3,12,7,5,14,21,55,1,2023
ENG-Premier League,2022,Everton,Nathan Patterson,SCO,"DF,MF",20,2001,14.2,49,24,32,13,4,29,53,54.7,24,24,4,20,15,64,45,0,2023
ENG-Premier League,2022,Everton,Neal Maupay,FRA,FW,25,1996,12.4,11,5,3,4,4,2,4,50.0,2,8,0,8,5,16,0,0,2023
ENG-Premier League,2022,Everton,Rúben Vinagre,POR,"DF,MF",23,1999,0.3,2,2,1,1,0,1,2,50.0,1,0,0,0,0,2,1,0,2023
ENG-Premier League,2022,Everton,Salomón Rondón,VEN,FW,32,1989,1.2,0,0,0,0,0,0,0,,0,1,1,0,0,0,0,0,2023
ENG-Premier League,2022,Everton,Séamus Coleman,IRL,DF,33,1988,18.4,35,26,21,10,4,19,29,65.5,10,14,7,7,22,57,58,2,2023
ENG-Premier League,2022,Everton,Thomas Cannon,IRL,FW,19,2002,0.3,0,0,0,0,0,0,0,,0,0,0,0,0,0,0,0,2023
ENG-Premier League,2022,Everton,Tom Davies,ENG,MF,24,1998,6.0,15,9,5,9,1,7,14,50.0,7,10,1,9,4,19,7,1,2023
ENG-Premier League,2022,Everton,Vitaliy Mykolenko,UKR,DF,23,1999,29.5,58,34,36,19,3,28,51,54.9,23,50,16,34,46,104,99,0,2023
ENG-Premier League,2022,Everton,Yerry Mina,COL,DF,27,1994,6.6,15,8,9,6,0,9,11,81.8,2,7,4,3,6,21,28,0,2023
ENG-Premier League,2022,Fulham,Aleksandar Mitrović,SRB,FW,27,1994,22.3,14,7,8,4,2,5,12,41.7,7,22,5,17,3,17,20,1,2023
ENG-Premier League,2022,Fulham,Andreas Pereira,BRA,MF,26,1996,29.9,18,9,3,6,9,8,33,24.2,25,21,3,18,6,24,8,0,2023
ENG-Premier League,2022,Fulham,Antonee Robinson,USA,DF,24,1997,34.3,62,38,43,15,4,44,65,67.7,21,49,13,36,53,115,83,3,2023
ENG-Premier League,2022,Fulham,Bernd Leno,GER,GK,30,1992,36.0,0,0,0,0,0,0,2,0.0,2,0,0,0,0,0,18,0,2023
ENG-Premier League,2022,Fulham,Bobby Reid,JAM,"FW,DF",29,1993,27.5,42,24,14,14,14,16,34,47.1,18,25,3,22,20,62,28,1,2023
ENG-Premier League,2022,Fulham,Carlos Vinícius,BRA,FW,27,1995,12.3,4,1,0,2,2,0,4,0.0,4,7,0,7,0,4,10,0,2023
ENG-Premier League,2022,Fulham,Cédric Soares,POR,DF,30,1991,2.2,8,5,4,3,1,3,3,100.0,0,3,1,2,1,9,5,0,2023
ENG-Premier League,2022,Fulham,Daniel James,WAL,FW,24,1997,6.9,9,5,4,4,1,4,8,50.0,4,5,1,4,1,10,5,0,2023
ENG-Premier League,2022,Fulham,Harrison Reed,ENG,MF,27,1995,31.8,44,27,17,21,6,16,50,32.0,34,54,12,42,19,63,36,0,2023
ENG-Premier League,2022,Fulham,Harry Wilson,WAL,FW,25,1997,12.2,21,13,9,9,3,8,18,44.4,10,17,2,15,6,27,14,0,2023
ENG-Premier League,2022,Fulham,Issa Diop,FRA,DF,25,1997,22.4,28,19,18,9,1,17,32,53.1,15,24,17,7,35,63,86,0,2023
ENG-Premier League,2022,Fulham,Jay Stansfield,ENG,FW,19,2002,1.0,0,0,0,0,0,0,2,0.0,2,4,1,3,1,1,1,0,2023
ENG-Premier League,2022,Fulham,Josh Onomah,ENG,MF,25,1997,0.2,1,0,1,0,0,0,0,,0,1,0,1,0,1,0,0,2023
ENG-Premier League,2022,Fulham,João Palhinha,POR,MF,27,1995,34.5,147,83,58,65,24,71,134,53.0,63,48,5,43,46,193,61,2,2023
ENG-Premier League,2022,Fulham,Kenny Tete,NED,DF,26,1995,28.5,83,46,41,29,13,38,50,76.0,12,48,17,31,52,135,81,1,2023
ENG-Premier League,2022,Fulham,Kevin Mbabu,SUI,"DF,FW",27,1995,1.6,3,2,2,1,0,1,3,33.3,2,2,0,2,3,6,3,0,2023
ENG-Premier League,2022,Fulham,Layvin Kurzawa,FRA,DF,29,1992,1.5,3,2,1,1,1,3,3,100.0,0,1,1,0,2,5,4,0,2023
ENG-Premier League,2022,Fulham,Luke Harris,WAL,"MF,FW",17,2005,0.1,0,0,0,0,0,0,0,,0,0,0,0,0,0,0,0,2023
ENG-Premier League,2022,Fulham,Manor Solomon,ISR,FW,23,1999,6.4,20,12,12,6,2,9,16,56.3,7,8,0,8,5,25,3,0,2023
ENG-Premier League,2022,Fulham,Marek Rodák,SVK,GK,25,1996,2.0,0,0,0,0,0,0,0,,0,0,0,0,0,0,1,1,2023
ENG-Premier League,2022,Fulham,Nathaniel Chalobah,ENG,MF,27,1994,0.1,1,1,1,0,0,1,1,100.0,0,0,0,0,0,1,2,0,2023
ENG-Premier League,2022,Fulham,Neeskens Kebano,COD,FW,30,1992,8.5,17,9,8,6,3,9,17,52.9,8,14,0,14,1,18,8,0,2023
ENG-Premier League,2022,Fulham,Saša Lukić,SRB,MF,25,1996,4.6,8,3,1,4,3,3,7,42.9,4,6,2,4,5,13,3,0,2023
ENG-Premier League,2022,Fulham,Shane Duffy,IRL,"DF,FW",30,1992,0.2,0,0,0,0,0,0,0,,0,0,0,0,0,0,0,1,2023
ENG-Premier League,2022,Fulham,Tim Ream,USA,DF,34,1987,32.2,30,16,15,12,3,13,26,50.0,13,45,24,21,41,71,116,2,2023
ENG-Premier League,2022,Fulham,Tom Cairney,SCO,MF,31,1991,11.0,17,6,4,8,5,7,10,70.0,3,18,3,15,5,22,3,0,2023
ENG-Premier League,2022,Fulham,Tosin Adarabioyo,ENG,DF,24,1997,23.2,30,13,22,6,2,16,23,69.6,7,20,15,5,26,56,140,1,2023
ENG-Premier League,2022,Fulham,Tyrese Francois,AUS,FW,22,2000,0.0,0,0,0,0,0,0,0,,0,0,0,0,0,0,1,0,2023
ENG-Premier League,2022,Fulham,Willian,BRA,FW,33,1988,23.6,13,8,8,3,2,7,25,28.0,18,13,0,13,9,22,9,0,2023
ENG-Premier League,2022,Leeds United,Adam Forshaw,ENG,MF,30,1991,5.3,12,9,5,7,0,7,17,41.2,10,9,1,8,4,16,2,0,2023
ENG-Premier League,2022,Leeds United,Brenden Aaronson,USA,"MF,FW",21,2000,26.4,45,18,16,22,7,15,46,32.6,31,43,3,40,5,50,6,1,2023
ENG-Premier League,2022,Leeds United,Cody Drameh,ENG,DF,20,2001,0.8,5,4,0,4,1,2,3,66.7,1,0,0,0,1,6,1,0,2023
ENG-Premier League,2022,Leeds United,Crysencio Summerville,NED,FW,20,2001,15.8,30,20,14,14,2,11,23,47.8,12,20,2,18,13,43,11,0,2023
ENG-Premier League,2022,Leeds United,Daniel James,WAL,FW,24,1997,2.2,6,2,1,3,2,3,6,50.0,3,4,0,4,2,8,2,0,2023
ENG-Premier League,2022,Leeds United,Darko Gyabi,ENG,FW,18,2004,0.1,2,2,1,1,0,0,0,,0,2,0,2,0,2,0,0,2023
ENG-Premier League,2022,Leeds United,Degnand Gnonto,ITA,"FW,MF",18,2003,15.0,27,17,7,15,5,10,30,33.3,20,24,1,23,5,32,7,0,2023
ENG-Premier League,2022,Leeds United,Diego Llorente,ESP,DF,28,1993,7.2,13,10,8,5,0,4,8,50.0,4,6,2,4,15,28,24,2,2023
ENG-Premier League,2022,Leeds United,Georginio Rutter,FRA,"FW,MF",20,2002,3.0,10,9,5,3,2,5,8,62.5,3,5,0,5,3,13,3,0,2023
ENG-Premier League,2022,Leeds United,Illan Meslier,FRA,GK,22,2000,34.0,2,1,2,0,0,2,4,50.0,2,0,0,0,1,3,30,3,2023
ENG-Premier League,2022,Leeds United,Jack Harrison,ENG,"FW,MF",25,1996,30.1,41,17,5,15,21,12,52,23.1,40,47,2,45,22,63,25,0,2023
ENG-Premier League,2022,Leeds United,Joe Gelhardt,ENG,FW,20,2002,2.4,6,2,1,3,2,3,5,60.0,2,5,0,5,0,6,4,0,2023
ENG-Premier League,2022,Leeds United,Joel Robles,ESP,GK,32,1990,4.0,0,0,0,0,0,0,1,0.0,1,0,0,0,0,0,2,1,2023
ENG-Premier League,2022,Leeds United,Junior Firpo,ESP,DF,25,1996,15.2,47,25,27,15,5,24,46,52.2,22,23,7,16,24,71,40,0,2023
ENG-Premier League,2022,Leeds United,Liam Cooper,SCO,DF,30,1991,15.8,38,23,27,9,2,23,36,63.9,13,16,8,8,34,72,57,3,2023
ENG-Premier League,2022,Leeds United,Luis Sinisterra,COL,FW,23,1999,9.6,21,14,8,9,4,11,18,61.1,7,11,1,10,8,29,2,0,2023
ENG-Premier League,2022,Leeds United,Luke Ayling,ENG,DF,30,1991,22.8,66,37,42,15,9,42,85,49.4,43,34,11,23,26,92,52,2,2023
ENG-Premier League,2022,Leeds United,Marc Roca,ESP,MF,25,1996,25.7,66,40,27,34,5,20,65,30.8,45,34,10,24,23,89,24,2,2023
ENG-Premier League,2022,Leeds United,Mateo Joseph,ENG,"FW,MF",18,2003,0.3,0,0,0,0,0,0,0,,0,1,0,1,0,0,1,0,2023
ENG-Premier League,2022,Leeds United,Mateusz Klich,POL,"MF,FW",32,1990,3.1,12,8,3,4,5,7,13,53.8,6,4,0,4,0,12,1,0,2023
ENG-Premier League,2022,Leeds United,Maximilian Wöber,AUT,DF,24,1998,14.1,25,18,9,15,1,16,24,66.7,8,32,14,18,27,52,67,1,2023
ENG-Premier League,2022,Leeds United,Pascal Struijk,NED,DF,22,1999,24.4,84,57,43,31,10,49,75,65.3,26,32,12,20,32,116,70,1,2023
ENG-Premier League,2022,Leeds United,Patrick Bamford,ENG,FW,28,1993,16.8,9,6,0,6,3,4,20,20.0,16,12,5,7,5,14,13,0,2023
ENG-Premier League,2022,Leeds United,Rasmus Nissen,DEN,DF,25,1997,21.8,62,35,35,21,6,42,76,55.3,34,32,14,18,35,97,61,0,2023
ENG-Premier League,2022,Leeds United,Robin Koch,GER,DF,26,1996,35.3,53,30,32,16,5,24,56,42.9,32,44,21,23,43,96,152,1,2023
ENG-Premier League,2022,Leeds United,Rodrigo,ESP,"FW,MF",31,1991,21.5,24,10,2,15,7,8,19,42.1,11,16,4,12,6,30,21,1,2023
ENG-Premier League,2022,Leeds United,Sam Greenwood,ENG,"MF,FW",20,2002,4.7,15,7,7,8,0,8,21,38.1,13,10,2,8,1,16,1,0,2023
ENG-Premier League,2022,Leeds United,Tyler Adams,USA,MF,23,1999,24.0,89,46,44,35,10,50,77,64.9,27,48,8,40,35,124,29,0,2023
ENG-Premier League,2022,Leeds United,Weston McKennie,USA,MF,23,1998,16.0,30,13,5,18,7,10,29,34.5,19,22,3,19,22,52,26,0,2023
ENG-Premier League,2022,Leicester City,Ayoze Pérez,ESP,"MF,FW",29,1993,4.2,11,8,5,4,2,8,19,42.1,11,6,0,6,2,13,3,0,2023
ENG-Premier League,2022,Leicester City,Boubakary Soumaré,FRA,MF,23,1999,18.1,57,34,29,26,2,23,43,53.5,20,15,4,11,33,90,27,1,2023
ENG-Premier League,2022,Leicester City,Daniel Amartey,GHA,DF,27,1994,17.9,19,8,13,5,1,12,14,85.7,2,24,17,7,8,27,71,0,2023
ENG-Premier League,2022,Leicester City,Daniel Iversen,DEN,GK,25,1997,12.0,0,0,0,0,0,0,0,,0,0,0,0,0,0,6,1,2023
ENG-Premier League,2022,Leicester City,Danny Ward,WAL,GK,29,1993,26.0,1,1,1,0,0,1,3,33.3,2,0,0,0,0,1,14,2,2023
ENG-Premier League,2022,Leicester City,Dennis Praet,BEL,"MF,FW",28,1994,7.2,12,9,5,6,1,6,11,54.5,5,12,2,10,5,17,6,0,2023
ENG-Premier League,2022,Leicester City,Harry Souttar,AUS,DF,23,1998,11.0,15,9,10,5,0,7,18,38.9,11,16,12,4,12,27,45,0,2023
ENG-Premier League,2022,Leicester City,Harvey Barnes,ENG,"FW,MF",24,1997,30.1,26,14,8,14,4,14,42,33.3,28,32,1,31,8,34,12,0,2023
ENG-Premier League,2022,Leicester City,James Justin,ENG,DF,24,1998,13.9,20,18,7,12,1,9,14,64.3,5,24,6,18,15,35,47,0,2023
ENG-Premier League,2022,Leicester City,James Maddison,ENG,"MF,FW",25,1996,27.6,51,26,25,19,7,19,50,38.0,31,19,1,18,13,64,6,1,2023
ENG-Premier League,2022,Leicester City,Jamie Vardy,ENG,FW,35,1987,20.6,10,5,4,3,3,1,7,14.3,6,17,3,14,2,12,30,0,2023
ENG-Premier League,2022,Leicester City,Jonny Evans,NIR,DF,34,1988,11.7,13,5,12,1,0,7,11,63.6,4,15,11,4,18,31,51,0,2023
ENG-Premier League,2022,Leicester City,Kelechi Iheanacho,NGA,"FW,MF",25,1996,12.5,7,2,0,3,4,3,10,30.0,7,9,1,8,0,7,8,0,2023
ENG-Premier League,2022,Leicester City,Kiernan Dewsbury-Hall,ENG,MF,23,1998,25.6,53,29,14,34,5,19,47,40.4,28,55,13,42,28,81,21,0,2023
ENG-Premier League,2022,Leicester City,Lewis Brunt,ENG,DF,21,2000,0.3,0,0,0,0,0,0,0,,0,0,0,0,0,0,2,0,2023
ENG-Premier League,2022,Leicester City,Luke Thomas,ENG,DF,21,2001,11.9,23,19,15,5,3,15,32,46.9,17,20,4,16,27,50,35,0,2023
ENG-Premier League,2022,Leicester City,Marc Albrighton,ENG,"FW,MF",32,1989,2.6,4,1,0,2,2,1,8,12.5,7,6,2,4,1,5,5,0,2023
ENG-Premier League,2022,Leicester City,Nampalys Mendy,SEN,MF,30,1992,8.4,13,9,7,6,0,8,15,53.3,7,20,4,16,13,26,2,0,2023
ENG-Premier League,2022,Leicester City,Patson Daka,ZAM,FW,23,1998,13.2,14,8,6,8,0,3,12,25.0,9,14,2,12,7,21,7,0,2023
ENG-Premier League,2022,Leicester City,Ricardo Pereira,POR,"DF,MF",28,1993,5.0,11,7,8,3,0,7,17,41.2,10,8,2,6,4,15,20,0,2023
ENG-Premier League,2022,Leicester City,Tetê,BRA,FW,22,2000,8.2,14,8,5,7,2,6,21,28.6,15,9,0,9,2,16,3,0,2023
ENG-Premier League,2022,Leicester City,Timothy Castagne,BEL,DF,26,1995,36.2,87,44,53,27,7,41,84,48.8,43,50,13,37,43,130,110,0,2023
ENG-Premier League,2022,Leicester City,Victor Bernth Kristiansen,DEN,DF,19,2002,9.9,38,23,18,16,4,22,30,73.3,8,16,4,12,3,41,26,0,2023
ENG-Premier League,2022,Leicester City,Wesley Fofana,FRA,DF,21,2000,2.0,4,2,1,2,1,1,3,33.3,2,1,1,0,9,13,5,0,2023
ENG-Premier League,2022,Leicester City,Wilfred Ndidi,NGA,MF,25,1996,18.7,61,42,34,24,3,17,43,39.5,26,32,14,18,38,99,48,3,2023
ENG-Premier League,2022,Leicester City,Wout Faes,BEL,DF,24,1998,31.0,56,33,28,26,2,28,44,63.6,16,53,37,16,41,97,113,2,2023
ENG-Premier League,2022,Leicester City,Youri Tielemans,BEL,MF,25,1997,26.0,66,39,27,30,9,23,61,37.7,38,35,8,27,28,94,24,1,2023
ENG-Premier League,2022,Leicester City,Çağlar Söyüncü,TUR,DF,26,1996,5.9,14,9,10,4,0,7,10,70.0,3,9,8,1,7,21,30,0,2023
ENG-Premier League,2022,Liverpool,Alex Oxlade-Chamberlain,ENG,"FW,MF",28,1993,3.7,5,4,1,2,2,1,5,20.0,4,5,2,3,1,6,4,0,2023
ENG-Premier League,2022,Liverpool,Alisson,BRA,GK,29,1992,37.0,0,0,0,0,0,0,3,0.0,3,3,0,3,0,0,20,0,2023
ENG-Premier League,2022,Liverpool,Andrew Robertson,SCO,DF,28,1994,28.7,38,21,12,16,10,21,41,51.2,20,32,5,27,18,56,50,3,2023
ENG-Premier League,2022,Liverpool,Ben Doak,SCO,FW,16,2005,0.3,3,2,1,2,0,1,1,100.0,0,1,0,1,0,3,0,0,2023
ENG-Premier League,2022,Liverpool,Bobby Clark,ENG,MF,17,2005,0.1,0,0,0,0,0,0,0,,0,2,0,2,0,0,0,0,2023
ENG-Premier League,2022,Liverpool,Caoimhín Kelleher,IRL,GK,23,1998,1.0,0,0,0,0,0,0,0,,0,0,0,0,0,0,0,0,2023
ENG-Premier League,2022,Liverpool,Cody Gakpo,NED,"FW,MF",23,1999,16.2,26,15,4,13,9,13,38,34.2,25,13,1,12,4,30,2,0,2023
ENG-Premier League,2022,Liverpool,Curtis Jones,ENG,MF,21,2001,11.5,34,17,8,12,14,18,31,58.1,13,12,2,10,3,37,9,0,2023
ENG-Premier League,2022,Liverpool,Darwin Núñez,URU,FW,23,1999,18.8,11,5,2,4,5,4,17,23.5,13,10,0,10,3,14,13,0,2023
ENG-Premier League,2022,Liverpool,Diogo Jota,POR,FW,25,1996,12.6,23,15,8,8,7,12,37,32.4,25,5,0,5,3,26,11,0,2023
ENG-Premier League,2022,Liverpool,Fabinho,BRA,MF,28,1993,29.7,65,38,18,40,7,24,62,38.7,38,38,11,27,37,102,40,0,2023
ENG-Premier League,2022,Liverpool,Fabio Carvalho,POR,"MF,FW",19,2002,3.9,8,8,3,3,2,3,6,50.0,3,6,0,6,6,14,0,0,2023
ENG-Premier League,2022,Liverpool,Harvey Elliott,ENG,"MF,FW",19,2003,17.9,27,18,6,12,9,9,36,25.0,27,26,1,25,15,42,8,0,2023
ENG-Premier League,2022,Liverpool,Ibrahima Konaté,FRA,DF,23,1999,17.2,38,26,25,13,0,16,27,59.3,11,12,5,7,26,64,61,4,2023
ENG-Premier League,2022,Liverpool,James Milner,ENG,"MF,DF",36,1986,10.1,26,16,11,11,4,15,34,44.1,19,14,2,12,12,38,15,0,2023
ENG-Premier League,2022,Liverpool,Joe Gomez,ENG,DF,25,1997,16.3,28,21,15,11,2,11,19,57.9,8,17,11,6,24,52,51,2,2023
ENG-Premier League,2022,Liverpool,Jordan Henderson,ENG,MF,32,1990,23.0,32,23,10,18,4,15,36,41.7,21,21,3,18,21,53,16,1,2023
ENG-Premier League,2022,Liverpool,Joël Matip,CMR,DF,30,1991,12.1,14,8,12,2,0,11,23,47.8,12,8,3,5,21,35,45,3,2023
ENG-Premier League,2022,Liverpool,Kostas Tsimikas,GRE,DF,26,1996,8.6,14,9,10,2,2,10,16,62.5,6,8,1,7,12,26,15,0,2023
ENG-Premier League,2022,Liverpool,Luis Díaz,COL,FW,25,1997,11.1,17,11,4,8,5,8,15,53.3,7,8,0,8,6,23,2,0,2023
ENG-Premier League,2022,Liverpool,Mohamed Salah,EGY,FW,30,1992,36.6,21,12,4,5,12,10,26,38.5,16,21,0,21,6,27,4,0,2023
ENG-Premier League,2022,Liverpool,Naby Keïta,GUI,MF,27,1995,3.3,5,4,2,3,0,1,4,25.0,3,1,0,1,2,7,3,0,2023
ENG-Premier League,2022,Liverpool,Nathaniel Phillips,ENG,DF,25,1997,0.7,2,1,0,2,0,2,2,100.0,0,0,0,0,2,4,1,0,2023
ENG-Premier League,2022,Liverpool,Roberto Firmino,BRA,"FW,MF",30,1991,13.5,17,12,2,12,3,4,21,19.0,17,16,1,15,7,24,2,0,2023
ENG-Premier League,2022,Liverpool,Stefan Bajcetic,ESP,MF,17,2004,5.8,9,6,5,3,1,8,27,29.6,19,7,0,7,9,18,4,0,2023
ENG-Premier League,2022,Liverpool,Thiago Alcántara,ESP,MF,31,1991,13.9,43,24,20,21,2,14,23,60.9,9,15,3,12,21,64,13,2,2023
ENG-Premier League,2022,Liverpool,Trent Alexander-Arnold,ENG,DF,23,1998,32.5,57,40,32,16,9,42,79,53.2,37,25,7,18,43,100,41,2,2023
ENG-Premier League,2022,Liverpool,Virgil van Dijk,NED,DF,31,1991,31.5,27,14,13,11,3,8,19,42.1,11,24,16,8,31,58,138,2,2023
ENG-Premier League,2022,Manchester City,Aymeric Laporte,ESP,DF,28,1994,11.0,11,8,6,4,1,7,11,63.6,4,10,4,6,3,14,30,1,2023
ENG-Premier League,2022,Manchester City,Bernardo Silva,POR,"MF,FW",27,1994,24.5,44,23,11,25,8,18,44,40.9,26,23,6,17,16,60,6,0,2023
ENG-Premier League,2022,Manchester City,Cole Palmer,ENG,"MF,FW",20,2002,4.1,5,1,0,3,2,3,5,60.0,2,2,1,1,1,6,2,0,2023
ENG-Premier League,2022,Manchester City,Ederson,BRA,GK,28,1993,35.0,3,1,3,0,0,1,2,50.0,1,0,0,0,1,4,10,2,2023
ENG-Premier League,2022,Manchester City,Erling Haaland,NOR,FW,22,2000,30.8,3,2,0,2,1,1,5,20.0,4,12,4,8,3,6,14,0,2023
ENG-Premier League,2022,Manchester City,Jack Grealish,ENG,FW,26,1995,22.8,25,16,10,12,3,13,22,59.1,9,17,3,14,7,32,9,0,2023
ENG-Premier League,2022,Manchester City,John Stones,ENG,"DF,MF",28,1994,20.5,23,13,11,8,4,7,10,70.0,3,17,10,7,9,32,40,0,2023
ENG-Premier League,2022,Manchester City,João Cancelo,POR,DF,28,1994,14.2,29,21,16,9,4,17,24,70.8,7,7,1,6,19,48,9,1,2023
ENG-Premier League,2022,Manchester City,Julián Álvarez,ARG,"FW,MF",22,2000,16.3,26,16,3,13,10,9,29,31.0,20,13,0,13,2,28,6,0,2023
ENG-Premier League,2022,Manchester City,Kalvin Phillips,ENG,MF,26,1995,3.3,6,4,3,3,0,2,9,22.2,7,7,3,4,5,11,10,0,2023
ENG-Premier League,2022,Manchester City,Kevin De Bruyne,BEL,MF,31,1991,26.9,28,12,3,12,13,14,39,35.9,25,27,2,25,9,37,10,0,2023
ENG-Premier League,2022,Manchester City,Kyle Walker,ENG,DF,32,1990,21.8,13,9,8,5,0,4,24,16.7,20,12,2,10,18,31,22,0,2023
ENG-Premier League,2022,Manchester City,Manuel Akanji,SUI,DF,27,1995,25.4,36,25,15,18,3,23,36,63.9,13,27,9,18,16,52,33,0,2023
ENG-Premier League,2022,Manchester City,Máximo Perrone,ARG,MF,19,2003,0.2,0,0,0,0,0,0,0,,0,1,0,1,0,0,0,0,2023
ENG-Premier League,2022,Manchester City,Nathan Aké,NED,DF,27,1995,20.8,26,12,15,9,2,11,15,73.3,4,20,10,10,20,46,48,0,2023
ENG-Premier League,2022,Manchester City,Phil Foden,ENG,FW,22,2000,20.5,16,10,9,5,2,8,19,42.1,11,25,2,23,5,21,12,0,2023
ENG-Premier League,2022,Manchester City,Rico Lewis,ENG,"DF,MF",17,2004,10.0,16,9,9,5,2,6,11,54.5,5,8,4,4,6,22,13,1,2023
ENG-Premier League,2022,Manchester City,Riyad Mahrez,ALG,"FW,MF",31,1991,21.3,30,14,8,13,9,13,38,34.2,25,27,1,26,9,39,5,0,2023
ENG-Premier League,2022,Manchester City,Rodri,ESP,MF,26,1996,32.3,67,41,28,28,11,26,52,50.0,26,40,14,26,33,100,43,1,2023
ENG-Premier League,2022,Manchester City,Rúben Dias,POR,DF,25,1997,22.2,21,13,10,10,1,11,18,61.1,7,21,13,8,18,39,56,1,2023
ENG-Premier League,2022,Manchester City,Sergio Gómez,ESP,"DF,MF",21,2000,3.9,9,4,6,1,2,5,8,62.5,3,5,3,2,2,11,9,1,2023
ENG-Premier League,2022,Manchester City,Shea Charles,NIR,DF,18,2003,0.3,4,0,4,0,0,1,1,100.0,0,0,0,0,1,5,2,0,2023
ENG-Premier League,2022,Manchester City,Stefan Ortega,GER,GK,29,1992,3.0,0,0,0,0,0,0,0,,0,0,0,0,0,0,0,0,2023
ENG-Premier League,2022,Manchester City,İlkay Gündoğan,GER,MF,31,1990,26.1,30,18,7,13,10,12,33,36.4,21,18,3,15,20,50,13,0,2023
ENG-Premier League,2022,Manchester Utd,Aaron Wan-Bissaka,ENG,DF,24,1997,15.9,40,25,20,17,3,23,25,92.0,2,24,8,16,22,62,41,0,2023
ENG-Premier League,2022,Manchester Utd,Alejandro Garnacho,ARG,"FW,MF",18,2004,6.3,5,2,2,0,3,1,11,9.1,10,5,0,5,5,10,3,0,2023
ENG-Premier League,2022,Manchester Utd,Anthony Elanga,SWE,FW,20,2002,4.7,3,0,0,2,1,1,2,50.0,1,4,0,4,2,5,4,0,2023
ENG-Premier League,2022,Manchester Utd,Anthony Martial,FRA,FW,26,1995,10.9,5,3,0,2,3,1,4,25.0,3,11,2,9,1,6,4,0,2023
ENG-Premier League,2022,Manchester Utd,Antony,BRA,FW,22,2000,20.0,22,9,9,9,4,8,28,28.6,20,18,0,18,11,33,6,0,2023
ENG-Premier League,2022,Manchester Utd,Bruno Fernandes,POR,"MF,FW",27,1994,36.8,68,42,24,25,19,30,71,42.3,41,37,5,32,25,93,40,1,2023
ENG-Premier League,2022,Manchester Utd,Casemiro,BRA,MF,30,1992,23.6,89,46,43,35,11,48,92,52.2,44,49,11,38,34,123,64,0,2023
ENG-Premier League,2022,Manchester Utd,Christian Eriksen,DEN,MF,30,1992,22.8,22,18,10,7,5,10,32,31.3,22,23,9,14,11,33,20,1,2023
ENG-Premier League,2022,Manchester Utd,Cristiano Ronaldo,POR,FW,37,1985,5.8,2,2,1,0,1,1,2,50.0,1,0,0,0,1,3,9,0,2023
ENG-Premier League,2022,Manchester Utd,David de Gea,ESP,GK,31,1990,38.0,0,0,0,0,0,0,1,0.0,1,0,0,0,1,1,15,3,2023
ENG-Premier League,2022,Manchester Utd,Diogo Dalot,POR,DF,23,1999,23.9,54,41,40,13,1,33,45,73.3,12,25,7,18,37,91,55,2,2023
ENG-Premier League,2022,Manchester Utd,Donny van de Beek,NED,MF,25,1997,1.9,0,0,0,0,0,0,1,0.0,1,2,1,1,1,1,1,0,2023
ENG-Premier League,2022,Manchester Utd,Facundo Pellistri,URU,"FW,MF",20,2001,0.7,1,1,0,1,0,0,0,,0,0,0,0,0,1,3,0,2023
ENG-Premier League,2022,Manchester Utd,Fred,BRA,MF,29,1993,13.9,47,30,24,20,3,15,38,39.5,23,38,2,36,19,66,19,0,2023
ENG-Premier League,2022,Manchester Utd,Harry Maguire,ENG,DF,29,1993,8.5,8,6,6,1,1,4,5,80.0,1,18,11,7,13,21,41,0,2023
ENG-Premier League,2022,Manchester Utd,Jadon Sancho,ENG,"FW,MF",22,2000,18.7,16,10,7,5,4,8,28,28.6,20,25,2,23,7,23,6,0,2023
ENG-Premier League,2022,Manchester Utd,Kobbie Mainoo,ENG,MF,17,2005,0.1,0,0,0,0,0,0,0,,0,1,1,0,0,0,0,0,2023
ENG-Premier League,2022,Manchester Utd,Lisandro Martínez,ARG,DF,24,1998,23.5,54,28,33,18,3,30,43,69.8,13,51,27,24,33,87,103,0,2023
ENG-Premier League,2022,Manchester Utd,Luke Shaw,ENG,DF,27,1995,28.4,55,36,31,22,2,32,45,71.1,13,51,17,34,36,91,55,2,2023
ENG-Premier League,2022,Manchester Utd,Marcel Sabitzer,AUT,MF,28,1994,7.0,12,8,3,8,1,2,11,18.2,9,6,2,4,8,20,11,0,2023
ENG-Premier League,2022,Manchester Utd,Marcus Rashford,ENG,FW,24,1997,32.0,20,10,7,8,5,9,24,37.5,15,31,4,27,7,27,14,0,2023
ENG-Premier League,2022,Manchester Utd,Raphaël Varane,FRA,DF,29,1993,21.2,24,9,18,6,0,7,17,41.2,10,24,17,7,11,35,91,0,2023
ENG-Premier League,2022,Manchester Utd,Scott McTominay,SCO,MF,25,1996,12.9,32,19,16,10,6,13,22,59.1,9,15,6,9,14,46,45,0,2023
ENG-Premier League,2022,Manchester Utd,Tyrell Malacia,NED,DF,22,1999,15.5,46,33,33,12,1,14,25,56.0,11,13,3,10,25,71,49,0,2023
ENG-Premier League,2022,Manchester Utd,Victor Lindelöf,SWE,DF,28,1994,15.2,22,17,10,9,3,9,17,52.9,8,18,9,9,21,43,63,1,2023
ENG-Premier League,2022,Manchester Utd,Wout Weghorst,NED,"FW,MF",29,1992,8.9,11,5,6,1,4,2,9,22.2,7,7,2,5,7,18,9,0,2023
ENG-Premier League,2022,Newcastle Utd,Alexander Isak,SWE,FW,22,1999,16.9,18,8,4,7,7,10,28,35.7,18,21,2,19,4,22,8,0,2023
ENG-Premier League,2022,Newcastle Utd,Allan Saint-Maximin,FRA,FW,25,1997,12.4,10,3,3,6,1,2,11,18.2,9,4,0,4,5,15,2,0,2023
ENG-Premier League,2022,Newcastle Utd,Anthony Gordon,ENG,"FW,MF",21,2001,5.4,14,12,5,7,2,9,20,45.0,11,9,1,8,2,16,1,1,2023
ENG-Premier League,2022,Newcastle Utd,Bruno Guimarães,BRA,MF,24,1997,30.3,78,40,27,46,5,38,65,58.5,27,28,4,24,36,114,22,1,2023
ENG-Premier League,2022,Newcastle Utd,Callum Wilson,ENG,FW,30,1992,20.9,9,3,0,8,1,0,3,0.0,3,8,0,8,1,10,5,0,2023
ENG-Premier League,2022,Newcastle Utd,Chris Wood,NZL,FW,30,1991,5.0,5,4,0,3,2,3,5,60.0,2,2,2,0,1,6,7,0,2023
ENG-Premier League,2022,Newcastle Utd,Dan Burn,ENG,DF,30,1992,34.6,60,38,29,23,8,34,67,50.7,33,42,16,26,32,92,120,2,2023
ENG-Premier League,2022,Newcastle Utd,Elliot Anderson,SCO,"MF,FW",19,2002,4.6,11,5,5,3,3,6,12,50.0,6,11,2,9,6,17,2,0,2023
ENG-Premier League,2022,Newcastle Utd,Emil Krafth,SWE,DF,27,1994,0.0,0,0,0,0,0,0,0,,0,0,0,0,0,0,0,0,2023
ENG-Premier League,2022,Newcastle Utd,Fabian Schär,SUI,DF,30,1991,35.6,47,22,31,13,3,24,39,61.5,15,34,19,15,52,99,139,0,2023
ENG-Premier League,2022,Newcastle Utd,Jacob Murphy,ENG,FW,27,1995,13.9,15,7,3,8,4,8,20,40.0,12,17,0,17,7,22,3,0,2023
ENG-Premier League,2022,Newcastle Utd,Jamaal Lascelles,ENG,DF,28,1993,2.4,1,0,1,0,0,1,1,100.0,0,3,2,1,0,1,17,0,2023
ENG-Premier League,2022,Newcastle Utd,Jamal Lewis,NIR,"DF,FW",24,1998,0.1,0,0,0,0,0,0,0,,0,0,0,0,0,0,0,0,2023
ENG-Premier League,2022,Newcastle Utd,Javier Manquillo,ESP,DF,28,1994,0.4,3,2,2,1,0,2,2,100.0,0,1,0,1,1,4,1,0,2023
ENG-Premier League,2022,Newcastle Utd,Joe Willock,ENG,MF,22,1999,28.4,51,30,13,26,12,25,58,43.1,33,54,8,46,25,76,17,0,2023
ENG-Premier League,2022,Newcastle Utd,Joelinton,BRA,"MF,FW",25,1996,29.6,70,49,36,26,8,26,62,41.9,36,52,7,45,48,118,39,0,2023
ENG-Premier League,2022,Newcastle Utd,Jonjo Shelvey,ENG,MF,30,1992,0.4,1,0,1,0,0,0,1,0.0,1,1,0,1,0,1,0,0,2023
ENG-Premier League,2022,Newcastle Utd,Kieran Trippier,ENG,DF,31,1990,37.1,71,49,36,27,8,46,90,51.1,44,45,15,30,43,114,84,2,2023
ENG-Premier League,2022,Newcastle Utd,Lewis Miley,ENG,MF,16,2006,0.2,0,0,0,0,0,0,0,,0,1,0,1,0,0,0,0,2023
ENG-Premier League,2022,Newcastle Utd,Martin Dúbravka,SVK,GK,33,1989,1.7,0,0,0,0,0,0,1,0.0,1,0,0,0,0,0,1,0,2023
ENG-Premier League,2022,Newcastle Utd,Matt Ritchie,SCO,"FW,MF",32,1989,0.4,1,1,0,1,0,1,3,33.3,2,0,0,0,1,2,0,0,2023
ENG-Premier League,2022,Newcastle Utd,Matt Targett,ENG,DF,26,1995,6.8,13,10,8,3,2,9,24,37.5,15,8,3,5,9,22,16,0,2023
ENG-Premier League,2022,Newcastle Utd,Miguel Almirón,PAR,FW,28,1994,27.7,46,30,16,19,11,18,42,42.9,24,25,2,23,10,56,17,0,2023
ENG-Premier League,2022,Newcastle Utd,Nick Pope,ENG,GK,30,1992,36.2,1,0,1,0,0,1,3,33.3,2,0,0,0,0,1,27,2,2023
ENG-Premier League,2022,Newcastle Utd,Ryan Fraser,SCO,FW,28,1994,3.5,2,2,0,0,2,2,5,40.0,3,3,1,2,0,2,3,0,2023
ENG-Premier League,2022,Newcastle Utd,Sean Longstaff,ENG,MF,24,1997,28.0,42,21,16,20,6,20,52,38.5,32,35,8,27,16,58,23,0,2023
ENG-Premier League,2022,Newcastle Utd,Sven Botman,NED,DF,22,2000,34.7,38,24,31,7,0,22,28,78.6,6,44,24,20,34,72,126,2,2023
ENG-Premier League,2022,Nott'ham Forest,Alexander Mighten,ENG,FW,20,2002,0.1,0,0,0,0,0,0,1,0.0,1,0,0,0,0,0,0,0,2023
ENG-Premier League,2022,Nott'ham Forest,André Ayew,GHA,"FW,MF",32,1989,3.5,5,3,0,4,1,2,4,50.0,2,6,1,5,0,5,7,0,2023
ENG-Premier League,2022,Nott'ham Forest,Brennan Johnson,WAL,"FW,MF",21,2001,32.6,34,20,18,8,8,8,28,28.6,20,30,1,29,5,39,7,1,2023
ENG-Premier League,2022,Nott'ham Forest,Cafú,POR,MF,29,1993,0.1,0,0,0,0,0,0,0,,0,0,0,0,0,0,1,0,2023
ENG-Premier League,2022,Nott'ham Forest,Cheikhou Kouyaté,SEN,MF,32,1989,9.8,29,21,18,8,3,9,13,69.2,4,14,2,12,10,39,24,0,2023
ENG-Premier League,2022,Nott'ham Forest,Chris Wood,NZL,FW,30,1991,4.1,0,0,0,0,0,0,1,0.0,1,2,1,1,1,1,2,0,2023
ENG-Premier League,2022,Nott'ham Forest,Danilo,BRA,MF,21,2001,10.8,18,7,7,9,2,6,25,24.0,19,26,6,20,9,27,19,0,2023
ENG-Premier League,2022,Nott'ham Forest,Dean Henderson,ENG,GK,25,1997,18.0,0,0,0,0,0,0,0,,0,0,0,0,0,0,12,1,2023
ENG-Premier League,2022,Nott'ham Forest,Emmanuel Dennis,NGA,"FW,MF",24,1997,8.0,17,11,5,5,7,8,17,47.1,9,13,1,12,2,19,6,0,2023
ENG-Premier League,2022,Nott'ham Forest,Felipe,BRA,DF,33,1989,15.8,42,23,29,13,0,24,41,58.5,17,34,13,21,36,78,90,0,2023
ENG-Premier League,2022,Nott'ham Forest,Giulian Biancone,FRA,DF,22,2000,0.2,2,1,2,0,0,1,1,100.0,0,0,0,0,1,3,0,0,2023
ENG-Premier League,2022,Nott'ham Forest,Gustavo Scarpa,BRA,"MF,FW",28,1994,2.0,5,2,3,1,1,2,5,40.0,3,4,0,4,0,5,3,0,2023
ENG-Premier League,2022,Nott'ham Forest,Harry Toffolo,ENG,DF,26,1995,10.4,17,8,10,4,3,10,14,71.4,4,16,8,8,10,27,33,0,2023
ENG-Premier League,2022,Nott'ham Forest,Jack Colback,ENG,MF,32,1989,5.5,18,13,12,6,0,5,8,62.5,3,3,0,3,3,21,9,0,2023
ENG-Premier League,2022,Nott'ham Forest,Jesse Lingard,ENG,"FW,MF",29,1992,10.3,4,4,2,2,0,1,7,14.3,6,11,0,11,5,9,4,0,2023
ENG-Premier League,2022,Nott'ham Forest,Joe Worrall,ENG,DF,25,1997,24.7,53,25,39,12,2,25,35,71.4,10,33,23,10,26,79,111,1,2023
ENG-Premier League,2022,Nott'ham Forest,Jonjo Shelvey,ENG,MF,30,1992,6.0,2,1,0,1,1,1,9,11.1,8,7,2,5,5,7,10,1,2023
ENG-Premier League,2022,Nott'ham Forest,Keylor Navas,CRC,GK,35,1986,17.0,0,0,0,0,0,0,0,,0,0,0,0,1,1,11,1,2023
ENG-Premier League,2022,Nott'ham Forest,Lewis O'Brien,ENG,MF,23,1998,6.5,16,9,4,11,1,6,12,50.0,6,13,2,11,5,21,9,0,2023
ENG-Premier League,2022,Nott'ham Forest,Morgan Gibbs-White,ENG,"MF,FW",22,2000,33.0,26,14,7,7,12,11,32,34.4,21,23,4,19,14,40,15,0,2023
ENG-Premier League,2022,Nott'ham Forest,Moussa Niakhate,SEN,DF,26,1996,12.9,18,9,15,3,0,11,22,50.0,11,18,8,10,19,37,60,0,2023
ENG-Premier League,2022,Nott'ham Forest,Neco Williams,WAL,DF,21,2001,20.9,72,47,49,17,6,38,71,53.5,33,33,8,25,33,105,48,0,2023
ENG-Premier League,2022,Nott'ham Forest,Orel Mangala,BEL,MF,24,1998,17.2,28,20,16,10,2,12,29,41.4,17,21,7,14,23,51,15,0,2023
ENG-Premier League,2022,Nott'ham Forest,Remo Freuler,SUI,MF,30,1992,24.0,43,23,23,15,5,19,43,44.2,24,36,9,27,29,72,45,0,2023
ENG-Premier League,2022,Nott'ham Forest,Renan Lodi,BRA,DF,24,1998,24.6,52,39,38,8,6,33,66,50.0,33,25,6,19,33,85,74,0,2023
ENG-Premier League,2022,Nott'ham Forest,Ryan Yates,ENG,MF,24,1997,20.4,38,19,19,16,3,14,22,63.6,8,26,8,18,10,48,44,0,2023
ENG-Premier League,2022,Nott'ham Forest,Sam Surridge,ENG,FW,24,1998,3.6,5,0,1,3,1,1,4,25.0,3,5,2,3,0,5,7,0,2023
ENG-Premier League,2022,Nott'ham Forest,Scott McKenna,SCO,DF,25,1996,17.5,12,7,7,3,2,6,10,60.0,4,20,14,6,12,24,85,1,2023
ENG-Premier League,2022,Nott'ham Forest,Serge Aurier,CIV,DF,29,1992,21.6,64,41,41,18,5,23,33,69.7,10,34,11,23,29,93,75,0,2023
ENG-Premier League,2022,Nott'ham Forest,Steve Cook,ENG,DF,31,1991,10.6,8,4,4,4,0,5,7,71.4,2,16,11,5,12,20,51,0,2023
ENG-Premier League,2022,Nott'ham Forest,Taiwo Awoniyi,NGA,FW,24,1997,15.6,17,10,2,10,5,6,10,60.0,4,18,4,14,4,21,20,0,2023
ENG-Premier League,2022,Nott'ham Forest,Wayne Hennessey,WAL,GK,35,1987,3.0,1,0,1,0,0,1,1,100.0,0,0,0,0,0,1,2,0,2023
ENG-Premier League,2022,Nott'ham Forest,Willy Boly,CIV,DF,31,1991,7.6,13,6,8,3,2,8,13,61.5,5,13,4,9,12,25,45,0,2023
ENG-Premier League,2022,Southampton,Adam Armstrong,ENG,"FW,MF",25,1997,14.8,14,9,6,5,3,3,10,30.0,7,15,3,12,5,19,6,0,2023
ENG-Premier League,2022,Southampton,Ainsley Maitland-Niles,ENG,"DF,MF",24,1997,15.6,45,24,23,18,4,28,44,63.6,16,28,7,21,22,67,45,1,2023
ENG-Premier League,2022,Southampton,Alex McCarthy,ENG,GK,32,1989,6.0,0,0,0,0,0,0,1,0.0,1,0,0,0,1,1,3,1,2023
ENG-Premier League,2022,Southampton,Armel Bella Kotchap,GER,DF,20,2001,20.9,37,17,28,9,0,15,20,75.0,5,29,12,17,44,81,110,0,2023
ENG-Premier League,2022,Southampton,Carlos Alcaraz,ARG,"MF,FW",19,2002,11.4,10,5,2,7,1,6,22,27.3,16,14,5,9,1,11,11,0,2023
ENG-Premier League,2022,Southampton,Che Adams,SCO,FW,26,1996,22.1,17,13,7,8,2,7,12,58.3,5,13,4,9,4,21,22,0,2023
ENG-Premier League,2022,Southampton,Dominic Ballard,ENG,"FW,MF",17,2005,0.3,0,0,0,0,0,0,0,,0,0,0,0,1,1,0,0,2023
ENG-Premier League,2022,Southampton,Duje Ćaleta-Car,CRO,DF,25,1996,10.5,14,10,9,4,1,6,9,66.7,3,15,11,4,15,29,65,1,2023
ENG-Premier League,2022,Southampton,Gavin Bazunu,IRL,GK,20,2002,32.0,1,0,1,0,0,1,1,100.0,0,0,0,0,1,2,24,2,2023
ENG-Premier League,2022,Southampton,Ibrahima Diallo,FRA,MF,23,1999,9.1,25,15,14,10,1,8,14,57.1,6,11,1,10,6,31,11,0,2023
ENG-Premier League,2022,Southampton,Jack Stephens,ENG,DF,28,1994,0.5,2,2,2,0,0,1,1,100.0,0,1,1,0,1,3,2,0,2023
ENG-Premier League,2022,Southampton,James Bree,ENG,DF,24,1997,4.1,5,3,4,1,0,3,4,75.0,1,3,1,2,6,11,11,0,2023
ENG-Premier League,2022,Southampton,James Ward-Prowse,ENG,MF,27,1994,37.5,65,37,31,27,7,21,61,34.4,40,30,10,20,55,120,48,0,2023
ENG-Premier League,2022,Southampton,Jan Bednarek,POL,DF,26,1996,18.6,27,21,20,7,0,12,16,75.0,4,38,27,11,49,76,87,0,2023
ENG-Premier League,2022,Southampton,Joe Aribo,NGA,"MF,FW",26,1996,13.6,31,20,15,12,4,11,20,55.0,9,14,1,13,10,41,11,0,2023
ENG-Premier League,2022,Southampton,Juan Larios,ESP,DF,18,2004,1.7,7,6,6,1,0,5,5,100.0,0,2,0,2,3,10,4,0,2023
ENG-Premier League,2022,Southampton,Kamaldeen Sulemana,GHA,"FW,MF",20,2002,10.7,15,9,4,7,4,4,14,28.6,10,16,0,16,6,21,6,0,2023
ENG-Premier League,2022,Southampton,Kami Doyle,ENG,MF,16,2005,0.1,0,0,0,0,0,0,0,,0,0,0,0,0,0,0,0,2023
ENG-Premier League,2022,Southampton,Kyle Walker-Peters,ENG,DF,25,1997,29.4,61,32,34,24,3,22,42,52.4,20,47,8,39,27,88,52,0,2023
ENG-Premier League,2022,Southampton,Lyanco,BRA,DF,25,1997,13.1,24,16,15,9,0,12,18,66.7,6,30,25,5,20,44,65,2,2023
ENG-Premier League,2022,Southampton,Mislav Oršić,CRO,MF,29,1992,0.1,1,1,1,0,0,0,0,,0,0,0,0,0,1,0,0,2023
ENG-Premier League,2022,Southampton,Mohamed Elyounoussi,NOR,"MF,FW",27,1994,24.1,46,28,22,20,4,19,43,44.2,24,40,3,37,27,73,37,0,2023
ENG-Premier League,2022,Southampton,Mohammed Salisu,GHA,DF,23,1999,21.9,51,29,33,16,2,24,34,70.6,10,56,25,31,31,82,122,1,2023
ENG-Premier League,2022,Southampton,Moussa Djenepo,MLI,"DF,FW",24,1998,7.9,19,11,13,5,1,11,26,42.3,15,19,2,17,11,30,7,0,2023
ENG-Premier League,2022,Southampton,Nathan Redmond,ENG,DF,28,1994,0.0,0,0,0,0,0,0,0,,0,0,0,0,0,0,0,0,2023
ENG-Premier League,2022,Southampton,Oriol Romeu,ESP,MF,30,1991,0.8,1,0,0,1,0,0,0,,0,1,0,1,1,2,1,0,2023
ENG-Premier League,2022,Southampton,Paul Onuachu,NGA,FW,28,1994,4.5,3,2,1,1,1,1,3,33.3,2,4,1,3,0,3,4,0,2023
ENG-Premier League,2022,Southampton,Romain Perraud,FRA,DF,24,1997,20.4,54,33,23,23,8,28,52,53.8,24,24,6,18,20,74,42,0,2023
ENG-Premier League,2022,Southampton,Roméo Lavia,BEL,MF,18,2004,24.7,60,35,27,29,4,21,53,39.6,32,47,11,36,33,93,23,1,2023
ENG-Premier League,2022,Southampton,Samuel Amo-Ameyaw,ENG,MF,16,2006,0.0,0,0,0,0,0,0,1,0.0,1,0,0,0,0,0,0,0,2023
ENG-Premier League,2022,Southampton,Samuel Edozie,ENG,"FW,MF",19,2003,6.3,17,10,6,10,1,3,8,37.5,5,7,0,7,6,23,6,0,2023
ENG-Premier League,2022,Southampton,Sekou Mara,FRA,"FW,MF",20,2002,6.2,14,10,5,8,1,3,9,33.3,6,11,0,11,1,15,5,0,2023
ENG-Premier League,2022,Southampton,Stuart Armstrong,SCO,"MF,FW",30,1992,15.6,32,21,15,13,4,14,39,35.9,25,18,0,18,10,42,9,1,2023
ENG-Premier League,2022,Southampton,Theo Walcott,ENG,"FW,MF",33,1989,12.5,13,6,8,4,1,8,27,29.6,19,8,1,7,9,22,7,0,2023
ENG-Premier League,2022,Southampton,Valentino Livramento,ENG,"DF,FW",19,2002,0.3,2,1,2,0,0,0,0,,0,0,0,0,2,4,3,0,2023
ENG-Premier League,2022,Southampton,Yan Valery,TUN,DF,23,1999,0.5,0,0,0,0,0,0,0,,0,1,0,1,0,0,3,0,2023
ENG-Premier League,2022,Tottenham,Arnaut Danjuma,NED,"FW,MF",25,1997,1.9,2,0,1,1,0,0,0,,0,1,0,1,0,2,0,0,2023
ENG-Premier League,2022,Tottenham,Ben Davies,WAL,DF,29,1993,25.4,28,11,13,13,2,14,26,53.8,12,17,8,9,18,46,72,0,2023
ENG-Premier League,2022,Tottenham,Bryan,ESP,"MF,FW",21,2001,1.6,3,1,3,0,0,0,3,0.0,3,3,0,3,1,4,1,0,2023
ENG-Premier League,2022,Tottenham,Clément Lenglet,FRA,DF,27,1995,22.4,38,23,18,15,5,16,34,47.1,18,26,11,15,18,56,68,2,2023
ENG-Premier League,2022,Tottenham,Cristian Romero,ARG,DF,24,1998,26.3,68,36,42,24,2,29,46,63.0,17,40,18,22,44,112,102,3,2023
ENG-Premier League,2022,Tottenham,Davinson Sánchez,COL,DF,26,1996,9.5,24,11,17,6,1,14,20,70.0,6,16,10,6,12,36,41,0,2023
ENG-Premier League,2022,Tottenham,Dejan Kulusevski,SWE,"MF,FW",22,2000,23.0,38,15,23,7,8,16,44,36.4,28,19,0,19,13,51,7,0,2023
ENG-Premier League,2022,Tottenham,Djed Spence,ENG,"FW,DF",21,2000,0.1,0,0,0,0,0,0,0,,0,0,0,0,0,0,0,0,2023
ENG-Premier League,2022,Tottenham,Emerson,BRA,DF,23,1999,19.3,54,33,38,12,4,27,40,67.5,13,17,3,14,18,72,75,0,2023
ENG-Premier League,2022,Tottenham,Eric Dier,ENG,DF,28,1994,31.3,30,19,16,12,2,9,19,47.4,10,41,24,17,35,65,112,2,2023
ENG-Premier League,2022,Tottenham,Fraser Forster,ENG,GK,34,1988,13.5,1,0,1,0,0,0,0,,0,1,0,1,0,1,3,1,2023
ENG-Premier League,2022,Tottenham,George Abbott,ENG,MF,16,2005,0.0,0,0,0,0,0,0,0,,0,0,0,0,1,1,0,0,2023
ENG-Premier League,2022,Tottenham,Harry Kane,ENG,FW,29,1993,37.8,15,12,1,6,8,7,21,33.3,14,27,7,20,2,17,18,0,2023
ENG-Premier League,2022,Tottenham,Harvey White,ENG,MF,20,2001,0.1,0,0,0,0,0,0,1,0.0,1,0,0,0,0,0,0,0,2023
ENG-Premier League,2022,Tottenham,Hugo Lloris,FRA,GK,35,1986,24.5,1,1,1,0,0,1,3,33.3,2,0,0,0,1,2,13,4,2023
ENG-Premier League,2022,Tottenham,Ivan Perišić,CRO,"DF,MF",33,1989,23.4,42,24,25,10,7,27,47,57.4,20,29,7,22,22,64,49,1,2023
ENG-Premier League,2022,Tottenham,Japhet Tanganga,ENG,DF,23,1999,1.6,3,2,3,0,0,1,5,20.0,4,1,0,1,2,5,8,0,2023
ENG-Premier League,2022,Tottenham,Lucas Moura,BRA,"MF,DF",29,1992,1.7,8,5,1,3,4,1,4,25.0,3,0,0,0,2,10,1,1,2023
ENG-Premier League,2022,Tottenham,Matt Doherty,IRL,"DF,MF",30,1992,7.4,16,10,12,3,1,8,10,80.0,2,11,6,5,8,24,14,1,2023
ENG-Premier League,2022,Tottenham,Matthew Craig,SCO,MF,19,2003,0.2,4,1,2,2,0,0,0,,0,0,0,0,0,4,0,0,2023
ENG-Premier League,2022,Tottenham,Oliver Skipp,ENG,MF,21,2000,16.6,34,17,18,15,1,16,33,48.5,17,17,8,9,17,51,19,1,2023
ENG-Premier League,2022,Tottenham,Pape Matar Sarr,SEN,"MF,FW",19,2002,2.4,7,6,4,2,1,4,8,50.0,4,3,2,1,6,13,6,0,2023
ENG-Premier League,2022,Tottenham,Pedro Porro,ESP,"DF,MF",22,1999,12.6,25,16,8,15,2,14,39,35.9,25,25,2,23,15,40,24,1,2023
ENG-Premier League,2022,Tottenham,Pierre Højbjerg,DEN,MF,26,1995,34.8,56,30,28,22,6,26,67,38.8,41,46,17,29,49,105,64,1,2023
ENG-Premier League,2022,Tottenham,Richarlison,BRA,"MF,FW",25,1997,11.2,21,16,13,5,3,12,27,44.4,15,14,1,13,5,26,10,0,2023
ENG-Premier League,2022,Tottenham,Rodrigo Bentancur,URU,MF,25,1997,16.7,45,28,15,21,9,16,28,57.1,12,28,15,13,20,65,22,0,2023
ENG-Premier League,2022,Tottenham,Ryan Sessegnon,ENG,DF,22,2000,9.0,16,11,9,7,0,6,12,50.0,6,8,1,7,6,22,17,1,2023
ENG-Premier League,2022,Tottenham,Son Heung-min,KOR,"MF,FW",30,1992,32.1,24,12,7,8,9,9,30,30.0,21,23,2,21,13,37,6,0,2023
ENG-Premier League,2022,Tottenham,Yves Bissouma,MLI,MF,25,1996,11.2,16,13,6,6,4,2,7,28.6,5,15,6,9,12,28,10,0,2023
ENG-Premier League,2022,West Ham,Aaron Cresswell,ENG,DF,32,1989,24.8,21,11,12,7,2,12,31,38.7,19,21,11,10,27,48,56,0,2023
ENG-Premier League,2022,West Ham,Alphonse Areola,FRA,GK,29,1993,3.4,0,0,0,0,0,0,0,,0,0,0,0,0,0,0,0,2023
ENG-Premier League,2022,West Ham,Angelo Ogbonna,ITA,DF,34,1988,13.7,11,4,7,4,0,5,10,50.0,5,11,7,4,17,28,74,1,2023
ENG-Premier League,2022,West Ham,Ben Johnson,ENG,DF,22,2000,9.6,20,14,12,4,4,12,18,66.7,6,12,4,8,9,29,28,1,2023
ENG-Premier League,2022,West Ham,Conor Coventry,IRL,"MF,FW",22,2000,0.0,0,0,0,0,0,0,0,,0,0,0,0,0,0,0,0,2023
ENG-Premier League,2022,West Ham,Craig Dawson,ENG,DF,32,1990,8.0,10,6,8,2,0,4,6,66.7,2,9,6,3,6,16,26,0,2023
ENG-Premier League,2022,West Ham,Danny Ings,ENG,FW,30,1992,8.6,9,8,0,4,5,5,14,35.7,9,8,2,6,3,12,5,0,2023
ENG-Premier League,2022,West Ham,Declan Rice,ENG,MF,23,1999,36.4,79,38,44,31,4,31,50,62.0,19,45,15,30,63,142,58,0,2023
ENG-Premier League,2022,West Ham,Divin Mubama,ENG,FW,17,2004,0.4,1,1,1,0,0,0,0,,0,0,0,0,0,1,0,0,2023
ENG-Premier League,2022,West Ham,Emerson Palmieri,ITA,DF,27,1994,14.7,26,14,9,15,2,12,24,50.0,12,17,4,13,15,41,36,0,2023
ENG-Premier League,2022,West Ham,Flynn Downes,ENG,MF,23,1999,8.5,16,9,4,10,2,6,12,50.0,6,15,2,13,7,23,6,0,2023
ENG-Premier League,2022,West Ham,Gianluca Scamacca,ITA,FW,23,1999,10.3,10,5,1,3,6,2,2,100.0,0,3,0,3,4,14,5,0,2023
ENG-Premier League,2022,West Ham,Jarrod Bowen,ENG,"FW,MF",25,1996,35.9,39,16,14,11,14,16,57,28.1,41,47,9,38,36,75,25,0,2023
ENG-Premier League,2022,West Ham,Kurt Zouma,FRA,DF,27,1994,22.1,9,4,4,5,0,5,8,62.5,3,17,14,3,30,39,120,1,2023
ENG-Premier League,2022,West Ham,Lucas Paquetá,BRA,MF,24,1997,23.9,71,53,23,36,12,27,66,40.9,39,41,4,37,16,87,31,0,2023
ENG-Premier League,2022,West Ham,Manuel Lanzini,ARG,"MF,FW",29,1993,2.8,2,2,1,1,0,2,6,33.3,4,2,0,2,2,4,0,0,2023
ENG-Premier League,2022,West Ham,Maxwel Cornet,CIV,FW,25,1996,2.7,7,3,5,0,2,4,6,66.7,2,6,0,6,2,9,3,0,2023
ENG-Premier League,2022,West Ham,Michail Antonio,JAM,FW,32,1990,20.3,14,7,1,8,5,3,12,25.0,9,13,5,8,5,19,9,0,2023
ENG-Premier League,2022,West Ham,Nayef Aguerd,MAR,DF,26,1996,17.7,27,18,18,8,1,13,20,65.0,7,26,24,2,18,45,79,2,2023
ENG-Premier League,2022,West Ham,Pablo Fornals,ESP,"FW,MF",26,1996,16.7,30,15,9,12,9,13,34,38.2,21,16,2,14,14,44,9,0,2023
ENG-Premier League,2022,West Ham,Saïd Benrahma,ALG,"FW,MF",26,1995,23.0,25,15,11,7,7,11,27,40.7,16,23,1,22,9,34,13,0,2023
ENG-Premier League,2022,West Ham,Thilo Kehrer,GER,DF,25,1996,24.8,43,24,25,14,4,21,44,47.7,23,16,6,10,34,77,76,1,2023
ENG-Premier League,2022,West Ham,Tomáš Souček,CZE,MF,27,1995,31.3,77,37,41,29,7,28,58,48.3,30,42,17,25,53,130,71,3,2023
ENG-Premier League,2022,West Ham,Vladimír Coufal,CZE,DF,29,1992,23.7,58,31,37,15,6,36,51,70.6,15,24,6,18,38,96,70,0,2023
ENG-Premier League,2022,West Ham,Łukasz Fabiański,POL,GK,37,1985,34.6,2,0,2,0,0,1,2,50.0,1,1,0,1,0,2,10,1,2023
ENG-Premier League,2022,Wolves,Adama Traoré,ESP,"FW,MF",26,1996,16.6,14,7,7,4,3,4,9,44.4,5,8,1,7,3,17,17,0,2023
ENG-Premier League,2022,Wolves,Boubacar Traoré,MLI,MF,20,2001,4.6,12,5,4,5,3,3,7,42.9,4,4,2,2,7,19,1,0,2023
ENG-Premier League,2022,Wolves,Chem Campbell,WAL,"FW,MF",19,2002,0.8,2,1,1,1,0,0,1,0.0,1,2,0,2,1,3,0,0,2023
ENG-Premier League,2022,Wolves,Connor Ronan,IRL,MF,24,1998,0.0,0,0,0,0,0,0,0,,0,0,0,0,0,0,0,0,2023
ENG-Premier League,2022,Wolves,Craig Dawson,ENG,DF,32,1990,15.7,9,6,6,3,0,4,7,57.1,3,31,23,8,12,21,74,2,2023
ENG-Premier League,2022,Wolves,Daniel Bentley,ENG,GK,29,1993,2.0,1,1,1,0,0,1,1,100.0,0,0,0,0,0,1,0,0,2023
ENG-Premier League,2022,Wolves,Daniel Podence,POR,"FW,MF",26,1995,19.7,27,17,13,9,5,6,31,19.4,25,19,0,19,7,34,6,0,2023
ENG-Premier League,2022,Wolves,Dexter Lembikisa,JAM,DF,18,2003,0.3,0,0,0,0,0,0,0,,0,0,0,0,0,0,0,0,2023
ENG-Premier League,2022,Wolves,Diego Costa,ESP,FW,33,1988,13.8,3,1,3,0,0,2,9,22.2,7,6,1,5,2,5,17,0,2023
ENG-Premier League,2022,Wolves,Gonçalo Guedes,POR,"FW,MF",25,1996,7.9,8,6,4,3,1,5,8,62.5,3,4,0,4,1,9,2,0,2023
ENG-Premier League,2022,Wolves,Hugo Bueno,ESP,DF,19,2002,14.6,33,16,23,6,4,17,33,51.5,16,14,1,13,10,43,36,0,2023
ENG-Premier League,2022,Wolves,Hwang Hee-chan,KOR,"FW,MF",26,1996,12.6,20,9,7,8,5,6,19,31.6,13,18,2,16,5,25,5,0,2023
ENG-Premier League,2022,Wolves,Jonny Castro,ESP,DF,28,1994,14.0,34,15,23,10,1,18,37,48.6,19,26,5,21,14,48,28,2,2023
ENG-Premier League,2022,Wolves,Joseph Hodge,IRL,MF,19,2002,1.9,5,2,1,3,1,3,4,75.0,1,5,0,5,0,5,2,1,2023
ENG-Premier League,2022,Wolves,José Sá,POR,GK,29,1993,36.0,1,0,1,0,0,1,1,100.0,0,0,0,0,0,1,10,6,2023
ENG-Premier League,2022,Wolves,João Gomes,BRA,MF,21,2001,7.3,29,13,14,14,1,13,23,56.5,10,12,3,9,4,33,11,0,2023
ENG-Premier League,2022,Wolves,João Moutinho,POR,MF,35,1986,19.8,51,30,24,21,6,19,46,41.3,27,22,6,16,18,69,20,0,2023
ENG-Premier League,2022,Wolves,Leander Dendoncker,BEL,MF,27,1995,2.4,4,2,0,3,1,2,3,66.7,1,2,0,2,9,13,4,0,2023
ENG-Premier League,2022,Wolves,Mario Lemina,GAB,MF,28,1993,14.4,38,24,22,13,3,20,38,52.6,18,26,8,18,14,52,24,1,2023
ENG-Premier League,2022,Wolves,Matheus Cunha,BRA,FW,23,1999,10.7,7,4,0,5,2,2,10,20.0,8,15,3,12,9,16,11,0,2023
ENG-Premier League,2022,Wolves,Matheus Nunes,POR,MF,23,1998,27.4,67,43,36,22,9,28,61,45.9,33,35,4,31,16,83,35,2,2023
ENG-Premier League,2022,Wolves,Max Kilman,ENG,DF,25,1997,36.7,36,20,26,9,1,16,30,53.3,14,70,42,28,19,55,164,1,2023
ENG-Premier League,2022,Wolves,Morgan Gibbs-White,ENG,"FW,MF",22,2000,2.0,3,1,3,0,0,2,3,66.7,1,2,0,2,1,4,3,0,2023
ENG-Premier League,2022,Wolves,Nathan Collins,IRL,DF,21,2001,20.2,27,15,19,8,0,15,24,62.5,9,35,28,7,21,48,84,0,2023
ENG-Premier League,2022,Wolves,Nélson Semedo,POR,DF,28,1993,29.2,71,42,48,19,4,33,64,51.6,31,42,15,27,29,100,83,2,2023
ENG-Premier League,2022,Wolves,Pablo Sarabia,ESP,"FW,MF",30,1992,8.5,12,6,4,5,3,6,15,40.0,9,7,0,7,2,14,4,0,2023
ENG-Premier League,2022,Wolves,Pedro Neto,POR,"FW,MF",22,2000,10.7,11,6,4,2,5,7,17,41.2,10,5,1,4,4,15,4,0,2023
ENG-Premier League,2022,Wolves,Rayan Aït Nouri,ALG,DF,21,2001,12.0,33,20,25,7,1,9,15,60.0,6,3,0,3,9,42,28,0,2023
ENG-Premier League,2022,Wolves,Raúl Jiménez,MEX,FW,31,1991,9.4,9,6,3,5,1,3,6,50.0,3,9,0,9,0,9,8,0,2023
ENG-Premier League,2022,Wolves,Rúben Neves,POR,MF,25,1997,33.5,79,43,31,33,15,32,74,43.2,42,59,22,37,50,129,85,1,2023
ENG-Premier League,2022,Wolves,Sasa Kalajdzic,AUT,FW,25,1997,0.5,0,0,0,0,0,0,0,,0,0,0,0,1,1,0,0,2023
ENG-Premier League,2022,Wolves,Toti Gomes,POR,DF,23,1999,10.9,15,9,11,4,0,9,13,69.2,4,16,8,8,11,26,51,0,2023
ESP-La Liga,2017,Alavés,Adrián Diéguez,ESP,DF,21,1996,4.8,10,5,5,5,0,6,13,46.2,7,5,0,5,11,21,24,1,2018
ESP-La Liga,2017,Alavés,Aleksandar Katai,SRB,"MF,DF",26,1991,0.6,1,1,0,1,0,0,1,0.0,1,0,0,0,0,1,0,0,2018
ESP-La Liga,2017,Alavés,Alexis,ESP,DF,31,1985,24.3,33,24,24,7,2,20,45,44.4,25,28,14,14,30,63,114,3,2018
ESP-La Liga,2017,Alavés,Alfonso Pedraza,ESP,"MF,DF",21,1996,27.1,57,40,24,21,12,19,56,33.9,37,39,5,34,32,89,26,0,2018
ESP-La Liga,2017,Alavés,Antonio Sivera,ESP,GK,20,1996,0.7,0,0,0,0,0,0,0,,0,0,0,0,0,0,0,0,2018
ESP-La Liga,2017,Alavés,Bojan Krkić,ESP,"FW,MF",26,1990,4.9,2,1,1,1,0,1,2,50.0,1,5,0,5,3,5,0,0,2018
ESP-La Liga,2017,Alavés,Burgui,ESP,"MF,FW",23,1993,11.5,10,5,2,4,4,2,6,33.3,4,5,0,5,7,17,1,0,2018
ESP-La Liga,2017,Alavés,Carlos Vigaray,ESP,DF,22,1994,9.9,27,16,16,9,2,11,16,68.8,5,5,1,4,14,41,13,0,2018
ESP-La Liga,2017,Alavés,Christian Santos,VEN,FW,29,1988,4.8,2,0,1,0,1,0,4,0.0,4,2,1,1,2,4,9,0,2018
ESP-La Liga,2017,Alavés,Daniel Torres,COL,MF,27,1989,13.5,19,11,14,5,0,7,31,22.6,24,15,7,8,19,38,32,2,2018
ESP-La Liga,2017,Alavés,Enzo Fernández,ESP,MF,22,1995,0.8,2,2,2,0,0,0,0,,0,0,0,0,0,2,1,0,2018
ESP-La Liga,2017,Alavés,Ermedin Demirović,BIH,FW,19,1998,2.0,1,1,0,1,0,0,1,0.0,1,5,0,5,0,1,2,0,2018
ESP-La Liga,2017,Alavés,Fernando Pacheco,ESP,GK,25,1992,37.3,0,0,0,0,0,0,0,,0,1,0,1,3,3,12,4,2018
ESP-La Liga,2017,Alavés,Guillermo Maripán,CHI,DF,23,1994,17.0,28,16,24,4,0,17,32,53.1,15,19,10,9,36,64,108,0,2018
ESP-La Liga,2017,Alavés,Hernán Pérez,PAR,MF,28,1989,4.2,11,8,6,4,1,2,19,10.5,17,5,0,5,3,14,6,0,2018
ESP-La Liga,2017,Alavés,Héctor Hernández,ESP,DF,26,1991,0.2,1,1,0,1,0,1,1,100.0,0,0,0,0,0,1,1,0,2018
ESP-La Liga,2017,Alavés,Ibai Gómez,ESP,"MF,FW",27,1989,25.8,19,15,11,4,4,6,30,20.0,24,16,1,15,15,34,20,1,2018
ESP-La Liga,2017,Alavés,John Guidetti,SWE,FW,25,1992,13.6,7,7,3,1,3,2,10,20.0,8,10,1,9,2,9,7,0,2018
ESP-La Liga,2017,Alavés,Manu García,ESP,MF,31,1986,27.1,95,65,38,51,6,24,89,27.0,65,34,11,23,35,130,67,0,2018
ESP-La Liga,2017,Alavés,Martin Agirregabiria,ESP,DF,21,1996,20.3,50,33,31,17,2,32,50,64.0,18,13,7,6,41,91,66,0,2018
ESP-La Liga,2017,Alavés,Munir El Haddadi,MAR,FW,21,1995,27.2,25,20,8,9,8,5,14,35.7,9,13,2,11,9,34,5,0,2018
ESP-La Liga,2017,Alavés,Rodrigo Ely,BRA,DF,23,1993,29.9,32,18,26,6,0,19,34,55.9,15,45,36,9,50,82,183,0,2018
ESP-La Liga,2017,Alavés,Rubén Duarte,ESP,DF,21,1995,23.8,76,40,42,27,7,35,59,59.3,24,40,10,30,44,120,94,0,2018
ESP-La Liga,2017,Alavés,Rubén Sobrino,ESP,"FW,MF",25,1992,16.3,33,24,12,16,5,6,27,22.2,21,19,2,17,18,51,10,0,2018
ESP-La Liga,2017,Alavés,Tomás Pina Isla,ESP,MF,29,1987,26.5,71,49,27,38,6,20,40,50.0,20,28,10,18,43,114,37,0,2018
ESP-La Liga,2017,Alavés,Víctor Laguardia,ESP,DF,27,1989,17.0,20,15,13,5,2,11,19,57.9,8,23,14,9,29,49,109,0,2018
ESP-La Liga,2017,Alavés,Víctor López,ESP,MF,20,1997,0.7,2,1,0,2,0,0,1,0.0,1,0,0,0,1,3,1,0,2018
ESP-La Liga,2017,Alavés,Wakaso,GHA,MF,27,1990,12.2,43,30,25,15,3,13,39,33.3,26,22,1,21,35,78,21,0,2018
ESP-La Liga,2017,Alavés,Álvaro Medrán,ESP,MF,23,1994,10.5,20,14,5,10,5,8,21,38.1,13,7,0,7,13,33,10,0,2018
ESP-La Liga,2017,Alavés,Óscar Romero,PAR,"MF,FW",25,1992,2.8,5,2,4,1,0,0,3,0.0,3,3,0,3,3,8,2,0,2018
ESP-La Liga,2017,Athletic Club,Ager Aketxe,ESP,MF,23,1993,0.4,1,1,1,0,0,1,2,50.0,1,1,0,1,1,2,0,0,2018
ESP-La Liga,2017,Athletic Club,Ander Iturraspe,ESP,MF,28,1989,21.2,42,31,18,22,2,10,32,31.3,22,22,7,15,35,77,57,0,2018
ESP-La Liga,2017,Athletic Club,Andoni López,ESP,DF,21,1996,1.0,1,0,1,0,0,1,1,100.0,0,1,0,1,1,2,6,0,2018
ESP-La Liga,2017,Athletic Club,Aritz Aduriz,ESP,FW,36,1981,23.9,11,8,2,6,3,1,6,16.7,5,6,0,6,3,14,18,0,2018
ESP-La Liga,2017,Athletic Club,Aymeric Laporte,ESP,DF,23,1994,19.0,38,23,27,11,0,14,25,56.0,11,19,13,6,27,65,94,1,2018
ESP-La Liga,2017,Athletic Club,Beñat Etxebarria,ESP,MF,30,1987,12.4,28,20,12,13,3,13,36,36.1,23,6,1,5,28,56,12,0,2018
ESP-La Liga,2017,Athletic Club,Eneko Bóveda,ESP,DF,28,1988,5.8,12,11,7,4,1,5,11,45.5,6,3,0,3,14,26,14,0,2018
ESP-La Liga,2017,Athletic Club,Enric Saborit,ESP,DF,25,1992,15.9,50,27,31,17,2,19,29,65.5,10,17,5,12,24,74,55,0,2018
ESP-La Liga,2017,Athletic Club,Iago Herrerín,ESP,GK,29,1988,8.0,2,1,2,0,0,2,2,100.0,0,0,0,0,0,2,7,1,2018
ESP-La Liga,2017,Athletic Club,Iker Muniain,ESP,"MF,FW",24,1992,8.7,10,8,2,6,2,1,7,14.3,6,4,0,4,4,14,3,0,2018
ESP-La Liga,2017,Athletic Club,Iñaki Williams,GHA,"FW,MF",23,1994,31.7,28,17,11,15,2,8,41,19.5,33,24,2,22,17,45,13,0,2018
ESP-La Liga,2017,Athletic Club,Iñigo Córdoba,ESP,FW,20,1997,16.2,44,30,18,21,5,16,58,27.6,42,31,0,31,21,65,9,0,2018
ESP-La Liga,2017,Athletic Club,Iñigo Lekue,ESP,"DF,FW",24,1993,23.5,71,42,37,26,8,34,53,64.2,19,29,3,26,16,87,46,1,2018
ESP-La Liga,2017,Athletic Club,Iñigo Martínez,ESP,DF,26,1991,16.0,28,20,20,8,0,18,29,62.1,11,17,8,9,30,58,82,0,2018
ESP-La Liga,2017,Athletic Club,Kepa Arrizabalaga,ESP,GK,22,1994,30.0,0,0,0,0,0,0,2,0.0,2,0,0,0,2,2,6,2,2018
ESP-La Liga,2017,Athletic Club,Markel Susaeta,ESP,"FW,MF",29,1987,25.2,42,29,16,15,11,16,65,24.6,49,17,0,17,18,60,13,0,2018
ESP-La Liga,2017,Athletic Club,Mikel Balenziaga,ESP,DF,29,1988,17.2,34,24,17,13,4,15,27,55.6,12,24,5,19,17,51,61,0,2018
ESP-La Liga,2017,Athletic Club,Mikel Rico,ESP,MF,32,1984,13.0,24,13,7,16,1,12,34,35.3,22,15,5,10,23,47,12,1,2018
ESP-La Liga,2017,Athletic Club,Mikel San José,ESP,MF,28,1989,23.9,52,37,19,23,10,19,73,26.0,54,43,13,30,41,93,30,0,2018
ESP-La Liga,2017,Athletic Club,Mikel Vesga,ESP,MF,24,1993,9.0,17,8,6,11,0,4,25,16.0,21,14,3,11,8,25,15,0,2018
ESP-La Liga,2017,Athletic Club,Raúl García,ESP,"MF,FW",31,1986,29.2,82,51,28,36,18,26,71,36.6,45,55,3,52,30,112,23,0,2018
ESP-La Liga,2017,Athletic Club,Sabin Merino,ESP,"FW,MF",25,1992,4.2,7,3,2,3,2,3,8,37.5,5,6,2,4,1,8,10,0,2018
ESP-La Liga,2017,Athletic Club,Unai Núñez,ESP,DF,20,1997,32.7,73,52,54,19,0,38,56,67.9,18,52,27,25,67,140,155,2,2018
ESP-La Liga,2017,Athletic Club,Xabier Etxeita,ESP,DF,29,1987,4.2,2,2,2,0,0,1,4,25.0,3,3,2,1,7,9,25,1,2018
ESP-La Liga,2017,Athletic Club,Yeray Álvarez,ESP,DF,22,1995,7.5,12,7,8,4,0,6,9,66.7,3,8,2,6,11,23,18,0,2018
ESP-La Liga,2017,Athletic Club,Óscar de Marcos,ESP,"DF,FW",28,1989,18.4,28,21,11,15,2,13,29,44.8,16,15,2,13,19,47,36,0,2018
ESP-La Liga,2017,Atlético Madrid,Antoine Griezmann,FRA,"FW,MF",26,1991,28.0,36,24,6,23,7,10,30,33.3,20,20,1,19,10,46,14,0,2018
ESP-La Liga,2017,Atlético Madrid,Arona Sané,SEN,"MF,FW",22,1995,0.7,1,0,1,0,0,0,0,,0,1,0,1,0,1,0,0,2018
ESP-La Liga,2017,Atlético Madrid,Augusto Fernández,ARG,MF,31,1986,1.2,3,2,1,2,0,1,3,33.3,2,3,2,1,2,5,3,0,2018
ESP-La Liga,2017,Atlético Madrid,Axel Werner,ARG,GK,21,1996,1.0,0,0,0,0,0,0,0,,0,0,0,0,0,0,1,0,2018
ESP-La Liga,2017,Atlético Madrid,Carlos Isaac,ESP,DF,19,1998,0.7,1,0,1,0,0,1,3,33.3,2,0,0,0,2,3,1,0,2018
ESP-La Liga,2017,Atlético Madrid,Diego Costa,ESP,FW,28,1988,11.6,17,11,2,10,5,4,15,26.7,11,14,4,10,5,22,3,0,2018
ESP-La Liga,2017,Atlético Madrid,Diego Godín,URU,DF,31,1986,28.4,50,33,37,11,2,26,47,55.3,21,33,20,13,59,109,145,1,2018
ESP-La Liga,2017,Atlético Madrid,Fernando Torres,ESP,FW,33,1984,10.9,11,8,3,7,1,2,6,33.3,4,4,1,3,2,13,9,0,2018
ESP-La Liga,2017,Atlético Madrid,Filipe Luís,BRA,DF,31,1985,18.4,83,52,41,33,9,36,49,73.5,13,27,7,20,35,118,34,0,2018
ESP-La Liga,2017,Atlético Madrid,Gabi,ESP,MF,34,1983,26.1,80,49,39,37,4,38,104,36.5,66,28,10,18,44,124,38,0,2018
ESP-La Liga,2017,Atlético Madrid,Jan Oblak,SVN,GK,24,1993,37.0,0,0,0,0,0,0,0,,0,0,0,0,2,2,7,0,2018
ESP-La Liga,2017,Atlético Madrid,José María Giménez,URU,DF,22,1995,18.8,38,27,29,6,3,23,35,65.7,12,28,15,13,30,68,101,1,2018
ESP-La Liga,2017,Atlético Madrid,Juanfran,ESP,DF,32,1985,14.5,33,24,21,9,3,21,32,65.6,11,14,4,10,26,59,35,0,2018
ESP-La Liga,2017,Atlético Madrid,Koke,ESP,MF,25,1992,30.6,75,45,31,32,12,27,95,28.4,68,40,3,37,24,99,38,0,2018
ESP-La Liga,2017,Atlético Madrid,Kévin Gameiro,FRA,FW,30,1987,12.5,11,9,3,4,4,1,10,10.0,9,6,0,6,4,15,11,0,2018
ESP-La Liga,2017,Atlético Madrid,Lucas Hernández,FRA,DF,21,1996,23.5,93,68,51,35,7,55,74,74.3,19,35,10,25,40,133,90,0,2018
ESP-La Liga,2017,Atlético Madrid,Luciano Vietto,ARG,FW,23,1993,3.0,5,4,1,2,2,0,3,0.0,3,3,0,3,3,8,3,0,2018
ESP-La Liga,2017,Atlético Madrid,Nicolás Gaitán,ARG,"MF,FW",29,1988,2.4,9,6,3,5,1,3,9,33.3,6,2,0,2,1,10,3,0,2018
ESP-La Liga,2017,Atlético Madrid,Saúl Ñíguez,ESP,MF,22,1994,35.1,132,90,53,69,10,40,104,38.5,64,61,12,49,55,187,77,0,2018
ESP-La Liga,2017,Atlético Madrid,Stefan Savić,MNE,DF,26,1991,25.5,30,20,23,7,0,16,39,41.0,23,38,23,15,45,75,150,1,2018
ESP-La Liga,2017,Atlético Madrid,Thomas Partey,GHA,"MF,DF",24,1993,26.4,94,64,48,39,7,33,69,47.8,36,32,7,25,53,147,34,1,2018
ESP-La Liga,2017,Atlético Madrid,Toni Moya,ESP,MF,19,1998,0.0,0,0,0,0,0,0,0,,0,0,0,0,0,0,0,0,2018
ESP-La Liga,2017,Atlético Madrid,Vitolo,ESP,"MF,FW",27,1989,6.9,9,6,4,3,2,3,15,20.0,12,10,1,9,6,15,5,0,2018
ESP-La Liga,2017,Atlético Madrid,Yannick Carrasco,BEL,"MF,FW",23,1993,10.0,17,13,7,5,5,3,8,37.5,5,9,0,9,4,21,3,0,2018
ESP-La Liga,2017,Atlético Madrid,Ángel Correa,ARG,"MF,FW",22,1995,25.0,41,29,12,16,13,8,57,14.0,49,30,1,29,25,66,17,0,2018
ESP-La Liga,2017,Atlético Madrid,Šime Vrsaljko,CRO,DF,25,1992,18.8,48,30,25,17,6,26,40,65.0,14,24,8,16,36,84,63,0,2018
ESP-La Liga,2017,Barcelona,Aleix Vidal,ESP,"MF,FW",27,1989,5.1,6,4,2,3,1,1,10,10.0,9,4,0,4,9,15,1,0,2018
ESP-La Liga,2017,Barcelona,André Gomes,POR,MF,24,1993,7.1,19,12,8,10,1,5,13,38.5,8,7,1,6,4,23,6,0,2018
ESP-La Liga,2017,Barcelona,Andrés Iniesta,ESP,MF,33,1984,20.3,28,22,11,8,9,6,31,19.4,25,21,2,19,10,38,12,1,2018
ESP-La Liga,2017,Barcelona,Denis Suárez,ESP,"MF,FW",23,1994,6.6,11,9,3,8,0,3,8,37.5,5,7,0,7,2,13,3,0,2018
ESP-La Liga,2017,Barcelona,Gerard Deulofeu,ESP,"MF,FW",23,1994,5.6,8,5,6,1,1,3,4,75.0,1,2,0,2,8,16,0,0,2018
ESP-La Liga,2017,Barcelona,Gerard Piqué,ESP,DF,30,1987,29.2,31,22,22,9,0,16,36,44.4,20,40,27,13,30,61,127,0,2018
ESP-La Liga,2017,Barcelona,Ivan Rakitić,CRO,MF,29,1988,31.5,52,31,16,30,6,15,45,33.3,30,42,7,35,44,96,16,0,2018
ESP-La Liga,2017,Barcelona,Jasper Cillessen,NED,GK,28,1989,1.0,0,0,0,0,0,0,0,,0,0,0,0,0,0,0,0,2018
ESP-La Liga,2017,Barcelona,Javier Mascherano,ARG,DF,33,1984,6.0,15,13,9,6,0,8,9,88.9,1,14,8,6,8,23,20,0,2018
ESP-La Liga,2017,Barcelona,Jordi Alba,ESP,DF,28,1989,30.5,63,42,35,22,6,26,52,50.0,26,34,5,29,68,131,67,1,2018
ESP-La Liga,2017,Barcelona,José Arnaiz,ESP,MF,22,1995,0.1,1,1,0,1,0,0,0,,0,0,0,0,0,1,0,0,2018
ESP-La Liga,2017,Barcelona,Lionel Messi,ARG,FW,30,1987,33.3,17,8,0,11,6,2,18,11.1,16,11,1,10,7,24,0,0,2018
ESP-La Liga,2017,Barcelona,Lucas Digne,FRA,DF,24,1993,7.8,22,17,13,6,3,8,12,66.7,4,15,3,12,12,34,18,0,2018
ESP-La Liga,2017,Barcelona,Luis Suárez,URU,FW,30,1987,32.2,17,10,4,5,8,4,19,21.1,15,4,3,1,8,25,31,0,2018
ESP-La Liga,2017,Barcelona,Marc-André ter Stegen,GER,GK,25,1992,37.0,1,0,1,0,0,1,3,33.3,2,1,0,1,4,5,12,1,2018
ESP-La Liga,2017,Barcelona,Nélson Semedo,POR,DF,23,1993,16.6,34,25,19,11,4,17,29,58.6,12,16,2,14,22,56,26,1,2018
ESP-La Liga,2017,Barcelona,Ousmane Dembélé,FRA,"FW,MF",20,1997,10.3,10,7,2,5,3,1,13,7.7,12,8,0,8,5,15,2,0,2018
ESP-La Liga,2017,Barcelona,Paco Alcácer,ESP,"MF,FW",23,1993,7.7,4,3,0,2,2,0,6,0.0,6,5,0,5,11,15,3,0,2018
ESP-La Liga,2017,Barcelona,Paulinho,BRA,MF,29,1988,21.6,39,28,17,15,7,11,38,28.9,27,25,3,22,15,54,16,1,2018
ESP-La Liga,2017,Barcelona,Philippe Coutinho,BRA,"MF,FW",25,1992,14.4,27,14,8,14,5,9,32,28.1,23,14,0,14,6,33,4,0,2018
ESP-La Liga,2017,Barcelona,Samuel Umtiti,FRA,DF,23,1993,24.3,50,35,35,15,0,20,29,69.0,9,25,17,8,37,87,72,3,2018
ESP-La Liga,2017,Barcelona,Sergi Roberto,ESP,DF,25,1992,24.7,63,40,30,25,8,25,49,51.0,24,18,8,10,39,102,30,1,2018
ESP-La Liga,2017,Barcelona,Sergio Busquets,ESP,MF,29,1988,28.8,88,48,27,46,15,39,79,49.4,40,37,10,27,51,139,15,1,2018
ESP-La Liga,2017,Barcelona,Thomas Vermaelen,BEL,DF,31,1985,11.3,13,9,7,5,1,5,11,45.5,6,10,3,7,18,31,28,0,2018
ESP-La Liga,2017,Barcelona,Yerry Mina,COL,DF,22,1994,4.1,10,8,6,4,0,4,6,66.7,2,6,3,3,6,16,16,0,2018
ESP-La Liga,2017,Betis,Aitor Ruibal,ESP,MF,21,1996,0.1,0,0,0,0,0,0,0,,0,0,0,0,0,0,0,0,2018
ESP-La Liga,2017,Betis,Alin Toșca,ROU,DF,25,1992,4.7,12,9,7,5,0,5,9,55.6,4,7,1,6,5,17,17,1,2018
ESP-La Liga,2017,Betis,Andrés Guardado,MEX,MF,30,1986,25.2,41,27,17,18,6,15,55,27.3,40,27,5,22,22,63,29,1,2018
ESP-La Liga,2017,Betis,Antonio Adán,ESP,GK,30,1987,30.0,1,0,1,0,0,1,1,100.0,0,1,0,1,0,1,11,2,2018
ESP-La Liga,2017,Betis,Antonio Barragán,ESP,DF,30,1987,26.4,59,42,40,11,8,24,36,66.7,12,22,5,17,24,83,66,0,2018
ESP-La Liga,2017,Betis,Antonio Sanabria,PAR,FW,21,1996,9.5,8,8,0,4,4,0,3,0.0,3,5,0,5,4,12,6,0,2018
ESP-La Liga,2017,Betis,Aïssa Mandi,ALG,DF,25,1991,33.6,54,35,27,25,2,19,34,55.9,15,39,24,15,71,125,133,3,2018
ESP-La Liga,2017,Betis,Cristian Tello,ESP,"FW,MF",25,1991,18.8,32,24,12,14,6,7,37,18.9,30,19,0,19,16,48,4,1,2018
ESP-La Liga,2017,Betis,Dani Giménez,ESP,GK,34,1983,3.4,0,0,0,0,0,0,0,,0,0,0,0,0,0,0,0,2018
ESP-La Liga,2017,Betis,Fabián Ruiz Peña,ESP,MF,21,1996,29.5,83,53,34,40,9,26,73,35.6,47,35,3,32,42,125,36,1,2018
ESP-La Liga,2017,Betis,Francis Guerrero,ESP,"DF,MF",21,1996,11.0,31,19,22,7,2,16,34,47.1,18,16,4,12,21,52,26,0,2018
ESP-La Liga,2017,Betis,Javi García,ESP,"MF,DF",30,1987,26.8,34,22,18,16,0,13,40,32.5,27,19,12,7,25,59,78,1,2018
ESP-La Liga,2017,Betis,Joaquín,ESP,"MF,FW",36,1981,27.5,22,19,11,10,1,4,16,25.0,12,17,2,15,15,37,38,0,2018
ESP-La Liga,2017,Betis,Joel Campbell,CRC,"MF,FW",25,1992,2.4,6,2,3,3,0,3,6,50.0,3,2,0,2,0,6,0,0,2018
ESP-La Liga,2017,Betis,Jordi Amat,IDN,"DF,MF",25,1992,22.7,32,23,15,16,1,11,24,45.8,13,14,4,10,38,70,77,2,2018
ESP-La Liga,2017,Betis,Juanjo Narváez,COL,MF,22,1995,3.4,8,6,4,4,0,3,6,50.0,3,3,0,3,8,16,4,0,2018
ESP-La Liga,2017,Betis,Julio Gracia,ESP,"DF,FW",19,1998,0.3,0,0,0,0,0,0,0,,0,0,0,0,1,1,0,0,2018
ESP-La Liga,2017,Betis,Junior Firpo,ESP,DF,20,1996,13.2,26,17,15,8,3,10,18,55.6,8,21,2,19,20,46,37,1,2018
ESP-La Liga,2017,Betis,Loren Morón,ESP,FW,23,1993,11.8,14,8,4,5,5,4,17,23.5,13,14,1,13,1,15,12,0,2018
ESP-La Liga,2017,Betis,Marc Bartra,ESP,DF,26,1991,15.8,38,28,30,8,0,21,39,53.8,18,19,10,9,32,70,97,1,2018
ESP-La Liga,2017,Betis,Matías Nahuel,ESP,"MF,FW",20,1996,2.8,4,4,1,1,2,2,5,40.0,3,2,0,2,2,6,1,0,2018
ESP-La Liga,2017,Betis,Pedro López,ESP,GK,22,1995,4.6,0,0,0,0,0,0,0,,0,1,0,1,0,0,3,0,2018
ESP-La Liga,2017,Betis,Rafa Navarro,ESP,DF,23,1994,1.5,3,2,3,0,0,0,4,0.0,4,0,0,0,1,4,6,0,2018
ESP-La Liga,2017,Betis,Riza Durmisi,DEN,DF,23,1994,23.1,39,21,24,14,1,10,18,55.6,8,18,7,11,15,54,65,1,2018
ESP-La Liga,2017,Betis,Rubén Castro,ESP,FW,36,1981,4.0,1,1,0,0,1,0,0,,0,0,0,0,0,1,2,0,2018
ESP-La Liga,2017,Betis,Ryad Boudebouz,ALG,"MF,FW",27,1990,15.1,32,18,6,21,5,6,26,23.1,20,18,1,17,7,39,8,0,2018
ESP-La Liga,2017,Betis,Sergio León,ESP,FW,28,1989,22.0,13,7,3,6,4,3,11,27.3,8,12,1,11,6,19,5,0,2018
ESP-La Liga,2017,Betis,Víctor Camarasa,ESP,MF,23,1994,13.9,20,15,8,10,2,3,13,23.1,10,8,0,8,15,35,13,0,2018
ESP-La Liga,2017,Betis,Zouhair Feddal,MAR,DF,28,1989,14.0,22,14,14,6,2,7,12,58.3,5,17,13,4,36,58,95,2,2018
ESP-La Liga,2017,Celta Vigo,Andreu Fontàs,ESP,DF,27,1989,9.8,13,9,8,5,0,3,13,23.1,10,9,5,4,14,27,30,0,2018
ESP-La Liga,2017,Celta Vigo,Andrew Hjulsager,DEN,"DF,MF",22,1995,0.2,0,0,0,0,0,0,2,0.0,2,1,0,1,0,0,0,0,2018
ESP-La Liga,2017,Celta Vigo,Brais Méndez,ESP,"MF,FW",20,1997,10.5,19,15,9,6,4,7,17,41.2,10,13,0,13,4,23,12,0,2018
ESP-La Liga,2017,Celta Vigo,Daniel Molina Orta,ESP,MF,21,1996,0.1,0,0,0,0,0,0,0,,0,0,0,0,0,0,0,0,2018
ESP-La Liga,2017,Celta Vigo,Daniel Wass,DEN,"MF,DF",28,1989,32.6,30,21,8,18,4,8,25,32.0,17,23,3,20,30,60,47,0,2018
ESP-La Liga,2017,Celta Vigo,Emre Mor,TUR,"FW,MF",20,1997,7.4,14,7,6,7,1,6,11,54.5,5,7,1,6,4,18,7,0,2018
ESP-La Liga,2017,Celta Vigo,Facundo Roncaglia,ARG,DF,30,1987,16.6,35,25,30,5,0,22,36,61.1,14,18,6,12,31,66,50,1,2018
ESP-La Liga,2017,Celta Vigo,Gustavo Cabral,ARG,DF,31,1985,21.0,29,21,14,15,0,14,38,36.8,24,22,11,11,43,72,106,2,2018
ESP-La Liga,2017,Celta Vigo,Hugo Mallo,ESP,DF,26,1991,33.3,84,55,55,26,3,35,53,66.0,18,30,15,15,68,152,111,1,2018
ESP-La Liga,2017,Celta Vigo,Iago Aspas,ESP,FW,29,1987,32.6,26,22,10,10,6,5,34,14.7,29,15,1,14,23,49,11,1,2018
ESP-La Liga,2017,Celta Vigo,John Guidetti,SWE,"FW,MF",25,1992,1.3,0,0,0,0,0,0,0,,0,0,0,0,0,0,0,0,2018
ESP-La Liga,2017,Celta Vigo,Jonny Castro,ESP,DF,23,1994,35.6,102,78,60,31,11,43,91,47.3,48,48,8,40,93,195,92,1,2018
ESP-La Liga,2017,Celta Vigo,Jozabed,ESP,MF,26,1991,16.4,18,12,7,9,2,3,18,16.7,15,18,2,16,16,34,19,0,2018
ESP-La Liga,2017,Celta Vigo,Lucas Boyé,ARG,"FW,MF",21,1996,3.1,12,8,3,7,2,3,10,30.0,7,5,0,5,6,18,4,0,2018
ESP-La Liga,2017,Celta Vigo,Maxi Gómez,URU,FW,20,1996,34.1,7,4,1,4,2,0,18,0.0,18,9,4,5,3,10,34,0,2018
ESP-La Liga,2017,Celta Vigo,Nemanja Radoja,SRB,MF,24,1993,12.3,18,16,6,8,4,3,8,37.5,5,8,2,6,10,28,11,0,2018
ESP-La Liga,2017,Celta Vigo,Pablo Hernández,CHI,MF,30,1986,20.2,48,33,17,27,4,14,46,30.4,32,29,11,18,40,88,72,0,2018
ESP-La Liga,2017,Celta Vigo,Pione Sisto,DEN,"FW,MF",22,1995,28.0,18,12,8,6,4,9,33,27.3,24,12,1,11,12,30,7,1,2018
ESP-La Liga,2017,Celta Vigo,Rubén Blanco,ESP,GK,22,1995,21.6,0,0,0,0,0,0,2,0.0,2,1,0,1,3,3,16,1,2018
ESP-La Liga,2017,Celta Vigo,Róbert Mazáň,SVK,DF,23,1994,0.9,0,0,0,0,0,0,1,0.0,1,1,0,1,2,2,0,0,2018
ESP-La Liga,2017,Celta Vigo,Sergi Gómez,ESP,DF,25,1992,29.8,52,37,38,13,1,20,34,58.8,14,32,22,10,56,108,118,1,2018
ESP-La Liga,2017,Celta Vigo,Sergio Álvarez,ESP,GK,30,1986,16.4,0,0,0,0,0,0,1,0.0,1,1,0,1,0,0,11,1,2018
ESP-La Liga,2017,Celta Vigo,Stanislav Lobotka,SVK,MF,22,1994,34.0,64,45,24,35,5,23,65,35.4,42,25,9,16,39,103,22,0,2018
ESP-La Liga,2017,Eibar,Anaitz Arbilla,ESP,DF,30,1987,26.8,38,30,24,12,2,21,40,52.5,19,21,10,11,78,116,108,2,2018
ESP-La Liga,2017,Eibar,Ander Capa,ESP,DF,25,1992,25.0,57,38,34,14,9,25,38,65.8,13,21,2,19,52,109,50,1,2018
ESP-La Liga,2017,Eibar,Asier Riesgo,ESP,GK,33,1983,1.0,0,0,0,0,0,0,0,,0,0,0,0,0,0,0,0,2018
ESP-La Liga,2017,Eibar,Bebé,CPV,"MF,FW",27,1990,4.1,9,7,1,4,4,3,8,37.5,5,5,0,5,3,12,1,0,2018
ESP-La Liga,2017,Eibar,Charles,BRA,FW,33,1984,17.6,11,8,2,5,4,1,8,12.5,7,7,0,7,7,18,10,0,2018
ESP-La Liga,2017,Eibar,Cristian Rivera,ESP,MF,20,1997,2.7,13,10,4,8,1,5,7,71.4,2,2,2,0,3,16,2,0,2018
ESP-La Liga,2017,Eibar,Dani García,ESP,MF,27,1990,30.8,80,59,23,47,10,31,80,38.8,49,28,4,24,70,150,25,0,2018
ESP-La Liga,2017,Eibar,David Juncà,ESP,DF,23,1993,10.0,15,13,9,6,0,7,19,36.8,12,7,1,6,11,26,25,0,2018
ESP-La Liga,2017,Eibar,David Lombán,ESP,DF,30,1987,11.0,16,8,12,3,1,10,15,66.7,5,6,4,2,29,45,66,2,2018
ESP-La Liga,2017,Eibar,Fabián Orellana,CHI,"MF,FW",31,1986,13.1,14,8,5,8,1,4,23,17.4,19,10,1,9,7,21,3,0,2018
ESP-La Liga,2017,Eibar,Gonzalo Escalante,ARG,MF,24,1993,17.4,59,35,21,32,6,17,39,43.6,22,26,3,23,32,91,19,0,2018
ESP-La Liga,2017,Eibar,Imanol Sarriegi,ESP,"MF,FW",22,1995,0.5,2,2,1,0,1,2,3,66.7,1,2,0,2,1,3,0,0,2018
ESP-La Liga,2017,Eibar,Iván Alejo,ESP,"MF,FW",22,1995,12.2,20,16,4,9,7,1,10,10.0,9,9,0,9,5,25,1,0,2018
ESP-La Liga,2017,Eibar,Iván Ramis,ESP,DF,32,1984,14.5,20,14,8,12,0,8,19,42.1,11,12,5,7,25,45,51,2,2018
ESP-La Liga,2017,Eibar,Joan Jordán,ESP,MF,23,1994,27.0,31,24,8,19,4,10,68,14.7,58,24,0,24,30,61,12,0,2018
ESP-La Liga,2017,Eibar,José Ángel,ESP,DF,27,1989,27.0,61,44,36,19,6,38,58,65.5,20,31,1,30,38,99,76,0,2018
ESP-La Liga,2017,Eibar,Kike,ESP,FW,27,1989,27.3,14,8,1,7,6,2,11,18.2,9,15,1,14,10,24,14,0,2018
ESP-La Liga,2017,Eibar,Marko Dmitrović,SRB,GK,25,1992,36.0,4,4,4,0,0,4,11,36.4,7,1,0,1,2,6,26,2,2018
ESP-La Liga,2017,Eibar,Papakouli Diop,SEN,MF,31,1986,10.4,26,20,6,16,4,11,26,42.3,15,3,0,3,13,39,10,0,2018
ESP-La Liga,2017,Eibar,Paulo Oliveira,POR,DF,25,1992,24.6,41,22,28,13,0,16,22,72.7,6,23,9,14,62,103,140,0,2018
ESP-La Liga,2017,Eibar,Pedro León,ESP,"FW,MF",30,1986,10.3,9,4,0,2,7,0,4,0.0,4,18,2,16,9,18,5,0,2018
ESP-La Liga,2017,Eibar,Rubén Peña,ESP,"DF,MF",26,1991,19.2,41,28,20,17,4,20,42,47.6,22,24,6,18,30,71,31,0,2018
ESP-La Liga,2017,Eibar,Sergi Enrich,ESP,FW,27,1990,14.8,11,8,3,3,5,2,8,25.0,6,13,1,12,6,17,8,0,2018
ESP-La Liga,2017,Eibar,Takashi Inui,JPN,"MF,FW",29,1988,29.2,39,21,12,19,8,13,42,31.0,29,36,0,36,18,57,10,0,2018
ESP-La Liga,2017,Eibar,Xesc Regis,ESP,FW,20,1996,0.0,1,1,0,1,0,0,0,,0,0,0,0,0,1,0,0,2018
ESP-La Liga,2017,Eibar,Yoel,ESP,GK,28,1988,1.0,0,0,0,0,0,0,0,,0,0,0,0,0,0,2,0,2018
ESP-La Liga,2017,Eibar,Álex Gálvez,ESP,DF,28,1989,4.0,11,4,5,6,0,7,12,58.3,5,5,1,4,13,24,17,0,2018
ESP-La Liga,2017,Espanyol,Aarón Martín,ESP,DF,20,1997,31.3,56,36,41,12,3,31,59,52.5,28,26,5,21,49,105,78,0,2018
ESP-La Liga,2017,Espanyol,Carlos Sánchez,COL,MF,31,1986,12.5,25,12,6,16,3,9,24,37.5,15,13,5,8,18,43,24,2,2018
ESP-La Liga,2017,Espanyol,David López,ESP,"DF,MF",27,1989,37.0,67,49,47,19,1,27,54,50.0,27,43,26,17,67,134,161,0,2018
ESP-La Liga,2017,Espanyol,Diego López,ESP,GK,35,1981,9.5,0,0,0,0,0,0,1,0.0,1,0,0,0,0,0,1,0,2018
ESP-La Liga,2017,Espanyol,Dídac Vilà,ESP,"DF,MF",28,1989,8.1,29,26,15,9,5,13,18,72.2,5,14,3,11,14,43,27,0,2018
ESP-La Liga,2017,Espanyol,Esteban Granero,ESP,MF,30,1987,13.7,32,22,15,13,4,9,27,33.3,18,19,0,19,19,51,21,0,2018
ESP-La Liga,2017,Espanyol,Gerard Moreno,ESP,FW,25,1992,37.9,41,28,7,22,12,12,53,22.6,41,27,6,21,19,60,46,0,2018
ESP-La Liga,2017,Espanyol,Hernán Pérez,PAR,"MF,DF",28,1989,1.6,4,3,1,1,2,2,3,66.7,1,1,0,1,1,5,1,0,2018
ESP-La Liga,2017,Espanyol,Javi Fuego,ESP,MF,33,1984,14.9,34,25,19,12,3,11,28,39.3,17,15,6,9,19,53,23,0,2018
ESP-La Liga,2017,Espanyol,Javi López,ESP,DF,31,1986,10.7,47,35,31,12,4,18,35,51.4,17,7,2,5,18,65,48,0,2018
ESP-La Liga,2017,Espanyol,José Manuel Jurado,ESP,"MF,FW",31,1986,16.7,18,14,8,8,2,5,14,35.7,9,13,1,12,16,34,5,0,2018
ESP-La Liga,2017,Espanyol,Léo Baptistão,BRA,"FW,MF",24,1992,29.7,54,34,12,28,14,13,52,25.0,39,22,1,21,23,77,25,0,2018
ESP-La Liga,2017,Espanyol,Marc Navarro,ESP,DF,22,1995,12.3,20,13,12,8,0,10,20,50.0,10,11,6,5,22,42,17,0,2018
ESP-La Liga,2017,Espanyol,Marc Roca,ESP,MF,20,1996,2.9,8,7,3,5,0,3,4,75.0,1,4,2,2,4,12,10,0,2018
ESP-La Liga,2017,Espanyol,Mario Hermoso,ESP,DF,22,1995,21.4,14,12,13,1,0,8,21,38.1,13,15,8,7,25,39,122,0,2018
ESP-La Liga,2017,Espanyol,Naldo,BRA,DF,28,1988,10.2,14,8,12,1,1,5,10,50.0,5,13,10,3,16,30,57,1,2018
ESP-La Liga,2017,Espanyol,Pablo Piatti,ARG,"MF,FW",28,1989,19.3,45,32,14,21,10,17,57,29.8,40,28,3,25,22,67,16,0,2018
ESP-La Liga,2017,Espanyol,Papakouli Diop,SEN,MF,31,1986,2.9,5,3,1,3,1,0,3,0.0,3,5,2,3,6,11,6,0,2018
ESP-La Liga,2017,Espanyol,Pau López,ESP,GK,22,1994,28.5,0,0,0,0,0,0,0,,0,0,0,0,1,1,15,2,2018
ESP-La Liga,2017,Espanyol,Sergi Darder,ESP,MF,23,1993,30.9,64,43,29,28,7,19,62,30.6,43,31,5,26,52,116,48,1,2018
ESP-La Liga,2017,Espanyol,Sergio García,ESP,"FW,MF",34,1983,18.2,15,12,1,10,4,3,22,13.6,19,6,3,3,10,25,12,0,2018
ESP-La Liga,2017,Espanyol,Sergio Sánchez,ESP,DF,31,1986,1.1,4,3,4,0,0,3,4,75.0,1,1,0,1,3,7,3,0,2018
ESP-La Liga,2017,Espanyol,Víctor Sánchez,ESP,"MF,DF",29,1987,27.3,106,72,56,45,5,49,113,43.4,64,38,14,24,79,185,73,1,2018
ESP-La Liga,2017,Espanyol,Óscar Duarte,CRC,DF,28,1989,11.0,12,9,8,4,0,4,11,36.4,7,8,8,0,9,21,60,2,2018
ESP-La Liga,2017,Espanyol,Óscar Melendo,ESP,"MF,FW",19,1997,7.6,2,2,2,0,0,0,5,0.0,5,2,0,2,3,5,3,0,2018
ESP-La Liga,2017,Getafe,Alberto Redondo,ESP,DF,20,1997,1.0,4,3,4,0,0,2,4,50.0,2,2,1,1,0,4,1,0,2018
ESP-La Liga,2017,Getafe,Amath,SEN,"MF,FW",21,1996,31.8,78,53,32,28,18,24,89,27.0,65,36,3,33,33,111,20,0,2018
ESP-La Liga,2017,Getafe,Barri,ESP,"MF,FW",21,1995,1.3,1,0,0,1,0,0,4,0.0,4,1,1,0,1,2,3,0,2018
ESP-La Liga,2017,Getafe,Bruno González,ESP,DF,27,1990,17.1,25,18,18,7,0,13,26,50.0,13,11,3,8,31,56,107,0,2018
ESP-La Liga,2017,Getafe,Cala,ESP,DF,27,1989,20.0,21,14,16,5,0,13,27,48.1,14,21,10,11,39,60,124,0,2018
ESP-La Liga,2017,Getafe,Carlos Calderón,ESP,MF,22,1995,0.0,1,1,0,0,1,0,0,,0,0,0,0,0,1,0,0,2018
ESP-La Liga,2017,Getafe,Damián Suárez,URU,DF,29,1988,32.0,86,64,54,21,11,44,90,48.9,46,34,8,26,46,132,76,1,2018
ESP-La Liga,2017,Getafe,Daniel Pacheco,ESP,"MF,FW",26,1991,1.9,4,4,1,2,1,0,1,0.0,1,2,0,2,2,6,1,0,2018
ESP-La Liga,2017,Getafe,David Alba,ESP,DF,18,1999,0.7,1,1,1,0,0,1,1,100.0,0,0,0,0,0,1,7,1,2018
ESP-La Liga,2017,Getafe,Djené,TOG,DF,25,1991,36.0,87,65,71,15,1,34,52,65.4,18,33,14,19,78,165,190,1,2018
ESP-La Liga,2017,Getafe,Emiliano Martínez,ARG,GK,24,1992,5.0,0,0,0,0,0,0,0,,0,0,0,0,0,0,3,0,2018
ESP-La Liga,2017,Getafe,Fayçal Fajr,MAR,"MF,FW",28,1988,26.5,62,45,22,34,6,17,66,25.8,49,26,4,22,30,92,42,0,2018
ESP-La Liga,2017,Getafe,Francisco Molinero,ESP,DF,32,1985,6.4,13,10,10,3,0,7,16,43.8,9,6,0,6,14,27,27,0,2018
ESP-La Liga,2017,Getafe,Francisco Portillo,ESP,"MF,FW",27,1990,27.3,38,23,15,18,5,11,45,24.4,34,25,1,24,22,60,21,0,2018
ESP-La Liga,2017,Getafe,Gaku Shibasaki,JPN,"MF,FW",25,1992,11.1,21,10,8,10,3,6,21,28.6,15,6,1,5,19,40,9,0,2018
ESP-La Liga,2017,Getafe,Hugo Duro,ESP,FW,17,1999,0.2,0,0,0,0,0,0,1,0.0,1,0,0,0,0,0,0,0,2018
ESP-La Liga,2017,Getafe,Jefferson Montero,ECU,"MF,FW",27,1989,0.6,1,1,1,0,0,1,1,100.0,0,0,0,0,0,1,2,0,2018
ESP-La Liga,2017,Getafe,Jorge Molina,ESP,FW,35,1982,31.0,18,10,3,6,9,4,27,14.8,23,25,4,21,7,25,27,0,2018
ESP-La Liga,2017,Getafe,Leandro Cabrera,URU,DF,26,1991,8.0,19,10,12,7,0,7,17,41.2,10,9,5,4,22,41,37,0,2018
ESP-La Liga,2017,Getafe,Loïc Rémy,FRA,"FW,MF",30,1987,5.1,4,2,1,3,0,1,5,20.0,4,4,0,4,1,5,2,0,2018
ESP-La Liga,2017,Getafe,Markel Bergara,ESP,MF,31,1986,16.3,35,22,17,17,1,7,25,28.0,18,10,3,7,23,58,20,0,2018
ESP-La Liga,2017,Getafe,Mathieu Flamini,FRA,MF,33,1984,5.3,11,5,3,7,1,4,9,44.4,5,2,0,2,8,19,8,0,2018
ESP-La Liga,2017,Getafe,Mathías Olivera,URU,MF,19,1997,1.1,3,1,1,0,2,3,5,60.0,2,3,0,3,1,4,2,0,2018
ESP-La Liga,2017,Getafe,Mauro Arambarri,URU,MF,21,1995,23.6,56,41,19,30,7,14,47,29.8,33,26,3,23,25,81,36,0,2018
ESP-La Liga,2017,Getafe,Mehdi Lacen,ALG,MF,33,1984,0.7,3,1,2,1,0,0,0,,0,1,0,1,0,3,1,0,2018
ESP-La Liga,2017,Getafe,Merveille Ndockyt,CGO,"MF,FW",19,1998,0.8,1,1,0,1,0,0,1,0.0,1,2,0,2,2,3,0,0,2018
ESP-La Liga,2017,Getafe,Miguel Ángel Rubio,ESP,DF,19,1998,0.3,0,0,0,0,0,0,0,,0,0,0,0,0,0,1,0,2018
ESP-La Liga,2017,Getafe,Sergio Mora,ESP,MF,37,1979,9.0,21,15,8,12,1,14,31,45.2,17,10,2,8,15,36,11,0,2018
ESP-La Liga,2017,Getafe,Vicente Guaita,ESP,GK,30,1987,33.0,0,0,0,0,0,0,0,,0,0,0,0,3,3,12,1,2018
ESP-La Liga,2017,Getafe,Vitorino Antunes,POR,DF,30,1987,31.1,58,44,42,14,2,38,74,51.4,36,31,3,28,58,116,89,1,2018
ESP-La Liga,2017,Getafe,Álvaro Jiménez,ESP,"MF,FW",22,1995,5.9,15,8,5,6,4,8,21,38.1,13,6,0,6,1,16,6,0,2018
ESP-La Liga,2017,Getafe,Ángel Rodríguez,ESP,FW,30,1987,25.5,28,19,3,19,6,3,26,11.5,23,18,3,15,6,34,14,0,2018
ESP-La Liga,2017,Girona,Aday,ESP,DF,29,1987,20.4,17,15,11,4,2,6,17,35.3,11,19,3,16,25,42,52,1,2018
ESP-La Liga,2017,Girona,Aleix García,ESP,MF,20,1997,9.5,24,14,13,9,2,12,22,54.5,10,9,1,8,17,41,12,0,2018
ESP-La Liga,2017,Girona,Anthony Lozano,HON,"FW,MF",24,1993,5.2,9,5,2,7,0,1,5,20.0,4,3,0,3,3,12,2,0,2018
ESP-La Liga,2017,Girona,Bernardo Espinosa,COL,DF,28,1989,31.9,36,22,29,6,1,18,33,54.5,15,27,19,8,66,102,169,0,2018
ESP-La Liga,2017,Girona,Borja García,ESP,MF,26,1990,31.1,39,18,15,18,6,13,39,33.3,26,31,2,29,30,69,15,0,2018
ESP-La Liga,2017,Girona,Carles Planas,ESP,DF,26,1991,2.1,5,2,4,1,0,3,6,50.0,3,1,0,1,5,10,6,0,2018
ESP-La Liga,2017,Girona,Cristhian Stuani,URU,FW,30,1986,30.1,22,14,2,17,3,3,29,10.3,26,10,0,10,5,27,32,0,2018
ESP-La Liga,2017,Girona,David Timor,ESP,"MF,DF",27,1989,10.3,17,10,7,7,3,7,18,38.9,11,10,5,5,20,37,30,1,2018
ESP-La Liga,2017,Girona,Douglas Luiz,BRA,"MF,FW",19,1998,3.4,10,9,4,6,0,3,11,27.3,8,1,0,1,4,14,0,0,2018
ESP-La Liga,2017,Girona,Eloi Amagat,ESP,MF,32,1985,0.2,0,0,0,0,0,0,1,0.0,1,0,0,0,0,0,0,0,2018
ESP-La Liga,2017,Girona,Gorka Iraizoz,ESP,GK,36,1981,8.5,1,1,1,0,0,1,2,50.0,1,0,0,0,1,2,9,2,2018
ESP-La Liga,2017,Girona,Johan Mojica,COL,DF,24,1992,23.7,42,27,31,8,3,21,37,56.8,16,24,3,21,32,74,42,2,2018
ESP-La Liga,2017,Girona,Jonás Ramalho,ESP,DF,24,1993,25.5,25,16,20,5,0,15,24,62.5,9,25,11,14,35,60,115,0,2018
ESP-La Liga,2017,Girona,Juanpe,ESP,DF,26,1991,34.1,48,30,28,20,0,30,43,69.8,13,27,19,8,53,101,137,0,2018
ESP-La Liga,2017,Girona,Kévin Soni,CMR,MF,19,1998,0.2,1,1,0,1,0,0,0,,0,0,0,0,0,1,0,0,2018
ESP-La Liga,2017,Girona,Marc Muniesa,ESP,DF,25,1992,12.5,33,18,17,15,1,11,23,47.8,12,12,5,7,33,66,40,0,2018
ESP-La Liga,2017,Girona,Marlos Moreno,COL,"MF,DF",20,1996,0.3,1,1,0,0,1,0,1,0.0,1,1,0,1,0,1,0,0,2018
ESP-La Liga,2017,Girona,Michael Olunga,KEN,"FW,MF",23,1994,4.8,6,5,1,3,2,1,3,33.3,2,5,0,5,3,9,5,0,2018
ESP-La Liga,2017,Girona,Olarenwaju Kayode,NGA,"FW,MF",24,1993,4.3,3,3,1,2,0,0,4,0.0,4,1,0,1,1,4,0,0,2018
ESP-La Liga,2017,Girona,Pablo Maffeo,ESP,DF,20,1997,29.4,74,55,39,23,12,25,49,51.0,24,28,7,21,50,124,82,0,2018
ESP-La Liga,2017,Girona,Pedro Alcalá,ESP,DF,28,1989,7.7,9,5,5,4,0,1,3,33.3,2,7,3,4,14,23,41,0,2018
ESP-La Liga,2017,Girona,Pere Pons,ESP,MF,24,1993,28.4,80,54,28,48,4,23,87,26.4,64,28,3,25,30,110,25,0,2018
ESP-La Liga,2017,Girona,Portu,ESP,MF,25,1992,33.3,30,24,9,11,10,8,33,24.2,25,14,0,14,12,42,1,0,2018
ESP-La Liga,2017,Girona,Yassine Bounou,MAR,GK,26,1991,29.5,1,1,1,0,0,0,2,0.0,2,0,0,0,4,5,14,0,2018
ESP-La Liga,2017,Girona,Álex Granell,ESP,MF,28,1988,31.6,78,53,31,39,8,38,114,33.3,76,46,3,43,47,125,29,0,2018
ESP-La Liga,2017,La Coruña,Adrián López,ESP,"FW,MF",29,1988,26.1,24,14,11,8,5,7,25,28.0,18,22,4,18,10,34,49,0,2018
ESP-La Liga,2017,La Coruña,Alejandro Arribas,ESP,DF,28,1989,3.0,2,2,1,1,0,1,5,20.0,4,5,3,2,6,8,8,0,2018
ESP-La Liga,2017,La Coruña,Borja Valle,ESP,"FW,MF",25,1992,5.4,6,6,3,3,0,1,4,25.0,3,2,0,2,3,9,4,0,2018
ESP-La Liga,2017,La Coruña,Bruno Gama,POR,"FW,MF",29,1987,1.3,1,1,1,0,0,1,3,33.3,2,0,0,0,0,1,2,0,2018
ESP-La Liga,2017,La Coruña,Carles Gil,ESP,"FW,MF",24,1992,5.3,6,4,1,4,1,1,5,20.0,4,5,0,5,4,10,0,0,2018
ESP-La Liga,2017,La Coruña,Celso Borges,CRC,MF,29,1988,25.6,61,39,34,22,5,15,47,31.9,32,39,7,32,34,95,36,0,2018
ESP-La Liga,2017,La Coruña,Costel Pantilimon,ROU,GK,30,1987,6.0,0,0,0,0,0,0,1,0.0,1,0,0,0,0,0,0,1,2018
ESP-La Liga,2017,La Coruña,Edu Expósito,ESP,"MF,FW",20,1996,1.1,1,0,0,0,1,0,1,0.0,1,1,0,1,2,3,2,0,2018
ESP-La Liga,2017,La Coruña,Emre Çolak,TUR,MF,26,1991,16.1,24,19,4,14,6,7,28,25.0,21,7,1,6,7,31,5,1,2018
ESP-La Liga,2017,La Coruña,Eneko Bóveda,ESP,DF,28,1988,7.4,24,16,13,10,1,8,13,61.5,5,18,7,11,16,40,36,2,2018
ESP-La Liga,2017,La Coruña,Fabian Schär,SUI,DF,25,1991,24.7,59,45,45,14,0,32,61,52.5,29,36,20,16,45,104,141,1,2018
ESP-La Liga,2017,La Coruña,Federico Cartabia,ARG,"FW,MF",24,1993,14.7,37,23,15,15,7,11,30,36.7,19,15,0,15,18,55,10,0,2018
ESP-La Liga,2017,La Coruña,Federico Valverde,URU,"MF,FW",19,1998,13.7,25,16,12,10,3,8,15,53.3,7,12,1,11,21,46,17,0,2018
ESP-La Liga,2017,La Coruña,Fernando Navarro,ESP,DF,35,1982,11.6,32,22,24,7,1,16,25,64.0,9,13,3,10,29,61,49,0,2018
ESP-La Liga,2017,La Coruña,Florin Andone,ROU,FW,24,1993,18.2,9,7,4,4,1,4,17,23.5,13,9,2,7,3,12,12,0,2018
ESP-La Liga,2017,La Coruña,Francis Uzoho,NGA,GK,18,1998,2.0,0,0,0,0,0,0,0,,0,0,0,0,0,0,1,0,2018
ESP-La Liga,2017,La Coruña,Gerard Valentín,ESP,"DF,FW",24,1993,1.8,5,4,4,0,1,1,2,50.0,1,1,0,1,3,8,3,0,2018
ESP-La Liga,2017,La Coruña,Guilherme,BRA,MF,26,1991,29.3,79,56,35,37,7,28,77,36.4,49,36,9,27,46,125,62,0,2018
ESP-La Liga,2017,La Coruña,Juanfran,ESP,DF,28,1988,34.0,64,44,38,22,4,35,65,53.8,30,29,11,18,63,127,121,0,2018
ESP-La Liga,2017,La Coruña,Lucas Pérez,ESP,FW,28,1988,31.1,17,12,5,8,4,1,32,3.1,31,19,1,18,9,26,1,0,2018
ESP-La Liga,2017,La Coruña,Luisinho,POR,DF,32,1985,29.1,111,77,64,40,7,65,96,67.7,31,24,4,20,55,166,113,0,2018
ESP-La Liga,2017,La Coruña,Maksym Koval,UKR,GK,24,1992,1.3,0,0,0,0,0,0,0,,0,0,0,0,0,0,0,2,2018
ESP-La Liga,2017,La Coruña,Michael Krohn-Dehli,DEN,MF,34,1983,8.1,12,9,6,5,1,4,17,23.5,13,2,0,2,13,25,7,0,2018
ESP-La Liga,2017,La Coruña,Mujaid Sadick,ESP,DF,17,2000,1.2,4,2,2,2,0,2,3,66.7,1,3,2,1,1,5,4,0,2018
ESP-La Liga,2017,La Coruña,Pedro Mosquera,ESP,MF,29,1988,15.5,48,31,15,29,4,13,38,34.2,25,26,6,20,23,71,38,0,2018
ESP-La Liga,2017,La Coruña,Przemysław Tytoń,POL,GK,30,1987,1.1,0,0,0,0,0,0,0,,0,0,0,0,0,0,0,0,2018
ESP-La Liga,2017,La Coruña,Raúl Albentosa,ESP,DF,28,1988,19.4,13,6,9,4,0,7,20,35.0,13,26,19,7,26,39,92,1,2018
ESP-La Liga,2017,La Coruña,Rubén,ESP,GK,33,1984,27.5,1,0,1,0,0,1,3,33.3,2,0,0,0,1,2,5,4,2018
ESP-La Liga,2017,La Coruña,Sidnei,BRA,DF,27,1989,19.8,41,28,30,11,0,18,25,72.0,7,26,9,17,31,72,101,1,2018
ESP-La Liga,2017,La Coruña,Steve Aldo One,CMR,DF,22,1995,1.0,1,0,0,1,0,0,0,,0,0,0,0,0,1,7,0,2018
ESP-La Liga,2017,La Coruña,Sulley Muntari,GHA,MF,32,1984,4.5,9,7,2,7,0,1,7,14.3,6,10,4,6,11,20,10,0,2018
ESP-La Liga,2017,La Coruña,Zakaria Bakkali,BEL,"FW,MF",21,1996,10.1,12,10,7,4,1,4,14,28.6,10,5,0,5,4,16,6,0,2018
ESP-La Liga,2017,Las Palmas,Alberto Aquilani,ITA,MF,33,1984,14.4,33,19,13,17,3,11,31,35.5,20,20,4,16,23,56,23,0,2018
ESP-La Liga,2017,Las Palmas,Alen Halilović,CRO,"FW,MF",21,1996,14.5,11,7,5,6,0,4,17,23.5,13,10,1,9,5,16,4,0,2018
ESP-La Liga,2017,Las Palmas,Aythami Artiles,ESP,DF,31,1986,2.0,2,2,2,0,0,0,1,0.0,1,2,1,1,2,4,19,0,2018
ESP-La Liga,2017,Las Palmas,Benito Ramírez,ESP,"FW,DF",22,1995,1.8,6,3,2,3,1,1,5,20.0,4,0,0,0,2,8,3,0,2018
ESP-La Liga,2017,Las Palmas,Borja Herrera,ESP,DF,24,1993,2.7,2,1,2,0,0,2,7,28.6,5,6,1,5,3,5,4,0,2018
ESP-La Liga,2017,Las Palmas,Dani Castellano,ESP,DF,29,1987,22.5,46,29,29,16,1,25,48,52.1,23,28,7,21,42,88,64,1,2018
ESP-La Liga,2017,Las Palmas,David García,ESP,DF,35,1982,9.6,16,10,10,4,2,8,12,66.7,4,15,8,7,19,35,33,1,2018
ESP-La Liga,2017,Las Palmas,David Simón,ESP,DF,28,1988,8.0,24,17,11,10,3,9,16,56.3,7,13,4,9,22,46,11,1,2018
ESP-La Liga,2017,Las Palmas,Erik Expósito,ESP,FW,21,1996,5.2,1,1,0,1,0,0,6,0.0,6,6,0,6,1,2,5,0,2018
ESP-La Liga,2017,Las Palmas,Fabio González,ESP,MF,20,1997,0.7,2,1,2,0,0,1,4,25.0,3,1,0,1,1,3,1,0,2018
ESP-La Liga,2017,Las Palmas,Gabriel Peñalba,ARG,MF,32,1984,6.3,6,5,4,2,0,5,11,45.5,6,7,4,3,8,14,15,0,2018
ESP-La Liga,2017,Las Palmas,Hernán,ESP,MF,26,1990,3.9,18,9,8,7,3,10,17,58.8,7,2,0,2,8,26,5,0,2018
ESP-La Liga,2017,Las Palmas,Hernán Toledo,ARG,"FW,MF",21,1996,6.9,5,5,2,2,1,1,11,9.1,10,2,0,2,5,10,5,0,2018
ESP-La Liga,2017,Las Palmas,Imoh Ezekiel,NGA,"MF,FW",23,1993,5.2,8,6,3,2,3,3,4,75.0,1,4,0,4,2,10,3,0,2018
ESP-La Liga,2017,Las Palmas,Jairo Samperio,ESP,"FW,MF",24,1993,6.2,9,6,2,6,1,3,13,23.1,10,5,1,4,1,10,5,0,2018
ESP-La Liga,2017,Las Palmas,Javi Castellano,ESP,MF,29,1987,17.4,47,27,20,25,2,20,37,54.1,17,23,6,17,38,85,16,1,2018
ESP-La Liga,2017,Las Palmas,Jonathan Calleri,ARG,FW,23,1993,34.5,24,16,5,10,9,4,23,17.4,19,15,2,13,7,31,35,0,2018
ESP-La Liga,2017,Las Palmas,Jonathan Viera,ESP,MF,27,1989,22.1,36,25,10,22,4,3,28,10.7,25,21,0,21,11,47,2,0,2018
ESP-La Liga,2017,Las Palmas,Leandro Chichizola,ARG,GK,27,1990,27.0,2,0,2,0,0,2,6,33.3,4,0,0,0,4,6,29,3,2018
ESP-La Liga,2017,Las Palmas,Loïc Rémy,FRA,FW,30,1987,8.5,4,3,1,3,0,0,1,0.0,1,0,0,0,1,5,2,0,2018
ESP-La Liga,2017,Las Palmas,Matías Aguirregaray,URU,DF,28,1989,12.8,26,20,12,12,2,12,32,37.5,20,13,1,12,24,50,25,0,2018
ESP-La Liga,2017,Las Palmas,Mauricio Lemos,URU,"DF,MF",21,1995,14.0,22,10,17,5,0,15,27,55.6,12,16,13,3,25,47,51,1,2018
ESP-La Liga,2017,Las Palmas,Michel,BRA,DF,27,1990,23.7,33,24,21,8,4,14,25,56.0,11,21,11,10,39,72,64,1,2018
ESP-La Liga,2017,Las Palmas,Momo,ESP,"FW,MF",35,1982,7.5,14,8,8,3,3,4,13,30.8,9,5,0,5,5,19,1,0,2018
ESP-La Liga,2017,Las Palmas,Nacho Gil,ESP,"FW,MF",21,1995,8.1,10,6,6,2,2,5,21,23.8,16,9,0,9,6,16,2,0,2018
ESP-La Liga,2017,Las Palmas,Oghenekaro Etebo,NGA,MF,21,1995,13.5,24,17,9,12,3,12,26,46.2,14,17,3,14,27,51,10,0,2018
ESP-La Liga,2017,Las Palmas,Oussama Tannane,MAR,FW,23,1994,6.4,15,13,6,8,1,7,12,58.3,5,5,0,5,5,20,0,0,2018
ESP-La Liga,2017,Las Palmas,Pedro Bigas,ESP,DF,26,1990,9.9,14,9,10,4,0,7,13,53.8,6,18,11,7,16,30,41,2,2018
ESP-La Liga,2017,Las Palmas,Raúl Lizoain,ESP,GK,26,1991,11.0,1,0,1,0,0,1,3,33.3,2,0,0,0,1,2,2,3,2018
ESP-La Liga,2017,Las Palmas,Sergi Samper,ESP,MF,22,1995,1.6,10,4,4,6,0,2,3,66.7,1,0,0,0,0,10,0,0,2018
ESP-La Liga,2017,Las Palmas,Sergio Araujo,ARG,"MF,FW",25,1992,0.4,3,2,0,0,3,1,1,100.0,0,0,0,0,0,3,0,0,2018
ESP-La Liga,2017,Las Palmas,Tana,ESP,"MF,FW",26,1990,17.2,31,24,13,14,4,12,36,33.3,24,8,0,8,23,54,5,0,2018
ESP-La Liga,2017,Las Palmas,Vicente Gómez,ESP,MF,28,1988,16.9,21,13,6,11,4,10,29,34.5,19,18,4,14,17,38,14,1,2018
ESP-La Liga,2017,Las Palmas,Vitolo,ESP,"FW,MF",27,1989,7.7,15,12,9,5,1,4,17,23.5,13,10,3,7,6,21,9,0,2018
ESP-La Liga,2017,Las Palmas,Ximo Navarro,ESP,DF,27,1990,29.0,63,43,44,19,0,28,50,56.0,22,27,16,11,66,129,131,4,2018
ESP-La Liga,2017,Las Palmas,Álex Gálvez,ESP,DF,28,1989,18.0,50,36,26,24,0,22,41,53.7,19,20,11,9,43,93,74,2,2018
ESP-La Liga,2017,Leganés,Alejandro Gutiérrez Mozo,ESP,MF,22,1995,0.5,3,2,1,2,0,1,4,25.0,3,0,0,0,0,3,0,0,2018
ESP-La Liga,2017,Leganés,Alexander,ARG,"MF,FW",28,1988,11.8,14,11,2,11,1,2,12,16.7,10,11,0,11,22,36,4,0,2018
ESP-La Liga,2017,Leganés,Claudio Beauvue,GLP,FW,29,1988,18.6,5,3,2,2,1,1,12,8.3,11,7,0,7,2,7,16,0,2018
ESP-La Liga,2017,Leganés,Darko Brašanac,SRB,"MF,FW",25,1992,13.4,32,17,11,17,4,13,33,39.4,20,14,3,11,14,46,12,0,2018
ESP-La Liga,2017,Leganés,Diego Rico,ESP,DF,24,1993,24.8,68,43,37,21,10,36,53,67.9,17,30,6,24,76,144,61,0,2018
ESP-La Liga,2017,Leganés,Dimitris Siovas,GRE,DF,28,1988,22.9,48,33,43,5,0,29,46,63.0,17,27,12,15,62,110,89,0,2018
ESP-La Liga,2017,Leganés,Erik Morán,ESP,MF,26,1991,2.5,2,2,1,0,1,0,3,0.0,3,1,1,0,4,6,0,0,2018
ESP-La Liga,2017,Leganés,Ezequiel Muñoz,ARG,DF,26,1990,15.6,36,28,24,12,0,11,20,55.0,9,18,11,7,24,60,84,0,2018
ESP-La Liga,2017,Leganés,Gabriel,BRA,MF,23,1993,26.4,90,69,28,54,8,29,74,39.2,45,38,4,34,38,128,27,0,2018
ESP-La Liga,2017,Leganés,Gerard Gumbau,ESP,MF,22,1994,15.9,35,26,13,21,1,12,37,32.4,25,12,4,8,14,49,27,0,2018
ESP-La Liga,2017,Leganés,Iván Cuéllar,ESP,GK,33,1984,35.0,4,3,4,0,0,3,4,75.0,1,0,0,0,3,7,22,6,2018
ESP-La Liga,2017,Leganés,Jaime Sierra Mateos,ESP,"FW,MF",19,1998,0.3,1,1,1,0,0,0,1,0.0,1,0,0,0,1,2,0,0,2018
ESP-La Liga,2017,Leganés,Javier Eraso,ESP,"MF,FW",27,1990,28.1,32,15,10,18,4,13,42,31.0,29,16,5,11,23,55,17,0,2018
ESP-La Liga,2017,Leganés,Jon Ander Serantes,ESP,GK,27,1989,1.0,0,0,0,0,0,0,0,,0,0,0,0,0,0,0,1,2018
ESP-La Liga,2017,Leganés,Joseba Zaldúa,ESP,DF,25,1992,28.4,68,52,31,31,6,39,62,62.9,23,28,5,23,61,129,85,0,2018
ESP-La Liga,2017,Leganés,Martín Mantovani,ARG,DF,33,1984,11.4,12,5,10,2,0,7,10,70.0,3,10,6,4,22,34,67,0,2018
ESP-La Liga,2017,Leganés,Mauro dos Santos,ARG,DF,28,1989,10.9,16,14,11,5,0,10,15,66.7,5,7,5,2,12,28,53,1,2018
ESP-La Liga,2017,Leganés,Miguel Ángel Guerrero,ESP,FW,27,1990,16.0,7,5,0,2,5,1,11,9.1,10,11,0,11,9,16,16,0,2018
ESP-La Liga,2017,Leganés,Nabil El Zhar,MAR,"FW,MF",30,1986,22.0,11,6,4,6,1,3,18,16.7,15,14,1,13,18,29,3,0,2018
ESP-La Liga,2017,Leganés,Naranjo,ESP,"MF,FW",23,1994,6.2,17,10,3,12,2,4,12,33.3,8,11,1,10,3,20,4,0,2018
ESP-La Liga,2017,Leganés,Nereo Champagne,ARG,GK,32,1985,2.0,0,0,0,0,0,0,0,,0,0,0,0,0,0,3,0,2018
ESP-La Liga,2017,Leganés,Nordin Amrabat,MAR,"FW,MF",30,1987,18.0,19,10,5,10,4,5,17,29.4,12,13,0,13,5,24,2,0,2018
ESP-La Liga,2017,Leganés,Omar Ramos,ESP,"FW,MF",29,1988,16.1,22,14,6,8,8,9,22,40.9,13,16,1,15,14,36,15,0,2018
ESP-La Liga,2017,Leganés,Raúl García,ESP,DF,28,1989,15.5,34,25,24,9,1,18,30,60.0,12,18,3,15,19,53,50,1,2018
ESP-La Liga,2017,Leganés,Rubén Pérez,ESP,MF,28,1989,28.0,99,61,47,48,4,48,101,47.5,53,30,5,25,77,176,40,0,2018
ESP-La Liga,2017,Leganés,Sergio Segura García,ESP,DF,21,1995,0.3,,2,,,,,,,,,,,1,,,,2018
ESP-La Liga,2017,Leganés,Tito,ESP,DF,32,1985,6.8,8,5,5,3,0,6,18,33.3,12,12,5,7,12,20,16,0,2018
ESP-La Liga,2017,Leganés,Unai Bustinza,ESP,DF,25,1992,18.2,36,21,25,8,3,21,38,55.3,17,17,9,8,47,83,64,0,2018
ESP-La Liga,2017,Levante,Aly Abeid,MTN,DF,19,1997,0.9,2,1,1,1,0,0,1,0.0,1,1,0,1,3,5,3,0,2018
ESP-La Liga,2017,Levante,Antonio Luna,ESP,DF,26,1991,22.5,39,26,23,13,3,24,41,58.5,17,26,9,17,36,75,68,0,2018
ESP-La Liga,2017,Levante,Armando Sadiku,ALB,FW,26,1991,3.0,1,1,0,1,0,0,1,0.0,1,4,2,2,2,3,2,0,2018
ESP-La Liga,2017,Levante,Cheick Doukouré,CIV,MF,24,1992,11.4,34,19,18,15,1,6,22,27.3,16,15,4,11,14,48,4,0,2018
ESP-La Liga,2017,Levante,Chema,ESP,DF,25,1992,22.4,20,13,14,6,0,9,18,50.0,9,43,27,16,30,50,110,1,2018
ESP-La Liga,2017,Levante,Coke,ESP,DF,30,1987,15.4,35,23,26,7,2,18,39,46.2,21,17,5,12,34,69,46,0,2018
ESP-La Liga,2017,Levante,Emmanuel Boateng,GHA,FW,21,1996,14.2,4,3,0,0,4,0,6,0.0,6,8,1,7,5,9,17,0,2018
ESP-La Liga,2017,Levante,Enes Ünal,TUR,FW,20,1997,6.6,6,6,2,2,2,1,10,10.0,9,7,1,6,2,8,5,0,2018
ESP-La Liga,2017,Levante,Enis Bardhi,MKD,MF,22,1995,17.6,39,26,14,16,9,10,38,26.3,28,11,0,11,16,55,7,0,2018
ESP-La Liga,2017,Levante,Erick Cabaco,URU,DF,22,1995,11.6,25,14,21,4,0,14,20,70.0,6,10,8,2,17,42,71,2,2018
ESP-La Liga,2017,Levante,Fahad Al Muwallad,KSA,MF,22,1994,0.3,0,0,0,0,0,0,1,0.0,1,0,0,0,1,1,0,0,2018
ESP-La Liga,2017,Levante,Giampaolo Pazzini,ITA,FW,32,1984,4.9,0,0,0,0,0,0,0,,0,1,0,1,1,1,1,0,2018
ESP-La Liga,2017,Levante,Hacen,MTN,"FW,MF",19,1997,0.9,0,0,0,0,0,0,0,,0,4,2,2,1,1,0,0,2018
ESP-La Liga,2017,Levante,Ivi,ESP,"MF,FW",23,1994,19.6,48,34,19,23,6,21,62,33.9,41,21,1,20,15,63,15,0,2018
ESP-La Liga,2017,Levante,Iván López,ESP,DF,23,1993,1.9,1,1,1,0,0,0,0,,0,2,2,0,8,9,2,0,2018
ESP-La Liga,2017,Levante,Jason,ESP,"FW,MF",23,1994,19.8,32,25,11,14,7,11,38,28.9,27,14,1,13,20,52,8,0,2018
ESP-La Liga,2017,Levante,Jefferson Lerma,COL,MF,22,1994,23.7,51,35,26,23,2,17,45,37.8,28,25,10,15,49,100,43,0,2018
ESP-La Liga,2017,Levante,José Campaña,ESP,MF,24,1993,30.4,57,36,25,27,5,19,58,32.8,39,31,10,21,45,102,37,0,2018
ESP-La Liga,2017,Levante,José Luis Morales,ESP,"MF,FW",30,1987,34.0,37,23,15,15,7,13,65,20.0,52,28,0,28,26,63,20,0,2018
ESP-La Liga,2017,Levante,Koke Vegas,ESP,GK,21,1995,1.0,0,0,0,0,0,0,0,,0,0,0,0,0,0,1,0,2018
ESP-La Liga,2017,Levante,Nano,ESP,FW,22,1995,3.1,7,6,2,4,1,1,1,100.0,0,4,0,4,0,7,0,0,2018
ESP-La Liga,2017,Levante,Oier Olazábal,ESP,GK,27,1989,26.0,0,0,0,0,0,0,2,0.0,2,1,0,1,1,1,12,3,2018
ESP-La Liga,2017,Levante,Pedro López Muñoz,ESP,DF,33,1983,17.7,33,23,21,10,2,17,30,56.7,13,22,7,15,26,59,45,0,2018
ESP-La Liga,2017,Levante,Raúl Fernández,ESP,GK,29,1988,11.0,0,0,0,0,0,0,0,,0,1,0,1,0,0,10,1,2018
ESP-La Liga,2017,Levante,Rober,ESP,"DF,MF",22,1995,21.2,35,22,27,8,0,17,32,53.1,15,29,18,11,41,76,75,1,2018
ESP-La Liga,2017,Levante,Roger Martí,ESP,FW,26,1991,10.7,8,4,2,5,1,2,13,15.4,11,11,0,11,1,9,5,0,2018
ESP-La Liga,2017,Levante,Rubén Rochina,ESP,"MF,DF",26,1991,1.7,8,5,5,2,1,4,6,66.7,2,0,0,0,2,10,0,0,2018
ESP-La Liga,2017,Levante,Samu García,ESP,"FW,MF",27,1990,2.1,9,7,1,6,2,2,5,40.0,3,3,0,3,1,10,2,0,2018
ESP-La Liga,2017,Levante,Saša Lukić,SRB,MF,20,1996,11.0,21,16,9,8,4,5,16,31.3,11,14,6,8,17,38,13,0,2018
ESP-La Liga,2017,Levante,Sergio Postigo,ESP,DF,28,1988,26.9,36,23,30,5,1,18,32,56.3,14,27,13,14,40,76,140,1,2018
ESP-La Liga,2017,Levante,Shaquell Moore,USA,DF,20,1996,4.7,8,6,3,3,2,3,7,42.9,4,4,0,4,13,21,11,0,2018
ESP-La Liga,2017,Levante,Toño,ESP,DF,27,1989,12.0,12,11,11,1,0,5,10,50.0,5,4,0,4,6,18,29,0,2018
ESP-La Liga,2017,Levante,Álex Alegría,ESP,FW,24,1992,7.0,8,5,1,3,4,2,6,33.3,4,7,0,7,4,12,9,0,2018
ESP-La Liga,2017,Málaga,Adalberto Peñaranda,VEN,"FW,MF",20,1997,8.9,10,6,2,6,2,2,3,66.7,1,8,1,7,0,10,1,0,2018
ESP-La Liga,2017,Málaga,Adrián González,ESP,"MF,FW",29,1988,26.0,40,25,14,22,4,12,50,24.0,38,25,8,17,38,78,34,0,2018
ESP-La Liga,2017,Málaga,Alberto Bueno,ESP,"MF,FW",29,1988,2.5,3,2,2,1,0,2,11,18.2,9,2,0,2,1,4,2,0,2018
ESP-La Liga,2017,Málaga,Alberto López,ESP,DF,22,1995,0.5,1,1,0,1,0,1,1,100.0,0,1,0,1,2,3,2,0,2018
ESP-La Liga,2017,Málaga,Andrés Prieto,ESP,GK,23,1993,4.0,0,0,0,0,0,0,0,,0,0,0,0,0,0,2,0,2018
ESP-La Liga,2017,Málaga,Borja Bastón,ESP,FW,24,1992,10.9,9,7,1,6,2,1,13,7.7,12,7,0,7,3,12,5,0,2018
ESP-La Liga,2017,Málaga,Brown Ideye,NGA,FW,28,1988,8.1,2,2,0,2,0,0,5,0.0,5,2,0,2,1,3,11,0,2018
ESP-La Liga,2017,Málaga,Chory Castro,URU,"MF,FW",32,1984,22.9,37,24,15,14,8,11,32,34.4,21,21,2,19,23,60,13,0,2018
ESP-La Liga,2017,Málaga,Cifu,ESP,DF,26,1990,1.2,2,1,0,1,1,1,5,20.0,4,1,1,0,2,4,2,0,2018
ESP-La Liga,2017,Málaga,Diego González,ESP,DF,22,1995,15.9,27,19,20,7,0,18,26,69.2,8,25,10,15,19,46,69,0,2018
ESP-La Liga,2017,Málaga,Diego Rolán,URU,"FW,MF",24,1993,21.6,33,25,7,13,13,9,44,20.5,35,18,1,17,12,45,9,0,2018
ESP-La Liga,2017,Málaga,Emanuel Cecchini,ARG,"MF,DF",20,1996,0.3,3,1,2,1,0,2,3,66.7,1,0,0,0,2,5,2,0,2018
ESP-La Liga,2017,Málaga,Esteban Rolón,ARG,MF,22,1995,4.6,6,4,4,2,0,2,4,50.0,2,7,1,6,9,15,8,1,2018
ESP-La Liga,2017,Málaga,Federico Ricca,URU,DF,22,1994,12.3,43,24,32,9,2,23,33,69.7,10,10,2,8,24,67,46,0,2018
ESP-La Liga,2017,Málaga,Ignasi Miquel,ESP,DF,24,1992,19.7,19,10,11,7,1,4,15,26.7,11,23,13,10,33,52,113,0,2018
ESP-La Liga,2017,Málaga,Isaac Success,NGA,"MF,FW",21,1996,5.5,9,7,4,4,1,3,8,37.5,5,2,0,2,5,14,0,0,2018
ESP-La Liga,2017,Málaga,Iván Rodríguez,ESP,DF,21,1996,0.2,1,1,0,1,0,0,0,,0,0,0,0,1,2,1,0,2018
ESP-La Liga,2017,Málaga,Javier Ontiveros,ESP,"MF,FW",19,1997,4.3,10,7,8,2,0,2,4,50.0,2,4,2,2,4,14,4,0,2018
ESP-La Liga,2017,Málaga,Jony,ESP,"FW,MF",26,1991,2.4,3,2,2,0,1,0,4,0.0,4,1,0,1,2,5,1,0,2018
ESP-La Liga,2017,Málaga,Juan Cruz,ESP,FW,17,2000,0.1,2,2,0,2,0,0,0,,0,0,0,0,0,2,0,0,2018
ESP-La Liga,2017,Málaga,Juankar,ESP,DF,27,1990,8.7,23,17,13,8,2,11,20,55.0,9,8,1,7,19,42,26,0,2018
ESP-La Liga,2017,Málaga,Juanpi,VEN,"MF,FW",23,1994,6.8,11,8,2,7,2,3,8,37.5,5,7,0,7,6,17,1,0,2018
ESP-La Liga,2017,Málaga,Keko,ESP,"MF,FW",25,1991,13.4,38,23,17,13,8,15,47,31.9,32,25,3,22,13,51,9,0,2018
ESP-La Liga,2017,Málaga,Luis Hernández,ESP,DF,28,1989,36.0,49,43,37,9,3,17,33,51.5,16,32,21,11,77,126,185,1,2018
ESP-La Liga,2017,Málaga,Manuel Iturra,CHI,MF,33,1984,17.6,70,45,36,27,7,22,55,40.0,33,19,2,17,29,99,23,0,2018
ESP-La Liga,2017,Málaga,Maxime Lestienne,BEL,MF,25,1992,7.4,8,5,5,0,3,3,15,20.0,12,7,1,6,6,14,6,0,2018
ESP-La Liga,2017,Málaga,Mehdi Lacen,ALG,MF,33,1984,11.7,35,19,18,17,0,14,38,36.8,24,13,1,12,15,50,11,0,2018
ESP-La Liga,2017,Málaga,Miguel Torres,ESP,DF,31,1986,7.5,16,13,13,3,0,6,14,42.9,8,9,7,2,13,29,35,0,2018
ESP-La Liga,2017,Málaga,Paul Baysse,FRA,DF,29,1988,13.8,25,16,21,3,1,10,17,58.8,7,10,6,4,20,45,84,0,2018
ESP-La Liga,2017,Málaga,Recio,ESP,MF,26,1991,20.4,54,42,26,23,5,17,62,27.4,45,15,3,12,30,84,17,0,2018
ESP-La Liga,2017,Málaga,Roberto,ESP,GK,31,1986,34.0,0,0,0,0,0,0,0,,0,0,0,0,2,2,15,0,2018
ESP-La Liga,2017,Málaga,Roberto Rosales,VEN,DF,28,1988,34.7,104,69,52,40,12,50,84,59.5,34,37,13,24,58,162,104,1,2018
ESP-La Liga,2017,Málaga,Samu García,ESP,MF,27,1990,2.0,8,6,4,3,1,3,10,30.0,7,4,0,4,6,14,3,0,2018
ESP-La Liga,2017,Málaga,Youssef En-Nesyri,MAR,FW,20,1997,17.7,31,25,10,14,7,6,26,23.1,20,11,0,11,9,40,32,0,2018
ESP-La Liga,2017,Málaga,Zdravko Kuzmanović,SRB,MF,29,1987,5.3,4,4,1,3,0,0,5,0.0,5,2,2,0,4,8,9,0,2018
ESP-La Liga,2017,Málaga,Álex Mula,ESP,"FW,MF",21,1996,6.2,7,3,3,4,0,2,12,16.7,10,5,0,5,6,13,1,0,2018
ESP-La Liga,2017,Málaga,Álex Robles,ESP,DF,18,1999,1.0,2,1,1,1,0,0,0,,0,1,0,1,3,5,4,0,2018
ESP-La Liga,2017,Real Madrid,Achraf Hakimi,MAR,DF,18,1998,8.4,21,15,9,6,6,11,25,44.0,14,9,1,8,10,31,19,1,2018
ESP-La Liga,2017,Real Madrid,Borja Mayoral,ESP,"FW,MF",20,1997,3.8,6,3,0,4,2,1,5,20.0,4,3,0,3,0,6,0,0,2018
ESP-La Liga,2017,Real Madrid,Casemiro,BRA,MF,25,1992,28.8,109,78,64,39,6,42,84,50.0,42,56,11,45,63,172,49,3,2018
ESP-La Liga,2017,Real Madrid,Cristiano Ronaldo,POR,FW,32,1985,25.4,7,4,3,3,1,1,6,16.7,5,10,3,7,6,13,14,0,2018
ESP-La Liga,2017,Real Madrid,Dani Carvajal,ESP,DF,25,1992,24.7,59,40,27,22,10,22,38,57.9,16,33,15,18,38,97,42,2,2018
ESP-La Liga,2017,Real Madrid,Dani Ceballos,ESP,MF,20,1996,4.5,8,7,3,2,3,4,16,25.0,12,6,0,6,5,13,1,0,2018
ESP-La Liga,2017,Real Madrid,Gareth Bale,WAL,"FW,MF",28,1989,20.0,19,13,7,8,4,3,14,21.4,11,13,1,12,12,31,18,0,2018
ESP-La Liga,2017,Real Madrid,Isco,ESP,MF,25,1992,19.7,22,12,5,10,7,5,35,14.3,30,11,0,11,15,37,2,0,2018
ESP-La Liga,2017,Real Madrid,Jesús Vallejo,ESP,DF,20,1997,7.0,8,7,6,2,0,2,5,40.0,3,6,5,1,16,24,21,1,2018
ESP-La Liga,2017,Real Madrid,Karim Benzema,FRA,FW,29,1987,23.9,14,8,2,6,6,3,20,15.0,17,18,0,18,8,22,19,0,2018
ESP-La Liga,2017,Real Madrid,Keylor Navas,CRC,GK,30,1986,27.0,2,1,2,0,0,1,1,100.0,0,0,0,0,3,5,10,2,2018
ESP-La Liga,2017,Real Madrid,Kiko Casilla,ESP,GK,30,1986,10.0,1,0,1,0,0,1,1,100.0,0,0,0,0,2,3,6,2,2018
ESP-La Liga,2017,Real Madrid,Luca Zidane,FRA,GK,19,1998,1.0,0,0,0,0,0,0,1,0.0,1,0,0,0,0,0,0,0,2018
ESP-La Liga,2017,Real Madrid,Lucas Vázquez,ESP,"MF,FW",26,1991,18.7,48,33,16,21,11,12,42,28.6,30,28,2,26,7,55,9,0,2018
ESP-La Liga,2017,Real Madrid,Luka Modrić,CRO,MF,31,1985,21.9,33,22,14,15,4,15,41,36.6,26,13,4,9,31,64,7,0,2018
ESP-La Liga,2017,Real Madrid,Marcelo,BRA,DF,29,1988,25.1,53,37,19,23,11,22,58,37.9,36,26,2,24,30,83,23,2,2018
ESP-La Liga,2017,Real Madrid,Marco Asensio,ESP,"FW,MF",21,1996,20.5,26,17,7,13,6,11,26,42.3,15,15,0,15,9,35,2,0,2018
ESP-La Liga,2017,Real Madrid,Marcos Llorente,ESP,MF,22,1995,6.1,15,8,7,8,0,6,11,54.5,5,7,0,7,5,20,8,0,2018
ESP-La Liga,2017,Real Madrid,Mateo Kovačić,CRO,MF,23,1994,11.0,37,27,19,18,0,8,27,29.6,19,9,4,5,5,42,5,0,2018
ESP-La Liga,2017,Real Madrid,Nacho,ESP,DF,27,1990,23.0,55,40,29,19,7,20,38,52.6,18,21,9,12,46,101,51,0,2018
ESP-La Liga,2017,Real Madrid,Raphaël Varane,FRA,DF,24,1993,25.8,28,19,20,7,1,8,15,53.3,7,27,10,17,33,61,109,2,2018
ESP-La Liga,2017,Real Madrid,Sergio Ramos,ESP,DF,31,1986,25.4,40,29,22,18,0,19,28,67.9,9,22,12,10,47,87,91,0,2018
ESP-La Liga,2017,Real Madrid,Theo Hernández,FRA,DF,19,1997,10.7,21,15,16,2,3,13,25,52.0,12,9,2,7,17,38,20,0,2018
ESP-La Liga,2017,Real Madrid,Toni Kroos,GER,MF,27,1990,25.1,55,35,19,29,7,22,59,37.3,37,20,2,18,16,71,10,1,2018
ESP-La Liga,2017,Real Sociedad,Adnan Januzaj,BEL,FW,22,1995,17.5,16,11,2,8,6,5,18,27.8,13,12,0,12,11,27,5,0,2018
ESP-La Liga,2017,Real Sociedad,Alberto de la Bella,ESP,DF,31,1985,17.0,36,22,25,10,1,16,28,57.1,12,19,5,14,21,57,54,0,2018
ESP-La Liga,2017,Real Sociedad,Andoni Gorosabel,ESP,DF,20,1996,0.8,3,2,1,2,0,2,5,40.0,3,1,0,1,4,7,1,0,2018
ESP-La Liga,2017,Real Sociedad,Aritz Elustondo,ESP,DF,23,1994,17.7,32,20,20,9,3,19,30,63.3,11,20,7,13,45,77,84,0,2018
ESP-La Liga,2017,Real Sociedad,Asier Illarramendi,ESP,MF,27,1990,35.1,85,57,35,41,9,37,90,41.1,53,44,8,36,75,160,35,0,2018
ESP-La Liga,2017,Real Sociedad,Carlos Martínez,ESP,DF,31,1986,0.0,0,0,0,0,0,0,0,,0,0,0,0,0,0,0,0,2018
ESP-La Liga,2017,Real Sociedad,Carlos Vela,MEX,FW,28,1989,4.2,12,7,5,3,4,6,7,85.7,1,2,0,2,0,12,1,0,2018
ESP-La Liga,2017,Real Sociedad,David Zurutuza,ESP,MF,31,1986,24.9,49,36,22,25,2,20,49,40.8,29,32,10,22,41,90,24,1,2018
ESP-La Liga,2017,Real Sociedad,Diego Llorente,ESP,DF,23,1993,25.8,30,22,16,13,1,18,29,62.1,11,41,18,23,43,73,96,0,2018
ESP-La Liga,2017,Real Sociedad,Gerónimo Rulli,ARG,GK,25,1992,26.0,2,1,2,0,0,2,6,33.3,4,0,0,0,0,2,10,2,2018
ESP-La Liga,2017,Real Sociedad,Héctor Moreno,MEX,DF,29,1988,8.0,7,3,7,0,0,5,7,71.4,2,3,3,0,10,17,17,0,2018
ESP-La Liga,2017,Real Sociedad,Igor Zubeldia,ESP,MF,20,1997,17.6,39,29,17,16,6,14,42,33.3,28,20,5,15,32,71,31,0,2018
ESP-La Liga,2017,Real Sociedad,Imanol Agirretxe,ESP,FW,30,1987,2.6,0,0,0,0,0,0,1,0.0,1,0,0,0,0,0,2,0,2018
ESP-La Liga,2017,Real Sociedad,Iñigo Martínez,ESP,DF,26,1991,11.7,14,9,9,4,1,5,11,45.5,6,9,4,5,23,37,55,0,2018
ESP-La Liga,2017,Real Sociedad,Jon Bautista,ESP,"FW,MF",22,1995,2.0,0,0,0,0,0,0,1,0.0,1,2,0,2,0,0,0,0,2018
ESP-La Liga,2017,Real Sociedad,Jon Guridi,ESP,MF,22,1995,0.6,1,0,1,0,0,0,1,0.0,1,1,0,1,0,1,0,0,2018
ESP-La Liga,2017,Real Sociedad,Juanmi,ESP,"FW,MF",24,1993,16.5,22,13,7,12,3,4,22,18.2,18,11,0,11,10,32,6,0,2018
ESP-La Liga,2017,Real Sociedad,Kévin Rodrigues,POR,DF,23,1994,18.2,44,32,18,20,6,19,34,55.9,15,22,6,16,27,71,39,0,2018
ESP-La Liga,2017,Real Sociedad,Miguel Ángel Moyá,ESP,GK,33,1984,8.5,0,0,0,0,0,0,1,0.0,1,0,0,0,2,2,7,0,2018
ESP-La Liga,2017,Real Sociedad,Mikel Oyarzabal,ESP,"FW,MF",20,1997,30.8,33,23,10,13,10,7,39,17.9,32,32,2,30,18,51,19,0,2018
ESP-La Liga,2017,Real Sociedad,Raúl Navas,ESP,DF,29,1988,19.9,22,15,18,4,0,14,26,53.8,12,23,13,10,30,52,73,0,2018
ESP-La Liga,2017,Real Sociedad,Rubén Pardo,ESP,MF,24,1992,2.5,1,0,0,1,0,1,2,50.0,1,5,0,5,5,6,1,0,2018
ESP-La Liga,2017,Real Sociedad,Sergio Canales,ESP,"MF,FW",26,1991,21.4,30,24,6,18,6,9,32,28.1,23,25,0,25,11,41,3,0,2018
ESP-La Liga,2017,Real Sociedad,Toño Ramírez,ESP,GK,30,1986,3.5,0,0,0,0,0,0,1,0.0,1,0,0,0,0,0,1,3,2018
ESP-La Liga,2017,Real Sociedad,Willian José,BRA,FW,25,1991,30.8,10,7,1,5,4,2,9,22.2,7,10,1,9,5,15,31,0,2018
ESP-La Liga,2017,Real Sociedad,Xabi Prieto,ESP,"MF,FW",33,1983,21.4,18,14,5,9,4,2,10,20.0,8,8,2,6,7,25,20,0,2018
ESP-La Liga,2017,Real Sociedad,Álvaro Odriozola,ESP,DF,21,1995,32.4,41,27,22,15,4,20,35,57.1,15,25,7,18,26,67,50,0,2018
ESP-La Liga,2017,Sevilla,Borja Lasso,ESP,MF,23,1994,0.6,4,1,2,2,0,1,2,50.0,1,3,0,3,0,4,0,0,2018
ESP-La Liga,2017,Sevilla,Carlos Fernández,ESP,FW,21,1996,1.5,2,1,1,1,0,0,2,0.0,2,1,0,1,0,2,0,0,2018
ESP-La Liga,2017,Sevilla,Clément Lenglet,FRA,DF,22,1995,33.3,67,50,32,35,0,21,38,55.3,17,44,27,17,35,102,157,1,2018
ESP-La Liga,2017,Sevilla,Daniel Carriço,POR,DF,28,1988,5.1,7,7,6,1,0,4,7,57.1,3,6,3,3,10,17,22,0,2018
ESP-La Liga,2017,Sevilla,David Soria,ESP,GK,24,1993,14.0,1,0,1,0,0,1,1,100.0,0,0,0,0,2,3,13,2,2018
ESP-La Liga,2017,Sevilla,Franco Vázquez,ARG,MF,28,1989,20.4,39,32,16,15,8,6,34,17.6,28,20,2,18,11,50,11,0,2018
ESP-La Liga,2017,Sevilla,Gabriel Mercado,ARG,DF,30,1987,23.5,55,37,35,18,2,36,67,53.7,31,32,20,12,42,97,83,1,2018
ESP-La Liga,2017,Sevilla,Ganso,BRA,MF,27,1989,5.8,15,11,3,12,0,3,11,27.3,8,7,0,7,2,17,4,0,2018
ESP-La Liga,2017,Sevilla,Guido Pizarro,ARG,MF,27,1990,19.5,75,47,36,36,3,29,67,43.3,38,20,7,13,26,101,48,0,2018
ESP-La Liga,2017,Sevilla,Guilherme Arana,BRA,DF,20,1997,2.1,4,2,3,1,0,1,1,100.0,0,0,0,0,5,9,8,0,2018
ESP-La Liga,2017,Sevilla,Jesús Navas,ESP,"FW,DF",31,1985,19.6,32,25,17,9,6,12,26,46.2,14,14,5,9,19,51,37,0,2018
ESP-La Liga,2017,Sevilla,Joaquín Correa,ARG,FW,22,1994,13.3,15,10,7,6,2,8,29,27.6,21,15,1,14,2,17,12,0,2018
ESP-La Liga,2017,Sevilla,Johannes Geis,GER,"DF,MF",23,1993,7.5,20,15,12,7,1,11,21,52.4,10,13,5,8,10,30,27,1,2018
ESP-La Liga,2017,Sevilla,José Alonso Lara,ESP,MF,17,2000,0.1,0,0,0,0,0,0,0,,0,0,0,0,0,0,0,0,2018
ESP-La Liga,2017,Sevilla,Lionel Carole,FRA,DF,26,1991,6.0,12,6,7,5,0,5,7,71.4,2,6,3,3,6,18,29,0,2018
ESP-La Liga,2017,Sevilla,Luis Muriel,COL,FW,26,1991,17.9,16,9,2,8,6,2,23,8.7,21,16,2,14,3,19,4,1,2018
ESP-La Liga,2017,Sevilla,Michael Krohn-Dehli,DEN,"MF,FW",34,1983,6.0,13,7,4,5,4,6,11,54.5,5,5,0,5,4,17,7,0,2018
ESP-La Liga,2017,Sevilla,Miguel Layún,MEX,DF,29,1988,13.2,28,19,14,12,2,17,36,47.2,19,18,4,14,15,43,44,1,2018
ESP-La Liga,2017,Sevilla,Nicolás Pareja,ARG,DF,33,1984,4.5,11,8,7,3,1,3,5,60.0,2,8,1,7,13,24,24,0,2018
ESP-La Liga,2017,Sevilla,Nolito,ESP,"FW,MF",30,1986,17.8,49,36,21,21,7,14,33,42.4,19,17,2,15,10,59,17,0,2018
ESP-La Liga,2017,Sevilla,Pablo Sarabia,ESP,"FW,MF",25,1992,26.6,27,19,10,13,4,11,49,22.4,38,39,1,38,30,57,34,1,2018
ESP-La Liga,2017,Sevilla,Roque Mesa,ESP,MF,28,1989,3.8,13,10,2,7,4,6,8,75.0,2,3,2,1,0,13,5,0,2018
ESP-La Liga,2017,Sevilla,Sandro Ramírez,ESP,"FW,MF",22,1995,8.0,8,8,1,5,2,1,7,14.3,6,2,0,2,4,12,2,0,2018
ESP-La Liga,2017,Sevilla,Sergio Escudero,ESP,DF,27,1989,25.9,78,49,40,26,12,32,62,51.6,30,35,6,29,66,144,69,1,2018
ESP-La Liga,2017,Sevilla,Sergio Rico,ESP,GK,23,1993,24.0,1,1,1,0,0,0,2,0.0,2,0,0,0,1,2,5,3,2018
ESP-La Liga,2017,Sevilla,Simon Kjær,DEN,DF,28,1989,17.5,35,24,25,8,2,13,22,59.1,9,16,10,6,32,67,109,0,2018
ESP-La Liga,2017,Sevilla,Steven Nzonzi,FRA,MF,28,1988,24.6,39,26,14,19,6,20,30,66.7,10,27,8,19,28,67,36,2,2018
ESP-La Liga,2017,Sevilla,Sébastien Corchia,FRA,DF,26,1990,9.1,18,13,7,8,3,9,16,56.3,7,18,4,14,16,34,20,0,2018
ESP-La Liga,2017,Sevilla,Walter Montoya,ARG,FW,24,1993,0.8,1,1,1,0,0,1,3,33.3,2,1,0,1,0,1,3,0,2018
ESP-La Liga,2017,Sevilla,Wissam Ben Yedder,FRA,FW,26,1990,18.9,12,8,2,5,5,1,2,50.0,1,10,0,10,5,17,2,0,2018
ESP-La Liga,2017,Sevilla,Éver Banega,ARG,MF,29,1988,26.7,71,53,25,37,9,22,63,34.9,41,23,1,22,12,83,17,3,2018
ESP-La Liga,2017,Valencia,Andreas Pereira,BRA,MF,21,1996,12.0,26,15,12,11,3,10,30,33.3,20,9,1,8,11,37,5,0,2018
ESP-La Liga,2017,Valencia,Carlos Soler,ESP,MF,20,1997,26.3,51,32,21,21,9,22,53,41.5,31,25,1,24,5,56,19,0,2018
ESP-La Liga,2017,Valencia,Daniel Parejo,ESP,MF,28,1989,33.3,88,57,35,43,10,31,87,35.6,56,37,10,27,34,122,27,1,2018
ESP-La Liga,2017,Valencia,Ezequiel Garay,ARG,DF,30,1986,22.5,18,12,15,3,0,10,14,71.4,4,22,11,11,24,42,139,0,2018
ESP-La Liga,2017,Valencia,Ferrán Torres,ESP,MF,17,2000,3.5,8,7,3,5,0,2,6,33.3,4,1,0,1,3,11,1,0,2018
ESP-La Liga,2017,Valencia,Francis Coquelin,FRA,"MF,DF",26,1991,7.3,18,14,11,6,1,9,16,56.3,7,9,2,7,20,38,23,0,2018
ESP-La Liga,2017,Valencia,Gabriel Paulista,BRA,DF,26,1990,28.7,47,27,41,4,2,32,46,69.6,14,30,14,16,51,98,142,2,2018
ESP-La Liga,2017,Valencia,Geoffrey Kondogbia,CTA,MF,24,1993,29.0,88,57,38,43,7,23,68,33.8,45,46,14,32,62,150,66,0,2018
ESP-La Liga,2017,Valencia,Gonçalo Guedes,POR,MF,20,1996,27.1,38,26,18,15,5,16,51,31.4,35,22,0,22,16,54,10,0,2018
ESP-La Liga,2017,Valencia,Jaume Doménech,ESP,GK,26,1990,5.0,0,0,0,0,0,0,0,,0,0,0,0,0,0,2,0,2018
ESP-La Liga,2017,Valencia,Jeison Murillo,COL,DF,25,1992,15.3,31,24,25,6,0,14,21,66.7,7,18,9,9,29,60,85,1,2018
ESP-La Liga,2017,Valencia,José Luis Gayà,ESP,DF,22,1995,32.4,77,60,52,22,3,43,68,63.2,25,43,12,31,56,133,90,1,2018
ESP-La Liga,2017,Valencia,João Cancelo,POR,MF,23,1994,1.0,1,1,0,1,0,1,1,100.0,0,1,0,1,2,3,0,0,2018
ESP-La Liga,2017,Valencia,Luciano Vietto,ARG,FW,23,1993,5.9,8,6,2,3,3,1,4,25.0,3,3,0,3,2,10,5,0,2018
ESP-La Liga,2017,Valencia,Martín Montoya,ESP,DF,26,1991,23.9,66,48,36,22,8,30,55,54.5,25,35,10,25,53,119,89,0,2018
ESP-La Liga,2017,Valencia,Nacho Gil,ESP,MF,21,1995,2.5,6,1,2,4,0,1,8,12.5,7,6,0,6,2,8,2,0,2018
ESP-La Liga,2017,Valencia,Nacho Vidal,ESP,DF,22,1995,5.0,17,14,15,1,1,14,22,63.6,8,5,2,3,10,27,18,0,2018
ESP-La Liga,2017,Valencia,Nemanja Maksimović,SRB,MF,22,1995,6.2,21,13,10,8,3,8,16,50.0,8,15,6,9,16,37,8,0,2018
ESP-La Liga,2017,Valencia,Neto,BRA,GK,28,1989,33.0,1,1,1,0,0,1,2,50.0,1,1,0,1,1,2,8,3,2018
ESP-La Liga,2017,Valencia,Rodrigo,ESP,FW,26,1991,29.8,23,13,9,12,2,3,21,14.3,18,14,2,12,17,40,11,1,2018
ESP-La Liga,2017,Valencia,Rúben Vezo,POR,DF,23,1994,17.3,43,24,30,12,1,16,32,50.0,16,25,9,16,23,66,83,0,2018
ESP-La Liga,2017,Valencia,Santi Mina,ESP,FW,21,1995,17.3,17,9,4,9,4,4,22,18.2,18,14,1,13,2,19,19,0,2018
ESP-La Liga,2017,Valencia,Simone Zaza,ITA,FW,26,1991,23.1,21,14,4,10,7,1,20,5.0,19,26,1,25,8,29,34,0,2018
ESP-La Liga,2017,Valencia,Toni Lato,ESP,"DF,MF",19,1997,8.9,30,16,22,6,2,16,27,59.3,11,9,3,6,9,39,23,0,2018
ESP-La Liga,2017,Valencia,Álvaro Medrán,ESP,MF,23,1994,0.8,1,1,1,0,0,1,2,50.0,1,0,0,0,3,4,1,0,2018
ESP-La Liga,2017,Villarreal,Adrián Marín,ESP,DF,20,1997,2.6,6,4,3,3,0,2,8,25.0,6,2,0,2,3,9,8,0,2018
ESP-La Liga,2017,Villarreal,Alfred N'Diaye,SEN,"DF,MF",27,1990,1.1,3,1,1,1,1,1,1,100.0,0,0,0,0,3,6,3,0,2018
ESP-La Liga,2017,Villarreal,Andrés Fernández,ESP,GK,30,1986,2.5,1,0,1,0,0,0,0,,0,0,0,0,0,1,4,0,2018
ESP-La Liga,2017,Villarreal,Antonio Rukavina,SRB,DF,33,1984,14.1,25,22,12,9,4,17,25,68.0,8,11,3,8,16,41,68,0,2018
ESP-La Liga,2017,Villarreal,Carlos Bacca,COL,FW,30,1986,27.7,10,2,2,4,4,1,12,8.3,11,16,1,15,8,18,16,0,2018
ESP-La Liga,2017,Villarreal,Chuca,ESP,MF,20,1997,1.0,1,0,1,0,0,1,3,33.3,2,1,1,0,1,2,1,1,2018
ESP-La Liga,2017,Villarreal,Cédric Bakambu,COD,FW,26,1991,14.0,10,7,3,6,1,1,7,14.3,6,9,1,8,3,13,27,0,2018
ESP-La Liga,2017,Villarreal,Dani Raba,ESP,"MF,FW",21,1995,12.3,25,21,9,12,4,9,45,20.0,36,21,1,20,17,42,10,0,2018
ESP-La Liga,2017,Villarreal,Daniele Bonera,ITA,DF,36,1981,13.2,16,11,8,7,1,10,15,66.7,5,17,12,5,12,28,72,0,2018
ESP-La Liga,2017,Villarreal,Darío Poveda,ESP,MF,20,1997,0.0,1,0,0,1,0,1,1,100.0,0,0,0,0,0,1,0,0,2018
ESP-La Liga,2017,Villarreal,Denis Cheryshev,RUS,"MF,FW",26,1990,10.3,27,16,12,10,5,6,23,26.1,17,18,1,17,13,40,10,0,2018
ESP-La Liga,2017,Villarreal,Enes Ünal,TUR,FW,20,1997,12.5,9,5,0,4,5,0,12,0.0,12,16,3,13,4,13,11,0,2018
ESP-La Liga,2017,Villarreal,Jaume Costa,ESP,DF,29,1988,28.2,67,43,39,22,6,33,51,64.7,18,30,8,22,46,113,97,0,2018
ESP-La Liga,2017,Villarreal,Javi Fuego,ESP,MF,33,1984,6.0,20,13,8,11,1,7,14,50.0,7,7,4,3,3,23,14,0,2018
ESP-La Liga,2017,Villarreal,Leonardo Suárez,ARG,MF,21,1996,0.3,0,0,0,0,0,0,0,,0,0,0,0,0,0,1,0,2018
ESP-La Liga,2017,Villarreal,Manu Trigueros,ESP,MF,25,1991,30.0,61,41,23,34,4,21,71,29.6,50,38,13,25,22,83,44,0,2018
ESP-La Liga,2017,Villarreal,Mariano Barbosa,ARG,GK,33,1984,12.5,0,0,0,0,0,0,0,,0,0,0,0,1,1,4,0,2018
ESP-La Liga,2017,Villarreal,Mario Gaspar,ESP,DF,26,1990,31.2,110,66,63,37,10,58,87,66.7,29,58,11,47,58,168,114,0,2018
ESP-La Liga,2017,Villarreal,Mario González,ESP,FW,21,1996,0.2,0,0,0,0,0,0,0,,0,1,0,1,0,0,0,0,2018
ESP-La Liga,2017,Villarreal,Nicola Sansone,ITA,"FW,MF",25,1991,7.1,8,4,2,4,2,2,17,11.8,15,1,0,1,1,9,2,0,2018
ESP-La Liga,2017,Villarreal,Pablo Fornals,ESP,"MF,FW",21,1996,29.1,52,33,19,26,7,18,60,30.0,42,29,3,26,22,74,18,0,2018
ESP-La Liga,2017,Villarreal,Pau Torres,ESP,DF,20,1997,0.6,0,0,0,0,0,0,1,0.0,1,1,1,0,0,0,4,0,2018
ESP-La Liga,2017,Villarreal,Ramiro Guerra,URU,MF,20,1997,0.8,3,2,1,0,2,2,3,66.7,1,0,0,0,0,3,2,0,2018
ESP-La Liga,2017,Villarreal,Roberto Soriano,ITA,"MF,FW",26,1991,12.7,30,20,10,16,4,3,16,18.8,13,14,0,14,4,34,9,0,2018
ESP-La Liga,2017,Villarreal,Rodri,ESP,MF,21,1996,35.9,104,71,50,48,6,30,86,34.9,56,49,21,28,52,156,100,1,2018
ESP-La Liga,2017,Villarreal,Roger Martínez,COL,FW,23,1994,2.6,1,1,0,1,0,0,2,0.0,2,2,0,2,0,1,1,0,2018
ESP-La Liga,2017,Villarreal,Rúben Semedo,POR,"DF,MF",23,1994,2.6,6,5,6,0,0,4,6,66.7,2,5,1,4,5,11,13,2,2018
ESP-La Liga,2017,Villarreal,Salem Al-Dawsari,KSA,MF,25,1991,0.4,1,0,0,1,0,1,1,100.0,0,1,0,1,0,1,0,0,2018
ESP-La Liga,2017,Villarreal,Samu Castillejo,ESP,"MF,FW",22,1995,23.0,41,28,22,10,9,13,62,21.0,49,39,5,34,22,63,37,0,2018
ESP-La Liga,2017,Villarreal,Sergio Asenjo,ESP,GK,28,1989,23.0,2,2,2,0,0,1,5,20.0,4,0,0,0,0,2,11,2,2018
ESP-La Liga,2017,Villarreal,Víctor Ruiz,ESP,DF,28,1989,26.8,33,22,29,4,0,13,25,52.0,12,27,18,9,58,91,134,1,2018
ESP-La Liga,2017,Villarreal,Álvaro González,ESP,DF,27,1990,32.2,38,26,30,7,1,22,41,53.7,19,34,23,11,53,91,188,0,2018
ESP-La Liga,2018,Alavés,Adrián Marín,ESP,"DF,MF",21,1997,3.2,13,8,8,5,0,4,7,57.1,3,1,0,1,7,20,13,0,2019
ESP-La Liga,2018,Alavés,Alejandro Blanco,ESP,"FW,MF",19,1998,0.2,1,1,1,0,0,1,3,33.3,2,1,0,1,0,1,0,0,2019
ESP-La Liga,2018,Alavés,Antonio Sivera,ESP,GK,21,1996,3.0,0,0,0,0,0,0,0,,0,0,0,0,0,0,4,1,2019
ESP-La Liga,2018,Alavés,Borja Bastón,ESP,FW,25,1992,16.0,16,7,4,9,3,2,24,8.3,22,16,5,11,4,20,10,0,2019
ESP-La Liga,2018,Alavés,Burgui,ESP,"MF,FW",24,1993,6.2,6,6,4,2,0,1,3,33.3,2,4,0,4,0,6,2,1,2019
ESP-La Liga,2018,Alavés,Carlos Vigaray,ESP,DF,23,1994,7.2,15,8,10,4,1,9,15,60.0,6,6,1,5,6,21,24,1,2019
ESP-La Liga,2018,Alavés,Daniel Torres,COL,MF,28,1989,0.8,2,1,2,0,0,0,3,0.0,3,0,0,0,2,4,0,0,2019
ESP-La Liga,2018,Alavés,Darko Brašanac,SRB,MF,26,1992,17.6,32,16,15,13,4,10,26,38.5,16,17,4,13,13,45,19,0,2019
ESP-La Liga,2018,Alavés,Diego Rolán,URU,"MF,FW",25,1993,3.3,7,4,3,1,3,0,2,0.0,2,1,0,1,1,8,4,0,2019
ESP-La Liga,2018,Alavés,Fernando Pacheco,ESP,GK,26,1992,35.0,0,0,0,0,0,0,1,0.0,1,0,0,0,1,1,23,0,2019
ESP-La Liga,2018,Alavés,Guillermo Maripán,CHI,DF,24,1994,22.3,46,26,34,12,0,26,38,68.4,12,35,19,16,40,86,133,2,2019
ESP-La Liga,2018,Alavés,Ibai Gómez,ESP,"MF,FW",28,1989,16.1,14,8,9,3,2,6,19,31.6,13,10,0,10,8,22,17,0,2019
ESP-La Liga,2018,Alavés,John Guidetti,SWE,FW,26,1992,7.0,4,1,0,3,1,0,4,0.0,4,4,0,4,1,5,6,0,2019
ESP-La Liga,2018,Alavés,Jonathan Calleri,ARG,FW,24,1993,31.9,20,13,3,11,6,1,24,4.2,23,34,7,27,7,27,53,0,2019
ESP-La Liga,2018,Alavés,Jony,ESP,"MF,FW",27,1991,33.0,20,14,6,7,7,7,37,18.9,30,18,0,18,22,42,12,2,2019
ESP-La Liga,2018,Alavés,Manu García,ESP,MF,32,1986,25.9,83,48,29,40,14,24,77,31.2,53,42,7,35,23,106,67,0,2019
ESP-La Liga,2018,Alavés,Martin Agirregabiria,ESP,DF,22,1996,22.6,45,29,32,10,3,28,46,60.9,18,33,11,22,27,72,65,1,2019
ESP-La Liga,2018,Alavés,Patrick Twumasi,GHA,"MF,FW",24,1994,1.9,3,3,2,0,1,0,4,0.0,4,2,0,2,1,4,1,0,2019
ESP-La Liga,2018,Alavés,Rodrigo Ely,BRA,DF,24,1993,4.8,8,5,5,3,0,5,7,71.4,2,9,7,2,7,15,30,0,2019
ESP-La Liga,2018,Alavés,Rubén Duarte,ESP,DF,22,1995,30.8,72,35,45,20,7,34,64,53.1,30,46,12,34,57,129,130,1,2019
ESP-La Liga,2018,Alavés,Rubén Sobrino,ESP,"FW,MF",26,1992,10.7,16,11,7,6,3,5,13,38.5,8,16,1,15,2,18,13,0,2019
ESP-La Liga,2018,Alavés,Takashi Inui,JPN,"MF,FW",30,1988,9.2,9,5,6,2,1,5,18,27.8,13,5,0,5,4,13,3,0,2019
ESP-La Liga,2018,Alavés,Tomás Pina Isla,ESP,MF,30,1987,26.0,64,41,23,36,5,18,46,39.1,28,15,4,11,41,105,43,1,2019
ESP-La Liga,2018,Alavés,Víctor Laguardia,ESP,DF,28,1989,36.0,47,34,37,10,0,24,33,72.7,9,42,19,23,53,100,232,0,2019
ESP-La Liga,2018,Alavés,Wakaso,GHA,MF,28,1990,18.5,46,30,23,19,4,12,36,33.3,24,37,9,28,16,62,19,2,2019
ESP-La Liga,2018,Alavés,Ximo Navarro,ESP,DF,28,1990,28.1,57,35,44,12,1,32,45,71.1,13,25,11,14,47,104,143,1,2019
ESP-La Liga,2018,Athletic Club,Ander Capa,ESP,"DF,FW",26,1992,18.2,43,27,32,8,3,13,27,48.1,14,20,2,18,30,73,47,0,2019
ESP-La Liga,2018,Athletic Club,Ander Iturraspe,ESP,MF,29,1989,1.1,2,2,1,1,0,1,1,100.0,0,0,0,0,6,8,2,0,2019
ESP-La Liga,2018,Athletic Club,Aritz Aduriz,ESP,FW,37,1981,10.5,4,2,1,1,2,1,7,14.3,6,2,1,1,0,4,4,0,2019
ESP-La Liga,2018,Athletic Club,Beñat Etxebarria,ESP,MF,31,1987,22.6,47,24,14,25,8,19,59,32.2,40,18,1,17,24,71,11,0,2019
ESP-La Liga,2018,Athletic Club,Cristian Ganea,ROU,DF,26,1992,0.5,0,0,0,0,0,0,3,0.0,3,1,0,1,1,1,2,0,2019
ESP-La Liga,2018,Athletic Club,Dani García,ESP,MF,28,1990,27.5,56,34,21,32,3,24,63,38.1,39,28,8,20,49,105,46,1,2019
ESP-La Liga,2018,Athletic Club,Gorka Guruzeta,ESP,"MF,FW",21,1996,0.6,1,1,1,0,0,0,2,0.0,2,1,0,1,2,3,0,0,2019
ESP-La Liga,2018,Athletic Club,Iago Herrerín,ESP,GK,30,1988,31.0,0,0,0,0,0,0,2,0.0,2,0,0,0,0,0,11,2,2019
ESP-La Liga,2018,Athletic Club,Ibai Gómez,ESP,FW,28,1989,6.4,6,3,3,2,1,4,9,44.4,5,8,1,7,2,8,8,0,2019
ESP-La Liga,2018,Athletic Club,Iker Muniain,ESP,"MF,FW",25,1992,26.5,29,20,10,14,5,6,29,20.7,23,17,3,14,12,41,6,0,2019
ESP-La Liga,2018,Athletic Club,Iñaki Williams,GHA,FW,24,1994,33.6,27,18,9,7,11,5,22,22.7,17,22,1,21,7,34,33,0,2019
ESP-La Liga,2018,Athletic Club,Iñigo Córdoba,ESP,"FW,MF",21,1997,14.7,37,23,15,17,5,14,47,29.8,33,27,0,27,17,54,13,0,2019
ESP-La Liga,2018,Athletic Club,Iñigo Lekue,ESP,DF,25,1993,2.3,5,2,3,2,0,2,7,28.6,5,4,0,4,4,9,11,0,2019
ESP-La Liga,2018,Athletic Club,Iñigo Martínez,ESP,DF,27,1991,32.2,53,26,36,16,1,23,37,62.2,14,24,14,10,69,122,144,0,2019
ESP-La Liga,2018,Athletic Club,Kenan Kodro,BIH,"FW,MF",24,1993,1.8,3,1,1,1,1,1,3,33.3,2,1,0,1,0,3,0,0,2019
ESP-La Liga,2018,Athletic Club,Markel Susaeta,ESP,"FW,MF",30,1987,15.3,17,10,4,6,7,3,23,13.0,20,10,1,9,12,29,5,0,2019
ESP-La Liga,2018,Athletic Club,Mikel Balenziaga,ESP,DF,30,1988,5.8,10,6,7,1,2,5,8,62.5,3,6,2,4,2,12,21,0,2019
ESP-La Liga,2018,Athletic Club,Mikel Rico,ESP,MF,33,1984,2.7,5,2,1,4,0,2,7,28.6,5,3,2,1,2,7,3,0,2019
ESP-La Liga,2018,Athletic Club,Mikel San José,ESP,MF,29,1989,19.3,43,25,19,19,5,15,48,31.3,33,27,6,21,21,64,35,0,2019
ESP-La Liga,2018,Athletic Club,Peru Nolaskoain,ESP,DF,19,1998,5.2,11,8,7,4,0,5,9,55.6,4,11,6,5,10,21,18,0,2019
ESP-La Liga,2018,Athletic Club,Raúl García,ESP,"MF,FW",32,1986,26.3,61,41,13,37,11,22,68,32.4,46,56,1,55,21,82,39,0,2019
ESP-La Liga,2018,Athletic Club,Unai López,ESP,MF,22,1995,3.6,7,5,3,2,2,2,12,16.7,10,10,3,7,1,8,2,0,2019
ESP-La Liga,2018,Athletic Club,Unai Núñez,ESP,DF,21,1997,11.8,15,11,11,4,0,7,11,63.6,4,20,12,8,28,43,60,2,2019
ESP-La Liga,2018,Athletic Club,Unai Simón,ESP,GK,21,1997,7.0,0,0,0,0,0,0,1,0.0,1,0,0,0,1,1,1,1,2019
ESP-La Liga,2018,Athletic Club,Yeray Álvarez,ESP,DF,23,1995,29.0,55,30,39,14,2,19,33,57.6,14,35,16,19,63,118,149,1,2019
ESP-La Liga,2018,Athletic Club,Yuri Berchiche,ESP,"DF,FW",28,1990,34.7,46,31,26,11,9,23,46,50.0,23,34,9,25,42,88,82,0,2019
ESP-La Liga,2018,Athletic Club,Óscar de Marcos,ESP,"DF,FW",29,1989,26.9,60,32,34,17,9,29,62,46.8,33,29,4,25,27,87,62,0,2019
ESP-La Liga,2018,Atlético Madrid,Andrés Solano,COL,DF,20,1998,0.5,4,3,2,2,0,2,2,100.0,0,1,0,1,0,4,1,0,2019
ESP-La Liga,2018,Atlético Madrid,Antoine Griezmann,FRA,"FW,MF",27,1991,35.5,31,19,8,13,10,8,28,28.6,20,18,1,17,12,43,21,0,2019
ESP-La Liga,2018,Atlético Madrid,Antonio Adán,ESP,GK,31,1987,1.0,0,0,0,0,0,0,0,,0,0,0,0,0,0,0,0,2019
ESP-La Liga,2018,Atlético Madrid,Borja Garcés,ESP,FW,18,1999,0.2,0,0,0,0,0,0,0,,0,0,0,0,0,0,0,0,2019
ESP-La Liga,2018,Atlético Madrid,Carlos Isaac,ESP,DF,20,1998,1.0,0,0,0,0,0,0,2,0.0,2,2,0,2,1,1,2,0,2019
ESP-La Liga,2018,Atlético Madrid,Diego Costa,ESP,FW,29,1988,12.4,4,1,0,4,0,1,8,12.5,7,5,0,5,2,6,6,0,2019
ESP-La Liga,2018,Atlético Madrid,Diego Godín,URU,DF,32,1986,27.9,52,30,33,19,0,20,42,47.6,22,22,9,13,45,97,141,2,2019
ESP-La Liga,2018,Atlético Madrid,Filipe Luís,BRA,DF,32,1985,22.6,66,36,33,25,8,32,58,55.2,26,18,3,15,44,110,47,0,2019
ESP-La Liga,2018,Atlético Madrid,Francisco Montero,ESP,DF,19,1999,4.5,8,4,5,3,0,5,6,83.3,1,10,4,6,5,13,18,1,2019
ESP-La Liga,2018,Atlético Madrid,Gelson Martins,POR,"FW,MF",23,1995,2.5,5,3,3,1,1,3,4,75.0,1,1,0,1,1,6,1,0,2019
ESP-La Liga,2018,Atlético Madrid,Jan Oblak,SVN,GK,25,1993,37.0,1,0,1,0,0,1,1,100.0,0,0,0,0,1,2,13,1,2019
ESP-La Liga,2018,Atlético Madrid,Joaquín Muñoz,ESP,FW,19,1999,0.0,0,0,0,0,0,0,0,,0,0,0,0,0,0,0,0,2019
ESP-La Liga,2018,Atlético Madrid,José María Giménez,URU,DF,23,1995,19.7,26,15,20,6,0,13,26,50.0,13,27,14,13,44,70,128,2,2019
ESP-La Liga,2018,Atlético Madrid,Juanfran,ESP,DF,33,1985,17.9,35,22,27,5,3,24,38,63.2,14,13,5,8,19,54,36,1,2019
ESP-La Liga,2018,Atlético Madrid,Koke,ESP,MF,26,1992,28.7,84,46,41,32,11,34,86,39.5,52,25,5,20,31,115,37,1,2019
ESP-La Liga,2018,Atlético Madrid,Lucas Hernández,FRA,DF,22,1996,12.4,35,25,20,14,1,17,20,85.0,3,17,9,8,14,49,49,0,2019
ESP-La Liga,2018,Atlético Madrid,Nikola Kalinić,CRO,FW,30,1988,7.1,6,4,2,4,0,1,3,33.3,2,1,0,1,2,8,2,0,2019
ESP-La Liga,2018,Atlético Madrid,Rodri,ESP,MF,22,1996,30.4,103,70,45,50,8,39,75,52.0,36,35,11,24,41,144,68,0,2019
ESP-La Liga,2018,Atlético Madrid,Santiago Arias,COL,DF,26,1992,19.7,48,32,31,16,1,20,31,64.5,11,14,2,12,34,82,43,0,2019
ESP-La Liga,2018,Atlético Madrid,Saúl Ñíguez,ESP,"MF,DF",23,1994,32.5,83,56,35,41,7,32,81,39.5,49,57,10,47,42,125,86,1,2019
ESP-La Liga,2018,Atlético Madrid,Sergio Camello,ESP,FW,17,2001,0.5,1,0,1,0,0,1,1,100.0,0,0,0,0,0,1,0,0,2019
ESP-La Liga,2018,Atlético Madrid,Stefan Savić,MNE,DF,27,1991,15.5,11,10,9,2,0,7,12,58.3,5,13,9,4,22,33,67,0,2019
ESP-La Liga,2018,Atlético Madrid,Thomas Lemar,FRA,MF,22,1995,20.2,38,21,23,11,4,19,42,45.2,23,26,1,25,22,60,7,1,2019
ESP-La Liga,2018,Atlético Madrid,Thomas Partey,GHA,MF,25,1993,23.0,66,42,32,25,9,21,49,42.9,28,26,5,21,49,115,22,2,2019
ESP-La Liga,2018,Atlético Madrid,Toni Moya,ESP,DF,20,1998,1.0,2,2,2,0,0,0,1,0.0,1,0,0,0,0,2,3,0,2019
ESP-La Liga,2018,Atlético Madrid,Victor Mollejo,ESP,"FW,DF",17,2001,0.7,0,0,0,0,0,0,2,0.0,2,0,0,0,0,0,0,0,2019
ESP-La Liga,2018,Atlético Madrid,Vitolo,ESP,"MF,FW",28,1989,8.4,17,13,8,6,3,6,19,31.6,13,8,1,7,10,27,6,0,2019
ESP-La Liga,2018,Atlético Madrid,Álvaro Morata,ESP,FW,25,1992,12.0,20,14,2,7,11,3,10,30.0,7,7,0,7,5,25,13,0,2019
ESP-La Liga,2018,Atlético Madrid,Ángel Correa,ARG,"MF,FW",23,1995,21.3,38,19,19,12,7,10,53,18.9,43,28,5,23,17,55,20,0,2019
ESP-La Liga,2018,Barcelona,Abel Ruiz,ESP,FW,18,2000,0.2,1,1,1,0,0,1,1,100.0,0,0,0,0,0,1,0,0,2019
ESP-La Liga,2018,Barcelona,Arthur Melo,BRA,MF,21,1996,15.9,15,10,5,6,4,6,13,46.2,7,8,0,8,9,24,9,1,2019
ESP-La Liga,2018,Barcelona,Arturo Vidal,CHI,MF,31,1987,21.4,78,44,32,37,9,30,69,43.5,39,46,5,41,29,107,23,1,2019
ESP-La Liga,2018,Barcelona,Carles Aleñá,ESP,MF,20,1998,7.1,7,4,0,6,1,2,8,25.0,6,4,0,4,2,9,0,0,2019
ESP-La Liga,2018,Barcelona,Carles Pérez,ESP,FW,20,1998,0.2,0,0,0,0,0,0,0,,0,1,0,1,0,0,0,0,2019
ESP-La Liga,2018,Barcelona,Clément Lenglet,FRA,DF,23,1995,21.5,47,29,26,19,2,22,36,61.1,14,30,20,10,21,68,70,0,2019
ESP-La Liga,2018,Barcelona,Denis Suárez,ESP,"MF,DF",24,1994,0.2,0,0,0,0,0,0,0,,0,1,0,1,0,0,0,0,2019
ESP-La Liga,2018,Barcelona,Gerard Piqué,ESP,DF,31,1987,35.0,42,27,25,17,0,24,37,64.9,13,41,27,14,36,78,154,5,2019
ESP-La Liga,2018,Barcelona,Ivan Rakitić,CRO,MF,30,1988,29.4,30,24,10,14,6,12,37,32.4,25,32,8,24,51,81,33,0,2019
ESP-La Liga,2018,Barcelona,Jasper Cillessen,NED,GK,29,1989,3.0,0,0,0,0,0,0,0,,0,0,0,0,0,0,3,2,2019
ESP-La Liga,2018,Barcelona,Jean-Clair Todibo,FRA,DF,18,1999,1.7,7,2,4,3,0,5,6,83.3,1,1,0,1,3,10,8,0,2019
ESP-La Liga,2018,Barcelona,Jeison Murillo,COL,DF,26,1992,1.3,2,2,1,1,0,0,3,0.0,3,0,0,0,0,2,5,1,2019
ESP-La Liga,2018,Barcelona,Jordi Alba,ESP,DF,29,1989,33.2,42,22,20,15,7,20,48,41.7,28,24,6,18,60,102,76,1,2019
ESP-La Liga,2018,Barcelona,Kevin-Prince Boateng,GHA,FW,31,1987,2.7,3,2,0,1,2,0,1,0.0,1,1,0,1,1,4,4,0,2019
ESP-La Liga,2018,Barcelona,Lionel Messi,ARG,FW,31,1987,30.1,12,7,5,3,4,1,17,5.9,16,10,0,10,3,15,1,0,2019
ESP-La Liga,2018,Barcelona,Luis Suárez,URU,FW,31,1987,31.4,18,11,1,6,11,4,10,40.0,6,12,4,8,8,26,24,0,2019
ESP-La Liga,2018,Barcelona,Malcom,BRA,"FW,MF",21,1997,6.8,3,2,0,1,2,2,3,66.7,1,7,0,7,1,4,1,0,2019
ESP-La Liga,2018,Barcelona,Marc-André ter Stegen,GER,GK,26,1992,35.0,0,0,0,0,0,0,3,0.0,3,0,0,0,2,2,5,2,2019
ESP-La Liga,2018,Barcelona,Moussa Wagué,SEN,"DF,FW",19,1998,2.5,6,5,1,4,1,3,7,42.9,4,1,0,1,4,10,3,0,2019
ESP-La Liga,2018,Barcelona,Munir El Haddadi,MAR,FW,22,1995,1.7,3,3,1,1,1,1,3,33.3,2,1,0,1,0,3,1,0,2019
ESP-La Liga,2018,Barcelona,Nélson Semedo,POR,DF,24,1993,17.8,38,27,23,12,3,12,18,66.7,6,23,7,16,22,60,26,0,2019
ESP-La Liga,2018,Barcelona,Ousmane Dembélé,FRA,"FW,MF",21,1997,18.5,23,15,4,13,6,6,18,33.3,12,13,0,13,5,28,4,0,2019
ESP-La Liga,2018,Barcelona,Philippe Coutinho,BRA,"FW,MF",26,1992,22.4,16,11,1,6,9,7,22,31.8,15,21,2,19,12,28,8,0,2019
ESP-La Liga,2018,Barcelona,Rafinha,BRA,"FW,MF",25,1993,2.5,8,6,2,3,3,2,2,100.0,0,5,1,4,1,9,2,0,2019
ESP-La Liga,2018,Barcelona,Riqui Puig,ESP,MF,18,1999,1.7,3,3,0,2,1,2,3,66.7,1,0,0,0,0,3,1,0,2019
ESP-La Liga,2018,Barcelona,Samuel Umtiti,FRA,DF,24,1993,13.2,8,5,3,4,1,4,6,66.7,2,10,8,2,18,26,28,2,2019
ESP-La Liga,2018,Barcelona,Sergi Roberto,ESP,"DF,MF",26,1992,23.2,28,20,15,9,4,16,24,66.7,8,18,3,15,43,71,31,0,2019
ESP-La Liga,2018,Barcelona,Sergio Busquets,ESP,MF,30,1988,30.2,90,60,35,45,10,41,89,46.1,48,43,8,35,54,144,22,1,2019
ESP-La Liga,2018,Barcelona,Thomas Vermaelen,BEL,DF,32,1985,6.5,6,4,3,3,0,3,7,42.9,4,4,2,2,6,12,21,0,2019
ESP-La Liga,2018,Barcelona,Álex Collado,ESP,FW,19,1999,0.9,1,0,0,1,0,0,1,0.0,1,3,0,3,0,1,2,0,2019
ESP-La Liga,2018,Betis,Andrés Guardado,MEX,"MF,DF",31,1986,25.9,24,15,9,12,3,11,47,23.4,36,27,1,26,28,52,28,1,2019
ESP-La Liga,2018,Betis,Antonio Barragán,ESP,"DF,FW",31,1987,10.4,14,8,9,4,1,2,12,16.7,10,15,4,11,5,19,30,2,2019
ESP-La Liga,2018,Betis,Antonio Sanabria,PAR,FW,22,1996,9.0,8,6,0,5,3,1,6,16.7,5,8,2,6,3,11,4,0,2019
ESP-La Liga,2018,Betis,Aïssa Mandi,ALG,DF,26,1991,34.0,52,34,27,20,5,12,29,41.4,17,39,23,16,41,93,71,2,2019
ESP-La Liga,2018,Betis,Cristian Tello,ESP,"DF,FW",26,1991,17.5,32,20,18,9,5,17,35,48.6,18,19,0,19,16,48,17,1,2019
ESP-La Liga,2018,Betis,Diego Lainez,MEX,"FW,MF",18,2000,3.9,4,4,0,3,1,1,1,100.0,0,2,0,2,1,5,2,0,2019
ESP-La Liga,2018,Betis,Emerson,BRA,"FW,DF",19,1999,3.5,9,7,6,1,2,3,10,30.0,7,6,0,6,7,16,12,0,2019
ESP-La Liga,2018,Betis,Francis Guerrero,ESP,"DF,FW",22,1996,19.8,51,28,25,16,10,23,41,56.1,18,15,1,14,21,72,47,4,2019
ESP-La Liga,2018,Betis,Giovani Lo Celso,ARG,"MF,FW",22,1996,26.6,52,31,16,28,8,9,35,25.7,26,24,1,23,17,69,8,0,2019
ESP-La Liga,2018,Betis,Javi García,ESP,"DF,MF",31,1987,5.8,3,1,3,0,0,2,3,66.7,1,5,1,4,5,8,27,0,2019
ESP-La Liga,2018,Betis,Jesé,ESP,"FW,MF",25,1993,8.7,7,4,3,3,1,2,8,25.0,6,8,0,8,1,8,1,0,2019
ESP-La Liga,2018,Betis,Joaquín,ESP,"FW,MF",37,1981,18.8,10,4,4,2,4,3,7,42.9,4,13,2,11,14,24,31,1,2019
ESP-La Liga,2018,Betis,Joel Robles,ESP,GK,28,1990,5.0,1,0,1,0,0,1,1,100.0,0,0,0,0,0,1,5,1,2019
ESP-La Liga,2018,Betis,Junior Firpo,ESP,"DF,FW",21,1996,21.5,38,25,16,14,8,10,24,41.7,14,27,2,25,23,61,48,0,2019
ESP-La Liga,2018,Betis,Loren Morón,ESP,FW,24,1993,21.7,18,12,4,11,3,6,27,22.2,21,24,1,23,6,24,18,0,2019
ESP-La Liga,2018,Betis,Marc Bartra,ESP,DF,27,1991,32.5,86,55,55,26,5,41,76,53.9,35,46,21,25,60,146,132,2,2019
ESP-La Liga,2018,Betis,Pau López,ESP,GK,23,1994,33.0,0,0,0,0,0,0,2,0.0,2,1,0,1,2,2,17,2,2019
ESP-La Liga,2018,Betis,Ryad Boudebouz,ALG,"MF,FW",28,1990,6.0,8,4,4,1,3,4,10,40.0,6,5,1,4,5,13,2,0,2019
ESP-La Liga,2018,Betis,Sergio Canales,ESP,MF,27,1991,29.5,44,30,19,18,7,11,53,20.8,42,34,3,31,9,53,8,1,2019
ESP-La Liga,2018,Betis,Sergio León,ESP,"FW,MF",29,1989,7.1,4,2,2,1,1,2,8,25.0,6,4,0,4,2,6,6,0,2019
ESP-La Liga,2018,Betis,Sidnei,BRA,DF,28,1989,19.4,48,29,33,12,3,18,34,52.9,16,21,8,13,41,89,57,0,2019
ESP-La Liga,2018,Betis,Takashi Inui,JPN,MF,30,1988,4.2,4,3,0,4,0,3,7,42.9,4,3,0,3,1,5,1,0,2019
ESP-La Liga,2018,Betis,Wilfrid Kaptoum,CMR,MF,22,1996,8.6,15,6,4,10,1,5,11,45.5,6,9,1,8,10,25,6,2,2019
ESP-La Liga,2018,Betis,William Carvalho,POR,MF,26,1992,26.5,45,27,20,21,4,16,29,55.2,13,8,0,8,12,57,30,0,2019
ESP-La Liga,2018,Betis,Zouhair Feddal,MAR,DF,29,1989,18.9,38,23,31,6,1,16,28,57.1,12,19,8,11,31,69,94,2,2019
ESP-La Liga,2018,Celta Vigo,Andrew Hjulsager,DEN,"MF,FW",23,1995,4.0,16,10,11,2,3,2,18,11.1,16,4,0,4,2,18,1,0,2019
ESP-La Liga,2018,Celta Vigo,Brais Méndez,ESP,"MF,FW",21,1997,26.1,61,31,23,29,9,14,53,26.4,39,32,3,29,24,85,24,0,2019
ESP-La Liga,2018,Celta Vigo,David Costas,ESP,DF,23,1995,13.0,25,13,21,4,0,10,15,66.7,5,12,6,6,18,43,58,1,2019
ESP-La Liga,2018,Celta Vigo,David Juncà,ESP,DF,24,1993,19.5,55,30,40,13,2,28,46,60.9,18,27,6,21,35,90,63,1,2019
ESP-La Liga,2018,Celta Vigo,Dennis Eckert,GER,FW,21,1997,2.4,3,2,0,1,2,0,2,0.0,2,1,0,1,2,5,3,0,2019
ESP-La Liga,2018,Celta Vigo,Emmanuel Apeh,NGA,"FW,MF",21,1996,0.2,0,0,0,0,0,0,1,0.0,1,0,0,0,0,0,0,0,2019
ESP-La Liga,2018,Celta Vigo,Emre Mor,TUR,"FW,MF",21,1997,4.1,7,4,1,3,3,2,7,28.6,5,5,0,5,3,10,1,0,2019
ESP-La Liga,2018,Celta Vigo,Facundo Roncaglia,ARG,DF,31,1987,11.9,34,22,26,8,0,17,24,70.8,7,12,5,7,20,54,51,2,2019
ESP-La Liga,2018,Celta Vigo,Fran Beltrán,ESP,MF,19,1999,16.9,23,17,8,12,3,13,31,41.9,18,19,2,17,19,42,15,1,2019
ESP-La Liga,2018,Celta Vigo,Gustavo Cabral,ARG,DF,32,1985,21.1,37,26,28,7,2,17,27,63.0,10,31,11,20,33,70,102,1,2019
ESP-La Liga,2018,Celta Vigo,Hugo Mallo,ESP,DF,27,1991,34.4,73,41,41,27,5,27,52,51.9,25,44,13,31,50,123,135,1,2019
ESP-La Liga,2018,Celta Vigo,Iago Aspas,ESP,"FW,MF",30,1987,25.0,16,11,4,8,4,4,20,20.0,16,14,0,14,16,32,5,0,2019
ESP-La Liga,2018,Celta Vigo,Jozabed,ESP,MF,27,1991,12.8,19,10,8,8,3,8,24,33.3,16,8,2,6,9,28,13,2,2019
ESP-La Liga,2018,Celta Vigo,Júnior Alonso,PAR,"DF,MF",25,1993,6.0,13,9,8,4,1,7,12,58.3,5,8,3,5,5,18,24,1,2019
ESP-La Liga,2018,Celta Vigo,Kevin Vázquez,ESP,DF,25,1993,2.4,6,5,5,0,1,4,7,57.1,3,8,3,5,2,8,9,0,2019
ESP-La Liga,2018,Celta Vigo,Lucas Olaza,URU,DF,24,1994,10.0,29,18,19,8,2,14,18,77.8,4,13,6,7,8,37,18,0,2019
ESP-La Liga,2018,Celta Vigo,Mathias Jensen,DEN,"MF,FW",22,1996,2.6,4,2,2,2,0,2,9,22.2,7,2,0,2,4,8,1,0,2019
ESP-La Liga,2018,Celta Vigo,Maxi Gómez,URU,FW,21,1996,32.9,6,4,1,4,1,1,12,8.3,11,3,0,3,2,8,43,0,2019
ESP-La Liga,2018,Celta Vigo,Néstor Araujo,MEX,DF,26,1991,29.8,42,22,32,9,1,18,22,81.8,4,32,21,11,35,77,153,1,2019
ESP-La Liga,2018,Celta Vigo,Okay Yokuşlu,TUR,MF,24,1994,24.4,61,39,31,28,2,28,45,62.2,17,32,11,21,37,98,53,2,2019
ESP-La Liga,2018,Celta Vigo,Pione Sisto,DEN,"FW,MF",23,1995,9.4,4,3,4,0,0,0,9,0.0,9,5,0,5,3,7,3,0,2019
ESP-La Liga,2018,Celta Vigo,Rubén Blanco,ESP,GK,23,1995,25.0,1,0,1,0,0,1,2,50.0,1,1,0,1,2,3,13,2,2019
ESP-La Liga,2018,Celta Vigo,Ryad Boudebouz,ALG,"MF,FW",28,1990,8.0,14,4,4,6,4,3,8,37.5,5,9,1,8,3,17,9,0,2019
ESP-La Liga,2018,Celta Vigo,Róbert Mazáň,SVK,DF,24,1994,1.0,3,3,3,0,0,2,2,100.0,0,2,0,2,3,6,0,0,2019
ESP-La Liga,2018,Celta Vigo,Sergio Álvarez,ESP,GK,31,1986,13.0,0,0,0,0,0,0,0,,0,0,0,0,0,0,4,0,2019
ESP-La Liga,2018,Celta Vigo,Sofiane Boufal,MAR,"MF,FW",24,1993,23.2,35,21,18,11,6,15,47,31.9,32,24,0,24,10,45,12,0,2019
ESP-La Liga,2018,Celta Vigo,Stanislav Lobotka,SVK,MF,23,1994,27.7,30,19,10,17,3,9,32,28.1,23,15,1,14,26,56,18,1,2019
ESP-La Liga,2018,Celta Vigo,Wesley Hoedt,NED,DF,24,1994,9.9,17,11,15,2,0,12,17,70.6,5,17,11,6,11,28,58,3,2019
ESP-La Liga,2018,Eibar,Anaitz Arbilla,ESP,DF,31,1987,21.7,31,24,25,5,1,17,27,63.0,10,12,5,7,46,77,92,2,2019
ESP-La Liga,2018,Eibar,Asier Riesgo,ESP,GK,34,1983,14.0,1,1,1,0,0,1,3,33.3,2,0,0,0,0,1,8,1,2019
ESP-La Liga,2018,Eibar,Bebé,CPV,MF,28,1990,0.7,0,0,0,0,0,0,0,,0,1,0,1,1,1,0,0,2019
ESP-La Liga,2018,Eibar,Charles,BRA,FW,34,1984,19.3,7,5,1,3,3,2,13,15.4,11,14,1,13,4,11,14,0,2019
ESP-La Liga,2018,Eibar,Fabián Orellana,CHI,"MF,FW",32,1986,30.4,44,21,14,16,14,9,42,21.4,33,17,0,17,19,63,4,0,2019
ESP-La Liga,2018,Eibar,Gonzalo Escalante,ARG,MF,25,1993,19.9,49,28,11,35,3,19,46,41.3,27,37,2,35,21,70,21,0,2019
ESP-La Liga,2018,Eibar,Iván Ramis,ESP,DF,33,1984,18.6,23,13,10,11,2,17,23,73.9,6,10,5,5,18,41,65,2,2019
ESP-La Liga,2018,Eibar,Joan Jordán,ESP,MF,24,1994,31.9,63,40,16,38,9,28,80,35.0,52,38,4,34,32,95,18,1,2019
ESP-La Liga,2018,Eibar,Jordi Calavera,ESP,DF,22,1995,0.0,0,0,0,0,0,0,0,,0,0,0,0,0,0,0,0,2019
ESP-La Liga,2018,Eibar,José Ángel,ESP,DF,28,1989,33.6,66,46,36,23,7,31,56,55.4,25,24,5,19,41,107,113,1,2019
ESP-La Liga,2018,Eibar,Kike,ESP,FW,28,1989,14.4,7,4,1,2,4,1,5,20.0,4,18,0,18,4,11,6,0,2019
ESP-La Liga,2018,Eibar,Marc Cardona,ESP,"FW,MF",23,1995,6.7,7,5,2,1,4,2,6,33.3,4,7,0,7,1,8,3,0,2019
ESP-La Liga,2018,Eibar,Marc Cucurella,ESP,"MF,FW",20,1998,26.2,49,37,13,21,15,10,23,43.5,13,36,3,33,20,69,24,0,2019
ESP-La Liga,2018,Eibar,Marko Dmitrović,SRB,GK,26,1992,24.0,0,0,0,0,0,0,0,,0,0,0,0,2,2,11,3,2019
ESP-La Liga,2018,Eibar,Miguel Marí,ESP,MF,21,1997,0.8,0,0,0,0,0,0,2,0.0,2,0,0,0,1,1,2,0,2019
ESP-La Liga,2018,Eibar,Pablo Hervías,ESP,MF,25,1993,2.0,1,1,0,1,0,0,4,0.0,4,2,0,2,0,1,0,0,2019
ESP-La Liga,2018,Eibar,Pablo de Blasis,ARG,"DF,MF",30,1988,16.9,32,19,17,8,7,12,32,37.5,20,18,0,18,13,45,20,0,2019
ESP-La Liga,2018,Eibar,Papakouli Diop,SEN,MF,32,1986,26.1,66,40,14,44,8,14,34,41.2,20,21,1,20,37,103,27,0,2019
ESP-La Liga,2018,Eibar,Paulo Oliveira,POR,DF,26,1992,24.9,49,39,33,16,0,28,44,63.6,16,25,10,15,36,85,116,0,2019
ESP-La Liga,2018,Eibar,Pedro Bigas,ESP,DF,27,1990,6.5,4,3,2,0,2,1,5,20.0,4,6,2,4,8,12,22,0,2019
ESP-La Liga,2018,Eibar,Pedro León,ESP,"MF,FW",31,1986,4.7,7,4,2,2,3,4,7,57.1,3,10,0,10,4,11,2,0,2019
ESP-La Liga,2018,Eibar,Pere Milla,ESP,"MF,FW",25,1992,3.8,7,6,1,5,1,0,5,0.0,5,4,1,3,2,9,1,0,2019
ESP-La Liga,2018,Eibar,Rubén Peña,ESP,DF,27,1991,29.7,63,46,24,27,12,24,53,45.3,29,37,9,28,35,98,57,0,2019
ESP-La Liga,2018,Eibar,Sergi Enrich,ESP,FW,28,1990,28.7,27,17,3,11,13,7,30,23.3,23,11,1,10,6,33,14,0,2019
ESP-La Liga,2018,Eibar,Sergio Álvarez,ESP,"DF,MF",26,1992,11.9,34,25,12,20,2,13,23,56.5,10,9,4,5,17,51,43,0,2019
ESP-La Liga,2018,Espanyol,Alejandro López,ESP,MF,21,1997,1.2,3,1,1,2,0,2,3,66.7,1,0,0,0,3,6,1,0,2019
ESP-La Liga,2018,Espanyol,Alfa Semedo,GNB,MF,20,1997,0.5,0,0,0,0,0,0,3,0.0,3,1,1,0,2,2,0,0,2019
ESP-La Liga,2018,Espanyol,Borja Iglesias,ESP,FW,25,1993,34.2,23,14,7,8,8,5,24,20.8,19,14,6,8,7,30,41,0,2019
ESP-La Liga,2018,Espanyol,David López,ESP,DF,28,1989,20.2,27,18,15,10,2,10,22,45.5,12,18,12,6,28,55,65,2,2019
ESP-La Liga,2018,Espanyol,Diego López,ESP,GK,36,1981,38.0,0,0,0,0,0,0,0,,0,0,0,0,2,2,9,3,2019
ESP-La Liga,2018,Espanyol,Dídac Vilà,ESP,DF,29,1989,26.2,67,31,33,26,8,31,58,53.4,27,41,12,29,53,120,94,1,2019
ESP-La Liga,2018,Espanyol,Esteban Granero,ESP,MF,31,1987,22.4,50,32,26,18,6,17,50,34.0,33,42,8,34,26,76,34,2,2019
ESP-La Liga,2018,Espanyol,Facundo Ferreyra,ARG,FW,27,1991,2.3,5,2,0,4,1,1,3,33.3,2,3,0,3,0,5,5,0,2019
ESP-La Liga,2018,Espanyol,Hernán Pérez,PAR,"FW,MF",29,1989,8.8,13,10,8,3,2,6,27,22.2,21,14,3,11,5,18,13,0,2019
ESP-La Liga,2018,Espanyol,Javi López,ESP,DF,32,1986,21.6,63,40,37,22,4,28,60,46.7,32,27,5,22,40,103,90,0,2019
ESP-La Liga,2018,Espanyol,Javi Puado,ESP,"FW,MF",20,1998,4.0,2,1,0,2,0,0,7,0.0,7,5,1,4,6,8,4,0,2019
ESP-La Liga,2018,Espanyol,Lluis López,ESP,DF,21,1997,5.8,5,3,4,1,0,3,6,50.0,3,6,2,4,7,12,21,0,2019
ESP-La Liga,2018,Espanyol,Léo Baptistão,BRA,"FW,MF",25,1992,13.7,22,14,11,5,6,8,27,29.6,19,17,0,17,8,30,14,0,2019
ESP-La Liga,2018,Espanyol,Marc Roca,ESP,MF,21,1996,34.6,71,45,36,26,9,28,70,40.0,42,43,21,22,36,107,60,3,2019
ESP-La Liga,2018,Espanyol,Mario Hermoso,ESP,DF,23,1995,31.2,38,24,29,7,2,21,39,53.8,18,34,25,9,37,75,175,2,2019
ESP-La Liga,2018,Espanyol,Naldo,BRA,DF,29,1988,15.1,18,10,9,5,4,6,10,60.0,4,19,13,6,26,44,112,1,2019
ESP-La Liga,2018,Espanyol,Pablo Piatti,ARG,"FW,MF",29,1989,8.3,21,15,8,10,3,8,16,50.0,8,15,0,15,2,23,8,0,2019
ESP-La Liga,2018,Espanyol,Pedrosa,ESP,DF,20,1998,8.5,14,9,11,2,1,7,14,50.0,7,10,4,6,8,22,27,0,2019
ESP-La Liga,2018,Espanyol,Roberto Rosales,VEN,DF,29,1988,19.4,48,31,22,16,10,21,44,47.7,23,19,7,12,22,70,68,0,2019
ESP-La Liga,2018,Espanyol,Sergi Darder,ESP,MF,24,1993,30.1,60,35,23,32,5,25,69,36.2,44,18,3,15,22,82,30,0,2019
ESP-La Liga,2018,Espanyol,Sergio García,ESP,"FW,MF",35,1983,16.5,18,10,4,11,3,3,16,18.8,13,6,1,5,10,28,4,0,2019
ESP-La Liga,2018,Espanyol,Víctor Sánchez,ESP,MF,30,1987,14.1,45,30,21,17,7,14,67,20.9,53,17,2,15,25,70,25,0,2019
ESP-La Liga,2018,Espanyol,Wu Lei,CHN,"FW,MF",26,1991,11.8,13,6,5,6,2,5,16,31.3,11,9,0,9,7,20,7,0,2019
ESP-La Liga,2018,Espanyol,Óscar Duarte,CRC,"DF,MF",29,1989,7.3,12,5,7,5,0,4,7,57.1,3,7,7,0,13,25,34,0,2019
ESP-La Liga,2018,Espanyol,Óscar Melendo,ESP,"MF,FW",20,1997,22.2,17,8,7,6,4,10,26,38.5,16,17,1,16,13,30,9,0,2019
ESP-La Liga,2018,Getafe,Amath,SEN,MF,22,1996,11.1,20,13,7,11,2,6,27,22.2,21,17,0,17,10,30,12,0,2019
ESP-La Liga,2018,Getafe,Bruno González,ESP,DF,28,1990,18.9,23,10,14,8,1,9,18,50.0,9,13,6,7,22,45,110,0,2019
ESP-La Liga,2018,Getafe,Damián Suárez,URU,DF,30,1988,36.0,96,62,43,41,12,53,120,44.2,67,47,6,41,46,142,57,2,2019
ESP-La Liga,2018,Getafe,David Soria,ESP,GK,25,1993,37.0,1,0,1,0,0,1,2,50.0,1,2,0,2,1,2,15,6,2019
ESP-La Liga,2018,Getafe,Dimitri Foulquier,FRA,"MF,DF",25,1993,20.0,29,12,10,14,5,11,22,50.0,11,23,2,21,20,49,38,0,2019
ESP-La Liga,2018,Getafe,Djené,TOG,DF,26,1991,33.1,54,34,43,11,0,26,43,60.5,17,27,11,16,74,128,154,3,2019
ESP-La Liga,2018,Getafe,Francisco Portillo,ESP,MF,28,1990,22.2,26,16,6,15,5,9,29,31.0,20,14,0,14,17,43,9,0,2019
ESP-La Liga,2018,Getafe,Gaku Shibasaki,JPN,"MF,FW",26,1992,4.3,7,3,2,4,1,3,6,50.0,3,2,0,2,3,10,4,0,2019
ESP-La Liga,2018,Getafe,Hugo Duro,ESP,"MF,FW",18,1999,4.6,6,4,1,2,3,3,6,50.0,3,6,1,5,3,9,4,0,2019
ESP-La Liga,2018,Getafe,Ignasi Miquel,ESP,DF,25,1992,3.5,1,0,0,1,0,1,2,50.0,1,4,4,0,5,6,25,0,2019
ESP-La Liga,2018,Getafe,Iván Alejo,ESP,MF,23,1995,1.6,2,0,0,2,0,0,4,0.0,4,2,0,2,0,2,3,0,2019
ESP-La Liga,2018,Getafe,Jaime Mata,ESP,"FW,MF",29,1988,27.0,30,21,8,14,8,7,26,26.9,19,14,0,14,17,47,27,0,2019
ESP-La Liga,2018,Getafe,Jorge Molina,ESP,FW,36,1982,29.4,12,9,1,4,7,2,15,13.3,13,22,0,22,7,19,26,1,2019
ESP-La Liga,2018,Getafe,Leandro Cabrera,URU,DF,27,1991,31.0,47,26,28,17,2,24,41,58.5,17,29,16,13,52,99,216,2,2019
ESP-La Liga,2018,Getafe,Leandro Chichizola,ARG,GK,28,1990,1.0,0,0,0,0,0,0,0,,0,0,0,0,0,0,1,0,2019
ESP-La Liga,2018,Getafe,Markel Bergara,ESP,MF,32,1986,0.6,2,2,0,1,1,2,3,66.7,1,3,0,3,1,3,2,0,2019
ESP-La Liga,2018,Getafe,Mathieu Flamini,FRA,MF,34,1984,5.0,9,4,4,4,1,4,7,57.1,3,3,1,2,5,14,4,0,2019
ESP-La Liga,2018,Getafe,Mathías Olivera,URU,"DF,MF",20,1997,11.2,24,17,11,8,5,10,18,55.6,8,25,2,23,10,34,22,0,2019
ESP-La Liga,2018,Getafe,Mauro Arambarri,URU,MF,22,1995,29.7,59,33,18,37,4,23,76,30.3,53,44,9,35,30,89,36,0,2019
ESP-La Liga,2018,Getafe,Nemanja Maksimović,SRB,MF,23,1995,35.7,77,45,21,51,5,21,61,34.4,40,60,15,45,71,148,33,0,2019
ESP-La Liga,2018,Getafe,Robert Ibáñez,ESP,MF,25,1993,0.8,2,2,1,1,0,0,1,0.0,1,3,0,3,0,2,0,0,2019
ESP-La Liga,2018,Getafe,Samuel Sáiz,ESP,MF,27,1991,3.4,4,3,0,3,1,2,5,40.0,3,1,0,1,0,4,2,0,2019
ESP-La Liga,2018,Getafe,Sebastián Cristóforo,URU,MF,24,1993,5.0,15,8,4,8,3,5,14,35.7,9,13,0,13,8,23,5,0,2019
ESP-La Liga,2018,Getafe,Sergi Guardiola,ESP,"MF,FW",27,1991,0.3,1,1,0,1,0,0,0,,0,0,0,0,0,1,0,0,2019
ESP-La Liga,2018,Getafe,Vitorino Antunes,POR,"DF,MF",31,1987,24.2,41,26,22,17,2,27,45,60.0,18,33,7,26,43,84,75,1,2019
ESP-La Liga,2018,Getafe,Ángel Rodríguez,ESP,FW,31,1987,20.2,16,7,1,6,9,6,26,23.1,20,15,1,14,8,24,8,0,2019
ESP-La Liga,2018,Girona,Aday,ESP,"DF,MF",30,1987,7.2,9,8,2,5,2,6,7,85.7,1,1,0,1,7,16,17,1,2019
ESP-La Liga,2018,Girona,Aleix García,ESP,MF,21,1997,18.5,37,19,17,20,0,13,36,36.1,23,21,6,15,21,58,18,0,2019
ESP-La Liga,2018,Girona,Anthony Lozano,HON,"FW,MF",25,1993,8.1,6,5,3,3,0,0,6,0.0,6,7,1,6,0,6,6,0,2019
ESP-La Liga,2018,Girona,Bernardo Espinosa,COL,DF,29,1989,30.3,20,14,16,4,0,8,17,47.1,9,46,31,15,40,60,197,5,2019
ESP-La Liga,2018,Girona,Borja García,ESP,"MF,FW",27,1990,29.2,39,27,17,15,7,22,44,50.0,22,23,2,21,38,77,17,0,2019
ESP-La Liga,2018,Girona,Carles Planas,ESP,DF,27,1991,4.7,12,6,7,5,0,4,11,36.4,7,2,0,2,4,16,15,0,2019
ESP-La Liga,2018,Girona,Cristhian Stuani,URU,FW,31,1986,30.3,23,13,7,13,3,5,20,25.0,15,13,1,12,4,27,39,0,2019
ESP-La Liga,2018,Girona,David Timor,ESP,MF,28,1989,1.8,2,2,1,1,0,0,1,0.0,1,1,1,0,3,5,3,0,2019
ESP-La Liga,2018,Girona,Douglas Luiz,BRA,MF,20,1998,16.6,34,19,13,20,1,9,38,23.7,29,19,7,12,21,55,26,0,2019
ESP-La Liga,2018,Girona,Gorka Iraizoz,ESP,GK,37,1981,6.2,1,0,1,0,0,1,1,100.0,0,0,0,0,1,2,7,0,2019
ESP-La Liga,2018,Girona,Johan Mojica,COL,"FW,MF",25,1992,0.2,1,1,1,0,0,0,0,,0,0,0,0,0,1,0,0,2019
ESP-La Liga,2018,Girona,Jonás Ramalho,ESP,DF,25,1993,18.0,13,6,12,1,0,8,14,57.1,6,24,11,13,16,29,80,1,2019
ESP-La Liga,2018,Girona,Juanpe,ESP,DF,27,1991,30.7,48,25,32,15,1,24,45,53.3,21,31,15,16,57,105,138,0,2019
ESP-La Liga,2018,Girona,Kévin Soni,CMR,"FW,DF",20,1998,0.9,3,2,0,2,1,2,4,50.0,2,3,0,3,1,4,0,0,2019
ESP-La Liga,2018,Girona,Marc Muniesa,ESP,"DF,MF",26,1992,15.6,49,34,27,17,5,15,28,53.6,13,18,6,12,37,86,49,1,2019
ESP-La Liga,2018,Girona,Paik Seung-ho,KOR,"FW,MF",21,1997,0.7,0,0,0,0,0,0,1,0.0,1,1,0,1,3,3,1,0,2019
ESP-La Liga,2018,Girona,Patrick Roberts,ENG,"MF,FW",21,1997,6.7,7,6,5,2,0,3,15,20.0,12,5,0,5,3,10,2,1,2019
ESP-La Liga,2018,Girona,Pedro Alcalá,ESP,DF,29,1989,20.8,32,23,23,9,0,15,23,65.2,8,21,18,3,36,68,120,0,2019
ESP-La Liga,2018,Girona,Pedro Porro,ESP,DF,18,1999,24.6,51,31,28,16,7,32,80,40.0,48,36,2,34,39,90,60,1,2019
ESP-La Liga,2018,Girona,Pere Pons,ESP,MF,25,1993,31.0,83,46,34,38,11,30,82,36.6,52,48,12,36,35,118,39,0,2019
ESP-La Liga,2018,Girona,Portu,ESP,"FW,MF",26,1992,31.3,33,24,8,15,10,12,43,27.9,31,16,1,15,8,41,5,0,2019
ESP-La Liga,2018,Girona,Raúl García,ESP,DF,29,1989,9.4,21,12,11,7,3,11,16,68.8,5,14,4,10,11,32,35,1,2019
ESP-La Liga,2018,Girona,Seydou Doumbia,CIV,FW,30,1987,6.0,5,1,1,2,2,0,2,0.0,2,2,0,2,3,8,1,0,2019
ESP-La Liga,2018,Girona,Valery,ESP,"DF,FW",18,1999,9.9,20,15,13,6,1,10,17,58.8,7,15,1,14,8,28,10,0,2019
ESP-La Liga,2018,Girona,Yassine Bounou,MAR,GK,27,1991,31.8,0,0,0,0,0,0,2,0.0,2,0,0,0,1,1,7,2,2019
ESP-La Liga,2018,Girona,Álex Granell,ESP,"MF,DF",29,1988,26.6,64,28,30,31,3,34,83,41.0,49,34,5,29,35,99,36,1,2019
ESP-La Liga,2018,Huesca,Adrián Diéguez,ESP,DF,22,1996,8.3,16,10,11,4,1,9,16,56.3,7,9,4,5,12,28,46,1,2019
ESP-La Liga,2018,Huesca,Aleksandar Jovanović,SRB,GK,25,1992,12.0,0,0,0,0,0,0,0,,0,0,0,0,1,1,3,0,2019
ESP-La Liga,2018,Huesca,Axel Werner,ARG,GK,22,1996,6.0,0,0,0,0,0,0,0,,0,0,0,0,0,0,2,0,2019
ESP-La Liga,2018,Huesca,Carlos Akapo,EQG,DF,25,1993,11.4,28,15,18,8,2,19,33,57.6,14,12,2,10,23,51,36,0,2019
ESP-La Liga,2018,Huesca,Cristian Rivera,ESP,MF,21,1997,18.8,38,25,18,19,1,11,25,44.0,14,21,4,17,31,69,31,0,2019
ESP-La Liga,2018,Huesca,Cucho,COL,FW,19,1999,23.9,22,13,6,10,6,6,18,33.3,12,23,2,21,9,31,21,0,2019
ESP-La Liga,2018,Huesca,Damián Musto,ARG,"MF,DF",31,1987,18.7,52,34,22,27,3,16,33,48.5,17,30,11,19,34,86,54,1,2019
ESP-La Liga,2018,Huesca,David Ferreiro,ESP,"MF,FW",30,1988,25.3,36,22,13,19,4,11,64,17.2,53,27,1,26,24,60,14,2,2019
ESP-La Liga,2018,Huesca,Enric Gallego,ESP,FW,31,1986,17.1,21,15,3,13,5,3,19,15.8,16,17,2,15,8,29,32,0,2019
ESP-La Liga,2018,Huesca,Ezequiel Ávila,ARG,"FW,MF",24,1994,22.2,18,10,7,7,4,4,26,15.4,22,21,2,19,13,31,22,0,2019
ESP-La Liga,2018,Huesca,Gonzalo Melero,ESP,MF,24,1994,14.9,26,23,5,19,2,11,48,22.9,37,14,4,10,2,28,23,0,2019
ESP-La Liga,2018,Huesca,Javi Galán,ESP,"DF,FW",23,1994,16.0,61,39,36,23,2,34,59,57.6,25,22,1,21,19,80,52,1,2019
ESP-La Liga,2018,Huesca,Jorge Miramón,ESP,DF,29,1989,27.7,73,55,49,17,7,34,53,64.2,19,34,11,23,44,117,65,1,2019
ESP-La Liga,2018,Huesca,Jorge Pulido,ESP,DF,27,1991,30.9,63,42,40,19,4,32,51,62.7,19,39,18,21,50,113,158,0,2019
ESP-La Liga,2018,Huesca,Juan Aguilera,ESP,MF,32,1985,3.8,2,2,0,1,1,1,4,25.0,3,4,2,2,4,6,2,0,2019
ESP-La Liga,2018,Huesca,Juanjo Camacho,ESP,"MF,DF",37,1980,0.4,1,1,1,0,0,1,1,100.0,0,0,0,0,0,1,1,0,2019
ESP-La Liga,2018,Huesca,Juanpi,VEN,"MF,FW",24,1994,7.4,16,6,9,5,2,4,12,33.3,8,15,0,15,6,22,3,0,2019
ESP-La Liga,2018,Huesca,Lluís Sastre,ESP,MF,32,1986,1.3,5,3,0,5,0,0,1,0.0,1,0,0,0,1,6,0,0,2019
ESP-La Liga,2018,Huesca,Luisinho,POR,DF,33,1985,5.6,14,10,9,5,0,10,17,58.8,7,6,1,5,16,30,17,0,2019
ESP-La Liga,2018,Huesca,Martín Mantovani,ARG,DF,34,1984,7.8,15,9,12,3,0,6,11,54.5,5,4,3,1,22,37,48,0,2019
ESP-La Liga,2018,Huesca,Moi Gómez,ESP,MF,24,1994,33.9,42,28,15,25,2,11,46,23.9,35,27,3,24,28,70,27,0,2019
ESP-La Liga,2018,Huesca,Pablo Insua,ESP,DF,24,1993,8.6,23,10,14,9,0,8,15,53.3,7,2,0,2,12,35,40,0,2019
ESP-La Liga,2018,Huesca,Rajko Brežančić,SRB,DF,28,1989,0.7,1,0,0,0,1,0,0,,0,0,0,0,0,1,0,0,2019
ESP-La Liga,2018,Huesca,Roberto Santamaría,ESP,GK,33,1985,20.0,0,0,0,0,0,0,0,,0,0,0,0,1,1,12,1,2019
ESP-La Liga,2018,Huesca,Rúben Semedo,POR,DF,24,1994,9.4,20,16,14,6,0,12,16,75.0,4,15,9,6,16,36,35,2,2019
ESP-La Liga,2018,Huesca,Samuele Longo,ITA,FW,26,1992,6.2,4,3,2,2,0,0,6,0.0,6,4,0,4,1,5,7,0,2019
ESP-La Liga,2018,Huesca,Serdar Gürler,TUR,"MF,FW",26,1991,5.4,5,5,3,2,0,3,11,27.3,8,8,0,8,1,6,2,0,2019
ESP-La Liga,2018,Huesca,Xabier Etxeita,ESP,DF,30,1987,29.7,47,23,32,12,3,26,47,55.3,21,38,25,13,39,86,163,3,2019
ESP-La Liga,2018,Huesca,Yangel Herrera,VEN,"MF,DF",20,1998,12.8,48,24,18,25,5,23,43,53.5,20,13,1,12,14,62,32,0,2019
ESP-La Liga,2018,Huesca,Álex Gallar,ESP,"MF,FW",26,1992,11.2,15,9,6,5,4,8,19,42.1,11,9,1,8,9,24,5,0,2019
ESP-La Liga,2018,Leganés,Alexander,ARG,FW,29,1988,0.1,1,0,1,0,0,1,1,100.0,0,0,0,0,0,1,0,0,2019
ESP-La Liga,2018,Leganés,Allan Nyom,CMR,"DF,FW",30,1988,19.0,32,24,20,10,2,12,17,70.6,5,7,2,5,20,52,35,0,2019
ESP-La Liga,2018,Leganés,Andriy Lunin,UKR,GK,19,1999,4.1,0,0,0,0,0,0,0,,0,0,0,0,0,0,0,0,2019
ESP-La Liga,2018,Leganés,Dani Ojeda,ESP,"MF,DF",23,1994,2.1,3,2,2,0,1,1,3,33.3,2,2,0,2,2,5,2,0,2019
ESP-La Liga,2018,Leganés,Diego Reyes,MEX,DF,25,1992,3.6,7,4,4,3,0,3,4,75.0,1,4,4,0,7,14,17,1,2019
ESP-La Liga,2018,Leganés,Diego Rolán,URU,"MF,FW",25,1993,2.4,6,4,3,3,0,2,9,22.2,7,2,0,2,3,9,3,0,2019
ESP-La Liga,2018,Leganés,Dimitris Siovas,GRE,DF,29,1988,32.9,57,32,38,18,1,27,47,57.4,20,32,15,17,65,122,155,1,2019
ESP-La Liga,2018,Leganés,Ezequiel Muñoz,ARG,DF,27,1990,2.3,3,2,1,2,0,0,0,,0,3,1,2,1,4,10,0,2019
ESP-La Liga,2018,Leganés,Gerard Gumbau,ESP,MF,23,1994,13.3,22,16,9,13,0,6,25,24.0,19,15,2,13,13,35,13,0,2019
ESP-La Liga,2018,Leganés,Guido Carrillo,ARG,FW,27,1991,22.1,25,14,4,12,9,6,19,31.6,13,12,1,11,8,33,25,0,2019
ESP-La Liga,2018,Leganés,Iván Cuéllar,ESP,GK,34,1984,33.9,0,0,0,0,0,0,1,0.0,1,0,0,0,2,2,10,0,2019
ESP-La Liga,2018,Leganés,Javier Eraso,ESP,"MF,FW",28,1990,7.0,6,3,3,2,1,0,6,0.0,6,3,1,2,7,13,4,0,2019
ESP-La Liga,2018,Leganés,Jonathan Silva,ARG,"DF,FW",24,1994,30.0,51,38,30,17,4,23,52,44.2,29,23,2,21,29,80,86,0,2019
ESP-La Liga,2018,Leganés,José Arnaiz,ESP,"MF,FW",23,1995,1.3,1,1,1,0,0,0,3,0.0,3,0,0,0,2,3,1,0,2019
ESP-La Liga,2018,Leganés,Juanfran,ESP,"DF,FW",29,1988,16.2,20,12,13,5,2,9,16,56.3,7,9,4,5,19,39,37,0,2019
ESP-La Liga,2018,Leganés,Kenneth Omeruo,NGA,DF,24,1993,27.0,49,27,41,8,0,20,29,69.0,9,23,11,12,37,86,159,3,2019
ESP-La Liga,2018,Leganés,Martin Braithwaite,DEN,FW,27,1991,15.6,5,3,0,0,5,0,4,0.0,4,9,0,9,3,8,4,0,2019
ESP-La Liga,2018,Leganés,Michael Santos,URU,"FW,MF",25,1993,6.2,12,5,1,7,4,2,7,28.6,5,7,1,6,1,13,1,0,2019
ESP-La Liga,2018,Leganés,Mikel Vesga,ESP,MF,25,1993,23.0,50,32,27,15,8,20,82,24.4,62,42,4,38,39,89,26,0,2019
ESP-La Liga,2018,Leganés,Nabil El Zhar,MAR,"MF,FW",31,1986,10.7,8,4,2,4,2,0,5,0.0,5,4,0,4,4,12,1,0,2019
ESP-La Liga,2018,Leganés,Raúl García,ESP,DF,29,1989,4.2,8,6,4,4,0,6,8,75.0,2,5,2,3,6,14,28,1,2019
ESP-La Liga,2018,Leganés,Recio,ESP,MF,27,1991,14.3,30,21,14,13,3,6,24,25.0,18,14,2,12,14,44,14,0,2019
ESP-La Liga,2018,Leganés,Rodrigo Tarín,ESP,DF,22,1996,15.9,22,14,15,5,2,7,10,70.0,3,11,5,6,31,53,79,0,2019
ESP-La Liga,2018,Leganés,Rubén Pérez,ESP,MF,29,1989,27.5,71,42,27,40,4,32,80,40.0,48,35,8,27,40,111,34,1,2019
ESP-La Liga,2018,Leganés,Sabin Merino,ESP,"FW,MF",26,1992,3.3,1,1,0,0,1,1,1,100.0,0,1,0,1,0,1,4,0,2019
ESP-La Liga,2018,Leganés,Unai Bustinza,ESP,DF,26,1992,22.5,41,31,25,14,2,17,33,51.5,16,31,13,18,53,94,110,2,2019
ESP-La Liga,2018,Leganés,Vasyl Kravets,UKR,"DF,FW",20,1997,5.3,16,11,8,6,2,6,13,46.2,7,5,1,4,4,20,10,1,2019
ESP-La Liga,2018,Leganés,Youssef En-Nesyri,MAR,FW,21,1997,23.4,16,8,6,5,5,4,24,16.7,20,18,3,15,6,22,23,0,2019
ESP-La Liga,2018,Leganés,Óscar Rodríguez Arnaiz,ESP,MF,20,1998,27.8,46,25,26,15,5,16,58,27.6,42,12,2,10,16,62,16,0,2019
ESP-La Liga,2018,Levante,Aitor Fernández,ESP,GK,27,1991,16.0,1,0,1,0,0,1,1,100.0,0,0,0,0,1,2,10,1,2019
ESP-La Liga,2018,Levante,Antonio Luna,ESP,"DF,FW",27,1991,14.0,14,10,6,7,1,6,23,26.1,17,22,7,15,15,29,48,1,2019
ESP-La Liga,2018,Levante,Borja Mayoral,ESP,FW,21,1997,18.0,9,4,1,6,2,5,16,31.3,11,10,1,9,5,14,5,0,2019
ESP-La Liga,2018,Levante,Cheick Doukouré,CIV,MF,25,1992,3.5,13,7,3,7,3,4,15,26.7,11,10,2,8,3,16,3,1,2019
ESP-La Liga,2018,Levante,Chema,ESP,DF,26,1992,13.9,27,19,16,9,2,13,19,68.4,6,19,11,8,19,46,83,0,2019
ESP-La Liga,2018,Levante,Coke,ESP,DF,31,1987,20.2,44,27,24,17,3,26,56,46.4,30,18,8,10,40,84,54,1,2019
ESP-La Liga,2018,Levante,Emmanuel Boateng,GHA,FW,22,1996,7.8,4,3,0,0,4,0,3,0.0,3,5,0,5,1,5,7,0,2019
ESP-La Liga,2018,Levante,Enis Bardhi,MKD,MF,23,1995,31.5,70,43,30,34,6,28,87,32.2,59,35,3,32,31,101,36,1,2019
ESP-La Liga,2018,Levante,Erick Cabaco,URU,DF,23,1995,18.1,22,13,19,3,0,12,29,41.4,17,29,14,15,29,51,69,0,2019
ESP-La Liga,2018,Levante,Fran Manzanara,ESP,"DF,MF",21,1996,1.7,7,5,3,3,1,4,4,100.0,0,3,2,1,1,8,7,0,2019
ESP-La Liga,2018,Levante,Jason,ESP,"DF,FW",24,1994,25.9,44,25,22,11,11,20,71,28.2,51,25,4,21,46,90,27,0,2019
ESP-La Liga,2018,Levante,José Campaña,ESP,MF,25,1993,35.7,65,45,31,29,5,27,86,31.4,59,51,7,44,48,113,46,1,2019
ESP-La Liga,2018,Levante,José Luis Morales,ESP,"FW,MF",31,1987,35.5,21,15,6,10,5,8,49,16.3,41,22,1,21,12,33,17,0,2019
ESP-La Liga,2018,Levante,Koke Vegas,ESP,GK,22,1995,1.0,0,0,0,0,0,0,0,,0,0,0,0,0,0,0,0,2019
ESP-La Liga,2018,Levante,Moses Simon,NGA,"DF,MF",23,1995,8.7,14,8,10,2,2,5,9,55.6,4,10,1,9,12,26,14,0,2019
ESP-La Liga,2018,Levante,Nikola Vukčević,MNE,MF,26,1991,7.4,25,18,12,9,4,9,24,37.5,15,15,5,10,10,35,17,0,2019
ESP-La Liga,2018,Levante,Oier Olazábal,ESP,GK,28,1989,21.0,1,1,1,0,0,1,2,50.0,1,1,0,1,1,2,15,2,2019
ESP-La Liga,2018,Levante,Pedro López Muñoz,ESP,DF,34,1983,5.2,5,3,5,0,0,3,7,42.9,4,8,3,5,8,13,7,0,2019
ESP-La Liga,2018,Levante,Raphael Dwamena,GHA,FW,22,1995,2.5,0,0,0,0,0,0,0,,0,2,1,1,0,0,2,0,2019
ESP-La Liga,2018,Levante,Rober,ESP,DF,23,1995,31.7,41,29,33,6,2,24,48,50.0,24,52,36,16,51,92,129,2,2019
ESP-La Liga,2018,Levante,Roger Martí,ESP,FW,27,1991,21.0,8,6,1,4,3,1,19,5.3,18,14,1,13,4,12,9,0,2019
ESP-La Liga,2018,Levante,Rubén Rochina,ESP,MF,27,1991,20.0,51,33,26,16,9,23,81,28.4,58,29,0,29,21,72,19,1,2019
ESP-La Liga,2018,Levante,Rúben Vezo,POR,DF,24,1994,14.9,26,17,17,8,1,14,22,63.6,8,23,20,3,19,45,88,0,2019
ESP-La Liga,2018,Levante,Sanjin Prcić,BIH,MF,24,1993,5.9,18,13,7,9,2,5,11,45.5,6,11,7,4,11,29,11,1,2019
ESP-La Liga,2018,Levante,Sergio Postigo,ESP,DF,29,1988,16.1,25,15,22,3,0,15,19,78.9,4,21,12,9,20,45,77,0,2019
ESP-La Liga,2018,Levante,Toño,ESP,"DF,FW",28,1989,19.6,17,13,12,3,2,10,21,47.6,11,20,5,15,14,31,42,0,2019
ESP-La Liga,2018,Rayo Vallecano,Abdoulaye Ba,SEN,DF,27,1991,23.4,46,33,37,8,1,29,39,74.4,10,32,18,14,29,75,165,4,2019
ESP-La Liga,2018,Rayo Vallecano,Adri Embarba,ESP,"MF,FW",26,1992,25.4,54,26,20,24,10,22,61,36.1,39,38,2,36,29,83,22,0,2019
ESP-La Liga,2018,Rayo Vallecano,Alberto García,ESP,GK,33,1985,17.0,1,1,1,0,0,1,3,33.3,2,1,0,1,2,3,1,2,2019
ESP-La Liga,2018,Rayo Vallecano,Bebé,CPV,"FW,MF",28,1990,14.5,19,9,10,4,5,9,19,47.4,10,16,1,15,9,28,16,1,2019
ESP-La Liga,2018,Rayo Vallecano,Catena,ESP,DF,23,1994,2.0,4,4,3,1,0,2,2,100.0,0,4,2,2,8,12,8,0,2019
ESP-La Liga,2018,Rayo Vallecano,Chechu,ESP,DF,36,1982,1.0,0,0,0,0,0,0,2,0.0,2,0,0,0,2,2,5,0,2019
ESP-La Liga,2018,Rayo Vallecano,Emiliano Velázquez,URU,DF,24,1994,14.2,49,32,38,9,2,20,34,58.8,14,29,7,22,47,96,106,1,2019
ESP-La Liga,2018,Rayo Vallecano,Franco Di Santo,ARG,FW,29,1989,1.9,2,2,1,0,1,1,2,50.0,1,0,0,0,0,2,2,0,2019
ESP-La Liga,2018,Rayo Vallecano,Gaël Kakuta,COD,"MF,FW",27,1991,8.0,12,7,5,5,2,2,10,20.0,8,4,1,3,9,21,9,0,2019
ESP-La Liga,2018,Rayo Vallecano,Giannelli Imbula,COD,MF,25,1992,19.2,14,7,6,7,1,5,12,41.7,7,12,3,9,8,22,6,0,2019
ESP-La Liga,2018,Rayo Vallecano,Gorka Elustondo,ESP,"MF,DF",31,1987,3.2,7,5,4,3,0,5,8,62.5,3,6,1,5,6,13,10,0,2019
ESP-La Liga,2018,Rayo Vallecano,Javi Guerra,ESP,"FW,MF",36,1982,2.6,3,3,1,1,1,0,3,0.0,3,2,0,2,1,4,0,0,2019
ESP-La Liga,2018,Rayo Vallecano,Jordi Amat,IDN,DF,26,1992,30.7,54,31,34,19,1,24,42,57.1,18,31,10,21,43,97,133,1,2019
ESP-La Liga,2018,Rayo Vallecano,José Pozo,ESP,MF,22,1996,18.0,13,10,4,5,4,4,25,16.0,21,7,1,6,4,17,6,0,2019
ESP-La Liga,2018,Rayo Vallecano,Luis Advíncula,PER,DF,28,1990,26.5,52,38,38,12,2,21,31,67.7,10,22,2,20,19,71,60,1,2019
ESP-La Liga,2018,Rayo Vallecano,Mario Suárez,ESP,MF,31,1987,11.4,37,23,17,17,3,15,28,53.6,13,10,3,7,14,51,17,2,2019
ESP-La Liga,2018,Rayo Vallecano,Raúl de Tomás,ESP,FW,23,1994,31.3,8,3,0,7,1,0,12,0.0,12,18,4,14,9,17,45,0,2019
ESP-La Liga,2018,Rayo Vallecano,Santi Comesaña,ESP,MF,21,1996,22.6,56,35,29,25,2,22,61,36.1,39,30,5,25,30,86,45,2,2019
ESP-La Liga,2018,Rayo Vallecano,Sergio Akieme,ESP,DF,20,1997,2.0,3,3,3,0,0,2,2,100.0,0,0,0,0,1,4,5,0,2019
ESP-La Liga,2018,Rayo Vallecano,Sergio Moreno,ESP,FW,19,1999,0.2,0,0,0,0,0,0,0,,0,0,0,0,0,0,0,0,2019
ESP-La Liga,2018,Rayo Vallecano,Stole Dimitrievski,MKD,GK,24,1993,21.0,0,0,0,0,0,0,1,0.0,1,0,0,0,0,0,8,1,2019
ESP-La Liga,2018,Rayo Vallecano,Tito,ESP,DF,33,1985,12.2,14,9,12,2,0,7,22,31.8,15,22,2,20,17,31,41,0,2019
ESP-La Liga,2018,Rayo Vallecano,Uche Henry Agbo,NGA,MF,22,1995,4.1,7,4,3,4,0,5,10,50.0,5,3,1,2,6,13,1,0,2019
ESP-La Liga,2018,Rayo Vallecano,Álex Alegría,ESP,"FW,MF",25,1992,1.6,1,1,0,1,0,0,3,0.0,3,1,0,1,0,1,0,0,2019
ESP-La Liga,2018,Rayo Vallecano,Álex Gálvez,ESP,DF,29,1989,15.7,38,28,25,13,0,14,28,50.0,14,7,2,5,45,83,69,1,2019
ESP-La Liga,2018,Rayo Vallecano,Álex Moreno,ESP,DF,25,1993,34.8,63,40,41,18,4,29,53,54.7,24,35,9,26,41,104,97,0,2019
ESP-La Liga,2018,Rayo Vallecano,Álvaro García,ESP,"FW,MF",25,1992,19.6,22,19,11,7,4,4,25,16.0,21,24,0,24,19,41,30,0,2019
ESP-La Liga,2018,Rayo Vallecano,Álvaro Medrán,ESP,MF,24,1994,12.8,15,8,5,6,4,6,21,28.6,15,10,1,9,17,32,9,0,2019
ESP-La Liga,2018,Rayo Vallecano,Óscar Trejo,ARG,"MF,FW",30,1988,19.6,57,41,21,25,11,8,33,24.2,25,24,2,22,18,75,15,0,2019
ESP-La Liga,2018,Real Madrid,Brahim Díaz,ESP,FW,18,1999,4.2,9,7,5,4,0,3,8,37.5,5,2,0,2,0,9,0,0,2019
ESP-La Liga,2018,Real Madrid,Casemiro,BRA,MF,26,1992,25.7,86,52,44,35,7,38,94,40.4,56,52,12,40,41,127,56,3,2019
ESP-La Liga,2018,Real Madrid,Cristo González,ESP,FW,20,1997,0.5,1,0,0,1,0,0,0,,0,0,0,0,1,2,0,0,2019
ESP-La Liga,2018,Real Madrid,Dani Carvajal,ESP,DF,26,1992,23.4,40,24,17,15,8,18,41,43.9,23,31,7,24,26,66,35,0,2019
ESP-La Liga,2018,Real Madrid,Dani Ceballos,ESP,"MF,FW",21,1996,13.9,32,21,9,16,7,11,31,35.5,20,26,1,25,15,47,6,0,2019
ESP-La Liga,2018,Real Madrid,Federico Valverde,URU,MF,20,1998,7.3,12,8,3,7,2,5,11,45.5,6,10,2,8,21,33,10,0,2019
ESP-La Liga,2018,Real Madrid,Gareth Bale,WAL,FW,29,1989,19.8,16,8,5,7,4,6,20,30.0,14,19,3,16,11,27,13,0,2019
ESP-La Liga,2018,Real Madrid,Isco,ESP,"MF,FW",26,1992,13.2,29,14,14,8,7,14,34,41.2,20,9,1,8,6,35,3,0,2019
ESP-La Liga,2018,Real Madrid,Javi Sánchez,ESP,DF,21,1997,0.5,1,0,1,0,0,0,0,,0,0,0,0,0,1,4,0,2019
ESP-La Liga,2018,Real Madrid,Jesús Vallejo,ESP,DF,21,1997,3.5,6,5,4,2,0,5,6,83.3,1,4,4,0,7,13,12,0,2019
ESP-La Liga,2018,Real Madrid,Karim Benzema,FRA,FW,30,1987,32.8,24,11,2,11,11,2,17,11.8,15,16,1,15,8,32,25,0,2019
ESP-La Liga,2018,Real Madrid,Keylor Navas,CRC,GK,31,1986,10.0,0,0,0,0,0,0,0,,0,0,0,0,1,1,5,0,2019
ESP-La Liga,2018,Real Madrid,Luca Zidane,FRA,GK,20,1998,1.0,0,0,0,0,0,0,0,,0,0,0,0,0,0,0,0,2019
ESP-La Liga,2018,Real Madrid,Lucas Vázquez,ESP,"FW,MF",27,1991,16.8,43,26,11,21,11,15,41,36.6,26,16,1,15,12,55,11,0,2019
ESP-La Liga,2018,Real Madrid,Luka Modrić,CRO,MF,32,1985,29.0,49,30,11,25,13,14,48,29.2,34,20,3,17,31,80,7,1,2019
ESP-La Liga,2018,Real Madrid,Marcelo,BRA,DF,30,1988,20.6,34,19,17,12,5,15,39,38.5,24,19,2,17,17,51,21,0,2019
ESP-La Liga,2018,Real Madrid,Marco Asensio,ESP,FW,22,1996,19.8,12,8,3,5,4,2,24,8.3,22,16,1,15,14,26,7,0,2019
ESP-La Liga,2018,Real Madrid,Marcos Llorente,ESP,MF,23,1995,6.0,16,12,7,7,2,8,18,44.4,10,8,0,8,7,23,12,0,2019
ESP-La Liga,2018,Real Madrid,Mariano,DOM,FW,24,1993,5.0,2,1,1,1,0,0,3,0.0,3,2,0,2,0,2,2,0,2019
ESP-La Liga,2018,Real Madrid,Nacho,ESP,DF,28,1990,18.9,26,19,14,7,5,11,22,50.0,11,19,7,12,32,58,65,1,2019
ESP-La Liga,2018,Real Madrid,Raphaël Varane,FRA,DF,25,1993,30.6,33,18,25,7,1,15,19,78.9,4,21,9,12,32,65,141,1,2019
ESP-La Liga,2018,Real Madrid,Sergio Ramos,ESP,DF,32,1986,27.5,41,32,25,12,4,22,39,56.4,17,29,15,14,37,78,90,2,2019
ESP-La Liga,2018,Real Madrid,Sergio Reguilón,ESP,DF,21,1996,12.4,25,14,15,9,1,10,21,47.6,11,13,3,10,20,45,41,1,2019
ESP-La Liga,2018,Real Madrid,Thibaut Courtois,BEL,GK,26,1992,27.0,0,0,0,0,0,0,2,0.0,2,0,0,0,2,2,5,0,2019
ESP-La Liga,2018,Real Madrid,Toni Kroos,GER,MF,28,1990,24.7,51,35,18,24,9,14,57,24.6,43,25,4,21,14,65,13,1,2019
ESP-La Liga,2018,Real Madrid,Vinicius Júnior,BRA,"FW,MF",18,2000,9.7,10,6,3,6,1,3,16,18.8,13,6,1,5,7,17,1,0,2019
ESP-La Liga,2018,Real Madrid,Álvaro Odriozola,ESP,DF,22,1995,13.1,28,25,13,11,4,14,18,77.8,4,11,1,10,11,39,17,1,2019
ESP-La Liga,2018,Real Sociedad,Adnan Januzaj,BEL,"FW,MF",23,1995,13.9,11,8,5,2,4,3,13,23.1,10,7,0,7,6,17,6,0,2019
ESP-La Liga,2018,Real Sociedad,Aihen Muñoz,ESP,DF,20,1997,10.6,13,8,11,2,0,10,19,52.6,9,19,9,10,7,20,26,0,2019
ESP-La Liga,2018,Real Sociedad,Alex Sola,ESP,DF,19,1999,1.0,4,3,0,3,1,3,4,75.0,1,0,0,0,1,5,2,0,2019
ESP-La Liga,2018,Real Sociedad,Ander Barrenetxea,ESP,"FW,MF",16,2001,4.4,7,2,2,0,5,2,8,25.0,6,8,0,8,4,11,1,0,2019
ESP-La Liga,2018,Real Sociedad,Ander Guevara,ESP,MF,21,1997,1.0,3,1,0,3,0,2,6,33.3,4,1,0,1,1,4,0,0,2019
ESP-La Liga,2018,Real Sociedad,Andoni Gorosabel,ESP,DF,21,1996,5.1,16,9,10,5,1,8,13,61.5,5,5,1,4,4,20,20,1,2019
ESP-La Liga,2018,Real Sociedad,Aritz Elustondo,ESP,DF,24,1994,25.0,47,29,31,14,2,26,41,63.4,15,23,7,16,39,86,150,0,2019
ESP-La Liga,2018,Real Sociedad,Asier Illarramendi,ESP,MF,28,1990,20.2,39,24,22,14,3,21,51,41.2,30,36,9,27,31,70,46,1,2019
ESP-La Liga,2018,Real Sociedad,David Zurutuza,ESP,MF,32,1986,13.6,27,16,9,15,3,8,22,36.4,14,19,4,15,24,51,26,1,2019
ESP-La Liga,2018,Real Sociedad,Diego Llorente,ESP,DF,24,1993,19.5,26,15,16,8,2,17,29,58.6,12,27,15,12,26,52,83,2,2019
ESP-La Liga,2018,Real Sociedad,Gerónimo Rulli,ARG,GK,26,1992,27.0,2,1,2,0,0,1,3,33.3,2,1,0,1,1,3,12,6,2019
ESP-La Liga,2018,Real Sociedad,Héctor Moreno,MEX,DF,30,1988,21.5,16,9,12,4,0,9,17,52.9,8,34,19,15,31,47,73,0,2019
ESP-La Liga,2018,Real Sociedad,Igor Zubeldia,ESP,MF,21,1997,28.3,61,35,32,24,5,22,54,40.7,32,30,6,24,45,106,60,0,2019
ESP-La Liga,2018,Real Sociedad,Jon Bautista,ESP,FW,23,1995,6.6,5,3,0,3,2,0,3,0.0,3,8,1,7,5,10,4,0,2019
ESP-La Liga,2018,Real Sociedad,Joseba Zaldúa,ESP,DF,26,1992,23.8,36,27,23,10,3,15,32,46.9,17,19,3,16,38,74,72,0,2019
ESP-La Liga,2018,Real Sociedad,Juanmi,ESP,"FW,MF",25,1993,16.9,21,12,7,11,3,8,22,36.4,14,12,0,12,16,37,13,0,2019
ESP-La Liga,2018,Real Sociedad,Kévin Rodrigues,POR,DF,24,1994,5.4,21,11,14,6,1,9,17,52.9,8,13,3,10,8,29,15,0,2019
ESP-La Liga,2018,Real Sociedad,Luca Sangalli,ESP,"MF,FW",23,1995,11.1,19,13,6,11,2,5,22,22.7,17,9,1,8,5,24,5,0,2019
ESP-La Liga,2018,Real Sociedad,Martín Merquelanz,ESP,MF,23,1995,0.1,0,0,0,0,0,0,0,,0,0,0,0,0,0,0,0,2019
ESP-La Liga,2018,Real Sociedad,Martín Zubimendi,ESP,MF,19,1999,0.1,1,0,0,1,0,0,1,0.0,1,0,0,0,0,1,0,0,2019
ESP-La Liga,2018,Real Sociedad,Miguel Ángel Moyá,ESP,GK,34,1984,11.0,1,1,1,0,0,1,2,50.0,1,0,0,0,1,2,9,2,2019
ESP-La Liga,2018,Real Sociedad,Mikel Merino,ESP,MF,22,1996,22.8,50,28,19,25,6,14,52,26.9,38,37,2,35,29,79,37,1,2019
ESP-La Liga,2018,Real Sociedad,Mikel Oyarzabal,ESP,"FW,MF",21,1997,35.0,36,20,15,15,6,12,49,24.5,37,54,3,51,14,50,26,0,2019
ESP-La Liga,2018,Real Sociedad,Raúl Navas,ESP,DF,30,1988,14.6,23,14,20,3,0,13,21,61.9,8,20,9,11,20,43,60,1,2019
ESP-La Liga,2018,Real Sociedad,Roberto López,ESP,MF,18,2000,0.3,0,0,0,0,0,0,1,0.0,1,1,0,1,1,1,2,0,2019
ESP-La Liga,2018,Real Sociedad,Robin Le Normand,ESP,DF,21,1996,3.2,5,2,2,3,0,1,3,33.3,2,3,0,3,4,9,13,1,2019
ESP-La Liga,2018,Real Sociedad,Rubén Pardo,ESP,"MF,FW",25,1992,15.2,11,7,2,9,0,4,17,23.5,13,14,6,8,21,32,9,0,2019
ESP-La Liga,2018,Real Sociedad,Sandro Ramírez,ESP,"FW,MF",23,1995,11.7,19,10,7,10,2,4,11,36.4,7,12,1,11,9,28,3,0,2019
ESP-La Liga,2018,Real Sociedad,Theo Hernández,FRA,DF,20,1997,22.0,54,33,30,15,9,28,44,63.6,16,21,5,16,33,87,42,3,2019
ESP-La Liga,2018,Real Sociedad,Willian José,BRA,FW,26,1991,26.3,5,3,1,3,1,2,7,28.6,5,11,5,6,1,6,27,0,2019
ESP-La Liga,2018,Sevilla,Aleix Vidal,ESP,"DF,MF",28,1989,5.9,13,11,5,5,3,5,14,35.7,9,5,0,5,4,17,12,0,2019
ESP-La Liga,2018,Sevilla,André Silva,POR,FW,22,1995,24.0,8,5,1,4,3,1,11,9.1,10,17,1,16,3,11,32,0,2019
ESP-La Liga,2018,Sevilla,Bryan,ESP,"MF,FW",17,2001,1.9,6,4,4,1,1,1,5,20.0,4,0,0,0,1,7,0,0,2019
ESP-La Liga,2018,Sevilla,Daniel Carriço,POR,DF,29,1988,23.7,35,18,23,11,1,12,20,60.0,8,19,12,7,31,66,104,1,2019
ESP-La Liga,2018,Sevilla,Franco Vázquez,ARG,MF,29,1989,25.3,51,37,21,21,9,23,66,34.8,43,25,2,23,23,74,27,1,2019
ESP-La Liga,2018,Sevilla,Gabriel Mercado,ARG,DF,31,1987,19.3,35,23,21,12,2,18,36,50.0,18,24,12,12,26,61,75,1,2019
ESP-La Liga,2018,Sevilla,Guilherme Arana,BRA,DF,21,1997,7.0,11,6,5,5,1,6,7,85.7,1,6,3,3,9,20,8,0,2019
ESP-La Liga,2018,Sevilla,Ibrahim Amadou,FRA,"MF,DF",25,1993,8.5,27,20,9,15,3,2,9,22.2,7,7,4,3,11,38,24,0,2019
ESP-La Liga,2018,Sevilla,Javier Díaz,ESP,GK,21,1997,1.0,0,0,0,0,0,0,0,,0,0,0,0,0,0,0,0,2019
ESP-La Liga,2018,Sevilla,Jesús Navas,ESP,"DF,FW",32,1985,30.1,28,21,15,11,2,16,24,66.7,8,23,5,18,29,57,62,0,2019
ESP-La Liga,2018,Sevilla,Joris Gnagnon,FRA,"DF,MF",21,1997,5.0,11,8,6,4,1,4,7,57.1,3,2,2,0,10,21,16,0,2019
ESP-La Liga,2018,Sevilla,Juan Soriano,ESP,GK,20,1997,4.0,0,0,0,0,0,0,0,,0,0,0,0,1,1,1,0,2019
ESP-La Liga,2018,Sevilla,Luis Muriel,COL,"MF,FW",27,1991,1.4,0,0,0,0,0,0,6,0.0,6,3,0,3,0,0,1,0,2019
ESP-La Liga,2018,Sevilla,Marko Rog,CRO,MF,23,1995,4.0,12,11,4,8,0,5,9,55.6,4,4,0,4,8,20,1,0,2019
ESP-La Liga,2018,Sevilla,Maxime Gonalons,FRA,MF,29,1989,6.0,8,4,2,5,1,1,15,6.7,14,10,4,6,5,13,12,0,2019
ESP-La Liga,2018,Sevilla,Maximilian Wöber,AUT,DF,20,1998,6.0,12,9,8,2,2,3,6,50.0,3,6,0,6,7,19,16,0,2019
ESP-La Liga,2018,Sevilla,Munir El Haddadi,MAR,"FW,MF",22,1995,11.6,17,10,5,7,5,2,7,28.6,5,15,0,15,6,23,9,0,2019
ESP-La Liga,2018,Sevilla,Nolito,ESP,"FW,DF",31,1986,0.8,3,2,1,1,1,1,2,50.0,1,2,0,2,0,3,1,0,2019
ESP-La Liga,2018,Sevilla,Pablo Sarabia,ESP,"MF,FW",26,1992,30.3,30,15,6,15,9,6,47,12.8,41,30,3,27,22,52,20,0,2019
ESP-La Liga,2018,Sevilla,Quincy Promes,NED,"FW,DF",26,1992,17.6,35,25,23,9,3,15,22,68.2,7,19,3,16,25,60,22,1,2019
ESP-La Liga,2018,Sevilla,Roque Mesa,ESP,MF,29,1989,19.4,46,27,16,22,8,15,38,39.5,23,16,0,16,14,60,12,4,2019
ESP-La Liga,2018,Sevilla,Sergi Gómez,ESP,DF,26,1992,30.7,49,38,33,12,4,18,28,64.3,10,30,20,10,40,89,135,1,2019
ESP-La Liga,2018,Sevilla,Sergio Escudero,ESP,"DF,FW",28,1989,17.2,43,29,20,18,5,18,35,51.4,17,22,4,18,24,67,52,0,2019
ESP-La Liga,2018,Sevilla,Simon Kjær,DEN,DF,29,1989,22.3,29,19,25,3,1,9,16,56.3,7,41,34,7,27,56,136,0,2019
ESP-La Liga,2018,Sevilla,Tomáš Vaclík,CZE,GK,29,1989,33.0,0,0,0,0,0,0,1,0.0,1,0,0,0,0,0,9,6,2019
ESP-La Liga,2018,Sevilla,Wissam Ben Yedder,FRA,FW,27,1990,31.2,18,16,3,11,4,2,12,16.7,10,18,0,18,11,29,2,0,2019
ESP-La Liga,2018,Sevilla,Éver Banega,ARG,MF,30,1988,29.6,71,50,32,35,4,20,70,28.6,50,26,5,21,28,99,28,0,2019
ESP-La Liga,2018,Valencia,Carlos Soler,ESP,MF,21,1997,27.3,41,28,15,23,3,16,65,24.6,49,46,6,40,19,60,37,0,2019
ESP-La Liga,2018,Valencia,Cristiano Piccini,ITA,DF,25,1992,20.8,32,23,25,7,0,13,26,50.0,13,27,7,20,27,59,64,1,2019
ESP-La Liga,2018,Valencia,Daniel Parejo,ESP,MF,29,1989,34.0,73,42,41,24,8,31,90,34.4,59,41,7,34,46,119,26,2,2019
ESP-La Liga,2018,Valencia,Daniel Wass,DEN,"DF,MF",29,1989,26.2,35,25,9,19,7,20,42,47.6,22,23,4,19,34,69,49,0,2019
ESP-La Liga,2018,Valencia,Denis Cheryshev,RUS,MF,27,1990,19.0,46,32,15,22,9,17,37,45.9,20,35,3,32,15,61,16,0,2019
ESP-La Liga,2018,Valencia,Ezequiel Garay,ARG,DF,31,1986,23.7,20,17,15,3,2,9,18,50.0,9,30,23,7,16,36,140,0,2019
ESP-La Liga,2018,Valencia,Facundo Roncaglia,ARG,DF,31,1987,6.7,13,10,8,5,0,4,6,66.7,2,4,2,2,10,23,22,0,2019
ESP-La Liga,2018,Valencia,Ferrán Torres,ESP,MF,18,2000,9.4,15,8,4,8,3,5,11,45.5,6,10,1,9,10,25,9,0,2019
ESP-La Liga,2018,Valencia,Francis Coquelin,FRA,MF,27,1991,19.6,46,31,25,14,7,17,35,48.6,18,21,5,16,49,95,29,1,2019
ESP-La Liga,2018,Valencia,Gabriel Paulista,BRA,DF,27,1990,29.1,29,16,20,6,3,14,28,50.0,14,37,21,16,70,99,162,1,2019
ESP-La Liga,2018,Valencia,Geoffrey Kondogbia,CTA,MF,25,1993,13.8,47,33,18,23,6,12,27,44.4,15,20,7,13,27,74,22,2,2019
ESP-La Liga,2018,Valencia,Gonçalo Guedes,POR,"MF,FW",21,1996,16.3,31,13,16,12,3,14,43,32.6,29,15,0,15,7,38,1,0,2019
ESP-La Liga,2018,Valencia,Jaume Doménech,ESP,GK,27,1990,4.0,0,0,0,0,0,0,1,0.0,1,0,0,0,0,0,1,0,2019
ESP-La Liga,2018,Valencia,Jeison Murillo,COL,DF,26,1992,1.0,2,1,1,1,0,1,2,50.0,1,1,0,1,2,4,6,0,2019
ESP-La Liga,2018,Valencia,José Luis Gayà,ESP,DF,23,1995,34.9,83,59,56,20,7,46,80,57.5,34,48,6,42,43,126,105,1,2019
ESP-La Liga,2018,Valencia,Kévin Gameiro,FRA,FW,31,1987,17.9,14,9,4,6,4,1,6,16.7,5,12,2,10,5,19,3,0,2019
ESP-La Liga,2018,Valencia,Lee Kangin,KOR,"MF,FW",17,2001,0.3,2,0,1,1,0,1,3,33.3,2,0,0,0,1,3,0,0,2019
ESP-La Liga,2018,Valencia,Michy Batshuayi,BEL,FW,24,1993,5.9,1,1,0,1,0,0,3,0.0,3,5,2,3,0,1,3,0,2019
ESP-La Liga,2018,Valencia,Mouctar Diakhaby,GUI,DF,21,1996,17.6,14,8,10,4,0,5,10,50.0,5,24,16,8,20,34,94,1,2019
ESP-La Liga,2018,Valencia,Neto,BRA,GK,29,1989,34.0,2,0,2,0,0,2,3,66.7,1,0,0,0,1,3,9,3,2019
ESP-La Liga,2018,Valencia,Rodrigo,ESP,FW,27,1991,28.1,21,10,6,9,6,3,17,17.6,14,17,1,16,3,24,18,0,2019
ESP-La Liga,2018,Valencia,Rubén Sobrino,ESP,"FW,MF",26,1992,2.1,6,3,1,4,1,1,1,100.0,0,1,1,0,1,7,1,0,2019
ESP-La Liga,2018,Valencia,Rúben Vezo,POR,DF,24,1994,2.2,2,1,2,0,0,2,4,50.0,2,2,1,1,2,4,10,0,2019
ESP-La Liga,2018,Valencia,Santi Mina,ESP,FW,22,1995,20.6,17,10,1,15,1,3,25,12.0,22,19,2,17,4,21,20,0,2019
ESP-La Liga,2018,Valencia,Toni Lato,ESP,DF,20,1997,3.0,6,4,4,1,1,1,5,20.0,4,9,3,6,6,12,13,0,2019
ESP-La Liga,2018,Valladolid,Antoñito,ESP,"DF,MF",30,1987,20.7,35,21,16,15,4,18,42,42.9,24,21,8,13,18,53,31,0,2019
ESP-La Liga,2018,Valladolid,Anuar,MAR,"MF,FW",23,1995,12.0,33,19,15,16,2,6,14,42.9,8,14,1,13,11,44,25,1,2019
ESP-La Liga,2018,Valladolid,Borja Fernández,ESP,"MF,DF",37,1981,9.3,17,12,7,9,1,6,16,37.5,10,14,2,12,14,31,25,0,2019
ESP-La Liga,2018,Valladolid,Chris Ramos,ESP,FW,21,1997,0.7,1,1,0,0,1,1,1,100.0,0,0,0,0,0,1,1,0,2019
ESP-La Liga,2018,Valladolid,Daniele Verde,ITA,"MF,FW",22,1996,7.3,6,3,2,2,2,1,6,16.7,5,3,0,3,7,13,3,1,2019
ESP-La Liga,2018,Valladolid,Duje Čop,CRO,FW,28,1990,7.6,5,4,1,2,2,0,8,0.0,8,8,3,5,3,8,3,0,2019
ESP-La Liga,2018,Valladolid,Enes Ünal,TUR,FW,21,1997,23.9,17,10,3,4,10,4,24,16.7,20,17,4,13,2,19,18,0,2019
ESP-La Liga,2018,Valladolid,Fernando Calero,ESP,DF,22,1995,34.8,51,31,33,18,0,23,38,60.5,15,55,31,24,55,106,170,0,2019
ESP-La Liga,2018,Valladolid,Hacen,MTN,MF,20,1997,0.0,0,0,0,0,0,0,0,,0,1,0,1,1,1,1,0,2019
ESP-La Liga,2018,Valladolid,Ivi,ESP,"MF,FW",24,1994,0.2,0,0,0,0,0,0,0,,0,0,0,0,0,0,0,0,2019
ESP-La Liga,2018,Valladolid,Javi Moyano,ESP,DF,32,1986,23.3,25,17,17,6,2,15,30,50.0,15,20,9,11,25,50,88,2,2019
ESP-La Liga,2018,Valladolid,Joaquín Fernández,ESP,"DF,MF",22,1996,9.3,16,9,14,1,1,8,16,50.0,8,9,7,2,17,33,45,0,2019
ESP-La Liga,2018,Valladolid,Jordi Masip,ESP,GK,29,1989,35.0,1,1,1,0,0,0,0,,0,1,0,1,1,2,3,3,2019
ESP-La Liga,2018,Valladolid,Keko,ESP,"MF,FW",26,1991,17.0,42,18,21,15,6,18,50,36.0,32,20,1,19,14,56,17,0,2019
ESP-La Liga,2018,Valladolid,Kiko Olivas,ESP,DF,29,1988,34.4,51,38,35,15,1,22,48,45.8,26,31,18,13,46,97,173,2,2019
ESP-La Liga,2018,Valladolid,Leonardo Suárez,ARG,"FW,MF",22,1996,5.7,3,3,2,0,1,2,4,50.0,2,7,1,6,1,4,4,0,2019
ESP-La Liga,2018,Valladolid,Miguel,ESP,FW,18,1999,0.1,0,0,0,0,0,0,1,0.0,1,0,0,0,1,1,0,0,2019
ESP-La Liga,2018,Valladolid,Moisés Delgado,ESP,DF,24,1994,3.0,7,6,3,3,1,2,3,66.7,1,2,1,1,3,10,9,0,2019
ESP-La Liga,2018,Valladolid,Míchel,ESP,MF,30,1988,28.4,60,38,25,31,4,18,73,24.7,55,40,4,36,43,103,30,1,2019
ESP-La Liga,2018,Valladolid,Nacho,ESP,DF,29,1989,35.0,110,66,73,30,7,67,100,67.0,33,43,10,33,45,155,113,2,2019
ESP-La Liga,2018,Valladolid,Pablo Hervías,ESP,MF,25,1993,1.8,1,0,0,1,0,0,1,0.0,1,0,0,0,2,3,0,0,2019
ESP-La Liga,2018,Valladolid,Rubén Alcaraz,ESP,MF,27,1991,33.1,96,54,50,40,6,32,89,36.0,57,59,10,49,38,134,52,1,2019
ESP-La Liga,2018,Valladolid,Sergi Guardiola,ESP,FW,27,1991,16.8,19,11,1,10,8,2,13,15.4,11,12,0,12,5,24,17,0,2019
ESP-La Liga,2018,Valladolid,Stiven Plaza,ECU,"FW,MF",19,1999,0.4,0,0,0,0,0,0,0,,0,0,0,0,0,0,0,0,2019
ESP-La Liga,2018,Valladolid,Toni Villa,ESP,"MF,FW",23,1995,19.6,51,32,24,18,9,20,47,42.6,27,15,0,15,12,63,10,0,2019
ESP-La Liga,2018,Valladolid,Waldo Rubio,ESP,MF,22,1995,5.5,4,2,3,1,0,1,6,16.7,5,2,0,2,1,5,8,1,2019
ESP-La Liga,2018,Valladolid,Yoel,ESP,GK,29,1988,3.0,0,0,0,0,0,0,0,,0,0,0,0,0,0,0,1,2019
ESP-La Liga,2018,Valladolid,Óscar Plano,ESP,"MF,FW",27,1991,29.9,63,45,23,28,12,14,48,29.2,34,19,3,16,22,85,28,1,2019
ESP-La Liga,2018,Villarreal,Alfonso Pedraza,ESP,"DF,FW",22,1996,23.3,59,44,34,19,6,22,62,35.5,40,33,7,26,29,88,55,0,2019
ESP-La Liga,2018,Villarreal,Andrés Fernández,ESP,GK,31,1986,6.0,1,0,1,0,0,1,1,100.0,0,0,0,0,0,1,4,1,2019
ESP-La Liga,2018,Villarreal,Carlos Bacca,COL,FW,31,1986,14.1,4,2,1,2,1,0,5,0.0,5,4,0,4,8,12,5,0,2019
ESP-La Liga,2018,Villarreal,Dani Raba,ESP,"MF,FW",22,1995,2.1,6,5,1,2,3,1,5,20.0,4,1,0,1,1,7,0,0,2019
ESP-La Liga,2018,Villarreal,Daniele Bonera,ITA,DF,37,1981,2.6,2,2,2,0,0,1,1,100.0,0,5,5,0,4,6,10,0,2019
ESP-La Liga,2018,Villarreal,Gerard Moreno,ESP,FW,26,1992,25.7,22,12,2,15,5,8,27,29.6,19,23,9,14,9,31,39,0,2019
ESP-La Liga,2018,Villarreal,Jaume Costa,ESP,DF,30,1988,16.6,33,21,26,5,2,20,33,60.6,13,12,3,9,21,54,61,0,2019
ESP-La Liga,2018,Villarreal,Javi Fuego,ESP,MF,34,1984,2.6,6,3,5,1,0,4,8,50.0,4,2,0,2,3,9,9,0,2019
ESP-La Liga,2018,Villarreal,Karl Toko Ekambi,CMR,"FW,MF",25,1992,23.8,11,8,1,6,4,2,14,14.3,12,8,0,8,11,22,9,1,2019
ESP-La Liga,2018,Villarreal,Manu Morlanes,ESP,MF,19,1999,6.8,21,11,9,9,3,7,19,36.8,12,7,3,4,5,26,9,0,2019
ESP-La Liga,2018,Villarreal,Manu Trigueros,ESP,MF,26,1991,17.2,46,35,18,23,5,20,57,35.1,37,17,6,11,16,62,17,0,2019
ESP-La Liga,2018,Villarreal,Manuel Iturra,CHI,MF,34,1984,0.8,2,0,0,2,0,0,0,,0,1,0,1,2,4,2,0,2019
ESP-La Liga,2018,Villarreal,Mario Gaspar,ESP,DF,27,1990,28.9,62,43,39,17,6,29,49,59.2,20,48,11,37,42,104,91,0,2019
ESP-La Liga,2018,Villarreal,Miguel Juan Llambrich,ESP,"DF,FW",22,1996,6.0,21,14,11,9,1,6,14,42.9,8,9,2,7,12,33,17,0,2019
ESP-La Liga,2018,Villarreal,Miguel Layún,MEX,"MF,DF",30,1988,5.6,8,2,0,7,1,2,6,33.3,4,8,2,6,1,9,10,0,2019
ESP-La Liga,2018,Villarreal,Nicola Sansone,ITA,"FW,MF",26,1991,0.4,0,0,0,0,0,0,0,,0,0,0,0,0,0,0,0,2019
ESP-La Liga,2018,Villarreal,Pablo Fornals,ESP,"MF,FW",22,1996,27.5,49,26,14,26,9,15,54,27.8,39,32,4,28,24,73,19,0,2019
ESP-La Liga,2018,Villarreal,Ramiro Funes Mori,ARG,"DF,MF",27,1991,29.2,41,29,30,9,2,19,44,43.2,25,36,24,12,42,83,149,2,2019
ESP-La Liga,2018,Villarreal,Samuel Chukwueze,NGA,"MF,FW",19,1999,19.0,19,11,7,10,2,9,31,29.0,22,11,2,9,10,29,2,0,2019
ESP-La Liga,2018,Villarreal,Santi Cazorla,ESP,"MF,FW",33,1984,29.4,69,34,32,26,11,24,69,34.8,45,35,6,29,28,97,17,1,2019
ESP-La Liga,2018,Villarreal,Santiago Cáseres,ARG,MF,21,1997,17.6,67,35,20,38,9,25,57,43.9,32,22,9,13,14,81,24,1,2019
ESP-La Liga,2018,Villarreal,Sergio Asenjo,ESP,GK,29,1989,32.0,0,0,0,0,0,0,1,0.0,1,0,0,0,3,3,26,2,2019
ESP-La Liga,2018,Villarreal,Vicente Iborra,ESP,MF,30,1988,18.5,31,18,22,5,4,14,37,37.8,23,25,7,18,22,53,41,1,2019
ESP-La Liga,2018,Villarreal,Víctor Ruiz,ESP,DF,29,1989,21.9,28,19,20,6,2,13,18,72.2,5,28,16,12,38,66,67,1,2019
ESP-La Liga,2018,Villarreal,Xavi Quintillà,ESP,DF,21,1996,7.0,10,4,5,4,1,6,12,50.0,6,5,2,3,8,18,17,0,2019
ESP-La Liga,2018,Villarreal,Álvaro González,ESP,DF,28,1990,32.9,49,35,33,14,2,25,35,71.4,10,34,24,10,37,86,177,2,2019
ESP-La Liga,2019,Alavés,Abdallahi Mahmoud,MTN,MF,19,2000,1.7,4,4,2,1,1,1,6,16.7,5,0,0,0,5,9,2,0,2020
ESP-La Liga,2019,Alavés,Adrián Marín,ESP,DF,22,1997,9.5,22,15,14,6,2,13,15,86.7,2,13,4,9,13,35,32,0,2020
ESP-La Liga,2019,Alavés,Aleix Vidal,ESP,MF,29,1989,24.1,21,14,8,11,2,8,37,21.6,29,14,1,13,23,44,18,0,2020
ESP-La Liga,2019,Alavés,Antonio Sivera,ESP,GK,22,1996,3.0,0,0,0,0,0,0,0,,0,0,0,0,0,0,2,0,2020
ESP-La Liga,2019,Alavés,Borja Sainz,ESP,"MF,FW",18,2001,6.4,16,9,4,9,3,8,26,30.8,18,14,0,14,3,19,0,0,2020
ESP-La Liga,2019,Alavés,Burgui,ESP,MF,25,1993,0.2,0,0,0,0,0,0,0,,0,0,0,0,0,0,0,0,2020
ESP-La Liga,2019,Alavés,Fernando Pacheco,ESP,GK,27,1992,26.2,1,0,1,0,0,1,3,33.3,2,0,0,0,0,1,10,0,2020
ESP-La Liga,2019,Alavés,Guillermo Maripán,CHI,DF,25,1994,1.0,1,1,1,0,0,1,2,50.0,1,0,0,0,2,3,10,0,2020
ESP-La Liga,2019,Alavés,Javi López,ESP,DF,17,2002,1.0,6,5,4,2,0,4,5,80.0,1,1,1,0,1,7,5,0,2020
ESP-La Liga,2019,Alavés,Javier Muñoz,ESP,"FW,MF",24,1995,0.6,0,0,0,0,0,0,0,,0,1,1,0,0,0,0,0,2020
ESP-La Liga,2019,Alavés,John Guidetti,SWE,"FW,MF",27,1992,1.1,2,1,0,1,1,0,0,,0,1,0,1,0,2,0,0,2020
ESP-La Liga,2019,Alavés,Joselu,ESP,FW,29,1990,30.9,26,17,4,12,10,4,32,12.5,28,36,5,31,13,39,46,0,2020
ESP-La Liga,2019,Alavés,José Luis Rodríguez,PAN,FW,21,1998,0.2,0,0,0,0,0,0,2,0.0,2,0,0,0,0,0,0,0,2020
ESP-La Liga,2019,Alavés,Lisandro Magallán,ARG,DF,25,1993,13.3,22,15,10,12,0,8,14,57.1,6,17,6,11,16,38,43,1,2020
ESP-La Liga,2019,Alavés,Ljubomir Fejsa,SRB,MF,30,1988,8.7,19,13,8,10,1,6,23,26.1,17,8,1,7,6,25,13,0,2020
ESP-La Liga,2019,Alavés,Lucas Pérez,ESP,FW,30,1988,27.7,12,6,2,8,2,3,13,23.1,10,13,2,11,2,14,0,0,2020
ESP-La Liga,2019,Alavés,Luis Rioja,ESP,MF,25,1993,18.2,18,12,11,6,1,8,25,32.0,17,21,0,21,16,34,6,0,2020
ESP-La Liga,2019,Alavés,Manu García,ESP,MF,33,1986,21.9,46,23,11,31,4,17,72,23.6,55,28,12,16,28,74,32,1,2020
ESP-La Liga,2019,Alavés,Martin Agirregabiria,ESP,DF,23,1996,23.3,55,30,32,18,5,30,54,55.6,24,19,7,12,18,73,48,0,2020
ESP-La Liga,2019,Alavés,Oliver Burke,SCO,"MF,FW",22,1997,15.9,19,14,8,9,2,10,23,43.5,13,24,0,24,8,27,16,0,2020
ESP-La Liga,2019,Alavés,Paulino,ESP,"FW,MF",22,1997,0.8,0,0,0,0,0,0,1,0.0,1,1,0,1,1,1,0,0,2020
ESP-La Liga,2019,Alavés,Pere Pons,ESP,MF,26,1993,12.1,28,16,14,12,2,12,26,46.2,14,16,3,13,12,40,8,1,2020
ESP-La Liga,2019,Alavés,Roberto,ESP,GK,33,1986,8.8,1,1,1,0,0,1,1,100.0,0,0,0,0,0,1,2,0,2020
ESP-La Liga,2019,Alavés,Rodrigo Ely,BRA,DF,25,1993,23.6,22,13,15,7,0,13,29,44.8,16,23,19,4,32,54,116,0,2020
ESP-La Liga,2019,Alavés,Rubén Duarte,ESP,DF,23,1995,29.6,61,32,30,28,3,34,60,56.7,26,30,8,22,47,108,71,0,2020
ESP-La Liga,2019,Alavés,Tachi,ESP,DF,21,1997,2.6,2,1,2,0,0,1,4,25.0,3,5,4,1,4,6,12,0,2020
ESP-La Liga,2019,Alavés,Tomás Pina Isla,ESP,MF,31,1987,14.9,37,22,13,21,3,12,24,50.0,12,15,5,10,16,53,31,0,2020
ESP-La Liga,2019,Alavés,Víctor Camarasa,ESP,MF,25,1994,14.4,18,10,5,10,3,7,18,38.9,11,8,3,5,15,33,12,0,2020
ESP-La Liga,2019,Alavés,Víctor Laguardia,ESP,DF,29,1989,29.5,21,15,15,6,0,16,30,53.3,14,24,18,6,37,58,131,1,2020
ESP-La Liga,2019,Alavés,Wakaso,GHA,MF,29,1990,14.3,54,31,25,24,5,16,33,48.5,17,23,5,18,17,71,17,1,2020
ESP-La Liga,2019,Alavés,Ximo Navarro,ESP,DF,29,1990,21.1,34,19,17,15,2,16,28,57.1,12,20,7,13,52,86,76,2,2020
ESP-La Liga,2019,Alavés,Édgar Méndez,ESP,"MF,FW",29,1990,9.6,11,7,4,6,1,5,13,38.5,8,10,2,8,5,16,7,0,2020
ESP-La Liga,2019,Athletic Club,Ander Capa,ESP,DF,27,1992,31.9,64,36,37,21,6,24,59,40.7,35,26,7,19,28,92,63,0,2020
ESP-La Liga,2019,Athletic Club,Aritz Aduriz,ESP,"FW,MF",38,1981,2.3,3,2,0,3,0,0,0,,0,0,0,0,0,3,2,0,2020
ESP-La Liga,2019,Athletic Club,Asier Villalibre,ESP,FW,21,1997,5.9,0,0,0,0,0,0,3,0.0,3,3,0,3,1,1,4,0,2020
ESP-La Liga,2019,Athletic Club,Beñat Etxebarria,ESP,MF,32,1987,4.4,6,1,2,3,1,2,13,15.4,11,6,1,5,4,10,6,0,2020
ESP-La Liga,2019,Athletic Club,Dani García,ESP,MF,29,1990,33.7,59,30,30,27,2,30,86,34.9,56,25,7,18,52,111,56,1,2020
ESP-La Liga,2019,Athletic Club,Iago Herrerín,ESP,GK,31,1988,4.7,0,0,0,0,0,0,0,,0,0,0,0,0,0,0,0,2020
ESP-La Liga,2019,Athletic Club,Ibai Gómez,ESP,FW,29,1989,7.7,5,3,2,2,1,3,8,37.5,5,4,0,4,3,8,6,0,2020
ESP-La Liga,2019,Athletic Club,Iker Muniain,ESP,"FW,MF",26,1992,26.5,26,19,11,10,5,4,24,16.7,20,9,0,9,12,38,7,0,2020
ESP-La Liga,2019,Athletic Club,Iñaki Williams,GHA,FW,25,1994,32.7,15,5,0,7,8,5,18,27.8,13,18,2,16,5,20,29,0,2020
ESP-La Liga,2019,Athletic Club,Iñigo Córdoba,ESP,FW,22,1997,16.0,33,20,16,12,5,14,52,26.9,38,30,2,28,16,49,13,0,2020
ESP-La Liga,2019,Athletic Club,Iñigo Lekue,ESP,"FW,DF",26,1993,6.9,22,12,14,6,2,11,14,78.6,3,7,0,7,3,25,11,0,2020
ESP-La Liga,2019,Athletic Club,Iñigo Martínez,ESP,DF,28,1991,33.0,48,30,33,13,2,27,47,57.4,20,28,13,15,39,87,140,0,2020
ESP-La Liga,2019,Athletic Club,Kenan Kodro,BIH,"FW,MF",25,1993,4.0,1,0,0,0,1,0,2,0.0,2,1,0,1,0,1,4,0,2020
ESP-La Liga,2019,Athletic Club,Larra,ESP,"FW,MF",21,1997,2.8,2,2,0,1,1,0,0,,0,1,0,1,0,2,0,0,2020
ESP-La Liga,2019,Athletic Club,Mikel Balenziaga,ESP,DF,31,1988,6.3,15,10,4,10,1,9,11,81.8,2,4,1,3,2,17,20,0,2020
ESP-La Liga,2019,Athletic Club,Mikel San José,ESP,MF,30,1989,4.0,9,4,2,4,3,2,10,20.0,8,3,1,2,9,18,12,0,2020
ESP-La Liga,2019,Athletic Club,Mikel Vesga,ESP,MF,26,1993,14.1,25,17,7,12,6,9,45,20.0,36,18,7,11,31,56,24,1,2020
ESP-La Liga,2019,Athletic Club,Oihan Sancet,ESP,"MF,FW",19,2000,8.2,11,7,5,4,2,4,11,36.4,7,6,0,6,2,13,2,0,2020
ESP-La Liga,2019,Athletic Club,Raúl García,ESP,"MF,FW",33,1986,31.9,57,37,19,26,12,16,76,21.1,60,46,6,40,24,81,44,0,2020
ESP-La Liga,2019,Athletic Club,Unai López,ESP,MF,23,1995,19.9,30,22,8,18,4,10,41,24.4,31,13,2,11,18,48,12,1,2020
ESP-La Liga,2019,Athletic Club,Unai Núñez,ESP,DF,22,1997,17.5,13,10,10,2,1,6,16,37.5,10,25,17,8,23,36,71,0,2020
ESP-La Liga,2019,Athletic Club,Unai Simón,ESP,GK,22,1997,33.2,0,0,0,0,0,0,1,0.0,1,1,0,1,1,1,10,1,2020
ESP-La Liga,2019,Athletic Club,Unai Vencedor Paris,ESP,MF,18,2000,0.8,0,0,0,0,0,0,0,,0,0,0,0,0,0,0,0,2020
ESP-La Liga,2019,Athletic Club,Yeray Álvarez,ESP,DF,24,1995,31.2,36,19,28,7,1,17,30,56.7,13,33,22,11,62,98,138,2,2020
ESP-La Liga,2019,Athletic Club,Yuri Berchiche,ESP,DF,29,1990,31.7,48,35,32,15,1,21,40,52.5,19,26,4,22,30,78,73,1,2020
ESP-La Liga,2019,Athletic Club,Óscar de Marcos,ESP,"DF,FW",30,1989,6.0,5,3,2,1,2,3,6,50.0,3,6,0,6,8,13,8,0,2020
ESP-La Liga,2019,Atlético Madrid,Antonio Adán,ESP,GK,32,1987,0.3,0,0,0,0,0,0,0,,0,0,0,0,0,0,0,0,2020
ESP-La Liga,2019,Atlético Madrid,Darío Poveda,ESP,MF,22,1997,0.1,1,0,0,1,0,0,0,,0,0,0,0,0,1,0,0,2020
ESP-La Liga,2019,Atlético Madrid,Diego Costa,ESP,FW,30,1988,15.0,9,5,1,4,4,1,10,10.0,9,4,2,2,3,12,10,0,2020
ESP-La Liga,2019,Atlético Madrid,Felipe,BRA,DF,30,1989,23.4,27,19,21,6,0,14,24,58.3,10,18,13,5,40,67,130,0,2020
ESP-La Liga,2019,Atlético Madrid,Germán Valera,ESP,FW,17,2002,0.0,0,0,0,0,0,0,0,,0,1,0,1,0,0,0,0,2020
ESP-La Liga,2019,Atlético Madrid,Héctor Herrera,MEX,MF,29,1990,12.5,31,21,9,18,4,13,32,40.6,19,16,7,9,17,48,13,2,2020
ESP-La Liga,2019,Atlético Madrid,Ivan Šaponjić,SRB,"DF,FW",21,1997,0.1,0,0,0,0,0,0,0,,0,0,0,0,0,0,0,0,2020
ESP-La Liga,2019,Atlético Madrid,Jan Oblak,SVN,GK,26,1993,37.7,0,0,0,0,0,0,0,,0,0,0,0,1,1,4,2,2020
ESP-La Liga,2019,Atlético Madrid,José María Giménez,URU,DF,24,1995,19.5,20,16,18,1,1,7,11,63.6,4,14,7,7,23,43,75,1,2020
ESP-La Liga,2019,Atlético Madrid,João Félix,POR,"FW,MF",19,1999,19.4,9,3,3,3,3,4,14,28.6,10,4,0,4,10,19,4,1,2020
ESP-La Liga,2019,Atlético Madrid,Kieran Trippier,ENG,DF,28,1990,22.0,52,34,24,21,7,34,53,64.2,19,33,7,26,24,76,46,0,2020
ESP-La Liga,2019,Atlético Madrid,Koke,ESP,MF,27,1992,30.0,70,42,27,30,13,29,89,32.6,60,33,8,25,29,99,28,2,2020
ESP-La Liga,2019,Atlético Madrid,Manuel Sánchez,ESP,DF,18,2000,3.6,13,7,2,7,4,8,15,53.3,7,3,0,3,7,20,1,0,2020
ESP-La Liga,2019,Atlético Madrid,Marcos Llorente,ESP,"MF,FW",24,1995,15.2,29,15,7,16,6,7,21,33.3,14,24,4,20,14,43,9,0,2020
ESP-La Liga,2019,Atlético Madrid,Mario Hermoso,ESP,DF,24,1995,13.5,15,8,12,2,1,11,20,55.0,9,11,5,6,12,27,61,0,2020
ESP-La Liga,2019,Atlético Madrid,Renan Lodi,BRA,DF,21,1998,26.6,73,46,28,35,10,40,65,61.5,25,28,7,21,38,111,56,0,2020
ESP-La Liga,2019,Atlético Madrid,Rodrigo Riquelme,ESP,"FW,MF",19,2000,0.1,0,0,0,0,0,0,0,,0,0,0,0,0,0,0,0,2020
ESP-La Liga,2019,Atlético Madrid,Santiago Arias,COL,DF,27,1992,12.0,36,24,20,12,4,10,18,55.6,8,12,7,5,19,55,20,1,2020
ESP-La Liga,2019,Atlético Madrid,Saúl Ñíguez,ESP,"MF,DF",24,1994,34.1,95,59,44,42,9,39,88,44.3,49,58,13,45,55,150,68,1,2020
ESP-La Liga,2019,Atlético Madrid,Sergio Camello,ESP,FW,18,2001,0.3,0,0,0,0,0,0,0,,0,0,0,0,0,0,0,0,2020
ESP-La Liga,2019,Atlético Madrid,Stefan Savić,MNE,DF,28,1991,22.0,22,17,11,10,1,11,18,61.1,7,16,9,7,24,46,91,1,2020
ESP-La Liga,2019,Atlético Madrid,Thomas Lemar,FRA,MF,23,1995,10.3,12,8,4,5,3,2,11,18.2,9,14,1,13,6,18,6,0,2020
ESP-La Liga,2019,Atlético Madrid,Thomas Partey,GHA,MF,26,1993,28.3,70,41,34,30,6,26,58,44.8,32,32,8,24,48,118,41,7,2020
ESP-La Liga,2019,Atlético Madrid,Toni Moya,ESP,MF,21,1998,0.0,0,0,0,0,0,0,0,,0,0,0,0,0,0,0,0,2020
ESP-La Liga,2019,Atlético Madrid,Vitolo,ESP,"FW,MF",29,1989,13.6,15,12,7,7,1,5,17,29.4,12,9,0,9,10,25,9,0,2020
ESP-La Liga,2019,Atlético Madrid,Yannick Carrasco,BEL,"MF,FW",25,1993,7.0,11,7,4,4,3,7,21,33.3,14,9,0,9,5,16,2,0,2020
ESP-La Liga,2019,Atlético Madrid,Álvaro Morata,ESP,FW,26,1992,23.3,17,8,4,9,4,1,13,7.7,12,12,2,10,5,22,23,0,2020
ESP-La Liga,2019,Atlético Madrid,Ángel Correa,ARG,"MF,FW",24,1995,22.9,25,9,7,9,9,9,36,25.0,27,23,5,18,14,39,21,0,2020
ESP-La Liga,2019,Atlético Madrid,Óscar Clemente,ESP,MF,20,1999,0.0,0,0,0,0,0,0,0,,0,1,0,1,0,0,0,0,2020
ESP-La Liga,2019,Atlético Madrid,Šime Vrsaljko,CRO,DF,27,1992,4.0,6,5,6,0,0,5,6,83.3,1,5,3,2,8,14,11,0,2020
ESP-La Liga,2019,Barcelona,Ansu Fati,ESP,FW,16,2002,11.4,16,8,4,7,5,5,15,33.3,10,14,1,13,8,24,3,0,2020
ESP-La Liga,2019,Barcelona,Antoine Griezmann,FRA,FW,28,1991,28.3,33,18,12,11,10,9,34,26.5,25,22,3,19,12,45,20,1,2020
ESP-La Liga,2019,Barcelona,Arthur Melo,BRA,MF,22,1996,13.1,15,10,4,7,4,4,12,33.3,8,9,0,9,4,19,5,2,2020
ESP-La Liga,2019,Barcelona,Arturo Vidal,CHI,MF,32,1987,18.6,63,38,22,30,11,24,58,41.4,34,31,7,24,17,80,16,1,2020
ESP-La Liga,2019,Barcelona,Carles Aleñá,ESP,MF,21,1998,1.9,2,1,1,1,0,1,4,25.0,3,1,0,1,0,2,0,0,2020
ESP-La Liga,2019,Barcelona,Carles Pérez,ESP,FW,21,1998,5.3,7,4,2,2,3,3,15,20.0,12,5,2,3,1,8,1,0,2020
ESP-La Liga,2019,Barcelona,Clément Lenglet,FRA,DF,24,1995,26.9,44,31,29,15,0,16,32,50.0,16,29,15,14,35,79,79,1,2020
ESP-La Liga,2019,Barcelona,Frenkie de Jong,NED,MF,22,1997,23.5,26,19,7,12,7,7,22,31.8,15,17,7,10,21,47,9,0,2020
ESP-La Liga,2019,Barcelona,Gerard Piqué,ESP,DF,32,1987,34.4,32,23,20,11,1,16,26,61.5,10,39,24,15,36,68,157,0,2020
ESP-La Liga,2019,Barcelona,Ivan Rakitić,CRO,MF,31,1988,17.7,27,14,8,15,4,10,28,35.7,18,19,6,13,15,42,18,1,2020
ESP-La Liga,2019,Barcelona,Jean-Clair Todibo,FRA,DF,19,1999,0.9,1,0,1,0,0,0,1,0.0,1,0,0,0,0,1,6,0,2020
ESP-La Liga,2019,Barcelona,Jordi Alba,ESP,DF,30,1989,24.3,20,13,9,7,4,6,27,22.2,21,12,3,9,37,57,40,0,2020
ESP-La Liga,2019,Barcelona,Junior Firpo,ESP,DF,22,1996,11.3,23,15,12,8,3,11,17,64.7,6,15,3,12,17,40,12,1,2020
ESP-La Liga,2019,Barcelona,Lionel Messi,ARG,FW,32,1987,32.0,21,10,4,7,10,3,21,14.3,18,9,0,9,7,28,1,0,2020
ESP-La Liga,2019,Barcelona,Luis Suárez,URU,FW,32,1987,22.2,4,0,0,1,3,2,12,16.7,10,6,1,5,1,5,11,0,2020
ESP-La Liga,2019,Barcelona,Marc-André ter Stegen,GER,GK,27,1992,36.0,2,2,2,0,0,2,3,66.7,1,0,0,0,2,4,17,6,2020
ESP-La Liga,2019,Barcelona,Martin Braithwaite,DEN,"FW,MF",28,1991,4.5,2,2,2,0,0,0,8,0.0,8,3,0,3,1,3,1,0,2020
ESP-La Liga,2019,Barcelona,Moussa Wagué,SEN,DF,20,1998,1.0,2,1,1,0,1,1,1,100.0,0,0,0,0,1,3,0,0,2020
ESP-La Liga,2019,Barcelona,Neto,BRA,GK,30,1989,2.0,0,0,0,0,0,0,0,,0,0,0,0,0,0,1,0,2020
ESP-La Liga,2019,Barcelona,Nélson Semedo,POR,DF,25,1993,23.3,51,30,27,18,6,21,36,58.3,15,18,3,15,22,73,30,0,2020
ESP-La Liga,2019,Barcelona,Ousmane Dembélé,FRA,FW,22,1997,4.0,2,2,1,1,0,2,5,40.0,3,4,0,4,0,2,0,1,2020
ESP-La Liga,2019,Barcelona,Rafinha,BRA,"FW,MF",26,1993,2.1,3,2,1,1,1,1,2,50.0,1,0,0,0,1,4,0,0,2020
ESP-La Liga,2019,Barcelona,Riqui Puig,ESP,MF,19,1999,5.7,11,7,1,9,1,5,17,29.4,12,2,0,2,5,16,1,0,2020
ESP-La Liga,2019,Barcelona,Ronald Araújo,URU,DF,20,1999,2.6,3,2,2,1,0,1,1,100.0,0,6,2,4,0,3,9,0,2020
ESP-La Liga,2019,Barcelona,Samuel Umtiti,FRA,DF,25,1993,10.5,11,5,5,5,1,5,8,62.5,3,4,2,2,22,33,32,0,2020
ESP-La Liga,2019,Barcelona,Sergi Roberto,ESP,"DF,MF",27,1992,26.0,35,22,16,11,8,15,25,60.0,10,12,3,9,33,68,36,0,2020
ESP-La Liga,2019,Barcelona,Sergio Busquets,ESP,MF,31,1988,27.6,80,44,23,43,14,41,71,57.7,30,36,5,31,44,124,24,2,2020
ESP-La Liga,2019,Barcelona,Álex Collado,ESP,FW,20,1999,0.1,0,0,0,0,0,0,0,,0,0,0,0,0,0,0,0,2020
ESP-La Liga,2019,Betis,Alfonso Pedraza,ESP,DF,23,1996,15.0,30,19,16,11,3,19,33,57.6,14,18,6,12,16,46,26,1,2020
ESP-La Liga,2019,Betis,Andrés Guardado,MEX,MF,32,1986,22.7,30,14,15,11,4,15,41,36.6,26,15,4,11,18,48,22,1,2020
ESP-La Liga,2019,Betis,Antonio Barragán,ESP,DF,32,1987,7.1,7,5,4,2,1,3,6,50.0,3,2,2,0,8,15,22,0,2020
ESP-La Liga,2019,Betis,Aïssa Mandi,ALG,DF,27,1991,28.6,33,15,22,8,3,18,28,64.3,10,29,15,14,38,71,93,0,2020
ESP-La Liga,2019,Betis,Borja Iglesias,ESP,FW,26,1993,21.4,7,5,1,4,2,0,9,0.0,9,7,4,3,5,12,18,0,2020
ESP-La Liga,2019,Betis,Carles Aleñá,ESP,"MF,FW",21,1998,8.2,14,9,5,7,2,3,17,17.6,14,4,1,3,1,15,3,0,2020
ESP-La Liga,2019,Betis,Cristian Tello,ESP,"MF,FW",27,1991,8.7,8,5,2,2,4,4,8,50.0,4,5,0,5,4,12,0,0,2020
ESP-La Liga,2019,Betis,Daniel Martín,ESP,GK,21,1998,5.9,0,0,0,0,0,0,0,,0,0,0,0,0,0,3,0,2020
ESP-La Liga,2019,Betis,Diego Lainez,MEX,"MF,FW",19,2000,3.9,6,5,2,4,0,5,8,62.5,3,6,0,6,1,7,1,0,2020
ESP-La Liga,2019,Betis,Emerson,BRA,DF,20,1999,31.5,74,46,49,19,6,36,79,45.6,43,30,9,21,31,105,57,1,2020
ESP-La Liga,2019,Betis,Guido Rodríguez,ARG,MF,25,1994,10.4,24,16,11,11,2,15,25,60.0,10,13,4,9,10,34,21,0,2020
ESP-La Liga,2019,Betis,Ismael,ESP,MF,18,2000,0.9,2,1,1,1,0,1,2,50.0,1,2,1,1,2,4,2,0,2020
ESP-La Liga,2019,Betis,Javi García,ESP,MF,32,1987,4.2,2,2,2,0,0,2,3,66.7,1,1,0,1,4,6,15,0,2020
ESP-La Liga,2019,Betis,Joaquín,ESP,"MF,FW",38,1981,22.9,14,7,4,8,2,4,11,36.4,7,10,2,8,15,29,22,1,2020
ESP-La Liga,2019,Betis,Joel Robles,ESP,GK,29,1990,32.1,0,0,0,0,0,0,2,0.0,2,0,0,0,0,0,13,2,2020
ESP-La Liga,2019,Betis,Juanmi,ESP,"FW,MF",26,1993,2.9,4,1,1,2,1,1,4,25.0,3,1,0,1,0,4,0,0,2020
ESP-La Liga,2019,Betis,Loren Morón,ESP,FW,25,1993,22.6,18,12,6,7,5,9,23,39.1,14,25,6,19,9,27,13,0,2020
ESP-La Liga,2019,Betis,Marc Bartra,ESP,"DF,MF",28,1991,28.0,62,34,39,23,0,27,54,50.0,27,45,24,21,35,97,127,0,2020
ESP-La Liga,2019,Betis,Nabil Fekir,FRA,"MF,FW",26,1993,29.3,41,26,14,19,8,12,37,32.4,25,27,3,24,10,51,3,0,2020
ESP-La Liga,2019,Betis,Raúl,ESP,"FW,MF",18,2000,0.2,0,0,0,0,0,0,2,0.0,2,0,0,0,0,0,0,0,2020
ESP-La Liga,2019,Betis,Sergio Canales,ESP,"MF,FW",28,1991,35.1,25,16,14,6,5,7,28,25.0,21,30,1,29,13,38,16,0,2020
ESP-La Liga,2019,Betis,Sidnei,BRA,DF,29,1989,13.1,23,19,17,6,0,9,14,64.3,5,15,12,3,21,44,57,0,2020
ESP-La Liga,2019,Betis,Wilfrid Kaptoum,CMR,MF,23,1996,2.2,5,2,3,2,0,3,3,100.0,0,4,1,3,1,6,3,0,2020
ESP-La Liga,2019,Betis,William Carvalho,POR,MF,27,1992,9.9,7,4,4,2,1,4,14,28.6,10,7,5,2,4,11,8,1,2020
ESP-La Liga,2019,Betis,Zouhair Feddal,MAR,DF,30,1989,15.9,20,13,14,5,1,10,14,71.4,4,15,9,6,23,43,74,0,2020
ESP-La Liga,2019,Betis,Álex Moreno,ESP,DF,26,1993,25.2,37,20,27,8,2,12,32,37.5,20,21,8,13,23,60,47,1,2020
ESP-La Liga,2019,Betis,Édgar González,ESP,MF,22,1997,7.6,8,3,3,5,0,2,14,14.3,12,4,2,2,10,18,16,0,2020
ESP-La Liga,2019,Celta Vigo,Brais Méndez,ESP,"MF,FW",22,1997,16.4,26,11,14,9,3,12,39,30.8,27,20,0,20,12,38,23,1,2020
ESP-La Liga,2019,Celta Vigo,David Costas,ESP,DF,24,1995,3.8,4,3,3,1,0,2,4,50.0,2,3,3,0,8,12,12,0,2020
ESP-La Liga,2019,Celta Vigo,David Juncà,ESP,DF,25,1993,2.9,6,5,4,1,1,2,3,66.7,1,4,1,3,2,8,3,0,2020
ESP-La Liga,2019,Celta Vigo,Denis Suárez,ESP,"MF,FW",25,1994,18.1,22,15,14,7,1,10,37,27.0,27,9,1,8,14,36,12,1,2020
ESP-La Liga,2019,Celta Vigo,Filip Bradarić,CRO,MF,27,1992,7.8,12,9,5,5,2,3,8,37.5,5,12,3,9,17,29,19,0,2020
ESP-La Liga,2019,Celta Vigo,Fran Beltrán,ESP,MF,20,1999,20.3,31,19,15,12,4,11,35,31.4,24,14,1,13,14,45,17,0,2020
ESP-La Liga,2019,Celta Vigo,Fyodor Smolov,RUS,FW,29,1990,8.3,2,1,0,2,0,1,9,11.1,8,6,0,6,7,9,9,0,2020
ESP-La Liga,2019,Celta Vigo,Gabriel Fernández,URU,"FW,MF",25,1994,6.2,1,0,0,1,0,1,3,33.3,2,5,1,4,2,3,2,0,2020
ESP-La Liga,2019,Celta Vigo,Hugo Mallo,ESP,DF,28,1991,21.8,62,42,44,16,2,27,48,56.3,21,24,8,16,22,84,97,1,2020
ESP-La Liga,2019,Celta Vigo,Iago Aspas,ESP,FW,31,1987,36.2,29,19,7,9,13,12,45,26.7,33,16,1,15,22,51,7,0,2020
ESP-La Liga,2019,Celta Vigo,Iván Villar,ESP,GK,22,1997,3.1,0,0,0,0,0,0,0,,0,0,0,0,0,0,5,0,2020
ESP-La Liga,2019,Celta Vigo,Jacobo,ESP,"DF,MF",22,1997,0.9,3,3,2,1,0,1,1,100.0,0,0,0,0,0,3,2,0,2020
ESP-La Liga,2019,Celta Vigo,Jeison Murillo,COL,DF,27,1992,17.0,37,20,30,6,1,18,27,66.7,9,13,9,4,20,57,74,2,2020
ESP-La Liga,2019,Celta Vigo,Jorge Sáenz,ESP,DF,22,1996,4.1,6,1,4,2,0,3,5,60.0,2,5,2,3,10,16,15,0,2020
ESP-La Liga,2019,Celta Vigo,Joseph Aidoo,GHA,DF,23,1995,27.8,43,27,30,11,2,13,27,48.1,14,31,14,17,45,88,124,3,2020
ESP-La Liga,2019,Celta Vigo,Juan Hernández,ESP,"FW,MF",24,1994,1.0,0,0,0,0,0,0,0,,0,0,0,0,1,1,0,0,2020
ESP-La Liga,2019,Celta Vigo,Kevin Vázquez,ESP,DF,26,1993,14.7,26,15,16,6,4,15,28,53.6,13,18,1,17,26,52,28,0,2020
ESP-La Liga,2019,Celta Vigo,Losada,ESP,"MF,FW",17,2001,0.1,0,0,0,0,0,0,0,,0,0,0,0,0,0,0,0,2020
ESP-La Liga,2019,Celta Vigo,Lucas Olaza,URU,DF,25,1994,34.9,56,39,36,17,3,39,59,66.1,20,37,10,27,31,87,60,1,2020
ESP-La Liga,2019,Celta Vigo,Nolito,ESP,"MF,FW",32,1986,3.6,7,5,5,2,0,3,8,37.5,5,4,1,3,1,8,4,0,2020
ESP-La Liga,2019,Celta Vigo,Néstor Araujo,MEX,DF,27,1991,32.1,44,27,35,8,1,22,36,61.1,14,26,18,8,52,96,142,0,2020
ESP-La Liga,2019,Celta Vigo,Okay Yokuşlu,TUR,MF,25,1994,21.9,41,27,18,21,2,20,42,47.6,22,12,5,7,28,69,71,1,2020
ESP-La Liga,2019,Celta Vigo,Pape Cheikh Diop,SEN,MF,21,1997,6.7,10,4,6,3,1,2,12,16.7,10,4,2,2,5,15,3,0,2020
ESP-La Liga,2019,Celta Vigo,Pione Sisto,DEN,"FW,MF",24,1995,9.9,17,8,5,6,6,4,19,21.1,15,18,0,18,6,23,4,1,2020
ESP-La Liga,2019,Celta Vigo,Rafinha,BRA,MF,26,1993,23.5,71,37,29,37,5,20,62,32.3,42,37,4,33,33,104,25,0,2020
ESP-La Liga,2019,Celta Vigo,Rubén Blanco,ESP,GK,24,1995,32.9,1,1,1,0,0,1,1,100.0,0,0,0,0,0,1,14,1,2020
ESP-La Liga,2019,Celta Vigo,Santi Mina,ESP,"FW,MF",23,1995,21.6,13,8,8,5,0,5,38,13.2,33,19,2,17,10,23,27,0,2020
ESP-La Liga,2019,Celta Vigo,Sergio Bermejo,ESP,"MF,FW",21,1997,0.1,0,0,0,0,0,0,0,,0,0,0,0,0,0,0,0,2020
ESP-La Liga,2019,Celta Vigo,Sergio Álvarez,ESP,GK,32,1986,2.0,0,0,0,0,0,0,0,,0,0,0,0,0,0,1,0,2020
ESP-La Liga,2019,Celta Vigo,Stanislav Lobotka,SVK,MF,24,1994,15.4,19,11,13,5,1,4,19,21.1,15,8,2,6,8,27,7,0,2020
ESP-La Liga,2019,Eibar,Anaitz Arbilla,ESP,DF,32,1987,22.3,33,20,23,8,2,16,34,47.1,18,20,4,16,29,62,82,0,2020
ESP-La Liga,2019,Eibar,Charles,BRA,FW,35,1984,14.5,10,5,0,6,4,4,22,18.2,18,7,2,5,7,17,6,0,2020
ESP-La Liga,2019,Eibar,Edu Expósito,ESP,MF,22,1996,25.7,52,28,12,31,9,18,49,36.7,31,20,6,14,31,83,18,1,2020
ESP-La Liga,2019,Eibar,Esteban Burgos,ARG,DF,27,1992,12.4,11,9,9,2,0,5,9,55.6,4,11,6,5,17,28,66,2,2020
ESP-La Liga,2019,Eibar,Fabián Orellana,CHI,"MF,FW",33,1986,26.6,29,18,10,6,13,14,52,26.9,38,9,0,9,20,49,2,0,2020
ESP-La Liga,2019,Eibar,Gonzalo Escalante,ARG,MF,26,1993,18.6,41,22,15,17,9,24,41,58.5,17,22,4,18,29,70,14,0,2020
ESP-La Liga,2019,Eibar,Iván Ramis,ESP,DF,34,1984,5.1,3,2,2,1,0,1,4,25.0,3,2,0,2,4,7,23,2,2020
ESP-La Liga,2019,Eibar,José Ángel,ESP,DF,29,1989,26.2,54,31,26,25,3,26,43,60.5,17,23,7,16,33,87,61,1,2020
ESP-La Liga,2019,Eibar,Kike,ESP,FW,29,1989,19.6,13,7,0,5,8,4,12,33.3,8,15,1,14,1,14,9,0,2020
ESP-La Liga,2019,Eibar,Marko Dmitrović,SRB,GK,27,1992,35.0,3,2,3,0,0,3,5,60.0,2,1,0,1,3,6,24,0,2020
ESP-La Liga,2019,Eibar,Miguel Atienza,ESP,MF,20,1999,0.3,1,1,0,1,0,1,2,50.0,1,1,1,0,2,3,1,0,2020
ESP-La Liga,2019,Eibar,Miguel Marí,ESP,MF,22,1997,0.1,0,0,0,0,0,0,0,,0,0,0,0,0,0,0,0,2020
ESP-La Liga,2019,Eibar,Pablo de Blasis,ARG,"DF,MF",31,1988,17.8,41,32,22,13,6,30,63,47.6,33,13,0,13,24,65,21,0,2020
ESP-La Liga,2019,Eibar,Papakouli Diop,SEN,MF,33,1986,25.0,39,26,13,22,4,18,42,42.9,24,24,7,17,34,73,38,0,2020
ESP-La Liga,2019,Eibar,Paulo Oliveira,POR,DF,27,1992,23.2,31,19,22,8,1,18,30,60.0,12,23,13,10,42,73,107,1,2020
ESP-La Liga,2019,Eibar,Pedro Bigas,ESP,DF,28,1990,19.7,18,9,11,7,0,9,19,47.4,10,16,10,6,36,54,82,0,2020
ESP-La Liga,2019,Eibar,Pedro León,ESP,"MF,FW",32,1986,21.1,28,20,8,9,11,12,25,48.0,13,18,1,17,19,47,7,0,2020
ESP-La Liga,2019,Eibar,Quique,ESP,"FW,MF",29,1990,5.4,2,1,1,0,1,0,0,,0,3,0,3,0,2,3,0,2020
ESP-La Liga,2019,Eibar,Rafa Soares,POR,DF,24,1995,4.8,6,5,5,0,1,5,11,45.5,6,1,0,1,2,8,6,0,2020
ESP-La Liga,2019,Eibar,Rober Correa,ESP,DF,26,1992,10.3,13,6,8,3,2,6,10,60.0,4,6,4,2,16,29,31,0,2020
ESP-La Liga,2019,Eibar,Sebastián Cristóforo,URU,MF,25,1993,9.7,35,19,11,14,10,13,32,40.6,19,25,3,22,8,43,2,0,2020
ESP-La Liga,2019,Eibar,Sergi Enrich,ESP,FW,29,1990,20.7,17,6,4,8,5,4,21,19.0,17,16,2,14,9,26,12,0,2020
ESP-La Liga,2019,Eibar,Sergio Álvarez,ESP,"MF,DF",27,1992,12.7,37,22,11,24,2,8,24,33.3,16,16,2,14,17,54,26,1,2020
ESP-La Liga,2019,Eibar,Takashi Inui,JPN,"MF,FW",31,1988,21.8,20,10,7,8,5,11,34,32.4,23,23,4,19,18,38,12,0,2020
ESP-La Liga,2019,Eibar,Yoel,ESP,GK,30,1988,3.0,0,0,0,0,0,0,0,,0,0,0,0,1,1,1,0,2020
ESP-La Liga,2019,Eibar,Álvaro Tejero,ESP,DF,23,1996,16.1,30,18,17,10,3,14,23,60.9,9,17,4,13,28,58,38,0,2020
ESP-La Liga,2019,Espanyol,Adri Embarba,ESP,"MF,FW",27,1992,15.2,37,22,16,16,5,16,33,48.5,17,28,4,24,16,53,11,0,2020
ESP-La Liga,2019,Espanyol,Ander Iturraspe,ESP,MF,30,1989,2.7,2,0,1,1,0,2,5,40.0,3,0,0,0,1,3,7,0,2020
ESP-La Liga,2019,Espanyol,Bernardo Espinosa,COL,DF,30,1989,25.1,24,16,18,4,2,16,28,57.1,12,19,11,8,24,48,108,2,2020
ESP-La Liga,2019,Espanyol,David López,ESP,"DF,MF",29,1989,27.3,38,20,15,20,3,13,41,31.7,28,28,13,15,35,73,63,3,2020
ESP-La Liga,2019,Espanyol,Diego López,ESP,GK,37,1981,35.9,2,2,2,0,0,1,2,50.0,1,0,0,0,2,4,8,1,2020
ESP-La Liga,2019,Espanyol,Dídac Vilà,ESP,DF,30,1989,27.7,73,42,44,23,6,25,61,41.0,36,31,5,26,40,113,63,0,2020
ESP-La Liga,2019,Espanyol,Esteban Granero,ESP,MF,32,1987,5.3,10,4,5,3,2,5,11,45.5,6,3,2,1,2,12,5,0,2020
ESP-La Liga,2019,Espanyol,Facundo Ferreyra,ARG,"FW,MF",28,1991,6.4,9,4,4,5,0,3,10,30.0,7,4,0,4,2,11,5,0,2020
ESP-La Liga,2019,Espanyol,Fernando Calero,ESP,DF,23,1995,11.6,14,9,10,4,0,7,15,46.7,8,13,5,8,8,22,42,1,2020
ESP-La Liga,2019,Espanyol,Javi López,ESP,DF,33,1986,15.4,47,34,23,18,6,19,40,47.5,21,12,6,6,21,68,38,2,2020
ESP-La Liga,2019,Espanyol,Jonathan Calleri,ARG,FW,25,1993,20.1,12,8,6,4,2,3,24,12.5,21,11,3,8,7,19,22,0,2020
ESP-La Liga,2019,Espanyol,Kévin Soni,CMR,FW,21,1998,0.0,0,0,0,0,0,0,0,,0,0,0,0,0,0,0,0,2020
ESP-La Liga,2019,Espanyol,Leandro Cabrera,URU,DF,28,1991,17.0,27,11,17,9,1,17,28,60.7,11,19,12,7,21,48,78,1,2020
ESP-La Liga,2019,Espanyol,Lluis López,ESP,DF,22,1997,3.3,4,2,3,1,0,2,2,100.0,0,4,0,4,1,5,6,1,2020
ESP-La Liga,2019,Espanyol,Marc Roca,ESP,MF,22,1996,33.4,82,52,29,44,9,29,82,35.4,53,28,10,18,31,113,53,2,2020
ESP-La Liga,2019,Espanyol,Matías Vargas,ARG,"FW,MF",22,1997,11.4,13,5,7,3,3,4,23,17.4,19,12,2,10,3,16,5,0,2020
ESP-La Liga,2019,Espanyol,Naldo,BRA,DF,30,1988,14.8,24,13,15,9,0,7,15,46.7,8,11,7,4,21,45,50,1,2020
ESP-La Liga,2019,Espanyol,Nico Ribaudo,ESP,"FW,MF",18,2001,2.0,3,1,1,0,2,2,6,33.3,4,1,0,1,1,4,0,0,2020
ESP-La Liga,2019,Espanyol,Oier Olazábal,ESP,GK,29,1989,2.0,0,0,0,0,0,0,0,,0,1,0,1,0,0,0,0,2020
ESP-La Liga,2019,Espanyol,Pablo Piatti,ARG,"DF,MF",30,1989,0.6,2,2,1,1,0,1,2,50.0,1,1,0,1,0,2,1,0,2020
ESP-La Liga,2019,Espanyol,Pedrosa,ESP,"DF,MF",21,1998,12.1,19,13,8,9,2,7,25,28.0,18,12,1,11,11,30,32,0,2020
ESP-La Liga,2019,Espanyol,Pipa,ESP,"DF,FW",21,1998,5.3,9,8,5,4,0,4,6,66.7,2,8,0,8,6,15,17,0,2020
ESP-La Liga,2019,Espanyol,Pol Lozano,ESP,MF,19,1999,1.9,5,3,3,2,0,3,7,42.9,4,3,0,3,1,6,2,0,2020
ESP-La Liga,2019,Espanyol,Raúl de Tomás,ESP,FW,24,1994,11.9,9,7,3,4,2,4,13,30.8,9,8,1,7,10,19,4,0,2020
ESP-La Liga,2019,Espanyol,Sergi Darder,ESP,MF,25,1993,29.5,47,23,11,26,10,17,58,29.3,41,30,1,29,24,71,23,1,2020
ESP-La Liga,2019,Espanyol,Sébastien Corchia,FRA,DF,28,1990,3.0,2,1,2,0,0,2,4,50.0,2,5,2,3,5,7,8,0,2020
ESP-La Liga,2019,Espanyol,Victor Perea,ESP,"DF,FW",19,2000,14.1,13,5,8,4,1,7,20,35.0,13,10,0,10,21,34,31,0,2020
ESP-La Liga,2019,Espanyol,Víctor Campuzano,ESP,FW,22,1997,9.7,12,9,1,6,5,3,19,15.8,16,8,0,8,2,14,4,0,2020
ESP-La Liga,2019,Espanyol,Víctor Sánchez,ESP,MF,31,1987,18.8,66,36,36,23,7,30,71,42.3,41,31,8,23,27,93,23,1,2020
ESP-La Liga,2019,Espanyol,Wu Lei,CHN,"FW,MF",27,1991,19.1,13,8,5,6,2,4,38,10.5,34,32,1,31,15,28,19,1,2020
ESP-La Liga,2019,Espanyol,Óscar Melendo,ESP,"MF,FW",21,1997,12.4,10,4,4,4,2,4,12,33.3,8,7,2,5,2,12,3,0,2020
ESP-La Liga,2019,Getafe,Allan Nyom,CMR,"DF,MF",31,1988,26.9,45,25,26,15,4,20,37,54.1,17,24,5,19,14,59,50,1,2020
ESP-La Liga,2019,Getafe,Amath,SEN,MF,23,1996,0.7,2,1,1,1,0,0,5,0.0,5,2,0,2,0,2,0,0,2020
ESP-La Liga,2019,Getafe,Bruno González,ESP,DF,29,1990,2.0,3,2,3,0,0,1,1,100.0,0,2,0,2,0,3,3,0,2020
ESP-La Liga,2019,Getafe,Chema,ESP,DF,27,1992,3.4,4,3,1,3,0,1,2,50.0,1,1,0,1,5,9,12,0,2020
ESP-La Liga,2019,Getafe,Damián Suárez,URU,DF,31,1988,28.8,62,32,32,21,9,38,72,52.8,34,25,2,23,27,89,41,0,2020
ESP-La Liga,2019,Getafe,David Soria,ESP,GK,26,1993,38.0,2,1,2,0,0,2,4,50.0,2,0,0,0,3,5,17,5,2020
ESP-La Liga,2019,Getafe,David Timor,ESP,"MF,DF",29,1989,10.5,9,6,4,5,0,5,16,31.3,11,8,3,5,18,27,23,0,2020
ESP-La Liga,2019,Getafe,Deyverson,BRA,FW,28,1991,2.3,0,0,0,0,0,0,1,0.0,1,2,1,1,0,0,5,0,2020
ESP-La Liga,2019,Getafe,Djené,TOG,DF,27,1991,34.0,42,32,27,15,0,17,30,56.7,13,20,7,13,34,76,105,1,2020
ESP-La Liga,2019,Getafe,Enric Gallego,ESP,FW,32,1986,1.8,3,1,1,1,1,2,4,50.0,2,2,0,2,2,5,1,0,2020
ESP-La Liga,2019,Getafe,Erick Cabaco,URU,DF,24,1995,3.0,3,2,1,2,0,0,3,0.0,3,1,1,0,3,6,11,0,2020
ESP-La Liga,2019,Getafe,Fayçal Fajr,MAR,MF,30,1988,4.5,1,1,0,1,0,0,3,0.0,3,4,0,4,4,5,1,0,2020
ESP-La Liga,2019,Getafe,Florent Poulolo,MTQ,DF,22,1997,0.0,0,0,0,0,0,0,0,,0,0,0,0,0,0,1,0,2020
ESP-La Liga,2019,Getafe,Francisco Portillo,ESP,MF,29,1990,4.2,11,6,3,6,2,4,12,33.3,8,2,0,2,2,13,3,0,2020
ESP-La Liga,2019,Getafe,Hugo Duro,ESP,"FW,MF",19,1999,4.2,6,5,2,2,2,4,8,50.0,4,3,0,3,1,7,3,0,2020
ESP-La Liga,2019,Getafe,Jaime Mata,ESP,FW,30,1988,30.5,21,13,3,11,7,3,20,15.0,17,16,1,15,7,28,15,0,2020
ESP-La Liga,2019,Getafe,Jason,ESP,MF,25,1994,13.1,29,20,8,16,5,15,33,45.5,18,18,3,15,18,47,9,0,2020
ESP-La Liga,2019,Getafe,Jorge Molina,ESP,FW,37,1982,21.0,8,2,0,4,4,0,12,0.0,12,13,2,11,4,12,18,0,2020
ESP-La Liga,2019,Getafe,Kenedy,BRA,MF,23,1996,6.5,9,5,3,3,3,2,5,40.0,3,10,0,10,11,20,4,0,2020
ESP-La Liga,2019,Getafe,Leandro Cabrera,URU,DF,28,1991,17.0,10,6,5,5,0,5,12,41.7,7,10,4,6,21,31,66,0,2020
ESP-La Liga,2019,Getafe,Marc Cucurella,ESP,"MF,DF",21,1998,36.0,74,51,23,38,13,24,76,31.6,52,58,8,50,36,110,28,1,2020
ESP-La Liga,2019,Getafe,Markel Bergara,ESP,MF,33,1986,0.8,0,0,0,0,0,0,0,,0,0,0,0,0,0,2,0,2020
ESP-La Liga,2019,Getafe,Mathías Olivera,URU,DF,21,1997,20.8,64,40,34,16,14,27,45,60.0,18,32,3,29,23,87,44,0,2020
ESP-La Liga,2019,Getafe,Mauro Arambarri,URU,MF,23,1995,34.1,72,33,24,40,8,31,69,44.9,38,52,5,47,43,115,40,2,2020
ESP-La Liga,2019,Getafe,Nemanja Maksimović,SRB,MF,24,1995,32.2,49,28,12,31,6,10,44,22.7,34,37,7,30,56,105,30,1,2020
ESP-La Liga,2019,Getafe,Oghenekaro Etebo,NGA,MF,23,1995,6.4,12,4,5,7,0,7,12,58.3,5,10,1,9,11,23,4,1,2020
ESP-La Liga,2019,Getafe,Raúl García,ESP,DF,30,1989,2.7,5,3,2,3,0,3,6,50.0,3,3,1,2,4,9,10,0,2020
ESP-La Liga,2019,Getafe,Vitorino Antunes,POR,MF,32,1987,0.1,0,0,0,0,0,0,0,,0,0,0,0,0,0,1,0,2020
ESP-La Liga,2019,Getafe,Xabier Etxeita,ESP,DF,31,1987,16.1,20,11,11,9,0,12,23,52.2,11,9,5,4,17,37,68,0,2020
ESP-La Liga,2019,Getafe,Ángel Rodríguez,ESP,FW,32,1987,15.6,14,8,2,8,4,2,18,11.1,16,10,1,9,3,17,10,0,2020
ESP-La Liga,2019,Granada,Aarón Escandell,ESP,GK,23,1995,3.0,1,1,1,0,0,1,1,100.0,0,0,0,0,0,1,0,0,2020
ESP-La Liga,2019,Granada,Adrián Ramos,COL,"FW,MF",33,1986,2.5,6,2,0,2,4,2,3,66.7,1,2,0,2,1,7,1,0,2020
ESP-La Liga,2019,Granada,Antonio Cortés,ESP,"FW,MF",19,2000,2.0,1,1,0,1,0,0,1,0.0,1,0,0,0,0,1,2,0,2020
ESP-La Liga,2019,Granada,Antonio Puertas,ESP,"FW,MF",27,1992,28.5,37,24,8,18,11,16,53,30.2,37,21,3,18,12,49,21,0,2020
ESP-La Liga,2019,Granada,Carlos Fernández,ESP,"FW,MF",23,1996,24.5,24,15,7,11,6,3,32,9.4,29,25,2,23,11,35,30,0,2020
ESP-La Liga,2019,Granada,Carlos Neva,ESP,DF,23,1996,24.5,16,11,12,3,1,9,21,42.9,12,15,2,13,28,44,60,0,2020
ESP-La Liga,2019,Granada,Darwin Machís,VEN,"FW,MF",26,1993,23.7,23,13,11,8,4,8,23,34.8,15,22,4,18,31,54,9,0,2020
ESP-La Liga,2019,Granada,Dimitri Foulquier,FRA,"DF,MF",26,1993,12.4,25,11,13,9,3,11,20,55.0,9,8,3,5,16,41,32,0,2020
ESP-La Liga,2019,Granada,Domingos Duarte,POR,DF,24,1995,34.3,30,19,24,5,1,11,20,55.0,9,34,24,10,34,64,153,1,2020
ESP-La Liga,2019,Granada,Fede Vico,ESP,"MF,FW",25,1994,9.7,5,1,2,3,0,2,11,18.2,9,12,1,11,5,10,2,0,2020
ESP-La Liga,2019,Granada,Germán Sánchez,ESP,DF,32,1986,25.5,16,10,12,4,0,6,16,37.5,10,29,23,6,33,49,115,2,2020
ESP-La Liga,2019,Granada,Gil Bastião Dias,POR,"MF,DF",22,1996,4.0,19,14,10,6,3,7,17,41.2,10,4,1,3,3,22,7,0,2020
ESP-La Liga,2019,Granada,Jesús Vallejo,ESP,DF,22,1997,7.0,6,5,4,2,0,3,4,75.0,1,7,4,3,5,11,28,0,2020
ESP-La Liga,2019,Granada,José Martínez,ESP,DF,26,1993,13.2,21,16,12,8,1,14,25,56.0,11,6,4,2,18,39,46,0,2020
ESP-La Liga,2019,Granada,Mario Rodriguez,ESP,MF,22,1997,0.0,0,0,0,0,0,0,0,,0,0,0,0,0,0,0,0,2020
ESP-La Liga,2019,Granada,Maxime Gonalons,FRA,MF,30,1989,16.7,62,38,25,35,2,22,54,40.7,32,27,3,24,20,82,20,1,2020
ESP-La Liga,2019,Granada,Quini,ESP,DF,29,1989,8.0,25,14,16,7,2,13,22,59.1,9,5,1,4,10,35,14,0,2020
ESP-La Liga,2019,Granada,Ramon Azeez,NGA,MF,26,1992,15.1,11,8,2,8,1,7,19,36.8,12,8,2,6,19,30,11,1,2020
ESP-La Liga,2019,Granada,Roberto Soldado,ESP,FW,34,1985,26.1,16,9,2,7,7,7,24,29.2,17,16,4,12,4,20,16,0,2020
ESP-La Liga,2019,Granada,Rui Silva,POR,GK,25,1994,35.0,2,1,2,0,0,2,2,100.0,0,0,0,0,2,4,22,3,2020
ESP-La Liga,2019,Granada,Víctor Díaz,ESP,DF,31,1988,32.0,74,43,38,31,5,31,60,51.7,29,53,23,30,48,122,94,1,2020
ESP-La Liga,2019,Granada,Yan Brice Eteki,CMR,MF,21,1997,16.7,37,21,14,18,5,15,31,48.4,16,17,4,13,24,61,20,1,2020
ESP-La Liga,2019,Granada,Yangel Herrera,VEN,MF,21,1998,26.3,88,49,25,53,10,36,80,45.0,44,38,9,29,34,122,28,0,2020
ESP-La Liga,2019,Granada,Álex Martínez,ESP,DF,28,1990,0.2,0,0,0,0,0,0,0,,0,0,0,0,0,0,0,0,2020
ESP-La Liga,2019,Granada,Álvaro Vadillo,ESP,"FW,MF",24,1994,13.5,16,11,6,8,2,9,16,56.3,7,12,0,12,7,23,2,0,2020
ESP-La Liga,2019,Granada,Ángel Montoro,ESP,MF,31,1988,10.8,19,8,8,9,2,3,13,23.1,10,10,1,9,13,32,15,0,2020
ESP-La Liga,2019,Granada,İsmail Köybaşı,TUR,"DF,FW",30,1989,2.6,4,4,3,1,0,0,2,0.0,2,4,0,4,5,9,2,0,2020
ESP-La Liga,2019,Leganés,Aitor Ruibal,ESP,"DF,MF",23,1996,13.6,27,17,14,11,2,16,39,41.0,23,18,1,17,8,35,11,0,2020
ESP-La Liga,2019,Leganés,Bryan,ESP,"MF,FW",18,2001,6.2,8,4,3,4,1,1,8,12.5,7,6,0,6,3,11,1,0,2020
ESP-La Liga,2019,Leganés,Chidozie Awaziem,NGA,DF,22,1997,22.2,34,22,29,5,0,16,27,59.3,11,26,15,11,28,62,73,1,2020
ESP-La Liga,2019,Leganés,Cristian Rivera,ESP,MF,22,1997,3.5,6,4,3,2,1,2,4,50.0,2,4,3,1,4,10,7,0,2020
ESP-La Liga,2019,Leganés,Dimitris Siovas,GRE,DF,30,1988,21.3,42,31,24,15,3,19,28,67.9,9,14,1,13,46,88,69,0,2020
ESP-La Liga,2019,Leganés,Guido Carrillo,ARG,FW,28,1991,13.5,13,10,3,6,4,2,14,14.3,12,9,1,8,3,16,22,0,2020
ESP-La Liga,2019,Leganés,Ibrahim Amadou,FRA,MF,26,1993,8.6,16,9,5,9,2,4,11,36.4,7,5,0,5,12,28,6,0,2020
ESP-La Liga,2019,Leganés,Iván Cuéllar,ESP,GK,35,1984,27.0,0,0,0,0,0,0,2,0.0,2,0,0,0,0,0,28,2,2020
ESP-La Liga,2019,Leganés,Javier Avilés,ESP,"MF,FW",21,1997,2.0,9,7,2,7,0,2,4,50.0,2,3,0,3,3,12,1,0,2020
ESP-La Liga,2019,Leganés,Javier Eraso,ESP,MF,29,1990,9.1,11,5,4,5,2,5,15,33.3,10,5,0,5,7,18,5,0,2020
ESP-La Liga,2019,Leganés,Jonathan Silva,ARG,DF,25,1994,30.9,60,34,32,22,6,27,52,51.9,25,12,4,8,34,94,46,0,2020
ESP-La Liga,2019,Leganés,José Arnaiz,ESP,MF,24,1995,3.7,3,0,1,2,0,2,5,40.0,3,4,0,4,2,5,1,0,2020
ESP-La Liga,2019,Leganés,Juan Soriano,ESP,GK,21,1997,11.0,0,0,0,0,0,0,0,,0,0,0,0,0,0,1,1,2020
ESP-La Liga,2019,Leganés,Kenneth Omeruo,NGA,DF,25,1993,20.8,28,17,25,3,0,11,18,61.1,7,21,12,9,36,64,112,2,2020
ESP-La Liga,2019,Leganés,Kévin Rodrigues,POR,"DF,MF",25,1994,21.5,56,31,31,17,8,25,46,54.3,21,30,3,27,31,87,26,1,2020
ESP-La Liga,2019,Leganés,Manuel Garrido,ESP,FW,18,2000,1.3,0,0,0,0,0,0,6,0.0,6,3,1,2,1,1,0,0,2020
ESP-La Liga,2019,Leganés,Marc Navarro,ESP,"FW,DF",24,1995,2.4,3,3,2,1,0,1,1,100.0,0,2,1,1,0,3,3,0,2020
ESP-La Liga,2019,Leganés,Martin Braithwaite,DEN,"FW,MF",28,1991,21.5,13,7,4,5,4,4,12,33.3,8,10,2,8,4,17,9,0,2020
ESP-La Liga,2019,Leganés,Miguel Ángel Guerrero,ESP,FW,29,1990,8.8,1,0,0,1,0,1,10,10.0,9,4,0,4,2,3,4,0,2020
ESP-La Liga,2019,Leganés,Recio,ESP,MF,28,1991,17.4,30,19,13,12,5,10,40,25.0,30,14,3,11,22,52,9,0,2020
ESP-La Liga,2019,Leganés,Roberto Rosales,VEN,DF,30,1988,20.8,42,23,23,17,2,19,43,44.2,24,17,4,13,30,72,48,0,2020
ESP-La Liga,2019,Leganés,Rodrigo Tarín,ESP,DF,23,1996,10.6,10,7,8,2,0,9,14,64.3,5,7,3,4,9,19,51,0,2020
ESP-La Liga,2019,Leganés,Roger Assalé,CIV,"FW,MF",25,1993,5.9,3,2,1,0,2,1,9,11.1,8,8,0,8,0,3,1,0,2020
ESP-La Liga,2019,Leganés,Roque Mesa,ESP,MF,30,1989,22.4,40,21,17,18,5,13,44,29.5,31,13,4,9,11,51,8,0,2020
ESP-La Liga,2019,Leganés,Rubén Pérez,ESP,MF,30,1989,24.4,50,27,21,23,6,16,47,34.0,31,21,4,17,38,88,33,0,2020
ESP-La Liga,2019,Leganés,Sabin Merino,ESP,FW,27,1992,0.9,0,0,0,0,0,0,0,,0,0,0,0,0,0,0,0,2020
ESP-La Liga,2019,Leganés,Unai Bustinza,ESP,DF,27,1992,29.8,66,40,40,19,7,32,53,60.4,21,30,9,21,65,131,77,0,2020
ESP-La Liga,2019,Leganés,Youssef En-Nesyri,MAR,FW,22,1997,15.4,9,7,1,2,6,3,17,17.6,14,15,2,13,5,14,22,0,2020
ESP-La Liga,2019,Leganés,Óscar Rodríguez Arnaiz,ESP,"MF,FW",21,1998,21.3,23,10,11,7,5,13,41,31.7,28,19,0,19,14,37,13,0,2020
ESP-La Liga,2019,Levante,Aitor Fernández,ESP,GK,28,1991,36.0,1,1,1,0,0,1,1,100.0,0,0,0,0,2,3,18,3,2020
ESP-La Liga,2019,Levante,Alejandro Blesa,ESP,MF,17,2002,0.0,0,0,0,0,0,0,1,0.0,1,0,0,0,0,0,0,0,2020
ESP-La Liga,2019,Levante,Borja Mayoral,ESP,FW,22,1997,23.8,12,3,4,6,2,2,13,15.4,11,11,0,11,4,16,6,0,2020
ESP-La Liga,2019,Levante,Bruno González,ESP,DF,29,1990,5.1,10,8,7,2,1,2,4,50.0,2,7,4,3,2,12,32,0,2020
ESP-La Liga,2019,Levante,Carlos Clerc,ESP,DF,27,1992,20.5,28,16,14,13,1,12,20,60.0,8,22,9,13,22,50,61,0,2020
ESP-La Liga,2019,Levante,Coke,ESP,DF,32,1987,11.0,25,18,14,8,3,14,30,46.7,16,9,2,7,13,38,19,0,2020
ESP-La Liga,2019,Levante,Eliseo Falcon,ESP,DF,22,1997,0.8,0,0,0,0,0,0,0,,0,0,0,0,0,0,2,0,2020
ESP-La Liga,2019,Levante,Enis Bardhi,MKD,MF,24,1995,23.5,24,11,7,15,2,8,35,22.9,27,15,4,11,15,39,19,0,2020
ESP-La Liga,2019,Levante,Erick Cabaco,URU,DF,24,1995,9.0,12,9,9,3,0,4,6,66.7,2,12,7,5,12,24,50,1,2020
ESP-La Liga,2019,Levante,Giorgi Kochorashvili,GEO,MF,20,1999,0.0,0,0,0,0,0,0,0,,0,0,0,0,0,0,0,0,2020
ESP-La Liga,2019,Levante,Gonzalo,ESP,DF,22,1997,0.1,1,0,0,1,0,0,0,,0,0,0,0,0,1,0,0,2020
ESP-La Liga,2019,Levante,Gonzalo Melero,ESP,MF,25,1994,13.7,20,13,9,9,2,7,27,25.9,20,12,3,9,9,29,15,1,2020
ESP-La Liga,2019,Levante,Hernâni Fortes,POR,"MF,FW",27,1991,7.3,5,2,4,0,1,1,3,33.3,2,3,0,3,4,9,9,0,2020
ESP-La Liga,2019,Levante,Joan Monterde,ESP,MF,21,1997,0.1,0,0,0,0,0,0,0,,0,0,0,0,0,0,0,0,2020
ESP-La Liga,2019,Levante,Jorge Miramón,ESP,DF,30,1989,27.0,52,27,35,13,4,26,45,57.8,19,30,8,22,46,98,61,1,2020
ESP-La Liga,2019,Levante,José Campaña,ESP,MF,26,1993,35.1,38,25,15,13,10,13,53,24.5,40,30,5,25,44,82,42,2,2020
ESP-La Liga,2019,Levante,José Luis Morales,ESP,"FW,MF",32,1987,28.0,17,8,5,9,3,6,34,17.6,28,14,1,13,6,23,5,1,2020
ESP-La Liga,2019,Levante,Koke Vegas,ESP,GK,23,1995,2.0,0,0,0,0,0,0,1,0.0,1,0,0,0,0,0,3,0,2020
ESP-La Liga,2019,Levante,Nemanja Radoja,SRB,MF,26,1993,22.1,43,19,27,16,0,15,46,32.6,31,21,4,17,23,66,24,0,2020
ESP-La Liga,2019,Levante,Nikola Vukčević,MNE,MF,27,1991,17.4,41,26,17,17,7,15,40,37.5,25,19,7,12,12,53,16,0,2020
ESP-La Liga,2019,Levante,Pablo Martínez,ESP,MF,21,1998,0.4,2,0,1,1,0,0,1,0.0,1,0,0,0,0,2,2,0,2020
ESP-La Liga,2019,Levante,Rober,ESP,DF,24,1995,2.1,3,1,2,0,1,2,2,100.0,0,0,0,0,3,6,2,0,2020
ESP-La Liga,2019,Levante,Roger Martí,ESP,FW,28,1991,25.2,18,11,8,7,3,7,29,24.1,22,14,0,14,6,24,17,0,2020
ESP-La Liga,2019,Levante,Rubén Rochina,ESP,MF,28,1991,20.8,41,26,22,9,10,19,52,36.5,33,16,0,16,12,53,19,1,2020
ESP-La Liga,2019,Levante,Rúben Vezo,POR,DF,25,1994,29.0,41,24,28,13,0,19,35,54.3,16,37,29,8,42,83,144,2,2020
ESP-La Liga,2019,Levante,Sergio León,ESP,FW,30,1989,7.5,3,3,0,3,0,2,4,50.0,2,3,0,3,1,4,2,0,2020
ESP-La Liga,2019,Levante,Sergio Postigo,ESP,DF,30,1988,26.4,32,15,23,7,2,11,18,61.1,7,24,15,9,34,66,132,1,2020
ESP-La Liga,2019,Levante,Toño,ESP,DF,29,1989,17.7,26,19,18,7,1,15,28,53.6,13,11,3,8,13,39,34,1,2020
ESP-La Liga,2019,Levante,Óscar Duarte,CRC,DF,30,1989,5.4,12,3,11,1,0,3,4,75.0,1,7,6,1,6,18,29,0,2020
ESP-La Liga,2019,Mallorca,Abdón Prats,ESP,FW,26,1992,3.1,1,1,0,0,1,0,1,0.0,1,1,0,1,0,1,1,0,2020
ESP-La Liga,2019,Mallorca,Aleix Febas,ESP,"MF,FW",23,1996,18.8,36,24,13,19,4,12,36,33.3,24,15,0,15,17,53,6,0,2020
ESP-La Liga,2019,Mallorca,Alejandro Pozo Pozo,ESP,DF,20,1999,16.6,38,24,30,6,2,19,38,50.0,19,23,2,21,23,61,29,1,2020
ESP-La Liga,2019,Mallorca,Aleksandar Sedlar,SRB,DF,27,1991,9.0,13,6,10,2,1,7,11,63.6,4,17,11,6,16,29,31,0,2020
ESP-La Liga,2019,Mallorca,Aleksandar Trajkovski,MKD,"MF,FW",26,1992,3.7,2,0,1,1,0,1,7,14.3,6,2,0,2,3,5,1,0,2020
ESP-La Liga,2019,Mallorca,Ante Budimir,CRO,FW,28,1991,30.7,31,15,4,22,5,7,29,24.1,22,21,4,17,8,39,29,0,2020
ESP-La Liga,2019,Mallorca,Antonio Raillo,ESP,DF,27,1991,30.8,31,21,24,7,0,13,19,68.4,6,31,26,5,22,53,112,1,2020
ESP-La Liga,2019,Mallorca,Ariday Cabrera,ESP,MF,30,1988,0.4,1,1,1,0,0,0,1,0.0,1,2,0,2,0,1,0,0,2020
ESP-La Liga,2019,Mallorca,Baba Rahman,GHA,DF,25,1994,1.2,3,2,2,0,1,0,0,,0,2,1,1,1,4,2,0,2020
ESP-La Liga,2019,Mallorca,Cucho,COL,"FW,MF",20,1999,16.5,15,8,6,8,1,6,21,28.6,15,14,1,13,10,25,15,0,2020
ESP-La Liga,2019,Mallorca,Dani Rodríguez,ESP,"MF,FW",31,1988,33.8,59,32,24,28,7,18,61,29.5,43,35,3,32,38,97,27,1,2020
ESP-La Liga,2019,Mallorca,Fabricio,ESP,GK,31,1987,1.0,0,0,0,0,0,0,0,,0,0,0,0,0,0,0,1,2020
ESP-La Liga,2019,Mallorca,Fran Gámez,ESP,DF,28,1991,19.6,64,42,32,27,5,33,74,44.6,41,31,11,20,29,93,41,0,2020
ESP-La Liga,2019,Mallorca,Iddrisu Baba,GHA,MF,23,1996,32.3,59,37,26,29,4,20,70,28.6,50,31,8,23,39,98,42,0,2020
ESP-La Liga,2019,Mallorca,Joan Sastre Vanrell,ESP,DF,22,1997,15.1,30,17,26,3,1,17,39,43.6,22,8,2,6,23,53,27,1,2020
ESP-La Liga,2019,Mallorca,Josep Señé,ESP,MF,27,1991,1.7,2,1,2,0,0,2,5,40.0,3,2,1,1,0,2,2,0,2020
ESP-La Liga,2019,Mallorca,Ki Sung-yueng,KOR,MF,30,1989,0.1,0,0,0,0,0,0,1,0.0,1,0,0,0,0,0,0,0,2020
ESP-La Liga,2019,Mallorca,Lago Junior,CIV,"MF,FW",28,1990,24.3,32,19,12,11,9,12,29,41.4,17,23,5,18,14,46,25,0,2020
ESP-La Liga,2019,Mallorca,Leonardo Koutris,GRE,DF,24,1995,1.0,1,1,0,0,1,1,2,50.0,1,1,1,0,1,2,6,0,2020
ESP-La Liga,2019,Mallorca,Luka Romero,ARG,FW,14,2004,0.1,0,0,0,0,0,0,0,,0,0,0,0,0,0,0,0,2020
ESP-La Liga,2019,Mallorca,Lumor Agbenyenu,GHA,DF,22,1996,20.1,31,21,19,9,3,16,35,45.7,19,13,2,11,21,52,66,1,2020
ESP-La Liga,2019,Mallorca,Manolo Reina,ESP,GK,34,1985,36.0,0,0,0,0,0,0,1,0.0,1,2,0,2,5,5,9,1,2020
ESP-La Liga,2019,Mallorca,Marc Pedraza,ESP,MF,32,1987,1.4,1,1,1,0,0,1,5,20.0,4,0,0,0,4,5,1,0,2020
ESP-La Liga,2019,Mallorca,Martin Valjent,SVK,DF,23,1995,35.4,25,17,14,10,1,13,25,52.0,12,39,27,12,37,62,146,1,2020
ESP-La Liga,2019,Mallorca,Miquel Parera,ESP,GK,23,1996,1.0,0,0,0,0,0,0,0,,0,0,0,0,0,0,0,0,2020
ESP-La Liga,2019,Mallorca,Pablo Chavarría,ARG,"FW,MF",31,1988,2.3,1,1,0,1,0,0,4,0.0,4,1,1,0,1,2,2,0,2020
ESP-La Liga,2019,Mallorca,Rafel Obrador,ESP,DF,15,2004,0.0,0,0,0,0,0,0,1,0.0,1,0,0,0,0,0,1,0,2020
ESP-La Liga,2019,Mallorca,Salva Sevilla,ESP,MF,35,1984,28.5,27,21,11,16,0,9,30,30.0,21,17,5,12,29,56,17,1,2020
ESP-La Liga,2019,Mallorca,Takefusa Kubo,JPN,"MF,FW",18,2001,25.7,34,22,16,12,6,15,44,34.1,29,19,1,18,23,57,10,0,2020
ESP-La Liga,2019,Mallorca,Xisco Campos,ESP,DF,37,1982,5.3,7,4,5,2,0,5,9,55.6,4,8,5,3,11,18,23,0,2020
ESP-La Liga,2019,Mallorca,Yannis Salibur,FRA,"MF,FW",28,1991,0.9,0,0,0,0,0,0,4,0.0,4,0,0,0,1,1,1,0,2020
ESP-La Liga,2019,Mallorca,Álex Alegría,ESP,FW,26,1992,1.2,1,0,1,0,0,0,0,,0,2,0,2,0,1,0,0,2020
ESP-La Liga,2019,Osasuna,Adrián López,ESP,FW,31,1988,16.0,7,5,1,5,1,2,19,10.5,17,6,2,4,4,11,8,0,2020
ESP-La Liga,2019,Osasuna,Aimar Oroz,ESP,FW,17,2001,0.1,0,0,0,0,0,0,0,,0,1,0,1,0,0,0,0,2020
ESP-La Liga,2019,Osasuna,Aridane Hernández,EQG,DF,30,1989,29.0,35,23,22,13,0,15,19,78.9,4,24,15,9,34,69,137,2,2020
ESP-La Liga,2019,Osasuna,Brandon,ESP,FW,24,1995,4.5,5,3,1,3,1,0,5,0.0,5,4,0,4,0,5,1,0,2020
ESP-La Liga,2019,Osasuna,Darko Brašanac,SRB,MF,27,1992,24.9,45,25,14,26,5,15,41,36.6,26,19,4,15,20,65,21,0,2020
ESP-La Liga,2019,Osasuna,David García,ESP,DF,25,1994,31.0,28,16,15,12,1,14,31,45.2,17,20,16,4,48,76,123,2,2020
ESP-La Liga,2019,Osasuna,Enric Gallego,ESP,FW,32,1986,9.8,9,5,1,5,3,0,4,0.0,4,10,2,8,4,13,8,0,2020
ESP-La Liga,2019,Osasuna,Ezequiel Ávila,ARG,FW,25,1994,17.7,17,12,6,7,4,6,18,33.3,12,12,0,12,3,20,5,0,2020
ESP-La Liga,2019,Osasuna,Facundo Roncaglia,ARG,DF,32,1987,14.2,24,20,12,10,2,11,20,55.0,9,18,3,15,22,46,46,0,2020
ESP-La Liga,2019,Osasuna,Fran Mérida,ESP,MF,29,1990,12.9,27,15,11,10,6,9,27,33.3,18,15,4,11,25,52,10,0,2020
ESP-La Liga,2019,Osasuna,Iñigo Pérez,ESP,MF,31,1988,12.0,15,11,3,7,5,8,22,36.4,14,7,1,6,12,27,6,0,2020
ESP-La Liga,2019,Osasuna,Javi Martínez,ESP,MF,19,1999,0.1,0,0,0,0,0,0,0,,0,0,0,0,0,0,1,0,2020
ESP-La Liga,2019,Osasuna,Jon Moncayola,ESP,"MF,DF",21,1998,16.6,52,30,26,22,4,27,54,50.0,27,29,5,24,16,68,23,1,2020
ESP-La Liga,2019,Osasuna,José Arnaiz,ESP,"FW,MF",24,1995,8.8,3,2,0,2,1,0,12,0.0,12,7,0,7,5,8,5,0,2020
ESP-La Liga,2019,Osasuna,Juan Pérez,ESP,GK,23,1996,2.0,1,1,1,0,0,1,2,50.0,1,0,0,0,0,1,0,0,2020
ESP-La Liga,2019,Osasuna,Juan Villar,ESP,FW,31,1988,2.7,1,0,0,1,0,0,2,0.0,2,4,1,3,1,2,0,0,2020
ESP-La Liga,2019,Osasuna,Kike Barja,ESP,"MF,FW",22,1997,3.5,1,1,1,0,0,1,1,100.0,0,3,1,2,0,1,2,0,2020
ESP-La Liga,2019,Osasuna,Lillo,ESP,DF,30,1989,2.2,4,2,2,2,0,1,1,100.0,0,2,1,1,2,6,8,0,2020
ESP-La Liga,2019,Osasuna,Luis Perea,ESP,FW,21,1997,0.2,0,0,0,0,0,0,0,,0,0,0,0,0,0,1,0,2020
ESP-La Liga,2019,Osasuna,Marc Cardona,ESP,FW,24,1995,7.8,1,0,0,1,0,0,8,0.0,8,3,1,2,2,3,2,0,2020
ESP-La Liga,2019,Osasuna,Nacho Vidal,ESP,DF,24,1995,25.9,45,29,26,13,6,21,38,55.3,17,24,6,18,44,89,70,1,2020
ESP-La Liga,2019,Osasuna,Oier Sanjurjo,ESP,MF,33,1986,25.8,65,34,21,34,10,28,64,43.8,36,33,8,25,35,100,39,1,2020
ESP-La Liga,2019,Osasuna,Pervis Estupiñán,ECU,DF,21,1998,33.1,84,45,53,27,4,42,77,54.5,35,30,7,23,58,142,61,6,2020
ESP-La Liga,2019,Osasuna,Raúl Navas,ESP,DF,31,1988,7.9,10,5,4,6,0,4,13,30.8,9,10,4,6,18,28,30,0,2020
ESP-La Liga,2019,Osasuna,Robert Ibáñez,ESP,"MF,FW",26,1993,6.0,13,8,4,5,4,7,20,35.0,13,7,0,7,5,18,5,0,2020
ESP-La Liga,2019,Osasuna,Roberto Torres,ESP,"MF,FW",30,1989,30.2,33,16,12,18,3,21,49,42.9,28,41,2,39,31,64,37,0,2020
ESP-La Liga,2019,Osasuna,Rubén,ESP,GK,35,1984,17.6,1,1,1,0,0,1,1,100.0,0,0,0,0,0,1,9,1,2020
ESP-La Liga,2019,Osasuna,Rubén García,ESP,"MF,FW",26,1993,24.3,55,30,22,26,7,18,46,39.1,28,34,5,29,11,66,23,1,2020
ESP-La Liga,2019,Osasuna,Sergio Herrera,ESP,GK,26,1993,18.4,1,1,1,0,0,1,4,25.0,3,0,0,0,1,2,13,3,2020
ESP-La Liga,2019,Osasuna,Toni Lato,ESP,"DF,MF",21,1997,5.2,22,15,11,8,3,9,10,90.0,1,9,1,8,8,30,13,1,2020
ESP-La Liga,2019,Osasuna,Unai García,ESP,DF,27,1992,6.0,9,6,4,4,1,5,9,55.6,4,13,9,4,8,17,31,0,2020
ESP-La Liga,2019,Real Madrid,Alphonse Areola,FRA,GK,26,1993,4.0,0,0,0,0,0,0,0,,0,0,0,0,0,0,0,0,2020
ESP-La Liga,2019,Real Madrid,Brahim Díaz,ESP,FW,19,1999,0.7,1,0,0,1,0,0,2,0.0,2,2,0,2,0,1,0,0,2020
ESP-La Liga,2019,Real Madrid,Casemiro,BRA,MF,27,1992,34.3,96,60,43,45,8,39,99,39.4,60,53,10,43,68,164,72,0,2020
ESP-La Liga,2019,Real Madrid,Dani Carvajal,ESP,DF,27,1992,30.4,65,46,33,25,7,23,42,54.8,19,43,14,29,36,101,53,0,2020
ESP-La Liga,2019,Real Madrid,Eden Hazard,BEL,"FW,MF",28,1991,12.0,7,3,2,3,2,3,15,20.0,12,5,0,5,6,13,0,0,2020
ESP-La Liga,2019,Real Madrid,Federico Valverde,URU,MF,21,1998,21.2,38,19,9,19,10,12,36,33.3,24,38,4,34,21,59,12,2,2020
ESP-La Liga,2019,Real Madrid,Ferland Mendy,FRA,DF,24,1995,20.1,32,26,20,9,3,14,18,77.8,4,19,5,14,22,54,30,1,2020
ESP-La Liga,2019,Real Madrid,Gareth Bale,WAL,"FW,MF",30,1989,12.1,9,5,5,2,2,3,14,21.4,11,8,2,6,6,15,9,0,2020
ESP-La Liga,2019,Real Madrid,Isco,ESP,"FW,MF",27,1992,13.1,13,9,2,10,1,5,14,35.7,9,9,0,9,7,20,4,1,2020
ESP-La Liga,2019,Real Madrid,James Rodríguez,COL,"MF,FW",28,1991,4.7,17,13,6,8,3,6,12,50.0,6,3,0,3,3,20,1,0,2020
ESP-La Liga,2019,Real Madrid,Karim Benzema,FRA,FW,31,1987,34.9,18,8,3,11,4,2,16,12.5,14,16,4,12,7,25,30,1,2020
ESP-La Liga,2019,Real Madrid,Lucas Vázquez,ESP,"MF,FW",28,1991,9.4,23,17,10,13,0,11,26,42.3,15,10,0,10,10,33,8,1,2020
ESP-La Liga,2019,Real Madrid,Luka Jović,SRB,FW,21,1997,4.8,2,1,0,0,2,1,2,50.0,1,1,0,1,2,4,0,0,2020
ESP-La Liga,2019,Real Madrid,Luka Modrić,CRO,MF,33,1985,22.2,37,18,9,15,13,16,41,39.0,25,10,2,8,22,59,12,0,2020
ESP-La Liga,2019,Real Madrid,Marcelo,BRA,DF,31,1988,14.4,19,11,8,8,3,9,28,32.1,19,19,2,17,18,37,21,0,2020
ESP-La Liga,2019,Real Madrid,Marco Asensio,ESP,FW,23,1996,3.7,4,3,3,1,0,1,4,25.0,3,2,0,2,1,5,4,0,2020
ESP-La Liga,2019,Real Madrid,Mariano,DOM,"FW,MF",25,1993,0.5,0,0,0,0,0,0,1,0.0,1,0,0,0,0,0,0,0,2020
ESP-La Liga,2019,Real Madrid,Nacho,ESP,DF,29,1990,4.9,11,6,6,3,2,6,10,60.0,4,5,3,2,12,23,18,1,2020
ESP-La Liga,2019,Real Madrid,Raphaël Varane,FRA,DF,26,1993,31.4,30,17,15,14,1,12,23,52.2,11,32,16,16,31,61,124,0,2020
ESP-La Liga,2019,Real Madrid,Rodrygo,BRA,FW,18,2001,11.3,6,1,2,3,1,2,21,9.5,19,13,0,13,10,16,5,0,2020
ESP-La Liga,2019,Real Madrid,Sergio Ramos,ESP,DF,33,1986,33.5,46,31,26,17,3,20,42,47.6,22,22,9,13,49,95,102,4,2020
ESP-La Liga,2019,Real Madrid,Thibaut Courtois,BEL,GK,27,1992,34.0,0,0,0,0,0,0,2,0.0,2,0,0,0,2,2,18,2,2020
ESP-La Liga,2019,Real Madrid,Toni Kroos,GER,MF,29,1990,29.5,56,28,18,29,9,18,70,25.7,52,27,0,27,23,79,15,0,2020
ESP-La Liga,2019,Real Madrid,Vinicius Júnior,BRA,"FW,MF",19,2000,15.2,26,16,13,8,5,8,32,25.0,24,14,0,14,3,29,2,0,2020
ESP-La Liga,2019,Real Madrid,Álvaro Odriozola,ESP,DF,23,1995,3.8,5,2,4,0,1,5,8,62.5,3,4,0,4,2,7,8,0,2020
ESP-La Liga,2019,Real Madrid,Éder Militão,BRA,DF,21,1998,11.4,25,15,15,9,1,10,17,58.8,7,12,6,6,20,45,42,0,2020
ESP-La Liga,2019,Real Sociedad,Adnan Januzaj,BEL,"FW,MF",24,1995,13.0,8,7,3,2,3,3,16,18.8,13,9,1,8,7,15,2,0,2020
ESP-La Liga,2019,Real Sociedad,Aihen Muñoz,ESP,DF,21,1997,10.9,28,18,13,12,3,18,27,66.7,9,13,2,11,2,30,19,0,2020
ESP-La Liga,2019,Real Sociedad,Alexander Isak,SWE,FW,19,1999,16.7,7,2,0,3,4,1,8,12.5,7,8,0,8,3,10,6,0,2020
ESP-La Liga,2019,Real Sociedad,Ander Barrenetxea,ESP,"FW,MF",17,2001,4.9,12,9,5,5,2,4,10,40.0,6,3,0,3,3,15,4,0,2020
ESP-La Liga,2019,Real Sociedad,Ander Guevara,ESP,MF,22,1997,10.4,27,11,9,17,1,12,30,40.0,18,13,3,10,8,35,15,1,2020
ESP-La Liga,2019,Real Sociedad,Andoni Gorosabel,ESP,DF,22,1996,7.9,14,8,9,3,2,10,20,50.0,10,13,1,12,13,27,21,0,2020
ESP-La Liga,2019,Real Sociedad,Aritz Elustondo,ESP,DF,25,1994,16.8,28,17,19,8,1,13,23,56.5,10,21,8,13,15,43,67,0,2020
ESP-La Liga,2019,Real Sociedad,Asier Illarramendi,ESP,MF,29,1990,2.4,2,2,1,0,1,2,6,33.3,4,2,1,1,5,7,6,0,2020
ESP-La Liga,2019,Real Sociedad,David Zurutuza,ESP,MF,33,1986,1.7,4,3,0,3,1,1,2,50.0,1,1,0,1,4,8,3,0,2020
ESP-La Liga,2019,Real Sociedad,Diego Llorente,ESP,DF,25,1993,25.9,30,14,20,9,1,16,28,57.1,12,14,7,7,28,58,101,5,2020
ESP-La Liga,2019,Real Sociedad,Igor Zubeldia,ESP,"MF,DF",22,1997,29.3,42,21,18,19,5,17,35,48.6,18,38,21,17,26,68,82,2,2020
ESP-La Liga,2019,Real Sociedad,Jon Pacheco,ESP,DF,18,2001,0.9,0,0,0,0,0,0,0,,0,1,0,1,0,0,2,0,2020
ESP-La Liga,2019,Real Sociedad,Joseba Zaldúa,ESP,DF,27,1992,28.3,62,43,39,18,5,31,59,52.5,28,31,7,24,37,99,71,0,2020
ESP-La Liga,2019,Real Sociedad,Kévin Rodrigues,POR,DF,25,1994,0.1,1,0,1,0,0,1,1,100.0,0,0,0,0,0,1,0,0,2020
ESP-La Liga,2019,Real Sociedad,Luca Sangalli,ESP,MF,24,1995,4.1,1,0,0,1,0,1,8,12.5,7,3,0,3,1,2,0,0,2020
ESP-La Liga,2019,Real Sociedad,Martin Ødegaard,NOR,MF,20,1998,28.1,27,19,5,14,8,7,34,20.6,27,13,0,13,17,44,5,0,2020
ESP-La Liga,2019,Real Sociedad,Martín Zubimendi,ESP,MF,20,1999,5.8,16,12,9,7,0,6,12,50.0,6,7,0,7,9,25,2,0,2020
ESP-La Liga,2019,Real Sociedad,Miguel Ángel Moyá,ESP,GK,35,1984,13.0,0,0,0,0,0,0,1,0.0,1,0,0,0,1,1,6,2,2020
ESP-La Liga,2019,Real Sociedad,Mikel Merino,ESP,MF,23,1996,34.9,79,52,20,44,15,28,86,32.6,58,46,8,38,51,130,52,0,2020
ESP-La Liga,2019,Real Sociedad,Mikel Oyarzabal,ESP,"FW,MF",22,1997,33.9,36,15,13,15,8,16,46,34.8,30,32,2,30,13,49,19,1,2020
ESP-La Liga,2019,Real Sociedad,Nacho Monreal,ESP,DF,33,1986,26.6,38,16,26,9,3,22,42,52.4,20,20,4,16,43,81,66,0,2020
ESP-La Liga,2019,Real Sociedad,Naïs Djouahra,FRA,FW,19,1999,0.3,0,0,0,0,0,0,0,,0,0,0,0,0,0,0,0,2020
ESP-La Liga,2019,Real Sociedad,Portu,ESP,"FW,MF",27,1992,26.6,32,21,10,15,7,13,33,39.4,20,28,3,25,13,45,5,0,2020
ESP-La Liga,2019,Real Sociedad,Roberto López,ESP,"FW,MF",19,2000,0.6,4,2,1,1,2,2,2,100.0,0,0,0,0,0,4,0,0,2020
ESP-La Liga,2019,Real Sociedad,Robin Le Normand,ESP,DF,22,1996,26.6,48,27,33,15,0,26,35,74.3,9,20,7,13,20,68,99,0,2020
ESP-La Liga,2019,Real Sociedad,Willian José,BRA,FW,27,1991,22.3,5,2,0,4,1,2,8,25.0,6,10,4,6,1,6,16,0,2020
ESP-La Liga,2019,Real Sociedad,Álex Remiro,ESP,GK,24,1995,25.0,0,0,0,0,0,0,1,0.0,1,0,0,0,0,0,25,1,2020
ESP-La Liga,2019,Sevilla,Alejandro Pozo Pozo,ESP,"MF,FW",20,1999,0.4,1,1,1,0,0,1,1,100.0,0,0,0,0,0,1,1,0,2020
ESP-La Liga,2019,Sevilla,Bryan,ESP,FW,18,2001,0.7,1,1,0,1,0,0,1,0.0,1,0,0,0,0,1,0,0,2020
ESP-La Liga,2019,Sevilla,Daniel Carriço,POR,DF,30,1988,9.4,8,2,4,3,1,1,6,16.7,5,4,3,1,8,16,23,0,2020
ESP-La Liga,2019,Sevilla,Diego Carlos,BRA,DF,26,1993,34.8,35,23,25,9,1,15,25,60.0,10,33,24,9,37,72,176,1,2020
ESP-La Liga,2019,Sevilla,Fernando,BRA,MF,32,1987,29.5,62,33,37,24,1,34,58,58.6,24,38,15,23,67,129,73,1,2020
ESP-La Liga,2019,Sevilla,Franco Vázquez,ARG,"MF,FW",30,1989,12.2,25,17,9,14,2,6,36,16.7,30,13,0,13,10,35,10,0,2020
ESP-La Liga,2019,Sevilla,Javier Hernández,MEX,FW,31,1988,5.0,6,4,0,4,2,1,6,16.7,5,5,0,5,5,11,1,0,2020
ESP-La Liga,2019,Sevilla,Jesús Navas,ESP,DF,33,1985,37.4,27,15,16,7,4,15,32,46.9,17,20,7,13,31,58,70,0,2020
ESP-La Liga,2019,Sevilla,Joan Jordán,ESP,MF,25,1994,25.0,64,34,27,31,6,21,76,27.6,55,25,5,20,26,90,20,4,2020
ESP-La Liga,2019,Sevilla,Jules Koundé,FRA,DF,20,1998,25.7,23,12,14,5,4,10,18,55.6,8,16,12,4,23,46,91,2,2020
ESP-La Liga,2019,Sevilla,Lucas Ocampos,ARG,"FW,MF",25,1994,30.5,54,31,30,19,5,30,72,41.7,42,33,2,31,22,76,27,0,2020
ESP-La Liga,2019,Sevilla,Luuk de Jong,NED,FW,28,1990,22.9,21,10,4,8,9,6,17,35.3,11,12,1,11,7,28,22,0,2020
ESP-La Liga,2019,Sevilla,Moanes Dabbur,ISR,FW,27,1992,0.3,1,1,0,0,1,0,0,,0,1,0,1,0,1,0,0,2020
ESP-La Liga,2019,Sevilla,Munir El Haddadi,MAR,FW,23,1995,13.9,19,17,6,11,2,4,21,19.0,17,8,0,8,7,26,8,0,2020
ESP-La Liga,2019,Sevilla,Nemanja Gudelj,SRB,"MF,DF",27,1991,13.5,20,14,11,8,1,6,19,31.6,13,17,8,9,12,32,35,1,2020
ESP-La Liga,2019,Sevilla,Nolito,ESP,FW,32,1986,10.0,21,12,5,11,5,7,20,35.0,13,7,0,7,1,22,1,0,2020
ESP-La Liga,2019,Sevilla,Rony Lopes,POR,FW,23,1995,1.5,0,0,0,0,0,0,0,,0,0,0,0,2,2,0,0,2020
ESP-La Liga,2019,Sevilla,Sergi Gómez,ESP,DF,27,1992,8.0,9,7,7,2,0,4,4,100.0,0,6,6,0,7,16,30,0,2020
ESP-La Liga,2019,Sevilla,Sergio Escudero,ESP,DF,29,1989,8.6,29,16,17,10,2,19,28,67.9,9,11,1,10,13,42,35,0,2020
ESP-La Liga,2019,Sevilla,Sergio Reguilón,ESP,DF,22,1996,27.9,57,30,28,25,4,27,64,42.2,37,25,5,20,33,90,53,0,2020
ESP-La Liga,2019,Sevilla,Suso,ESP,"FW,MF",25,1993,8.7,9,4,4,4,1,7,16,43.8,9,6,0,6,2,11,0,0,2020
ESP-La Liga,2019,Sevilla,Tomáš Vaclík,CZE,GK,30,1989,32.5,0,0,0,0,0,0,1,0.0,1,0,0,0,0,0,7,0,2020
ESP-La Liga,2019,Sevilla,Yassine Bounou,MAR,GK,28,1991,5.5,0,0,0,0,0,0,0,,0,0,0,0,0,0,0,0,2020
ESP-La Liga,2019,Sevilla,Youssef En-Nesyri,MAR,FW,22,1997,8.8,7,5,1,6,0,3,10,30.0,7,9,3,6,5,12,7,0,2020
ESP-La Liga,2019,Sevilla,Éver Banega,ARG,MF,31,1988,27.5,43,28,16,18,9,21,70,30.0,49,19,1,18,15,58,5,0,2020
ESP-La Liga,2019,Sevilla,Óliver Torres,ESP,"MF,FW",24,1994,17.7,45,27,12,26,7,23,60,38.3,37,23,1,22,13,58,9,1,2020
ESP-La Liga,2019,Valencia,Adrián Guerrero,ESP,DF,21,1998,1.4,2,2,1,1,0,2,3,66.7,1,0,0,0,2,4,1,0,2020
ESP-La Liga,2019,Valencia,Alessandro Florenzi,ITA,DF,28,1991,8.4,13,9,9,4,0,8,18,44.4,10,11,1,10,14,27,21,0,2020
ESP-La Liga,2019,Valencia,Carlos Soler,ESP,MF,22,1997,23.0,21,10,10,10,1,9,39,23.1,30,16,6,10,9,30,14,0,2020
ESP-La Liga,2019,Valencia,Cristiano Piccini,ITA,DF,26,1992,0.8,5,4,1,0,4,4,4,100.0,0,0,0,0,2,7,1,0,2020
ESP-La Liga,2019,Valencia,Daniel Parejo,ESP,MF,30,1989,33.6,67,41,29,32,6,32,101,31.7,69,38,11,27,22,89,20,2,2020
ESP-La Liga,2019,Valencia,Daniel Wass,DEN,"DF,MF",30,1989,30.4,44,25,25,13,6,25,57,43.9,32,22,5,17,31,75,91,1,2020
ESP-La Liga,2019,Valencia,Denis Cheryshev,RUS,"MF,FW",28,1990,10.3,16,9,5,4,7,3,17,17.6,14,15,1,14,7,23,10,0,2020
ESP-La Liga,2019,Valencia,Eliaquim Mangala,FRA,DF,28,1991,7.5,4,4,3,1,0,1,2,50.0,1,7,6,1,7,11,40,0,2020
ESP-La Liga,2019,Valencia,Ezequiel Garay,ARG,DF,32,1986,16.0,12,8,9,2,1,7,11,63.6,4,19,17,2,14,26,71,0,2020
ESP-La Liga,2019,Valencia,Ferrán Torres,ESP,"MF,FW",19,2000,25.0,23,15,6,16,1,8,30,26.7,22,20,3,17,14,37,12,0,2020
ESP-La Liga,2019,Valencia,Francis Coquelin,FRA,MF,28,1991,21.2,37,21,25,11,1,16,38,42.1,22,19,9,10,38,75,25,0,2020
ESP-La Liga,2019,Valencia,Gabriel Paulista,BRA,DF,28,1990,31.1,22,14,17,2,3,15,25,60.0,10,36,29,7,48,70,151,3,2020
ESP-La Liga,2019,Valencia,Geoffrey Kondogbia,CTA,MF,26,1993,20.1,63,40,40,18,5,19,51,37.3,32,25,6,19,57,120,36,2,2020
ESP-La Liga,2019,Valencia,Gonçalo Guedes,POR,"MF,FW",22,1996,14.1,19,11,11,7,1,9,32,28.1,23,10,1,9,7,26,1,0,2020
ESP-La Liga,2019,Valencia,Hugo Guillamón,ESP,DF,19,2000,5.5,8,3,5,2,1,5,10,50.0,5,3,2,1,5,13,29,0,2020
ESP-La Liga,2019,Valencia,Jasper Cillessen,NED,GK,30,1989,23.3,0,0,0,0,0,0,1,0.0,1,0,0,0,3,3,3,1,2020
ESP-La Liga,2019,Valencia,Jaume Costa,ESP,DF,31,1988,15.4,27,23,17,8,2,14,28,50.0,14,11,6,5,24,51,52,1,2020
ESP-La Liga,2019,Valencia,Jaume Doménech,ESP,GK,28,1990,14.7,0,0,0,0,0,0,1,0.0,1,0,0,0,1,1,3,1,2020
ESP-La Liga,2019,Valencia,José Luis Gayà,ESP,DF,24,1995,22.1,44,30,29,12,3,28,41,68.3,13,22,9,13,18,62,48,1,2020
ESP-La Liga,2019,Valencia,Kévin Gameiro,FRA,FW,32,1987,17.6,17,9,7,6,4,5,21,23.8,16,10,1,9,5,22,5,0,2020
ESP-La Liga,2019,Valencia,Lee Kangin,KOR,"MF,FW",18,2001,5.0,3,1,0,2,1,3,6,50.0,3,5,0,5,3,6,0,0,2020
ESP-La Liga,2019,Valencia,Manu Vallejo,ESP,"MF,FW",22,1997,4.6,7,3,0,3,4,5,9,55.6,4,4,0,4,2,9,2,0,2020
ESP-La Liga,2019,Valencia,Maxi Gómez,URU,FW,22,1996,23.8,9,7,1,6,2,4,8,50.0,4,8,1,7,5,14,14,0,2020
ESP-La Liga,2019,Valencia,Mouctar Diakhaby,GUI,DF,22,1996,16.0,11,8,7,3,1,5,8,62.5,3,17,15,2,11,22,73,0,2020
ESP-La Liga,2019,Valencia,Rodrigo,ESP,FW,28,1991,20.9,10,6,4,5,1,2,23,8.7,21,9,1,8,9,19,13,0,2020
ESP-La Liga,2019,Valencia,Rubén Sobrino,ESP,"FW,MF",27,1992,1.9,7,5,3,2,2,2,3,66.7,1,1,0,1,0,7,1,0,2020
ESP-La Liga,2019,Valencia,Thierry Correia,POR,DF,20,1999,2.9,8,3,5,3,0,1,2,50.0,1,5,0,5,2,10,10,0,2020
ESP-La Liga,2019,Valencia,Vicente Esquerdo,ESP,"MF,FW",20,1999,0.2,1,0,1,0,0,0,0,,0,1,0,1,0,1,1,0,2020
ESP-La Liga,2019,Valladolid,Antoñito,ESP,"DF,MF",31,1987,11.4,26,18,19,7,0,12,20,60.0,8,9,0,9,15,41,20,1,2020
ESP-La Liga,2019,Valladolid,Anuar,MAR,"MF,FW",24,1995,2.1,4,2,1,2,1,2,6,33.3,4,7,3,4,5,9,0,0,2020
ESP-La Liga,2019,Valladolid,Churripi,ESP,GK,25,1994,2.7,1,1,1,0,0,1,1,100.0,0,0,0,0,0,1,2,0,2020
ESP-La Liga,2019,Valladolid,Enes Ünal,TUR,FW,22,1997,26.0,20,12,6,11,3,6,28,21.4,22,17,5,12,6,26,13,0,2020
ESP-La Liga,2019,Valladolid,Fede San Emeterio,ESP,MF,22,1997,19.5,26,13,18,6,2,7,29,24.1,22,20,8,12,28,54,13,1,2020
ESP-La Liga,2019,Valladolid,Federico Barba,ITA,DF,25,1993,5.0,12,6,10,2,0,7,9,77.8,2,5,2,3,8,20,12,0,2020
ESP-La Liga,2019,Valladolid,Hatem Ben Arfa,FRA,"MF,FW",32,1987,1.8,0,0,0,0,0,0,4,0.0,4,1,0,1,0,0,0,0,2020
ESP-La Liga,2019,Valladolid,Javi Moyano,ESP,DF,33,1986,24.7,19,8,11,8,0,8,20,40.0,12,18,5,13,27,46,63,0,2020
ESP-La Liga,2019,Valladolid,Javi Sánchez,ESP,DF,22,1997,5.5,5,4,3,2,0,1,3,33.3,2,4,2,2,4,9,24,0,2020
ESP-La Liga,2019,Valladolid,Joaquín Fernández,ESP,"MF,DF",23,1996,18.4,30,24,17,10,3,9,30,30.0,21,14,10,4,32,62,57,0,2020
ESP-La Liga,2019,Valladolid,Jordi Masip,ESP,GK,30,1989,35.0,1,1,1,0,0,0,2,0.0,2,0,0,0,1,2,7,3,2020
ESP-La Liga,2019,Valladolid,Jorge de Frutos,ESP,"MF,DF",22,1997,0.7,2,2,2,0,0,1,2,50.0,1,0,0,0,0,2,1,0,2020
ESP-La Liga,2019,Valladolid,Kike Pérez,ESP,"MF,FW",22,1997,2.4,6,1,1,3,2,3,7,42.9,4,1,0,1,10,16,4,0,2020
ESP-La Liga,2019,Valladolid,Kiko Olivas,ESP,DF,30,1988,32.7,33,16,25,7,1,13,35,37.1,22,30,16,14,61,94,112,2,2020
ESP-La Liga,2019,Valladolid,Matheus Fernandes,BRA,"MF,FW",21,1998,1.8,6,2,2,2,2,3,5,60.0,2,4,0,4,2,8,2,0,2020
ESP-La Liga,2019,Valladolid,Miguel,ESP,FW,19,1999,2.6,2,1,1,0,1,1,2,50.0,1,3,1,2,0,2,1,0,2020
ESP-La Liga,2019,Valladolid,Mohammed Salisu,GHA,DF,20,1999,30.3,41,24,28,13,0,21,34,61.8,13,32,26,6,35,76,158,3,2020
ESP-La Liga,2019,Valladolid,Míchel,ESP,MF,31,1988,24.2,50,28,26,19,5,22,75,29.3,53,22,4,18,33,83,41,1,2020
ESP-La Liga,2019,Valladolid,Nacho,ESP,DF,30,1989,21.0,43,22,24,15,4,17,48,35.4,31,36,8,28,25,68,61,0,2020
ESP-La Liga,2019,Valladolid,Pablo Hervías,ESP,"MF,FW",26,1993,11.3,24,20,8,14,2,12,22,54.5,10,8,0,8,5,29,0,0,2020
ESP-La Liga,2019,Valladolid,Pedro Porro,ESP,"DF,MF",19,1999,8.2,18,10,11,7,0,10,18,55.6,8,3,0,3,7,25,19,1,2020
ESP-La Liga,2019,Valladolid,Raúl García,ESP,"DF,MF",30,1989,11.2,20,12,11,7,2,9,22,40.9,13,12,2,10,8,28,30,0,2020
ESP-La Liga,2019,Valladolid,Rubén Alcaraz,ESP,MF,28,1991,21.4,61,30,37,20,4,30,63,47.6,33,46,15,31,15,76,41,0,2020
ESP-La Liga,2019,Valladolid,Samu Pérez,ESP,GK,22,1997,0.3,0,0,0,0,0,0,0,,0,0,0,0,0,0,0,0,2020
ESP-La Liga,2019,Valladolid,Sandro Ramírez,ESP,"FW,MF",24,1995,14.5,12,10,2,6,4,2,20,10.0,18,11,1,10,7,19,2,0,2020
ESP-La Liga,2019,Valladolid,Sergi Guardiola,ESP,FW,28,1991,29.5,14,6,3,7,4,4,24,16.7,20,23,0,23,6,20,18,1,2020
ESP-La Liga,2019,Valladolid,Toni Villa,ESP,MF,24,1995,15.0,31,16,13,14,4,13,50,26.0,37,16,1,15,8,39,11,0,2020
ESP-La Liga,2019,Valladolid,Víctor García,ESP,"FW,MF",22,1997,1.0,0,0,0,0,0,0,1,0.0,1,1,0,1,0,0,1,0,2020
ESP-La Liga,2019,Valladolid,Waldo Rubio,ESP,"MF,FW",23,1995,9.8,13,8,10,3,0,5,31,16.1,26,12,0,12,7,20,7,0,2020
ESP-La Liga,2019,Valladolid,Óscar Plano,ESP,MF,28,1991,27.8,48,30,25,19,4,20,61,32.8,41,36,3,33,35,83,29,0,2020
ESP-La Liga,2019,Villarreal,Alberto Moreno,ESP,DF,27,1992,16.3,27,16,15,11,1,9,25,36.0,16,15,3,12,25,52,36,0,2020
ESP-La Liga,2019,Villarreal,Alex Baena,ESP,MF,18,2001,0.2,0,0,0,0,0,0,0,,0,1,0,1,0,0,0,0,2020
ESP-La Liga,2019,Villarreal,Andre-Frank Zambo Anguissa,CMR,MF,23,1995,28.7,76,49,29,40,7,26,78,33.3,52,42,6,36,44,120,30,0,2020
ESP-La Liga,2019,Villarreal,Andrés Fernández,ESP,GK,32,1986,4.0,0,0,0,0,0,0,0,,0,0,0,0,0,0,2,0,2020
ESP-La Liga,2019,Villarreal,Bruno Soriano,ESP,"MF,FW",35,1984,2.9,4,0,1,2,1,1,1,100.0,0,4,0,4,1,5,7,0,2020
ESP-La Liga,2019,Villarreal,Carlos Bacca,COL,FW,32,1986,7.6,5,1,1,2,2,2,6,33.3,4,4,0,4,0,5,7,0,2020
ESP-La Liga,2019,Villarreal,Fernando Niño,ESP,FW,18,2000,0.9,1,0,0,1,0,1,2,50.0,1,0,0,0,0,1,2,0,2020
ESP-La Liga,2019,Villarreal,Gerard Moreno,ESP,"FW,MF",27,1992,30.5,19,8,4,10,5,5,46,10.9,41,19,3,16,10,29,51,0,2020
ESP-La Liga,2019,Villarreal,Javier Ontiveros,ESP,"FW,MF",21,1997,9.9,29,14,13,14,2,8,35,22.9,27,13,1,12,5,34,7,0,2020
ESP-La Liga,2019,Villarreal,Karl Toko Ekambi,CMR,FW,26,1992,11.0,5,3,0,3,2,1,4,25.0,3,2,0,2,3,8,2,0,2020
ESP-La Liga,2019,Villarreal,Manu Morlanes,ESP,MF,20,1999,2.8,7,3,3,4,0,2,9,22.2,7,1,1,0,2,9,2,0,2020
ESP-La Liga,2019,Villarreal,Manu Trigueros,ESP,MF,27,1991,17.2,34,21,10,17,7,12,45,26.7,33,23,12,11,4,38,21,0,2020
ESP-La Liga,2019,Villarreal,Mario Gaspar,ESP,DF,28,1990,21.8,35,20,16,16,3,15,31,48.4,16,25,10,15,26,61,69,0,2020
ESP-La Liga,2019,Villarreal,Moi Gómez,ESP,"FW,MF",25,1994,25.8,30,22,9,14,7,11,33,33.3,22,22,2,20,25,55,23,0,2020
ESP-La Liga,2019,Villarreal,Paco Alcácer,ESP,FW,25,1993,10.3,3,3,2,1,0,1,7,14.3,6,4,1,3,2,5,10,0,2020
ESP-La Liga,2019,Villarreal,Pau Torres,ESP,DF,22,1997,33.0,34,21,24,10,0,16,24,66.7,8,39,23,16,27,61,153,1,2020
ESP-La Liga,2019,Villarreal,Ramiro Funes Mori,ARG,DF,28,1991,5.0,5,2,2,3,0,0,2,0.0,2,8,2,6,3,8,9,1,2020
ESP-La Liga,2019,Villarreal,Raúl Albiol,ESP,DF,33,1985,36.0,43,23,27,16,0,18,27,66.7,9,29,21,8,42,85,175,2,2020
ESP-La Liga,2019,Villarreal,Rubén Peña,ESP,DF,28,1991,21.2,42,24,23,19,0,17,50,34.0,33,25,8,17,35,77,58,2,2020
ESP-La Liga,2019,Villarreal,Samuel Chukwueze,NGA,"FW,MF",20,1999,22.8,23,14,12,6,5,13,30,43.3,17,15,1,14,10,33,14,1,2020
ESP-La Liga,2019,Villarreal,Santi Cazorla,ESP,MF,34,1984,27.2,48,25,14,21,13,20,57,35.1,37,23,1,22,19,67,16,2,2020
ESP-La Liga,2019,Villarreal,Sergio Asenjo,ESP,GK,30,1989,34.0,0,0,0,0,0,0,2,0.0,2,0,0,0,1,1,15,1,2020
ESP-La Liga,2019,Villarreal,Sofian Chakla,MAR,DF,25,1993,2.0,0,0,0,0,0,0,1,0.0,1,2,1,1,3,3,7,1,2020
ESP-La Liga,2019,Villarreal,Vicente Iborra,ESP,MF,31,1988,29.4,61,42,31,25,5,30,67,44.8,37,35,16,19,40,101,63,1,2020
ESP-La Liga,2019,Villarreal,Xavi Quintillà,ESP,DF,22,1996,17.5,22,12,14,4,4,10,20,50.0,10,11,4,7,12,34,35,0,2020
ESP-La Liga,2020,Alavés,Abdallahi Mahmoud,MTN,MF,20,2000,0.7,2,2,1,1,0,0,1,0.0,1,0,0,0,1,3,0,0,2021
ESP-La Liga,2020,Alavés,Adrián Marín,ESP,"DF,MF",23,1997,1.0,1,1,0,1,0,0,2,0.0,2,1,0,1,2,3,2,0,2021
ESP-La Liga,2020,Alavés,Antonio Sivera,ESP,GK,23,1996,0.8,0,0,0,0,0,0,0,,0,0,0,0,0,0,0,0,2021
ESP-La Liga,2020,Alavés,Borja Sainz,ESP,"MF,FW",19,2001,5.0,7,3,3,2,2,4,16,25.0,12,4,0,4,6,13,1,0,2021
ESP-La Liga,2020,Alavés,Burgui,ESP,MF,26,1993,0.2,3,1,2,1,0,1,1,100.0,0,0,0,0,0,3,0,0,2021
ESP-La Liga,2020,Alavés,Deyverson,BRA,FW,29,1991,9.7,6,4,3,1,2,2,13,15.4,11,9,0,9,9,15,13,0,2021
ESP-La Liga,2020,Alavés,Facundo Pellistri,URU,"MF,FW",18,2001,6.0,8,5,2,4,2,3,13,23.1,10,0,0,0,4,12,3,0,2021
ESP-La Liga,2020,Alavés,Fernando Pacheco,ESP,GK,28,1992,37.2,2,0,2,0,0,2,4,50.0,2,0,0,0,2,4,19,0,2021
ESP-La Liga,2020,Alavés,Florian Lejeune,FRA,DF,29,1991,33.5,43,32,36,7,0,21,35,60.0,14,38,24,14,51,94,149,1,2021
ESP-La Liga,2020,Alavés,Iñigo Córdoba,ESP,MF,23,1997,2.4,6,4,1,3,2,2,10,20.0,8,7,0,7,3,9,2,0,2021
ESP-La Liga,2020,Alavés,Javi López,ESP,"DF,MF",18,2002,2.8,5,5,3,2,0,2,3,66.7,1,2,0,2,3,8,3,1,2021
ESP-La Liga,2020,Alavés,John Guidetti,SWE,FW,28,1992,2.3,2,2,0,2,0,0,2,0.0,2,0,0,0,1,3,2,0,2021
ESP-La Liga,2020,Alavés,Joselu,ESP,FW,30,1990,33.6,27,14,6,15,6,8,28,28.6,20,26,3,23,15,42,58,1,2021
ESP-La Liga,2020,Alavés,Jota,ESP,MF,29,1991,15.5,19,14,6,7,6,3,29,10.3,26,12,0,12,9,28,9,0,2021
ESP-La Liga,2020,Alavés,Lucas Pérez,ESP,FW,31,1988,19.5,6,2,3,3,0,2,10,20.0,8,6,1,5,2,8,5,0,2021
ESP-La Liga,2020,Alavés,Luis Rioja,ESP,"MF,FW",26,1993,23.2,21,14,11,7,3,7,39,17.9,32,23,1,22,20,41,30,0,2021
ESP-La Liga,2020,Alavés,Manu García,ESP,MF,34,1986,12.5,24,13,10,13,1,8,35,22.9,27,16,1,15,12,36,21,0,2021
ESP-La Liga,2020,Alavés,Martin Agirregabiria,ESP,"DF,MF",24,1996,17.3,32,18,17,12,3,17,33,51.5,16,9,3,6,27,59,36,0,2021
ESP-La Liga,2020,Alavés,Pere Pons,ESP,MF,27,1993,13.2,20,10,8,8,4,5,16,31.3,11,15,2,13,7,27,10,0,2021
ESP-La Liga,2020,Alavés,Rodrigo Battaglia,ARG,MF,29,1991,27.7,38,16,21,14,3,16,50,32.0,34,30,14,16,29,67,40,1,2021
ESP-La Liga,2020,Alavés,Rodrigo Ely,BRA,DF,26,1993,5.2,5,2,3,2,0,3,4,75.0,1,2,1,1,7,12,23,1,2021
ESP-La Liga,2020,Alavés,Rubén Duarte,ESP,DF,24,1995,28.3,55,30,28,21,6,23,52,44.2,29,44,6,38,66,121,72,0,2021
ESP-La Liga,2020,Alavés,Sergi García,ESP,MF,21,1999,0.2,1,1,0,1,0,0,1,0.0,1,0,0,0,0,1,0,0,2021
ESP-La Liga,2020,Alavés,Stephane Keller,CMR,DF,18,2001,0.2,1,0,1,0,0,1,1,100.0,0,0,0,0,0,1,0,0,2021
ESP-La Liga,2020,Alavés,Tachi,ESP,DF,22,1997,9.4,11,9,9,2,0,6,14,42.9,8,9,6,3,11,22,32,0,2021
ESP-La Liga,2020,Alavés,Tomás Pina Isla,ESP,MF,32,1987,28.6,39,18,18,16,5,16,42,38.1,26,28,8,20,37,76,42,0,2021
ESP-La Liga,2020,Alavés,Tomás Tavares,POR,"MF,DF",19,2001,0.7,2,1,2,0,0,2,2,100.0,0,1,0,1,0,2,1,0,2021
ESP-La Liga,2020,Alavés,Víctor Laguardia,ESP,DF,30,1989,29.2,20,12,13,6,1,14,31,45.2,17,25,13,12,37,57,104,0,2021
ESP-La Liga,2020,Alavés,Ximo Navarro,ESP,DF,30,1990,26.4,54,30,36,17,1,14,30,46.7,16,14,4,10,47,101,75,3,2021
ESP-La Liga,2020,Alavés,Édgar Méndez,ESP,"MF,FW",30,1990,23.2,39,29,18,13,8,15,48,31.3,33,20,3,17,19,58,14,0,2021
ESP-La Liga,2020,Athletic Club,Ander Capa,ESP,DF,28,1992,23.7,37,18,22,13,2,18,37,48.6,19,21,8,13,25,62,57,0,2021
ESP-La Liga,2020,Athletic Club,Asier Villalibre,ESP,FW,22,1997,17.7,3,2,0,2,1,2,8,25.0,6,4,0,4,2,5,16,0,2021
ESP-La Liga,2020,Athletic Club,Dani García,ESP,MF,30,1990,21.3,39,19,10,23,6,15,46,32.6,31,20,7,13,33,72,34,0,2021
ESP-La Liga,2020,Athletic Club,Ibai Gómez,ESP,MF,30,1989,4.7,6,4,2,3,1,4,7,57.1,3,3,0,3,2,8,4,0,2021
ESP-La Liga,2020,Athletic Club,Iker Muniain,ESP,"MF,FW",27,1992,21.6,20,7,4,10,6,6,24,25.0,18,15,0,15,11,31,4,0,2021
ESP-La Liga,2020,Athletic Club,Iñaki Williams,GHA,FW,26,1994,26.5,11,7,0,4,7,2,14,14.3,12,13,1,12,5,16,22,0,2021
ESP-La Liga,2020,Athletic Club,Iñigo Córdoba,ESP,"FW,MF",23,1997,1.1,0,0,0,0,0,0,3,0.0,3,4,0,4,2,2,1,0,2021
ESP-La Liga,2020,Athletic Club,Iñigo Lekue,ESP,DF,27,1993,7.2,9,7,6,3,0,3,8,37.5,5,8,1,7,4,13,24,0,2021
ESP-La Liga,2020,Athletic Club,Iñigo Martínez,ESP,DF,29,1991,28.0,22,15,16,6,0,9,27,33.3,18,17,7,10,28,50,96,0,2021
ESP-La Liga,2020,Athletic Club,Iñigo Vicente,ESP,"FW,MF",22,1998,0.6,1,1,1,0,0,1,1,100.0,0,0,0,0,0,1,0,0,2021
ESP-La Liga,2020,Athletic Club,Jokin Ezkieta,ESP,GK,23,1996,1.0,0,0,0,0,0,0,0,,0,0,0,0,0,0,0,0,2021
ESP-La Liga,2020,Athletic Club,Jon Morcillo,ESP,"MF,FW",21,1998,15.1,16,9,3,6,7,7,30,23.3,23,9,0,9,15,31,11,0,2021
ESP-La Liga,2020,Athletic Club,Kenan Kodro,BIH,"FW,MF",26,1993,0.5,0,0,0,0,0,0,1,0.0,1,0,0,0,0,0,0,0,2021
ESP-La Liga,2020,Athletic Club,Mikel Balenziaga,ESP,DF,32,1988,18.8,26,15,11,12,3,9,18,50.0,9,22,7,15,7,33,46,0,2021
ESP-La Liga,2020,Athletic Club,Mikel Vesga,ESP,MF,27,1993,19.1,28,14,8,16,4,12,50,24.0,38,28,8,20,27,55,35,1,2021
ESP-La Liga,2020,Athletic Club,Nico Williams,ESP,MF,18,2002,0.6,1,0,1,0,0,0,2,0.0,2,0,0,0,1,2,0,0,2021
ESP-La Liga,2020,Athletic Club,Oier Zarraga,ESP,MF,21,1999,1.1,1,1,0,1,0,1,2,50.0,1,1,0,1,0,1,0,0,2021
ESP-La Liga,2020,Athletic Club,Oihan Sancet,ESP,"FW,MF",20,2000,11.5,8,2,3,4,1,2,7,28.6,5,4,0,4,5,13,7,0,2021
ESP-La Liga,2020,Athletic Club,Raúl García,ESP,"FW,MF",34,1986,19.4,34,19,9,19,6,7,22,31.8,15,30,1,29,15,49,20,0,2021
ESP-La Liga,2020,Athletic Club,Unai López,ESP,MF,24,1995,15.8,27,17,13,13,1,10,29,34.5,19,20,5,15,18,45,9,1,2021
ESP-La Liga,2020,Athletic Club,Unai Núñez,ESP,DF,23,1997,23.4,23,12,16,7,0,10,15,66.7,5,19,14,5,32,55,110,0,2021
ESP-La Liga,2020,Athletic Club,Unai Simón,ESP,GK,23,1997,37.0,1,0,1,0,0,1,2,50.0,1,0,0,0,0,1,7,7,2021
ESP-La Liga,2020,Athletic Club,Unai Vencedor Paris,ESP,MF,19,2000,18.9,31,21,10,15,6,11,42,26.2,31,17,6,11,18,49,14,0,2021
ESP-La Liga,2020,Athletic Club,Yeray Álvarez,ESP,DF,25,1995,21.6,19,12,11,8,0,9,21,42.9,12,12,5,7,53,72,73,0,2021
ESP-La Liga,2020,Athletic Club,Yuri Berchiche,ESP,DF,30,1990,18.7,24,19,14,5,5,10,24,41.7,14,14,0,14,11,35,29,0,2021
ESP-La Liga,2020,Athletic Club,Álex Berenguer,ESP,"MF,FW",25,1995,25.3,47,31,21,20,6,9,51,17.6,42,48,3,45,18,65,27,0,2021
ESP-La Liga,2020,Athletic Club,Óscar de Marcos,ESP,"DF,MF",31,1989,16.9,28,17,12,10,6,10,25,40.0,15,12,1,11,12,40,38,0,2021
ESP-La Liga,2020,Atlético Madrid,Diego Costa,ESP,FW,31,1988,2.3,1,0,1,0,0,1,3,33.3,2,0,0,0,0,1,2,0,2021
ESP-La Liga,2020,Atlético Madrid,Felipe,BRA,DF,31,1989,22.9,29,17,19,10,0,18,23,78.3,5,30,15,15,36,65,128,2,2021
ESP-La Liga,2020,Atlético Madrid,Geoffrey Kondogbia,CTA,MF,27,1993,6.8,30,20,12,16,2,11,20,55.0,9,11,5,6,11,41,8,1,2021
ESP-La Liga,2020,Atlético Madrid,Héctor Herrera,MEX,MF,30,1990,7.6,12,7,5,6,1,7,13,53.8,6,7,2,5,14,26,8,0,2021
ESP-La Liga,2020,Atlético Madrid,Jan Oblak,SVN,GK,27,1993,38.0,0,0,0,0,0,0,0,,0,0,0,0,0,0,6,2,2021
ESP-La Liga,2020,Atlético Madrid,José María Giménez,URU,DF,25,1995,19.6,20,7,14,5,1,12,17,70.6,5,17,11,6,21,41,65,0,2021
ESP-La Liga,2020,Atlético Madrid,João Félix,POR,"FW,MF",20,1999,17.5,8,4,1,6,1,4,17,23.5,13,3,0,3,5,13,2,0,2021
ESP-La Liga,2020,Atlético Madrid,Kieran Trippier,ENG,DF,29,1990,27.5,61,39,30,25,6,26,52,50.0,26,22,4,18,40,101,58,1,2021
ESP-La Liga,2020,Atlético Madrid,Koke,ESP,MF,28,1992,33.6,64,42,22,31,11,28,98,28.6,70,35,6,29,36,100,40,0,2021
ESP-La Liga,2020,Atlético Madrid,Lucas Torreira,URU,MF,24,1996,5.8,8,4,2,3,3,0,3,0.0,3,5,3,2,12,20,8,0,2021
ESP-La Liga,2020,Atlético Madrid,Luis Suárez,URU,FW,33,1987,27.9,11,7,0,4,7,3,12,25.0,9,7,0,7,5,16,13,0,2021
ESP-La Liga,2020,Atlético Madrid,Manuel Sánchez,ESP,DF,19,2000,0.5,0,0,0,0,0,0,1,0.0,1,1,0,1,0,0,1,0,2021
ESP-La Liga,2020,Atlético Madrid,Marcos Llorente,ESP,"MF,FW",25,1995,32.8,71,42,21,40,10,26,62,41.9,36,40,3,37,29,100,28,0,2021
ESP-La Liga,2020,Atlético Madrid,Mario Hermoso,ESP,DF,25,1995,28.6,55,31,40,11,4,37,61,60.7,24,23,10,13,36,91,73,0,2021
ESP-La Liga,2020,Atlético Madrid,Moussa Dembélé,FRA,FW,24,1996,1.1,0,0,0,0,0,0,1,0.0,1,0,0,0,1,1,0,0,2021
ESP-La Liga,2020,Atlético Madrid,Renan Lodi,BRA,"DF,FW",22,1998,12.5,30,17,13,12,5,17,26,65.4,9,15,0,15,16,46,18,0,2021
ESP-La Liga,2020,Atlético Madrid,Ricard,ESP,DF,20,2000,0.3,1,1,0,0,1,0,0,,0,1,0,1,0,1,1,0,2021
ESP-La Liga,2020,Atlético Madrid,Saúl Ñíguez,ESP,"MF,DF",25,1994,22.6,57,34,27,23,7,30,59,50.8,29,35,2,33,19,76,43,0,2021
ESP-La Liga,2020,Atlético Madrid,Stefan Savić,MNE,DF,29,1991,32.8,40,25,32,7,1,21,34,61.8,13,33,19,14,42,82,110,0,2021
ESP-La Liga,2020,Atlético Madrid,Thomas Lemar,FRA,MF,24,1995,15.2,30,17,9,17,4,11,24,45.8,13,22,1,21,11,41,10,0,2021
ESP-La Liga,2020,Atlético Madrid,Thomas Partey,GHA,MF,27,1993,2.2,7,4,4,3,0,5,8,62.5,3,4,1,3,2,9,1,0,2021
ESP-La Liga,2020,Atlético Madrid,Vitolo,ESP,"MF,FW",30,1989,3.3,4,1,2,0,2,1,6,16.7,5,3,0,3,3,7,2,0,2021
ESP-La Liga,2020,Atlético Madrid,Yannick Carrasco,BEL,"DF,MF",26,1993,24.2,27,15,14,6,7,15,34,44.1,19,24,0,24,17,44,16,1,2021
ESP-La Liga,2020,Atlético Madrid,Ángel Correa,ARG,"FW,MF",25,1995,26.6,38,21,10,23,5,15,45,33.3,30,18,1,17,22,60,16,0,2021
ESP-La Liga,2020,Atlético Madrid,Šime Vrsaljko,CRO,"FW,DF",28,1992,5.8,18,12,13,5,0,8,12,66.7,4,5,0,5,8,26,14,0,2021
ESP-La Liga,2020,Barcelona,Ansu Fati,ESP,FW,17,2002,4.8,9,4,2,4,3,2,10,20.0,8,4,0,4,3,12,1,0,2021
ESP-La Liga,2020,Barcelona,Antoine Griezmann,FRA,"FW,MF",29,1991,28.9,37,22,10,18,9,12,40,30.0,28,20,1,19,12,49,11,0,2021
ESP-La Liga,2020,Barcelona,Carles Aleñá,ESP,MF,22,1998,0.5,1,0,1,0,0,0,0,,0,0,0,0,0,1,0,0,2021
ESP-La Liga,2020,Barcelona,Clément Lenglet,FRA,DF,25,1995,27.5,36,21,23,10,3,19,28,67.9,9,26,12,14,33,69,71,1,2021
ESP-La Liga,2020,Barcelona,Francisco Trincão,POR,"FW,MF",20,1999,7.8,4,2,0,3,1,2,5,40.0,3,4,0,4,1,5,2,0,2021
ESP-La Liga,2020,Barcelona,Frenkie de Jong,NED,"MF,DF",23,1997,35.0,44,27,21,19,4,15,35,42.9,20,20,4,16,38,82,29,2,2021
ESP-La Liga,2020,Barcelona,Gerard Piqué,ESP,DF,33,1987,16.5,16,11,11,5,0,9,12,75.0,3,9,4,5,26,42,46,0,2021
ESP-La Liga,2020,Barcelona,Ilaix Moriba,GUI,MF,17,2003,6.0,14,6,5,7,2,5,10,50.0,5,16,1,15,5,19,4,1,2021
ESP-La Liga,2020,Barcelona,Jordi Alba,ESP,"DF,FW",31,1989,33.6,45,30,22,16,7,24,52,46.2,28,21,2,19,49,94,48,0,2021
ESP-La Liga,2020,Barcelona,Junior Firpo,ESP,"DF,MF",23,1996,3.2,1,1,1,0,0,0,1,0.0,1,5,3,2,4,5,7,0,2021
ESP-La Liga,2020,Barcelona,Lionel Messi,ARG,"FW,MF",33,1987,33.6,18,10,3,9,6,6,17,35.3,11,12,0,12,6,24,0,2,2021
ESP-La Liga,2020,Barcelona,Marc-André ter Stegen,GER,GK,28,1992,31.0,0,0,0,0,0,0,2,0.0,2,0,0,0,0,0,12,2,2021
ESP-La Liga,2020,Barcelona,Martin Braithwaite,DEN,FW,29,1991,13.1,8,4,2,3,3,1,6,16.7,5,2,0,2,6,14,7,0,2021
ESP-La Liga,2020,Barcelona,Miralem Pjanić,BIH,MF,30,1990,7.0,13,8,7,4,2,7,13,53.8,6,5,1,4,11,24,5,0,2021
ESP-La Liga,2020,Barcelona,Neto,BRA,GK,31,1989,7.0,0,0,0,0,0,0,1,0.0,1,0,0,0,0,0,3,1,2021
ESP-La Liga,2020,Barcelona,Ousmane Dembélé,FRA,FW,23,1997,19.7,14,9,4,9,1,6,17,35.3,11,10,0,10,9,23,3,1,2021
ESP-La Liga,2020,Barcelona,Pedri,ESP,MF,17,2002,26.8,44,27,16,16,12,17,71,23.9,54,46,1,45,33,77,7,0,2021
ESP-La Liga,2020,Barcelona,Philippe Coutinho,BRA,"MF,FW",28,1992,7.3,8,6,2,5,1,3,9,33.3,6,7,0,7,2,10,1,0,2021
ESP-La Liga,2020,Barcelona,Riqui Puig,ESP,"MF,FW",20,1999,3.2,5,3,1,3,1,4,8,50.0,4,0,0,0,1,6,0,0,2021
ESP-La Liga,2020,Barcelona,Ronald Araújo,URU,DF,21,1999,16.8,22,11,12,8,2,9,9,100.0,0,24,15,9,20,42,47,1,2021
ESP-La Liga,2020,Barcelona,Samuel Umtiti,FRA,DF,26,1993,7.2,5,1,3,2,0,1,2,50.0,1,11,6,5,9,14,15,0,2021
ESP-La Liga,2020,Barcelona,Sergi Roberto,ESP,"DF,FW",28,1992,10.5,9,6,5,2,2,7,13,53.8,6,12,6,6,10,19,20,0,2021
ESP-La Liga,2020,Barcelona,Sergio Busquets,ESP,MF,32,1988,28.0,63,35,21,29,13,27,76,35.5,49,27,4,23,53,116,18,2,2021
ESP-La Liga,2020,Barcelona,Sergiño Dest,USA,"DF,FW",19,2000,21.2,31,16,23,6,2,18,32,56.3,14,25,4,21,10,41,24,1,2021
ESP-La Liga,2020,Barcelona,Óscar Mingueza,ESP,DF,21,1999,21.1,52,33,28,17,7,30,53,56.6,23,19,6,13,20,72,48,2,2021
ESP-La Liga,2020,Betis,Aitor Ruibal,ESP,"FW,MF",24,1996,17.7,32,18,14,14,4,10,35,28.6,25,26,0,26,11,43,8,0,2021
ESP-La Liga,2020,Betis,Andrés Guardado,MEX,MF,33,1986,14.6,25,12,10,11,4,10,25,40.0,15,13,3,10,18,43,19,0,2021
ESP-La Liga,2020,Betis,Antonio Sanabria,PAR,FW,24,1996,10.4,5,5,0,4,1,0,2,0.0,2,8,1,7,3,8,9,0,2021
ESP-La Liga,2020,Betis,Aïssa Mandi,ALG,DF,28,1991,26.6,30,17,20,10,0,10,16,62.5,6,21,13,8,39,69,90,0,2021
ESP-La Liga,2020,Betis,Borja Iglesias,ESP,FW,27,1993,15.7,1,1,0,0,1,1,8,12.5,7,7,2,5,3,4,9,0,2021
ESP-La Liga,2020,Betis,Claudio Bravo,CHI,GK,37,1983,20.0,0,0,0,0,0,0,1,0.0,1,0,0,0,0,0,11,0,2021
ESP-La Liga,2020,Betis,Cristian Tello,ESP,"FW,MF",28,1991,14.3,16,10,5,9,2,4,22,18.2,18,14,0,14,11,27,8,0,2021
ESP-La Liga,2020,Betis,Diego Lainez,MEX,"FW,MF",20,2000,9.6,9,4,3,5,1,6,16,37.5,10,15,0,15,11,20,6,0,2021
ESP-La Liga,2020,Betis,Emerson,BRA,DF,21,1999,33.2,91,52,62,25,4,43,78,55.1,35,33,6,27,61,152,102,2,2021
ESP-La Liga,2020,Betis,Guido Rodríguez,ARG,MF,26,1994,31.8,98,56,52,40,6,40,85,47.1,45,52,14,38,68,166,58,2,2021
ESP-La Liga,2020,Betis,Joaquín,ESP,"FW,MF",39,1981,14.3,9,3,1,5,3,4,12,33.3,8,8,0,8,17,26,11,0,2021
ESP-La Liga,2020,Betis,Joel Robles,ESP,GK,30,1990,18.0,0,0,0,0,0,0,1,0.0,1,1,0,1,0,0,11,2,2021
ESP-La Liga,2020,Betis,Juan Miranda,ESP,DF,20,2000,18.4,27,11,16,9,2,16,32,50.0,16,18,2,16,29,56,58,1,2021
ESP-La Liga,2020,Betis,Juanmi,ESP,"FW,MF",27,1993,6.7,13,9,3,5,5,4,18,22.2,14,4,0,4,2,15,4,0,2021
ESP-La Liga,2020,Betis,Loren Morón,ESP,FW,26,1993,11.0,11,7,2,6,3,1,16,6.3,15,11,0,11,3,14,14,0,2021
ESP-La Liga,2020,Betis,Marc Bartra,ESP,DF,29,1991,18.8,27,16,18,8,1,12,22,54.5,10,19,5,14,40,67,74,3,2021
ESP-La Liga,2020,Betis,Martín Montoya,ESP,DF,29,1991,2.7,6,3,2,2,2,1,3,33.3,2,1,1,0,2,8,6,0,2021
ESP-La Liga,2020,Betis,Nabil Fekir,FRA,"MF,FW",27,1993,29.1,45,23,9,22,14,7,43,16.3,36,31,2,29,8,53,2,0,2021
ESP-La Liga,2020,Betis,Paul Akouokou,CIV,MF,22,1997,4.2,11,8,2,8,1,5,8,62.5,3,3,1,2,6,17,7,0,2021
ESP-La Liga,2020,Betis,Rodri,ESP,"FW,MF",20,2000,6.0,3,3,1,2,0,1,6,16.7,5,7,0,7,2,5,0,0,2021
ESP-La Liga,2020,Betis,Sergio Canales,ESP,"MF,FW",29,1991,27.8,16,9,9,6,1,3,21,14.3,18,18,0,18,13,29,5,0,2021
ESP-La Liga,2020,Betis,Sidnei,BRA,DF,30,1989,7.7,9,3,6,3,0,4,9,44.4,5,6,4,2,16,25,28,0,2021
ESP-La Liga,2020,Betis,Víctor Ruiz,ESP,DF,31,1989,24.0,11,7,7,4,0,4,13,30.8,9,17,13,4,44,55,85,0,2021
ESP-La Liga,2020,Betis,William Carvalho,POR,MF,28,1992,13.6,19,12,7,11,1,5,21,23.8,16,11,3,8,11,30,14,1,2021
ESP-La Liga,2020,Betis,Álex Moreno,ESP,DF,27,1993,19.8,42,26,25,12,5,20,43,46.5,23,18,4,14,35,77,48,0,2021
ESP-La Liga,2020,Celta Vigo,Aarón Martín,ESP,DF,23,1997,17.1,34,20,15,16,3,10,33,30.3,23,15,4,11,13,47,37,0,2021
ESP-La Liga,2020,Celta Vigo,Alfon,ESP,MF,21,1999,0.4,0,0,0,0,0,0,0,,0,0,0,0,0,0,0,0,2021
ESP-La Liga,2020,Celta Vigo,Augusto Solari,ARG,MF,28,1992,5.4,18,13,9,8,1,6,26,23.1,20,13,1,12,6,24,5,0,2021
ESP-La Liga,2020,Celta Vigo,Brais Méndez,ESP,"MF,FW",23,1997,29.7,59,31,23,27,9,16,65,24.6,49,27,2,25,32,91,34,0,2021
ESP-La Liga,2020,Celta Vigo,Carlos Dominguez,ESP,DF,19,2001,4.0,5,4,4,1,0,3,6,50.0,3,5,3,2,6,11,24,0,2021
ESP-La Liga,2020,Celta Vigo,Denis Suárez,ESP,MF,26,1994,31.7,64,32,22,30,12,21,94,22.3,73,30,2,28,22,86,15,2,2021
ESP-La Liga,2020,Celta Vigo,Emre Mor,TUR,"FW,MF",23,1997,5.6,8,4,1,3,4,0,3,0.0,3,5,0,5,5,13,0,0,2021
ESP-La Liga,2020,Celta Vigo,Facundo Ferreyra,ARG,FW,29,1991,3.3,4,3,1,2,1,0,2,0.0,2,5,0,5,2,6,2,0,2021
ESP-La Liga,2020,Celta Vigo,Fran Beltrán,ESP,"MF,FW",21,1999,15.5,30,22,15,12,3,8,24,33.3,16,14,1,13,16,46,24,0,2021
ESP-La Liga,2020,Celta Vigo,Gabriel Veiga,ESP,"MF,DF",18,2002,1.3,3,0,3,0,0,1,4,25.0,3,3,0,3,3,6,0,0,2021
ESP-La Liga,2020,Celta Vigo,Hugo Mallo,ESP,DF,29,1991,28.9,58,40,34,23,1,24,52,46.2,28,42,11,31,37,95,77,0,2021
ESP-La Liga,2020,Celta Vigo,Hugo Sotelo,ESP,MF,16,2003,0.0,0,0,0,0,0,0,0,,0,0,0,0,0,0,0,0,2021
ESP-La Liga,2020,Celta Vigo,Iago Aspas,ESP,FW,32,1987,31.8,11,3,2,7,2,2,23,8.7,21,25,2,23,16,27,21,0,2021
ESP-La Liga,2020,Celta Vigo,Iván Villar,ESP,GK,23,1997,19.8,0,0,0,0,0,0,1,0.0,1,0,0,0,0,0,18,0,2021
ESP-La Liga,2020,Celta Vigo,Jeison Murillo,COL,DF,28,1992,30.0,45,21,35,9,1,24,44,54.5,20,29,17,12,36,81,100,2,2021
ESP-La Liga,2020,Celta Vigo,Jordan Holsgrove,SCO,MF,20,1999,1.6,6,4,4,1,1,5,8,62.5,3,2,0,2,2,8,1,0,2021
ESP-La Liga,2020,Celta Vigo,Joseph Aidoo,GHA,DF,24,1995,14.3,26,17,17,9,0,12,21,57.1,9,7,4,3,25,51,88,1,2021
ESP-La Liga,2020,Celta Vigo,José Fontán,ESP,DF,20,2000,7.2,12,9,8,4,0,5,11,45.5,6,4,3,1,13,25,27,0,2021
ESP-La Liga,2020,Celta Vigo,Kevin Vázquez,ESP,DF,27,1993,6.2,11,5,9,2,0,3,9,33.3,6,8,0,8,9,20,18,0,2021
ESP-La Liga,2020,Celta Vigo,Lauti,URU,FW,19,2001,0.2,,0,,,,,,,,,,,0,,,,2021
ESP-La Liga,2020,Celta Vigo,Lucas Olaza,URU,DF,26,1994,17.9,25,16,12,12,1,10,18,55.6,8,15,1,14,24,49,34,0,2021
ESP-La Liga,2020,Celta Vigo,Miguel Baeza,ESP,"MF,FW",20,2000,6.0,7,6,5,2,0,5,13,38.5,8,3,0,3,3,10,2,0,2021
ESP-La Liga,2020,Celta Vigo,Miguel Rodríguez,ESP,"FW,DF",17,2003,0.3,1,1,0,1,0,0,0,,0,0,0,0,0,1,0,0,2021
ESP-La Liga,2020,Celta Vigo,Nolito,ESP,"MF,FW",33,1986,28.9,70,36,30,30,10,32,92,34.8,60,46,2,44,22,92,19,0,2021
ESP-La Liga,2020,Celta Vigo,Néstor Araujo,MEX,DF,28,1991,27.0,24,16,14,9,1,7,15,46.7,8,23,18,5,43,67,89,2,2021
ESP-La Liga,2020,Celta Vigo,Okay Yokuşlu,TUR,MF,26,1994,5.1,14,8,8,4,2,5,9,55.6,4,5,2,3,10,24,9,0,2021
ESP-La Liga,2020,Celta Vigo,Renato Tapia,PER,MF,25,1995,30.0,93,44,50,34,9,32,83,38.6,51,56,13,43,53,146,75,2,2021
ESP-La Liga,2020,Celta Vigo,Rubén Blanco,ESP,GK,25,1995,18.2,0,0,0,0,0,0,0,,0,0,0,0,0,0,7,3,2021
ESP-La Liga,2020,Celta Vigo,Santi Mina,ESP,FW,24,1995,26.8,31,13,9,12,10,6,37,16.2,31,15,3,12,6,37,17,0,2021
ESP-La Liga,2020,Celta Vigo,Sergio Carreira,ESP,DF,19,2000,2.9,3,0,2,1,0,1,1,100.0,0,2,0,2,1,4,7,0,2021
ESP-La Liga,2020,Cádiz,Alberto Cifuentes,ESP,GK,41,1979,2.0,0,0,0,0,0,0,0,,0,0,0,0,0,0,0,0,2021
ESP-La Liga,2020,Cádiz,Alberto Perea,ESP,MF,29,1990,17.2,28,17,12,10,6,9,35,25.7,26,26,1,25,21,49,9,0,2021
ESP-La Liga,2020,Cádiz,Alfonso Espino,URU,DF,28,1992,28.9,92,48,63,28,1,43,85,50.6,42,30,5,25,41,133,74,0,2021
ESP-La Liga,2020,Cádiz,Anthony Lozano,HON,FW,27,1993,16.9,12,4,1,5,6,2,13,15.4,11,3,1,2,3,15,8,0,2021
ESP-La Liga,2020,Cádiz,Augusto Fernández,ARG,MF,34,1986,4.1,11,3,5,6,0,2,13,15.4,11,5,1,4,9,20,5,0,2021
ESP-La Liga,2020,Cádiz,Bobby Adekanye,NED,"FW,MF",21,1999,0.4,0,0,0,0,0,0,1,0.0,1,0,0,0,0,0,1,0,2021
ESP-La Liga,2020,Cádiz,Cala,ESP,DF,30,1989,25.2,21,12,15,6,0,11,21,52.4,10,18,8,10,35,56,91,0,2021
ESP-La Liga,2020,Cádiz,Carlos Akapo,EQG,DF,27,1993,9.6,18,14,14,4,0,10,18,55.6,8,16,3,13,19,37,33,0,2021
ESP-La Liga,2020,Cádiz,David Gil,ESP,GK,26,1994,4.0,0,0,0,0,0,0,1,0.0,1,0,0,0,0,0,2,0,2021
ESP-La Liga,2020,Cádiz,Fali,ESP,"DF,MF",26,1993,29.3,42,25,24,15,3,16,37,43.2,21,28,15,13,32,74,119,0,2021
ESP-La Liga,2020,Cádiz,Filip Malbašić,SRB,"FW,MF",27,1992,9.6,12,7,4,5,3,6,18,33.3,12,10,0,10,4,16,2,0,2021
ESP-La Liga,2020,Cádiz,Isaac Carcelen,ESP,DF,27,1993,28.7,68,43,36,25,7,33,60,55.0,27,37,12,25,49,117,89,0,2021
ESP-La Liga,2020,Cádiz,Ivan Šaponjić,SRB,FW,22,1997,4.3,1,0,0,1,0,0,2,0.0,2,2,0,2,1,2,4,0,2021
ESP-La Liga,2020,Cádiz,Iván Alejo,ESP,"MF,FW",25,1995,9.2,14,10,8,4,2,4,23,17.4,19,14,1,13,3,17,10,0,2021
ESP-La Liga,2020,Cádiz,Jairo Izquierdo,ESP,"MF,DF",26,1993,14.2,21,13,13,8,0,12,31,38.7,19,7,1,6,14,35,12,0,2021
ESP-La Liga,2020,Cádiz,Jens Jønsson,DEN,MF,27,1993,29.1,55,29,25,25,5,22,52,42.3,30,39,7,32,51,106,45,0,2021
ESP-La Liga,2020,Cádiz,Jeremías Ledesma,ARG,GK,27,1993,32.0,1,0,1,0,0,1,1,100.0,0,1,0,1,0,1,22,6,2021
ESP-La Liga,2020,Cádiz,Jon Ander Garrido,ESP,MF,30,1989,8.9,18,10,8,7,3,10,26,38.5,16,12,4,8,14,32,13,0,2021
ESP-La Liga,2020,Cádiz,Jorge Pombo,ESP,"FW,MF",26,1994,5.8,7,3,3,2,2,1,8,12.5,7,2,0,2,2,9,3,0,2021
ESP-La Liga,2020,Cádiz,José Mari,ESP,MF,32,1987,16.1,32,17,13,18,1,14,31,45.2,17,16,7,9,27,59,33,1,2021
ESP-La Liga,2020,Cádiz,Marc Baró,ESP,DF,20,1999,1.0,2,1,2,0,0,0,2,0.0,2,1,0,1,2,4,2,1,2021
ESP-La Liga,2020,Cádiz,Marcos Mauro López Gutiérrez,ARG,DF,29,1991,20.3,23,15,15,8,0,15,24,62.5,9,18,12,6,22,45,78,0,2021
ESP-La Liga,2020,Cádiz,Nano,ESP,FW,25,1995,0.1,0,0,0,0,0,0,0,,0,0,0,0,0,0,0,0,2021
ESP-La Liga,2020,Cádiz,Nieto,ESP,"FW,DF",22,1998,0.2,1,1,0,1,0,0,0,,0,0,0,0,0,1,1,0,2021
ESP-La Liga,2020,Cádiz,Pedro Alcalá,ESP,DF,31,1989,10.1,8,4,6,2,0,3,5,60.0,2,19,13,6,16,24,50,0,2021
ESP-La Liga,2020,Cádiz,Rubén Sobrino,ESP,"FW,MF",28,1992,12.4,29,13,8,16,5,8,18,44.4,10,19,0,19,15,44,11,0,2021
ESP-La Liga,2020,Cádiz,Salvi,ESP,"MF,FW",29,1991,21.5,18,10,14,3,1,8,26,30.8,18,14,1,13,20,38,24,0,2021
ESP-La Liga,2020,Cádiz,Sergio González,ESP,"MF,DF",23,1997,1.0,1,0,0,1,0,1,2,50.0,1,0,0,0,2,3,0,0,2021
ESP-La Liga,2020,Cádiz,Yann Bodiger,FRA,MF,25,1995,2.8,2,2,1,1,0,1,6,16.7,5,7,3,4,8,10,4,0,2021
ESP-La Liga,2020,Cádiz,Álex Fernández,ESP,MF,27,1992,21.6,19,9,8,8,3,8,30,26.7,22,14,1,13,22,41,15,0,2021
ESP-La Liga,2020,Cádiz,Álex Martín,ESP,DF,22,1998,1.1,2,0,1,1,0,2,4,50.0,2,1,1,0,0,2,6,0,2021
ESP-La Liga,2020,Cádiz,Álvaro Bastida,ESP,MF,16,2004,0.4,0,0,0,0,0,0,0,,0,0,0,0,0,0,0,0,2021
ESP-La Liga,2020,Cádiz,Álvaro Giménez,ESP,FW,29,1991,4.5,4,2,2,2,0,0,3,0.0,3,2,0,2,2,6,3,0,2021
ESP-La Liga,2020,Cádiz,Álvaro Negredo,ESP,FW,34,1985,24.4,11,5,3,4,4,5,11,45.5,6,7,2,5,3,14,19,0,2021
ESP-La Liga,2020,Eibar,Aleix García,ESP,MF,23,1997,4.9,5,4,2,2,1,1,10,10.0,9,5,0,5,8,13,2,0,2021
ESP-La Liga,2020,Eibar,Alejandro Pozo Pozo,ESP,"DF,MF",21,1999,24.3,38,22,17,15,6,17,38,44.7,21,35,2,33,27,65,40,1,2021
ESP-La Liga,2020,Eibar,Anaitz Arbilla,ESP,DF,33,1987,31.2,45,26,31,11,3,27,54,50.0,27,36,11,25,69,114,73,1,2021
ESP-La Liga,2020,Eibar,Bryan,ESP,"MF,FW",19,2001,25.2,28,18,12,11,5,6,23,26.1,17,20,0,20,17,45,6,0,2021
ESP-La Liga,2020,Eibar,Damian Kądzior,POL,"FW,MF",28,1992,2.2,1,0,0,1,0,1,5,20.0,4,1,0,1,0,1,0,0,2021
ESP-La Liga,2020,Eibar,Edu Expósito,ESP,MF,23,1996,27.3,51,30,16,31,4,20,66,30.3,46,25,4,21,22,73,17,0,2021
ESP-La Liga,2020,Eibar,Esteban Burgos,ARG,DF,28,1992,12.3,7,6,4,3,0,1,5,20.0,4,8,7,1,23,30,54,2,2021
ESP-La Liga,2020,Eibar,Eñaut Mendía,ESP,FW,21,1999,0.7,2,1,2,0,0,1,2,50.0,1,1,1,0,0,2,0,0,2021
ESP-La Liga,2020,Eibar,José Ángel,ESP,DF,30,1989,10.0,15,8,9,4,2,8,12,66.7,4,7,0,7,13,28,17,1,2021
ESP-La Liga,2020,Eibar,Kike,ESP,FW,30,1989,34.3,24,18,5,7,12,6,22,27.3,16,24,1,23,7,31,29,0,2021
ESP-La Liga,2020,Eibar,Kévin Rodrigues,POR,"DF,MF",26,1994,12.2,16,8,8,5,3,7,23,30.4,16,10,1,9,20,36,15,1,2021
ESP-La Liga,2020,Eibar,Marko Dmitrović,SRB,GK,28,1992,34.7,4,3,4,0,0,2,4,50.0,2,0,0,0,0,4,16,2,2021
ESP-La Liga,2020,Eibar,Miguel Atienza,ESP,MF,21,1999,9.3,20,9,5,15,0,8,23,34.8,15,14,1,13,9,29,12,0,2021
ESP-La Liga,2020,Eibar,Papakouli Diop,SEN,MF,34,1986,25.8,43,29,15,22,6,12,41,29.3,29,23,5,18,39,82,34,1,2021
ESP-La Liga,2020,Eibar,Paulo Oliveira,POR,DF,28,1992,29.3,42,21,32,8,2,19,36,52.8,17,39,14,25,59,101,112,0,2021
ESP-La Liga,2020,Eibar,Pedro Bigas,ESP,DF,29,1990,17.0,11,9,7,4,0,7,14,50.0,7,12,6,6,23,34,54,0,2021
ESP-La Liga,2020,Eibar,Pedro León,ESP,"MF,FW",33,1986,10.4,9,8,3,3,3,3,17,17.6,14,11,0,11,7,16,2,0,2021
ESP-La Liga,2020,Eibar,Quique,ESP,"FW,MF",30,1990,1.9,0,0,0,0,0,0,1,0.0,1,2,0,2,0,0,0,0,2021
ESP-La Liga,2020,Eibar,Rafa Soares,POR,DF,25,1995,12.6,28,17,16,8,4,15,21,71.4,6,14,4,10,20,48,32,0,2021
ESP-La Liga,2020,Eibar,Recio,ESP,MF,29,1991,8.2,17,5,4,8,5,8,18,44.4,10,6,0,6,4,21,1,0,2021
ESP-La Liga,2020,Eibar,Rober Correa,ESP,DF,27,1992,12.6,16,9,8,6,2,8,12,66.7,4,9,1,8,20,36,31,0,2021
ESP-La Liga,2020,Eibar,Sergi Enrich,ESP,FW,30,1990,15.6,21,15,6,7,8,9,22,40.9,13,11,0,11,6,27,5,0,2021
ESP-La Liga,2020,Eibar,Sergio Cubero Ezcurra,ESP,MF,20,1999,0.0,0,0,0,0,0,0,0,,0,0,0,0,0,0,0,0,2021
ESP-La Liga,2020,Eibar,Sergio Álvarez,ESP,"MF,DF",28,1992,17.4,42,25,13,26,3,8,22,36.4,14,22,5,17,22,64,24,2,2021
ESP-La Liga,2020,Eibar,Takashi Inui,JPN,"MF,FW",32,1988,20.2,13,8,6,3,4,3,12,25.0,9,19,0,19,12,25,7,0,2021
ESP-La Liga,2020,Eibar,Unai Arietaleanizbeaskoa,ESP,"FW,MF",21,1999,0.5,1,0,0,0,1,0,0,,0,0,0,0,0,1,0,0,2021
ESP-La Liga,2020,Eibar,Unai Dufur,ESP,DF,21,1999,0.7,2,2,2,0,0,2,4,50.0,2,0,0,0,1,3,0,0,2021
ESP-La Liga,2020,Eibar,Yoel,ESP,GK,31,1988,3.3,0,0,0,0,0,0,0,,0,0,0,0,0,0,2,0,2021
ESP-La Liga,2020,Eibar,Yoshinori Mutō,JPN,"FW,MF",28,1992,12.5,12,7,1,4,7,3,8,37.5,5,5,0,5,3,15,2,0,2021
ESP-La Liga,2020,Eibar,Álvaro Tejero,ESP,DF,24,1996,1.2,1,1,0,0,1,1,3,33.3,2,1,0,1,3,4,6,0,2021
ESP-La Liga,2020,Elche,Antonio Barragán,ESP,DF,33,1987,24.8,28,14,21,5,2,12,21,57.1,9,22,8,14,33,61,67,1,2021
ESP-La Liga,2020,Elche,Cifu,ESP,DF,29,1990,5.0,10,7,7,3,0,7,13,53.8,6,5,1,4,8,18,10,0,2021
ESP-La Liga,2020,Elche,Dani Calvo,ESP,DF,26,1994,19.8,20,13,13,7,0,7,10,70.0,3,18,12,6,11,31,71,0,2021
ESP-La Liga,2020,Elche,Diego González,ESP,DF,25,1995,14.2,11,7,7,3,1,5,11,45.5,6,16,9,7,20,31,49,1,2021
ESP-La Liga,2020,Elche,Emiliano Rigoni,ARG,MF,27,1993,12.7,12,7,3,8,1,3,15,20.0,12,16,1,15,6,18,9,0,2021
ESP-La Liga,2020,Elche,Fidel,ESP,"MF,DF",30,1989,26.6,46,30,28,15,3,25,64,39.1,39,22,2,20,16,62,14,0,2021
ESP-La Liga,2020,Elche,Gonzalo Verdú,ESP,DF,31,1988,32.7,34,19,26,8,0,16,28,57.1,12,40,30,10,52,86,113,0,2021
ESP-La Liga,2020,Elche,Guido Carrillo,ARG,FW,29,1991,11.1,9,8,1,7,1,2,8,25.0,6,2,1,1,4,13,14,0,2021
ESP-La Liga,2020,Elche,Helibelton Palacios,COL,DF,27,1993,8.3,20,10,16,3,1,8,13,61.5,5,9,1,8,5,25,21,0,2021
ESP-La Liga,2020,Elche,Iván Marcone,ARG,MF,30,1990,29.4,64,41,42,17,5,35,84,41.7,49,27,8,19,36,100,33,3,2021
ESP-La Liga,2020,Elche,Jeison Lucumí,COL,MF,25,1995,0.5,1,1,0,1,0,0,0,,0,1,0,1,0,1,0,0,2021
ESP-La Liga,2020,Elche,Johan Mojica,COL,DF,27,1992,13.4,21,10,15,5,1,8,18,44.4,10,15,4,11,15,36,27,0,2021
ESP-La Liga,2020,Elche,John Donald,ESP,"DF,MF",19,2000,0.6,0,0,0,0,0,0,0,,0,0,0,0,0,0,1,0,2021
ESP-La Liga,2020,Elche,Jony Álamo,ESP,MF,18,2001,0.8,2,1,1,0,1,0,1,0.0,1,0,0,0,1,3,0,0,2021
ESP-La Liga,2020,Elche,Josan,ESP,"MF,DF",30,1989,21.4,34,18,23,11,0,13,39,33.3,26,24,1,23,21,55,26,1,2021
ESP-La Liga,2020,Elche,Josema,ESP,DF,24,1996,21.8,43,28,33,10,0,10,18,55.6,8,17,7,10,37,80,92,0,2021
ESP-La Liga,2020,Elche,Juan Sánchez Miño,ARG,"DF,MF",30,1990,5.5,8,5,5,3,0,6,14,42.9,8,4,0,4,4,12,7,0,2021
ESP-La Liga,2020,Elche,Lucas Boyé,ARG,FW,24,1996,29.9,47,31,13,27,7,10,49,20.4,39,37,2,35,19,66,21,0,2021
ESP-La Liga,2020,Elche,Luismi,ESP,"MF,DF",28,1992,1.9,4,2,1,3,0,1,2,50.0,1,2,0,2,4,8,0,0,2021
ESP-La Liga,2020,Elche,Nino,ESP,"FW,MF",40,1980,3.2,0,0,0,0,0,0,1,0.0,1,1,0,1,0,0,0,0,2021
ESP-La Liga,2020,Elche,Omenuke Mfulu,COD,MF,26,1994,8.8,18,12,10,8,0,5,15,33.3,10,7,1,6,11,29,18,0,2021
ESP-La Liga,2020,Elche,Pablo Piatti,ARG,"MF,FW",31,1989,4.0,8,6,3,3,2,3,12,25.0,9,5,0,5,2,10,1,0,2021
ESP-La Liga,2020,Elche,Paulo Gazzaniga,ARG,GK,28,1992,8.0,1,1,1,0,0,0,0,,0,0,0,0,1,2,4,0,2021
ESP-La Liga,2020,Elche,Pere Milla,ESP,"FW,MF",27,1992,22.0,24,17,12,10,2,8,37,21.6,29,17,5,12,13,37,17,1,2021
ESP-La Liga,2020,Elche,Ramón Folch,ESP,MF,30,1989,0.0,0,0,0,0,0,0,0,,0,0,0,0,0,0,0,0,2021
ESP-La Liga,2020,Elche,Raúl Guti,ESP,MF,23,1996,31.8,48,28,21,22,5,16,52,30.8,36,25,3,22,49,97,25,0,2021
ESP-La Liga,2020,Elche,Tete Morente,ESP,"MF,FW",23,1996,22.4,31,17,17,9,5,9,39,23.1,30,20,0,20,13,44,28,0,2021
ESP-La Liga,2020,Elche,Víctor Rodríguez,ESP,MF,31,1989,4.7,4,3,3,1,0,0,9,0.0,9,5,1,4,5,9,4,0,2021
ESP-La Liga,2020,Elche,Youssouf Koné,MLI,"DF,MF",25,1995,0.8,2,0,1,0,1,0,1,0.0,1,0,0,0,0,2,0,0,2021
ESP-La Liga,2020,Elche,Édgar Badía,ESP,GK,28,1992,30.0,1,0,1,0,0,1,3,33.3,2,0,0,0,0,1,17,3,2021
ESP-La Liga,2020,Getafe,Abdoulay Diaby,MLI,DF,29,1991,0.2,2,0,0,2,0,0,0,,0,2,0,2,0,2,0,0,2021
ESP-La Liga,2020,Getafe,Allan Nyom,CMR,"MF,DF",32,1988,25.8,38,23,14,19,5,15,30,50.0,15,16,2,14,22,60,42,0,2021
ESP-La Liga,2020,Getafe,Ante Palaversa,CRO,MF,20,2000,0.1,0,0,0,0,0,0,1,0.0,1,0,0,0,0,0,0,0,2021
ESP-La Liga,2020,Getafe,Carles Aleñá,ESP,"MF,FW",22,1998,15.2,15,10,3,9,3,7,25,28.0,18,14,1,13,2,17,2,0,2021
ESP-La Liga,2020,Getafe,Chema,ESP,"DF,MF",28,1992,6.2,11,5,6,5,0,5,7,71.4,2,1,0,1,10,21,23,0,2021
ESP-La Liga,2020,Getafe,Cucho,COL,"FW,MF",21,1999,16.3,19,10,1,14,4,2,23,8.7,21,18,1,17,6,25,8,0,2021
ESP-La Liga,2020,Getafe,Damián Suárez,URU,DF,32,1988,27.0,59,39,29,23,7,30,81,37.0,51,43,2,41,31,90,42,0,2021
ESP-La Liga,2020,Getafe,Darío Poveda,ESP,FW,23,1997,0.1,0,0,0,0,0,0,0,,0,1,0,1,0,0,0,0,2021
ESP-La Liga,2020,Getafe,David Soria,ESP,GK,27,1993,28.0,2,2,2,0,0,1,3,33.3,2,0,0,0,1,3,12,0,2021
ESP-La Liga,2020,Getafe,David Timor,ESP,"MF,DF",30,1989,15.5,13,9,5,6,2,9,21,42.9,12,5,1,4,19,32,32,1,2021
ESP-La Liga,2020,Getafe,Djené,TOG,DF,28,1991,32.7,61,39,31,26,4,26,34,76.5,8,24,11,13,42,103,96,0,2021
ESP-La Liga,2020,Getafe,Emmanuel Amankwaa Akurugu,GHA,DF,18,2001,0.5,0,0,0,0,0,0,1,0.0,1,1,0,1,2,2,1,0,2021
ESP-La Liga,2020,Getafe,Enes Ünal,TUR,FW,23,1997,14.6,11,3,0,8,3,4,15,26.7,11,11,0,11,2,13,14,0,2021
ESP-La Liga,2020,Getafe,Erick Cabaco,URU,DF,25,1995,14.7,24,14,11,12,1,12,22,54.5,10,8,6,2,13,37,51,1,2021
ESP-La Liga,2020,Getafe,Francisco Portillo,ESP,"MF,FW",30,1990,4.6,5,3,1,4,0,2,14,14.3,12,3,0,3,5,10,1,0,2021
ESP-La Liga,2020,Getafe,Iglesias,ESP,"DF,MF",22,1998,6.7,27,15,14,10,3,11,19,57.9,8,11,1,10,17,44,19,0,2021
ESP-La Liga,2020,Getafe,Jaime Mata,ESP,FW,31,1988,22.6,12,7,1,3,8,3,18,16.7,15,13,2,11,6,18,16,0,2021
ESP-La Liga,2020,Getafe,John Joe,IRL,"MF,FW",16,2003,0.7,2,0,0,2,0,0,0,,0,0,0,0,0,2,0,0,2021
ESP-La Liga,2020,Getafe,José Antonio Miranda,EQG,"MF,DF",22,1998,0.3,0,0,0,0,0,0,1,0.0,1,1,0,1,0,0,0,0,2021
ESP-La Liga,2020,Getafe,Mamor Niang,SEN,"MF,FW",18,2002,0.2,1,1,0,1,0,0,0,,0,1,0,1,0,1,0,0,2021
ESP-La Liga,2020,Getafe,Marc Cucurella,ESP,MF,22,1998,36.0,64,51,19,40,5,25,66,37.9,41,45,4,41,40,104,27,0,2021
ESP-La Liga,2020,Getafe,Mathías Olivera,URU,DF,22,1997,29.0,61,33,31,21,9,32,56,57.1,24,33,3,30,31,92,55,0,2021
ESP-La Liga,2020,Getafe,Mauro Arambarri,URU,MF,24,1995,33.1,64,39,22,35,7,23,80,28.8,57,40,5,35,42,106,28,0,2021
ESP-La Liga,2020,Getafe,Nemanja Maksimović,SRB,MF,25,1995,30.3,50,28,22,24,4,19,46,41.3,27,40,9,31,57,107,46,1,2021
ESP-La Liga,2020,Getafe,Rubén Yáñez,ESP,GK,26,1993,10.0,0,0,0,0,0,0,1,0.0,1,0,0,0,2,2,2,0,2021
ESP-La Liga,2020,Getafe,Sabit Abdulai,GHA,MF,21,1999,0.7,2,0,1,1,0,1,3,33.3,2,0,0,0,0,2,0,0,2021
ESP-La Liga,2020,Getafe,Sofian Chakla,MAR,DF,26,1993,10.0,12,8,10,1,1,5,7,71.4,2,3,2,1,14,26,48,1,2021
ESP-La Liga,2020,Getafe,Takefusa Kubo,JPN,"MF,FW",19,2001,8.9,7,4,2,3,2,1,14,7.1,13,14,0,14,14,21,4,0,2021
ESP-La Liga,2020,Getafe,Victor Mollejo,ESP,"MF,DF",19,2001,0.8,2,1,1,0,1,0,1,0.0,1,0,0,0,0,2,0,0,2021
ESP-La Liga,2020,Getafe,Xabier Etxeita,ESP,DF,32,1987,9.8,8,4,5,3,0,7,14,50.0,7,6,3,3,13,21,38,0,2021
ESP-La Liga,2020,Getafe,Ángel Rodríguez,ESP,"FW,MF",33,1987,15.3,7,4,1,4,2,1,16,6.3,15,7,0,7,2,9,8,0,2021
ESP-La Liga,2020,Granada,Aarón Escandell,ESP,GK,24,1995,5.0,1,1,1,0,0,1,1,100.0,0,0,0,0,0,1,6,0,2021
ESP-La Liga,2020,Granada,Adrián Marín,ESP,"DF,MF",23,1997,3.0,5,2,1,3,1,2,3,66.7,1,5,2,3,4,9,9,0,2021
ESP-La Liga,2020,Granada,Alberto Soro,ESP,"FW,MF",21,1999,4.4,7,2,2,4,1,4,10,40.0,6,7,0,7,1,8,2,0,2021
ESP-La Liga,2020,Granada,Antonio Puertas,ESP,"FW,MF",28,1992,24.1,27,13,9,12,6,10,32,31.3,22,24,5,19,12,39,25,0,2021
ESP-La Liga,2020,Granada,Barcia,ESP,DF,19,2000,1.0,1,1,1,0,0,0,0,,0,1,1,0,3,4,9,0,2021
ESP-La Liga,2020,Granada,Carlos Neva,ESP,DF,24,1996,20.0,12,6,6,6,0,6,11,54.5,5,16,4,12,27,39,58,0,2021
ESP-La Liga,2020,Granada,Dani Plomer,ESP,FW,21,1998,0.5,0,0,0,0,0,0,1,0.0,1,0,0,0,0,0,1,0,2021
ESP-La Liga,2020,Granada,Darwin Machís,VEN,"FW,MF",27,1993,22.5,30,17,12,10,8,6,19,31.6,13,21,2,19,22,52,13,0,2021
ESP-La Liga,2020,Granada,Dimitri Foulquier,FRA,DF,27,1993,29.6,35,21,20,12,3,15,26,57.7,11,24,7,17,26,61,60,0,2021
ESP-La Liga,2020,Granada,Domingos Duarte,POR,DF,25,1995,26.3,32,20,18,12,2,14,21,66.7,7,29,20,9,29,61,86,0,2021
ESP-La Liga,2020,Granada,Domingos Quina,POR,MF,20,1999,3.8,5,5,1,3,1,3,6,50.0,3,8,0,8,2,7,0,0,2021
ESP-La Liga,2020,Granada,Fede Vico,ESP,"MF,FW",26,1994,8.5,10,6,5,5,0,3,10,30.0,7,15,1,14,12,22,5,0,2021
ESP-La Liga,2020,Granada,Germán Sánchez,ESP,DF,33,1986,29.3,24,11,13,9,2,11,23,47.8,12,28,26,2,38,62,130,1,2021
ESP-La Liga,2020,Granada,Isma Ruiz,ESP,MF,19,2001,0.7,1,0,0,1,0,0,1,0.0,1,0,0,0,0,1,3,0,2021
ESP-La Liga,2020,Granada,Jesús Vallejo,ESP,DF,23,1997,15.0,11,6,7,3,1,7,18,38.9,11,21,11,10,13,24,55,0,2021
ESP-La Liga,2020,Granada,Jorge Molina,ESP,FW,38,1982,17.9,11,4,3,5,3,8,22,36.4,14,5,1,4,3,14,19,0,2021
ESP-La Liga,2020,Granada,Juan Brunet,ARG,MF,22,1998,0.3,0,0,0,0,0,0,0,,0,0,0,0,0,0,1,0,2021
ESP-La Liga,2020,Granada,Kenedy,BRA,"FW,MF",24,1996,16.3,22,12,10,7,5,5,25,20.0,20,21,4,17,26,48,15,1,2021
ESP-La Liga,2020,Granada,Kingsley Fobi,GHA,DF,21,1998,0.5,0,0,0,0,0,0,0,,0,0,0,0,1,1,1,0,2021
ESP-La Liga,2020,Granada,Luis Javier Suárez,COL,"FW,MF",22,1997,18.5,19,11,5,7,7,6,17,35.3,11,10,1,9,8,27,11,0,2021
ESP-La Liga,2020,Granada,Luis Milla,ESP,MF,25,1994,13.9,22,11,11,10,1,6,28,21.4,22,10,0,10,24,46,16,1,2021
ESP-La Liga,2020,Granada,Maxime Gonalons,FRA,MF,31,1989,16.4,53,37,18,33,2,15,37,40.5,22,17,0,17,25,78,21,1,2021
ESP-La Liga,2020,Granada,Nehuén Pérez,ARG,DF,20,2000,8.2,6,3,6,0,0,4,6,66.7,2,5,4,1,12,18,33,0,2021
ESP-La Liga,2020,Granada,Pepe,ESP,DF,20,2000,2.8,4,2,2,2,0,3,4,75.0,1,5,2,3,4,8,9,0,2021
ESP-La Liga,2020,Granada,Quini,ESP,DF,30,1989,13.2,33,22,23,7,3,19,36,52.8,17,15,6,9,15,48,39,0,2021
ESP-La Liga,2020,Granada,Ramon Azeez,NGA,MF,27,1992,1.1,1,1,0,1,0,0,0,,0,0,0,0,1,2,1,0,2021
ESP-La Liga,2020,Granada,Roberto Soldado,ESP,FW,35,1985,16.0,7,4,1,4,2,2,11,18.2,9,8,0,8,4,11,13,1,2021
ESP-La Liga,2020,Granada,Rui Silva,POR,GK,26,1994,32.0,1,0,1,0,0,1,3,33.3,2,0,0,0,2,3,14,0,2021
ESP-La Liga,2020,Granada,Víctor Díaz,ESP,DF,32,1988,9.2,21,10,13,6,2,10,19,52.6,9,14,8,6,16,37,39,0,2021
ESP-La Liga,2020,Granada,Yan Brice Eteki,CMR,MF,22,1997,14.7,23,15,10,12,1,8,19,42.1,11,13,3,10,13,36,16,1,2021
ESP-La Liga,2020,Granada,Yangel Herrera,VEN,MF,22,1998,25.7,59,26,19,32,8,11,41,26.8,30,53,17,36,26,85,32,1,2021
ESP-La Liga,2020,Granada,Álvaro Bravo,ESP,MF,22,1998,0.2,1,1,1,0,0,1,2,50.0,1,0,0,0,1,2,0,0,2021
ESP-La Liga,2020,Granada,Ángel,ESP,GK,18,2002,1.0,0,0,0,0,0,0,0,,0,0,0,0,0,0,1,0,2021
ESP-La Liga,2020,Granada,Ángel Montoro,ESP,MF,32,1988,15.1,15,9,7,7,1,4,16,25.0,12,13,3,10,22,37,21,0,2021
ESP-La Liga,2020,Huesca,Andrés Fernández,ESP,GK,33,1986,16.0,0,0,0,0,0,0,0,,0,0,0,0,0,0,3,2,2021
ESP-La Liga,2020,Huesca,Borja García,ESP,"MF,FW",29,1990,12.4,13,7,4,6,3,6,12,50.0,6,12,0,12,10,23,4,1,2021
ESP-La Liga,2020,Huesca,Dani Escriche,ESP,"FW,MF",22,1998,9.5,9,7,5,2,2,3,10,30.0,7,11,0,11,8,17,5,0,2021
ESP-La Liga,2020,Huesca,David Ferreiro,ESP,"MF,FW",32,1988,28.1,25,12,12,8,5,8,49,16.3,41,21,1,20,25,50,15,0,2021
ESP-La Liga,2020,Huesca,Denis Vavro,SVK,DF,24,1996,6.8,7,4,2,4,1,2,5,40.0,3,2,0,2,11,18,21,0,2021
ESP-La Liga,2020,Huesca,Dimitris Siovas,GRE,DF,31,1988,34.1,46,24,34,10,2,20,30,66.7,10,38,17,21,62,108,125,2,2021
ESP-La Liga,2020,Huesca,Eugeni Valderrama,ESP,"MF,FW",26,1994,1.3,2,2,1,0,1,0,1,0.0,1,0,0,0,5,7,3,0,2021
ESP-La Liga,2020,Huesca,Gastón Silva,URU,DF,26,1994,6.7,16,12,11,5,0,8,14,57.1,6,10,4,6,11,27,16,0,2021
ESP-La Liga,2020,Huesca,Idrissa Doumbia,CIV,MF,22,1998,8.7,15,8,6,7,2,5,13,38.5,8,6,3,3,7,22,9,0,2021
ESP-La Liga,2020,Huesca,Jaime Seoane,ESP,MF,23,1997,22.9,50,30,20,23,7,24,65,36.9,41,27,6,21,17,67,14,0,2021
ESP-La Liga,2020,Huesca,Javi Galán,ESP,DF,25,1994,34.1,88,54,47,35,6,46,72,63.9,26,30,4,26,39,127,61,0,2021
ESP-La Liga,2020,Huesca,Javier Ontiveros,ESP,"FW,MF",22,1997,10.2,21,14,10,10,1,9,26,34.6,17,12,0,12,9,30,6,0,2021
ESP-La Liga,2020,Huesca,Joaquín Muñoz,ESP,FW,21,1999,0.5,0,0,0,0,0,0,2,0.0,2,0,0,0,1,1,0,0,2021
ESP-La Liga,2020,Huesca,Jorge Pulido,ESP,DF,29,1991,32.1,39,24,31,8,0,17,29,58.6,12,32,18,14,52,91,98,0,2021
ESP-La Liga,2020,Huesca,Juan Carlos,ESP,"MF,FW",29,1991,3.2,5,3,4,1,0,2,15,13.3,13,7,0,7,1,6,1,0,2021
ESP-La Liga,2020,Huesca,Kelechi Nwakali,NGA,"MF,FW",22,1998,1.6,4,3,1,2,1,0,4,0.0,4,1,0,1,1,5,1,0,2021
ESP-La Liga,2020,Huesca,Luisinho,POR,DF,35,1985,2.0,3,3,2,1,0,1,3,33.3,2,3,0,3,4,7,7,0,2021
ESP-La Liga,2020,Huesca,Mikel Rico,ESP,MF,35,1984,24.3,24,12,14,8,2,11,34,32.4,23,20,3,17,23,47,22,0,2021
ESP-La Liga,2020,Huesca,Pablo Insua,ESP,DF,26,1993,17.6,37,18,26,9,2,14,31,45.2,17,14,8,6,24,61,68,0,2021
ESP-La Liga,2020,Huesca,Pablo Maffeo,ESP,DF,23,1997,21.8,26,17,21,4,1,12,26,46.2,14,18,6,12,35,61,27,0,2021
ESP-La Liga,2020,Huesca,Pedro López Muñoz,ESP,DF,36,1983,11.9,23,15,10,8,5,15,22,68.2,7,10,4,6,16,39,23,1,2021
ESP-La Liga,2020,Huesca,Pedro Mosquera,ESP,MF,32,1988,22.8,38,18,19,18,1,13,53,24.5,40,23,6,17,31,69,38,1,2021
ESP-La Liga,2020,Huesca,Rafa Mir,ESP,FW,23,1997,32.0,15,9,4,4,7,7,22,31.8,15,14,2,12,15,30,25,0,2021
ESP-La Liga,2020,Huesca,Sandro Ramírez,ESP,FW,25,1995,14.3,13,9,3,8,2,4,11,36.4,7,11,1,10,10,23,2,0,2021
ESP-La Liga,2020,Huesca,Sergio Gómez,ESP,"MF,FW",19,2000,8.8,29,10,17,9,3,11,22,50.0,11,15,0,15,14,43,9,0,2021
ESP-La Liga,2020,Huesca,Shinji Okazaki,JPN,"FW,MF",34,1986,12.5,7,5,5,0,2,0,5,0.0,5,5,0,5,4,11,6,0,2021
ESP-La Liga,2020,Huesca,Álvaro Fernández,ESP,GK,22,1998,22.0,1,1,0,1,0,1,3,33.3,2,0,0,0,2,3,7,0,2021
ESP-La Liga,2020,Levante,Aitor Fernández,ESP,GK,29,1991,29.0,0,0,0,0,0,0,0,,0,0,0,0,2,2,17,1,2021
ESP-La Liga,2020,Levante,Alejandro Blesa,ESP,MF,18,2002,0.1,0,0,0,0,0,0,0,,0,0,0,0,0,0,0,0,2021
ESP-La Liga,2020,Levante,Carlos Clerc,ESP,DF,28,1992,30.9,56,29,33,16,7,22,39,56.4,17,26,4,22,37,93,55,1,2021
ESP-La Liga,2020,Levante,Cheick Doukouré,CIV,"MF,FW",27,1992,1.1,5,4,2,1,2,3,4,75.0,1,2,0,2,3,8,0,0,2021
ESP-La Liga,2020,Levante,Coke,ESP,DF,33,1987,9.3,24,10,14,7,3,14,27,51.9,13,13,1,12,14,38,27,0,2021
ESP-La Liga,2020,Levante,Cárdenas,ESP,GK,23,1997,8.0,0,0,0,0,0,0,1,0.0,1,0,0,0,3,3,5,1,2021
ESP-La Liga,2020,Levante,Dani Gómez,ESP,FW,22,1998,18.5,4,3,2,1,1,0,11,0.0,11,3,0,3,2,6,4,0,2021
ESP-La Liga,2020,Levante,Edgar Sevikyan,RUS,MF,18,2001,0.1,0,0,0,0,0,0,0,,0,0,0,0,0,0,0,0,2021
ESP-La Liga,2020,Levante,Enis Bardhi,MKD,MF,25,1995,18.7,28,12,8,16,4,10,36,27.8,26,8,2,6,21,49,14,0,2021
ESP-La Liga,2020,Levante,Giorgi Kochorashvili,GEO,MF,21,1999,0.3,1,0,1,0,0,0,0,,0,0,0,0,0,1,0,0,2021
ESP-La Liga,2020,Levante,Gonzalo Melero,ESP,"MF,FW",26,1994,20.6,24,15,11,6,7,10,39,25.6,29,14,5,9,18,42,22,1,2021
ESP-La Liga,2020,Levante,Jorge Miramón,ESP,DF,31,1989,19.2,32,22,26,6,0,21,35,60.0,14,22,2,20,27,59,54,0,2021
ESP-La Liga,2020,Levante,Jorge de Frutos,ESP,MF,23,1997,24.3,48,24,21,21,6,11,41,26.8,30,25,2,23,16,64,18,0,2021
ESP-La Liga,2020,Levante,José Campaña,ESP,MF,27,1993,8.3,14,6,3,6,5,5,14,35.7,9,2,0,2,13,27,4,0,2021
ESP-La Liga,2020,Levante,José Luis Morales,ESP,"MF,FW",33,1987,27.1,18,10,7,9,2,8,36,22.2,28,17,0,17,11,29,11,0,2021
ESP-La Liga,2020,Levante,Koke Vegas,ESP,GK,24,1995,1.0,0,0,0,0,0,0,0,,0,0,0,0,0,0,1,1,2021
ESP-La Liga,2020,Levante,Mickael Malsa,MTQ,MF,24,1995,26.0,55,26,28,24,3,23,51,45.1,28,38,9,29,43,98,36,2,2021
ESP-La Liga,2020,Levante,Nemanja Radoja,SRB,MF,27,1993,12.5,23,15,12,10,1,5,19,26.3,14,9,3,6,19,42,12,1,2021
ESP-La Liga,2020,Levante,Nikola Vukčević,MNE,MF,28,1991,9.0,14,7,5,8,1,9,18,50.0,9,8,5,3,8,22,12,1,2021
ESP-La Liga,2020,Levante,Rober,ESP,"DF,MF",25,1995,15.8,14,7,8,3,3,8,18,44.4,10,24,16,8,35,49,52,1,2021
ESP-La Liga,2020,Levante,Roger Martí,ESP,FW,29,1991,24.4,11,7,5,4,2,6,23,26.1,17,10,3,7,4,15,6,0,2021
ESP-La Liga,2020,Levante,Rubén Rochina,ESP,MF,29,1991,15.6,38,28,12,23,3,12,35,34.3,23,22,2,20,22,60,7,0,2021
ESP-La Liga,2020,Levante,Rúben Vezo,POR,DF,26,1994,25.7,34,19,26,7,1,12,29,41.4,17,22,11,11,46,80,106,3,2021
ESP-La Liga,2020,Levante,Sergio León,ESP,FW,31,1989,8.3,6,2,0,4,2,2,8,25.0,6,4,0,4,3,9,2,0,2021
ESP-La Liga,2020,Levante,Sergio Postigo,ESP,DF,31,1988,18.0,16,12,12,3,1,7,18,38.9,11,21,10,11,33,49,84,1,2021
ESP-La Liga,2020,Levante,Son,ESP,"DF,MF",26,1994,12.3,18,10,11,6,1,9,19,47.4,10,11,2,9,12,30,20,0,2021
ESP-La Liga,2020,Levante,Toño,ESP,"DF,FW",30,1989,8.1,4,0,4,0,0,0,2,0.0,2,10,1,9,7,11,12,0,2021
ESP-La Liga,2020,Levante,Álex Cantero,ESP,FW,20,2000,2.6,2,1,0,2,0,1,2,50.0,1,1,0,1,0,2,3,0,2021
ESP-La Liga,2020,Levante,Óscar Duarte,CRC,DF,31,1989,22.9,22,13,17,5,0,10,18,55.6,8,23,15,8,36,58,97,1,2021
ESP-La Liga,2020,Osasuna,Adrián López,ESP,"FW,MF",32,1988,5.3,3,3,0,1,2,1,5,20.0,4,3,0,3,0,3,3,0,2021
ESP-La Liga,2020,Osasuna,Ante Budimir,CRO,FW,29,1991,18.1,20,12,2,11,7,4,15,26.7,11,17,4,13,2,22,17,1,2021
ESP-La Liga,2020,Osasuna,Aridane Hernández,EQG,DF,31,1989,22.5,20,11,13,6,1,7,12,58.3,5,22,19,3,34,54,127,1,2021
ESP-La Liga,2020,Osasuna,Darko Brašanac,SRB,MF,28,1992,10.1,10,6,6,4,0,5,16,31.3,11,8,1,7,7,17,10,0,2021
ESP-La Liga,2020,Osasuna,David García,ESP,DF,26,1994,35.0,26,17,13,13,0,13,24,54.2,11,36,19,17,59,85,171,0,2021
ESP-La Liga,2020,Osasuna,Enric Gallego,ESP,FW,33,1986,9.0,6,3,2,2,2,2,14,14.3,12,5,1,4,1,7,9,0,2021
ESP-La Liga,2020,Osasuna,Ezequiel Ávila,ARG,"FW,MF",26,1994,2.2,6,2,3,1,2,2,4,50.0,2,1,0,1,1,7,0,0,2021
ESP-La Liga,2020,Osasuna,Facundo Roncaglia,ARG,DF,33,1987,13.7,25,14,14,11,0,11,20,55.0,9,11,6,5,25,50,26,0,2021
ESP-La Liga,2020,Osasuna,Iñigo Pérez,ESP,"MF,DF",32,1988,15.0,20,10,9,6,5,10,16,62.5,6,12,0,12,15,35,8,1,2021
ESP-La Liga,2020,Osasuna,Javi Martínez,ESP,"MF,FW",20,1999,5.1,9,4,1,6,2,5,12,41.7,7,9,0,9,5,14,4,0,2021
ESP-La Liga,2020,Osasuna,Jon Moncayola,ESP,MF,22,1998,29.6,61,36,27,23,11,24,67,35.8,43,27,9,18,23,84,38,0,2021
ESP-La Liga,2020,Osasuna,Jonathan Calleri,ARG,FW,26,1993,17.2,15,6,2,4,9,3,17,17.6,14,18,2,16,1,16,10,1,2021
ESP-La Liga,2020,Osasuna,Jony,ESP,"MF,FW",29,1991,9.7,7,3,1,2,4,5,20,25.0,15,5,0,5,14,21,3,0,2021
ESP-La Liga,2020,Osasuna,Jonás Ramalho,ESP,DF,27,1993,3.4,5,4,4,0,1,1,3,33.3,2,3,0,3,2,7,7,0,2021
ESP-La Liga,2020,Osasuna,Juan Cruz Armada,ESP,DF,28,1992,21.8,36,22,17,16,3,19,35,54.3,16,19,5,14,15,51,50,0,2021
ESP-La Liga,2020,Osasuna,Juan Pérez,ESP,GK,24,1996,3.0,0,0,0,0,0,0,0,,0,0,0,0,0,0,1,0,2021
ESP-La Liga,2020,Osasuna,Kike Barja,ESP,"MF,FW",23,1997,15.9,10,5,6,1,3,5,24,20.8,19,10,1,9,16,26,8,0,2021
ESP-La Liga,2020,Osasuna,Lucas Torró,ESP,MF,26,1994,17.2,32,15,11,19,2,21,34,61.8,13,16,7,9,27,59,43,0,2021
ESP-La Liga,2020,Osasuna,Manuel Sánchez,ESP,DF,19,2000,10.8,27,15,10,10,7,11,25,44.0,14,8,0,8,8,35,14,0,2021
ESP-La Liga,2020,Osasuna,Marc Cardona,ESP,"FW,DF",25,1995,0.6,1,0,1,0,0,1,1,100.0,0,0,0,0,0,1,0,0,2021
ESP-La Liga,2020,Osasuna,Nacho Vidal,ESP,DF,25,1995,26.1,56,28,27,22,7,22,31,71.0,9,39,10,29,43,99,68,0,2021
ESP-La Liga,2020,Osasuna,Oier Sanjurjo,ESP,MF,34,1986,23.2,39,16,8,27,4,17,60,28.3,43,24,6,18,29,68,41,0,2021
ESP-La Liga,2020,Osasuna,Raúl Navas,ESP,DF,32,1988,1.9,6,3,5,1,0,4,6,66.7,2,0,0,0,3,9,13,0,2021
ESP-La Liga,2020,Osasuna,Roberto Torres,ESP,"MF,FW",31,1989,21.0,15,8,6,5,4,8,29,27.6,21,12,0,12,16,31,13,0,2021
ESP-La Liga,2020,Osasuna,Rubén,ESP,GK,36,1984,2.1,0,0,0,0,0,0,0,,0,0,0,0,0,0,1,0,2021
ESP-La Liga,2020,Osasuna,Rubén García,ESP,"MF,FW",27,1993,30.2,50,29,21,22,7,14,45,31.1,31,28,2,26,29,79,20,0,2021
ESP-La Liga,2020,Osasuna,Sergio Herrera,ESP,GK,27,1993,32.9,0,0,0,0,0,0,2,0.0,2,0,0,0,3,3,29,3,2021
ESP-La Liga,2020,Osasuna,Unai García,ESP,DF,28,1992,13.8,19,9,14,4,1,9,15,60.0,6,16,8,8,14,33,40,0,2021
ESP-La Liga,2020,Real Madrid,Blanco,ESP,"MF,FW",20,2000,2.4,7,2,4,2,1,3,7,42.9,4,6,2,4,3,10,5,0,2021
ESP-La Liga,2020,Real Madrid,Borja Mayoral,ESP,FW,23,1997,0.3,0,0,0,0,0,0,1,0.0,1,0,0,0,0,0,0,0,2021
ESP-La Liga,2020,Real Madrid,Casemiro,BRA,MF,28,1992,32.2,84,49,50,30,4,33,73,45.2,40,50,17,33,70,154,62,0,2021
ESP-La Liga,2020,Real Madrid,Dani Carvajal,ESP,DF,28,1992,10.6,27,20,12,10,5,11,20,55.0,9,19,1,18,13,40,27,0,2021
ESP-La Liga,2020,Real Madrid,Eden Hazard,BEL,"FW,MF",29,1991,5.9,3,2,1,2,0,0,3,0.0,3,3,0,3,3,6,0,0,2021
ESP-La Liga,2020,Real Madrid,Federico Valverde,URU,MF,22,1998,14.8,25,16,9,8,8,10,26,38.5,16,16,2,14,22,47,4,0,2021
ESP-La Liga,2020,Real Madrid,Ferland Mendy,FRA,DF,25,1995,24.5,26,16,17,6,3,12,24,50.0,12,16,4,12,26,52,32,1,2021
ESP-La Liga,2020,Real Madrid,Hugo Duro,ESP,FW,20,1999,0.6,0,0,0,0,0,0,0,,0,1,0,1,0,0,0,0,2021
ESP-La Liga,2020,Real Madrid,Isco,ESP,MF,28,1992,10.1,13,9,5,5,3,2,14,14.3,12,7,1,6,2,15,2,0,2021
ESP-La Liga,2020,Real Madrid,Karim Benzema,FRA,FW,32,1987,32.2,8,6,4,2,2,5,15,33.3,10,9,2,7,8,16,24,0,2021
ESP-La Liga,2020,Real Madrid,Lucas Vázquez,ESP,"DF,FW",29,1991,20.5,61,37,30,22,9,22,52,42.3,30,14,1,13,19,80,31,1,2021
ESP-La Liga,2020,Real Madrid,Luka Jović,SRB,FW,22,1997,1.7,0,0,0,0,0,0,0,,0,0,0,0,0,0,0,0,2021
ESP-La Liga,2020,Real Madrid,Luka Modrić,CRO,MF,34,1985,30.4,37,23,18,16,3,13,36,36.1,23,14,2,12,48,85,14,1,2021
ESP-La Liga,2020,Real Madrid,Marcelo,BRA,"DF,MF",32,1988,11.7,25,21,11,6,8,11,24,45.8,13,13,1,12,10,35,15,0,2021
ESP-La Liga,2020,Real Madrid,Marco Asensio,ESP,"FW,MF",24,1996,20.8,12,6,7,4,1,3,24,12.5,21,15,0,15,11,23,10,0,2021
ESP-La Liga,2020,Real Madrid,Mariano,DOM,FW,26,1993,5.7,4,2,2,1,1,0,9,0.0,9,3,1,2,0,4,3,0,2021
ESP-La Liga,2020,Real Madrid,Martin Ødegaard,NOR,MF,21,1998,2.6,1,0,0,1,0,1,2,50.0,1,1,0,1,1,2,0,0,2021
ESP-La Liga,2020,Real Madrid,Marvin,ESP,"DF,MF",20,2000,1.5,3,2,0,3,0,1,2,50.0,1,1,0,1,2,5,3,0,2021
ESP-La Liga,2020,Real Madrid,Miguel Gutiérrez,ESP,DF,19,2001,3.5,4,0,0,3,1,1,7,14.3,6,3,0,3,5,9,5,0,2021
ESP-La Liga,2020,Real Madrid,Nacho,ESP,DF,30,1990,22.2,27,14,13,11,3,12,35,34.3,23,19,9,10,40,67,58,0,2021
ESP-La Liga,2020,Real Madrid,Raphaël Varane,FRA,DF,27,1993,30.2,22,14,16,5,1,10,19,52.6,9,26,18,8,36,58,114,2,2021
ESP-La Liga,2020,Real Madrid,Rodrygo,BRA,FW,19,2001,10.9,15,6,10,4,1,2,17,11.8,15,15,0,15,7,22,4,0,2021
ESP-La Liga,2020,Real Madrid,Sergio Arribas,ESP,"MF,FW",18,2001,1.5,3,1,2,1,0,1,3,33.3,2,2,0,2,4,7,2,0,2021
ESP-La Liga,2020,Real Madrid,Sergio Ramos,ESP,DF,34,1986,14.2,15,12,8,6,1,6,10,60.0,4,9,5,4,19,34,39,1,2021
ESP-La Liga,2020,Real Madrid,Thibaut Courtois,BEL,GK,28,1992,38.0,0,0,0,0,0,0,1,0.0,1,1,0,1,1,1,17,2,2021
ESP-La Liga,2020,Real Madrid,Toni Kroos,GER,MF,30,1990,23.5,42,22,15,15,12,11,44,25.0,33,26,6,20,15,57,10,3,2021
ESP-La Liga,2020,Real Madrid,Vinicius Júnior,BRA,FW,20,2000,21.9,32,22,14,10,8,11,43,25.6,32,28,0,28,7,39,4,0,2021
ESP-La Liga,2020,Real Madrid,Víctor Chust,ESP,DF,20,2000,1.1,1,1,0,1,0,0,2,0.0,2,2,2,0,1,2,5,0,2021
ESP-La Liga,2020,Real Madrid,Álvaro Odriozola,ESP,DF,24,1995,9.2,14,7,5,8,1,3,5,60.0,2,6,3,3,6,20,12,1,2021
ESP-La Liga,2020,Real Madrid,Éder Militão,BRA,DF,22,1998,12.6,20,8,13,6,1,8,14,57.1,6,19,6,13,19,39,42,0,2021
ESP-La Liga,2020,Real Sociedad,Adnan Januzaj,BEL,"FW,MF",25,1995,11.3,9,8,0,6,3,3,8,37.5,5,7,2,5,3,12,4,0,2021
ESP-La Liga,2020,Real Sociedad,Aihen Muñoz,ESP,DF,22,1997,13.4,23,16,15,5,3,11,19,57.9,8,12,2,10,10,33,31,0,2021
ESP-La Liga,2020,Real Sociedad,Alexander Isak,SWE,FW,20,1999,26.0,9,5,0,3,6,3,8,37.5,5,17,1,16,3,12,7,0,2021
ESP-La Liga,2020,Real Sociedad,Ander Barrenetxea,ESP,"MF,FW",18,2001,14.5,29,19,5,18,6,9,24,37.5,15,20,0,20,6,35,8,0,2021
ESP-La Liga,2020,Real Sociedad,Ander Guevara,ESP,MF,23,1997,23.1,35,23,15,16,4,15,30,50.0,15,19,5,14,25,60,35,1,2021
ESP-La Liga,2020,Real Sociedad,Andoni Gorosabel,ESP,DF,23,1996,26.5,76,43,45,20,11,27,64,42.2,37,25,4,21,23,99,42,0,2021
ESP-La Liga,2020,Real Sociedad,Aritz Arambarri,ESP,DF,22,1998,0.3,1,1,0,1,0,1,2,50.0,1,0,0,0,0,1,0,0,2021
ESP-La Liga,2020,Real Sociedad,Aritz Elustondo,ESP,DF,26,1994,20.9,30,16,21,7,2,18,22,81.8,4,12,5,7,15,45,63,0,2021
ESP-La Liga,2020,Real Sociedad,Asier Illarramendi,ESP,MF,30,1990,3.7,5,2,1,4,0,1,5,20.0,4,2,0,2,5,10,7,0,2021
ESP-La Liga,2020,Real Sociedad,Carlos Fernández,ESP,"FW,MF",24,1996,4.3,3,2,0,2,1,1,8,12.5,7,6,1,5,0,3,6,0,2021
ESP-La Liga,2020,Real Sociedad,David Silva,ESP,MF,34,1986,15.5,19,12,2,14,3,8,21,38.1,13,14,1,13,13,32,8,2,2021
ESP-La Liga,2020,Real Sociedad,Diego Llorente,ESP,DF,26,1993,1.0,1,0,1,0,0,1,2,50.0,1,1,1,0,2,3,5,0,2021
ESP-La Liga,2020,Real Sociedad,Igor Zubeldia,ESP,DF,23,1997,21.8,23,16,15,8,0,8,14,57.1,6,20,13,7,12,35,46,0,2021
ESP-La Liga,2020,Real Sociedad,Jon Bautista,ESP,FW,25,1995,4.1,5,3,0,2,3,0,3,0.0,3,3,1,2,2,7,4,0,2021
ESP-La Liga,2020,Real Sociedad,Jon Guridi,ESP,MF,25,1995,9.2,19,9,10,6,3,8,22,36.4,14,8,1,7,10,29,9,0,2021
ESP-La Liga,2020,Real Sociedad,Jon Pacheco,ESP,DF,19,2001,0.4,0,0,0,0,0,0,0,,0,0,0,0,1,1,0,0,2021
ESP-La Liga,2020,Real Sociedad,Joseba Zaldúa,ESP,DF,28,1992,7.1,15,12,7,5,3,6,18,33.3,12,6,2,4,6,21,13,0,2021
ESP-La Liga,2020,Real Sociedad,Martín Merquelanz,ESP,"MF,FW",25,1995,6.1,9,3,3,2,4,2,7,28.6,5,7,1,6,3,12,4,0,2021
ESP-La Liga,2020,Real Sociedad,Martín Zubimendi,ESP,MF,21,1999,20.9,41,22,18,20,3,20,34,58.8,14,22,10,12,40,81,39,0,2021
ESP-La Liga,2020,Real Sociedad,Mikel Merino,ESP,MF,24,1996,23.9,61,36,14,36,11,18,45,40.0,27,36,8,28,32,93,26,0,2021
ESP-La Liga,2020,Real Sociedad,Mikel Oyarzabal,ESP,"FW,MF",23,1997,26.8,30,17,14,12,4,10,31,32.3,21,30,5,25,15,45,17,0,2021
ESP-La Liga,2020,Real Sociedad,Modibo Sagnan,FRA,DF,21,1999,6.9,12,7,6,6,0,4,6,66.7,2,7,2,5,6,18,25,1,2021
ESP-La Liga,2020,Real Sociedad,Nacho Monreal,ESP,DF,34,1986,23.1,31,19,17,11,3,7,20,35.0,13,14,3,11,31,62,43,0,2021
ESP-La Liga,2020,Real Sociedad,Portu,ESP,"FW,MF",28,1992,24.3,18,8,4,10,4,7,36,19.4,29,24,2,22,8,26,5,0,2021
ESP-La Liga,2020,Real Sociedad,Roberto López,ESP,"MF,FW",20,2000,5.6,5,1,1,2,2,2,5,40.0,3,2,0,2,4,9,6,0,2021
ESP-La Liga,2020,Real Sociedad,Roberto Navarro,ESP,MF,18,2002,0.4,1,1,1,0,0,0,2,0.0,2,0,0,0,1,2,0,0,2021
ESP-La Liga,2020,Real Sociedad,Robin Le Normand,ESP,DF,23,1996,30.5,34,20,25,8,1,9,19,47.4,10,35,24,11,36,70,87,1,2021
ESP-La Liga,2020,Real Sociedad,Urko González,ESP,MF,19,2001,0.5,0,0,0,0,0,0,1,0.0,1,1,1,0,0,0,1,0,2021
ESP-La Liga,2020,Real Sociedad,Willian José,BRA,FW,28,1991,7.7,3,1,0,3,0,1,3,33.3,2,3,1,2,0,3,8,0,2021
ESP-La Liga,2020,Real Sociedad,Álex Remiro,ESP,GK,25,1995,38.0,0,0,0,0,0,0,1,0.0,1,0,0,0,3,3,14,0,2021
ESP-La Liga,2020,Sevilla,Aleix Vidal,ESP,DF,30,1989,6.6,9,5,5,3,1,5,12,41.7,7,10,1,9,12,21,9,0,2021
ESP-La Liga,2020,Sevilla,Bryan,ESP,FW,19,2001,0.1,1,1,0,1,0,0,0,,0,0,0,0,0,1,0,0,2021
ESP-La Liga,2020,Sevilla,Carlos Fernández,ESP,FW,24,1996,1.6,1,0,1,0,0,0,2,0.0,2,3,1,2,1,2,0,0,2021
ESP-La Liga,2020,Sevilla,Diego Carlos,BRA,DF,27,1993,31.0,22,13,17,4,1,8,16,50.0,8,35,27,8,31,53,114,1,2021
ESP-La Liga,2020,Sevilla,Fernando,BRA,MF,33,1987,28.3,54,28,24,25,5,23,43,53.5,20,25,11,14,41,95,70,0,2021
ESP-La Liga,2020,Sevilla,Franco Vázquez,ARG,"FW,MF",31,1989,1.8,5,1,0,3,2,1,5,20.0,4,2,1,1,1,6,1,0,2021
ESP-La Liga,2020,Sevilla,Ivan Rakitić,CRO,MF,32,1988,24.8,32,18,18,10,4,12,41,29.3,29,19,4,15,26,58,29,1,2021
ESP-La Liga,2020,Sevilla,Jesús Navas,ESP,DF,34,1985,31.4,27,21,15,11,1,15,22,68.2,7,10,3,7,37,64,62,1,2021
ESP-La Liga,2020,Sevilla,Joan Jordán,ESP,MF,26,1994,26.7,52,28,17,29,6,17,76,22.4,59,22,3,19,27,79,25,0,2021
ESP-La Liga,2020,Sevilla,Jules Koundé,FRA,DF,21,1998,33.1,27,15,14,11,2,10,24,41.7,14,24,16,8,40,67,104,0,2021
ESP-La Liga,2020,Sevilla,Karim Rekik,NED,DF,25,1994,7.3,7,5,2,5,0,1,4,25.0,3,8,3,5,6,13,17,0,2021
ESP-La Liga,2020,Sevilla,Lucas Ocampos,ARG,FW,26,1994,29.2,36,24,12,16,8,13,37,35.1,24,33,1,32,19,55,30,1,2021
ESP-La Liga,2020,Sevilla,Luuk de Jong,NED,FW,29,1990,14.1,9,5,3,2,4,1,7,14.3,6,11,3,8,5,14,15,0,2021
ESP-La Liga,2020,Sevilla,Marcos Acuña,ARG,DF,28,1991,25.9,62,42,34,20,8,23,41,56.1,18,23,2,21,23,85,30,1,2021
ESP-La Liga,2020,Sevilla,Munir El Haddadi,MAR,FW,24,1995,9.4,12,8,5,5,2,2,12,16.7,10,6,0,6,5,17,6,0,2021
ESP-La Liga,2020,Sevilla,Nemanja Gudelj,SRB,"MF,DF",28,1991,11.6,23,12,16,5,2,4,10,40.0,6,10,6,4,24,47,24,2,2021
ESP-La Liga,2020,Sevilla,Oussama Idrissi,MAR,"FW,MF",24,1996,0.3,1,1,0,1,0,1,2,50.0,1,2,0,2,1,2,0,0,2021
ESP-La Liga,2020,Sevilla,Papu Gómez,ARG,"MF,FW",32,1988,10.2,9,6,2,4,3,2,12,16.7,10,13,2,11,7,16,6,0,2021
ESP-La Liga,2020,Sevilla,Sergi Gómez,ESP,DF,28,1992,8.0,4,3,2,2,0,1,1,100.0,0,5,4,1,6,10,34,0,2021
ESP-La Liga,2020,Sevilla,Sergio Escudero,ESP,DF,30,1989,6.3,12,8,6,5,1,6,12,50.0,6,5,2,3,9,21,7,0,2021
ESP-La Liga,2020,Sevilla,Suso,ESP,FW,26,1993,24.6,20,10,8,6,6,10,41,24.4,31,12,0,12,8,28,8,0,2021
ESP-La Liga,2020,Sevilla,Tomáš Vaclík,CZE,GK,31,1989,5.0,0,0,0,0,0,0,1,0.0,1,0,0,0,0,0,0,1,2021
ESP-La Liga,2020,Sevilla,Yassine Bounou,MAR,GK,29,1991,33.0,1,1,1,0,0,0,2,0.0,2,0,0,0,0,1,12,2,2021
ESP-La Liga,2020,Sevilla,Youssef En-Nesyri,MAR,FW,23,1997,25.7,17,11,2,9,6,4,21,19.0,17,15,0,15,8,25,23,0,2021
ESP-La Liga,2020,Sevilla,Óliver Torres,ESP,"MF,FW",25,1994,15.6,34,22,13,15,6,19,53,35.8,34,15,0,15,15,49,9,0,2021
ESP-La Liga,2020,Sevilla,Óscar Rodríguez Arnaiz,ESP,"MF,FW",22,1998,5.7,15,9,3,8,4,6,13,46.2,7,2,0,2,10,25,1,0,2021
ESP-La Liga,2020,Valencia,Alejandro Blanco,ESP,MF,21,1998,6.4,8,4,4,4,0,3,18,16.7,15,5,0,5,8,16,9,0,2021
ESP-La Liga,2020,Valencia,Carlos Soler,ESP,MF,23,1997,30.4,41,24,14,24,3,19,52,36.5,33,35,11,24,23,64,41,0,2021
ESP-La Liga,2020,Valencia,Christian Oliva,URU,MF,24,1996,2.2,2,0,1,1,0,1,6,16.7,5,1,0,1,6,8,0,0,2021
ESP-La Liga,2020,Valencia,Cristiano Piccini,ITA,DF,27,1992,0.7,1,1,1,0,0,1,2,50.0,1,0,0,0,0,1,3,0,2021
ESP-La Liga,2020,Valencia,Daniel Wass,DEN,"MF,DF",31,1989,33.1,52,31,21,29,2,22,55,40.0,33,33,13,20,47,99,69,0,2021
ESP-La Liga,2020,Valencia,Denis Cheryshev,RUS,MF,29,1990,12.2,19,15,6,7,6,6,26,23.1,20,15,1,14,12,31,15,0,2021
ESP-La Liga,2020,Valencia,Eliaquim Mangala,FRA,DF,29,1991,3.6,0,0,0,0,0,0,1,0.0,1,8,6,2,6,6,12,0,2021
ESP-La Liga,2020,Valencia,Francisco Reis Ferreira,POR,DF,23,1997,2.0,1,1,1,0,0,0,3,0.0,3,0,0,0,0,1,6,0,2021
ESP-La Liga,2020,Valencia,Gabriel Paulista,BRA,DF,29,1990,30.2,17,11,9,5,3,6,17,35.3,11,32,27,5,59,76,132,3,2021
ESP-La Liga,2020,Valencia,Geoffrey Kondogbia,CTA,MF,27,1993,4.9,16,9,9,4,3,7,19,36.8,12,6,1,5,8,24,8,0,2021
ESP-La Liga,2020,Valencia,Gonçalo Guedes,POR,"MF,FW",23,1996,25.4,18,12,8,7,3,10,45,22.2,35,24,1,23,8,26,7,0,2021
ESP-La Liga,2020,Valencia,Guillem Molina,ESP,DF,20,2000,1.7,1,0,1,0,0,0,5,0.0,5,1,1,0,4,5,5,0,2021
ESP-La Liga,2020,Valencia,Hugo Guillamón,ESP,DF,20,2000,22.1,23,13,17,6,0,8,20,40.0,12,19,14,5,27,50,102,3,2021
ESP-La Liga,2020,Valencia,Jason,ESP,"MF,DF",26,1994,4.9,9,3,5,2,2,4,16,25.0,12,6,1,5,10,19,4,0,2021
ESP-La Liga,2020,Valencia,Jasper Cillessen,NED,GK,31,1989,10.0,0,0,0,0,0,0,0,,0,0,0,0,0,0,0,0,2021
ESP-La Liga,2020,Valencia,Jaume Doménech,ESP,GK,29,1990,28.0,1,1,1,0,0,1,2,50.0,1,1,0,1,0,1,16,2,2021
ESP-La Liga,2020,Valencia,José Luis Gayà,ESP,DF,25,1995,31.6,59,33,40,13,6,33,68,48.5,35,22,3,19,38,97,62,1,2021
ESP-La Liga,2020,Valencia,Koba Koindredi,FRA,MF,18,2001,0.2,1,1,1,0,0,0,1,0.0,1,0,0,0,0,1,0,0,2021
ESP-La Liga,2020,Valencia,Kévin Gameiro,FRA,FW,33,1987,12.0,7,4,3,2,2,3,11,27.3,8,10,0,10,0,7,3,0,2021
ESP-La Liga,2020,Valencia,Lee Kangin,KOR,"FW,MF",19,2001,14.0,15,11,8,4,3,3,31,9.7,28,12,0,12,2,17,0,0,2021
ESP-La Liga,2020,Valencia,Manu Vallejo,ESP,"FW,MF",23,1997,10.6,18,8,5,8,5,5,26,19.2,21,8,0,8,3,21,3,0,2021
ESP-La Liga,2020,Valencia,Maxi Gómez,URU,FW,23,1996,29.9,11,9,3,7,1,3,14,21.4,11,13,3,10,2,13,34,0,2021
ESP-La Liga,2020,Valencia,Mouctar Diakhaby,GUI,DF,23,1996,23.1,16,8,10,6,0,8,12,66.7,4,28,21,7,27,43,102,1,2021
ESP-La Liga,2020,Valencia,Patrick Cutrone,ITA,FW,22,1998,1.2,0,0,0,0,0,0,1,0.0,1,0,0,0,1,1,0,0,2021
ESP-La Liga,2020,Valencia,Rubén Sobrino,ESP,"MF,FW",28,1992,0.5,1,1,1,0,0,0,1,0.0,1,0,0,0,0,1,1,0,2021
ESP-La Liga,2020,Valencia,Thierry Correia,POR,DF,21,1999,23.7,47,27,32,10,5,21,43,48.8,22,24,6,18,42,89,63,1,2021
ESP-La Liga,2020,Valencia,Toni Lato,ESP,DF,22,1997,8.1,13,6,7,3,3,6,13,46.2,7,12,1,11,10,23,21,0,2021
ESP-La Liga,2020,Valencia,Uroš Račić,SRB,MF,22,1998,24.3,38,22,16,16,6,16,54,29.6,38,33,11,22,26,64,54,0,2021
ESP-La Liga,2020,Valencia,Vicente Esquerdo,ESP,MF,21,1999,2.6,7,4,5,2,0,4,6,66.7,2,4,2,2,8,15,1,0,2021
ESP-La Liga,2020,Valencia,Yunus Musah,USA,MF,17,2002,17.0,21,18,12,3,6,8,24,33.3,16,20,0,20,15,36,12,1,2021
ESP-La Liga,2020,Valladolid,Bruno González,ESP,DF,30,1990,25.1,26,17,18,8,0,17,31,54.8,14,22,14,8,37,63,112,1,2021
ESP-La Liga,2020,Valladolid,Fabián Orellana,CHI,"MF,FW",34,1986,23.8,33,19,12,14,7,12,55,21.8,43,18,0,18,15,48,9,0,2021
ESP-La Liga,2020,Valladolid,Fede San Emeterio,ESP,MF,23,1997,16.2,25,14,15,7,3,11,31,35.5,20,23,8,15,28,53,33,0,2021
ESP-La Liga,2020,Valladolid,Javi Moyano,ESP,DF,34,1986,1.1,0,0,0,0,0,0,0,,0,2,0,2,0,0,2,0,2021
ESP-La Liga,2020,Valladolid,Javi Sánchez,ESP,DF,23,1997,10.2,15,10,10,4,1,9,10,90.0,1,15,7,8,15,30,37,0,2021
ESP-La Liga,2020,Valladolid,Jawad El Yamiq,MAR,DF,28,1992,15.3,21,14,14,7,0,8,11,72.7,3,15,10,5,46,67,100,0,2021
ESP-La Liga,2020,Valladolid,Joaquín Fernández,ESP,DF,24,1996,23.0,30,16,21,8,1,12,21,57.1,9,24,15,9,43,73,113,0,2021
ESP-La Liga,2020,Valladolid,Jordi Masip,ESP,GK,31,1989,25.0,0,0,0,0,0,0,2,0.0,2,2,0,2,2,2,8,1,2021
ESP-La Liga,2020,Valladolid,Jota,POR,"MF,FW",21,1999,7.4,7,3,1,4,2,5,10,50.0,5,4,0,4,6,13,5,1,2021
ESP-La Liga,2020,Valladolid,Kenan Kodro,BIH,"FW,MF",26,1993,5.1,0,0,0,0,0,0,2,0.0,2,2,1,1,2,2,6,0,2021
ESP-La Liga,2020,Valladolid,Kike Pérez,ESP,MF,23,1997,12.9,26,19,8,14,4,7,33,21.2,26,10,1,9,17,43,18,0,2021
ESP-La Liga,2020,Valladolid,Kiko Olivas,ESP,DF,31,1988,2.0,3,2,2,1,0,3,5,60.0,2,2,2,0,7,10,3,0,2021
ESP-La Liga,2020,Valladolid,Kuki,ESP,MF,22,1998,0.3,1,1,0,0,1,0,1,0.0,1,0,0,0,0,1,0,0,2021
ESP-La Liga,2020,Valladolid,Lucas Olaza,URU,DF,26,1994,14.0,20,9,11,7,2,9,17,52.9,8,15,7,8,15,35,38,0,2021
ESP-La Liga,2020,Valladolid,Luis Pérez,ESP,DF,25,1995,14.4,33,17,16,17,0,18,30,60.0,12,26,8,18,14,47,54,1,2021
ESP-La Liga,2020,Valladolid,Maranhão,BRA,FW,23,1996,13.1,8,2,2,2,4,0,8,0.0,8,15,2,13,2,10,9,0,2021
ESP-La Liga,2020,Valladolid,Miguel Ángel Rubio,ESP,DF,22,1998,1.5,0,0,0,0,0,0,0,,0,2,2,0,3,3,11,0,2021
ESP-La Liga,2020,Valladolid,Míchel,ESP,MF,32,1988,10.5,18,11,10,3,5,5,22,22.7,17,10,1,9,9,27,12,1,2021
ESP-La Liga,2020,Valladolid,Nacho,ESP,DF,31,1989,20.1,43,21,29,10,4,24,52,46.2,28,21,1,20,29,72,47,0,2021
ESP-La Liga,2020,Valladolid,Oriol Rey,ESP,MF,22,1998,0.2,0,0,0,0,0,0,0,,0,0,0,0,1,1,0,0,2021
ESP-La Liga,2020,Valladolid,Pablo Hervías,ESP,"DF,MF",27,1993,13.4,19,12,7,9,3,9,26,34.6,17,6,0,6,11,30,8,0,2021
ESP-La Liga,2020,Valladolid,Raúl García,ESP,"DF,MF",31,1989,5.6,10,8,5,5,0,6,20,30.0,14,5,1,4,9,19,10,0,2021
ESP-La Liga,2020,Valladolid,Roberto,ESP,GK,34,1986,13.0,0,0,0,0,0,0,1,0.0,1,0,0,0,0,0,7,0,2021
ESP-La Liga,2020,Valladolid,Roque Mesa,ESP,MF,31,1989,19.6,46,29,18,24,4,20,47,42.6,27,11,2,9,14,60,23,1,2021
ESP-La Liga,2020,Valladolid,Rubén Alcaraz,ESP,MF,29,1991,24.1,54,29,32,21,1,30,80,37.5,50,35,8,27,31,85,28,0,2021
ESP-La Liga,2020,Valladolid,Saidy Janko,GAM,DF,24,1995,13.6,19,10,12,5,2,8,14,57.1,6,9,1,8,18,37,47,0,2021
ESP-La Liga,2020,Valladolid,Sergi Guardiola,ESP,FW,29,1991,19.9,11,5,1,5,5,2,27,7.4,25,12,1,11,7,18,16,3,2021
ESP-La Liga,2020,Valladolid,Sergio Benito,ESP,FW,21,1999,0.0,0,0,0,0,0,0,0,,0,0,0,0,0,0,0,0,2021
ESP-La Liga,2020,Valladolid,Shon Weissman,ISR,FW,24,1996,23.7,12,9,4,5,3,2,23,8.7,21,17,3,14,8,20,7,0,2021
ESP-La Liga,2020,Valladolid,Toni Villa,ESP,"MF,FW",25,1995,10.8,31,16,11,14,6,15,42,35.7,27,15,1,14,5,36,3,0,2021
ESP-La Liga,2020,Valladolid,Waldo Rubio,ESP,"FW,MF",24,1995,4.2,6,4,2,2,2,1,14,7.1,13,6,0,6,3,9,3,0,2021
ESP-La Liga,2020,Valladolid,Óscar Plano,ESP,"MF,FW",29,1991,28.0,42,24,24,12,6,14,46,30.4,32,35,6,29,34,76,43,0,2021
ESP-La Liga,2020,Villarreal,Alberto Moreno,ESP,DF,28,1992,2.1,7,4,7,0,0,2,5,40.0,3,2,1,1,3,10,2,0,2021
ESP-La Liga,2020,Villarreal,Alex Baena,ESP,MF,19,2001,1.5,4,3,1,2,1,1,3,33.3,2,1,1,0,1,5,1,0,2021
ESP-La Liga,2020,Villarreal,Alfonso Pedraza,ESP,DF,24,1996,23.3,35,19,16,11,8,11,31,35.5,20,21,5,16,34,69,47,1,2021
ESP-La Liga,2020,Villarreal,Carlos Bacca,COL,FW,33,1986,8.7,9,5,5,3,1,3,5,60.0,2,5,0,5,3,12,2,0,2021
ESP-La Liga,2020,Villarreal,Dani Raba,ESP,"MF,FW",24,1995,1.7,2,1,0,1,1,2,8,25.0,6,1,0,1,0,2,0,0,2021
ESP-La Liga,2020,Villarreal,Daniel Parejo,ESP,MF,31,1989,34.6,65,40,32,23,10,33,81,40.7,48,35,8,27,45,110,21,3,2021
ESP-La Liga,2020,Villarreal,Fernando Niño,ESP,FW,19,2000,6.6,8,3,0,4,4,2,9,22.2,7,1,0,1,2,10,2,0,2021
ESP-La Liga,2020,Villarreal,Francis Coquelin,FRA,MF,29,1991,8.2,19,14,4,12,3,8,19,42.1,11,8,2,6,21,40,11,1,2021
ESP-La Liga,2020,Villarreal,Gerard Moreno,ESP,FW,28,1992,29.7,24,15,8,10,6,7,34,20.6,27,17,4,13,15,39,26,0,2021
ESP-La Liga,2020,Villarreal,Gerónimo Rulli,ARG,GK,28,1992,2.0,0,0,0,0,0,0,0,,0,0,0,0,0,0,0,1,2021
ESP-La Liga,2020,Villarreal,Jaume Costa,ESP,"DF,MF",32,1988,3.9,10,6,4,6,0,7,9,77.8,2,7,1,6,6,16,8,0,2021
ESP-La Liga,2020,Villarreal,Juan Foyth,ARG,"DF,MF",22,1998,13.0,40,22,22,14,4,12,29,41.4,17,21,6,15,19,59,24,1,2021
ESP-La Liga,2020,Villarreal,Manu Trigueros,ESP,MF,28,1991,28.1,51,30,25,21,5,21,77,27.3,56,32,2,30,17,68,19,0,2021
ESP-La Liga,2020,Villarreal,Mario Gaspar,ESP,DF,29,1990,20.6,55,34,22,24,9,21,40,52.5,19,26,4,22,30,85,47,1,2021
ESP-La Liga,2020,Villarreal,Moi Gómez,ESP,"MF,FW",26,1994,28.5,21,12,6,8,7,14,35,40.0,21,20,3,17,11,32,16,0,2021
ESP-La Liga,2020,Villarreal,Paco Alcácer,ESP,FW,26,1993,17.2,6,3,1,2,3,3,7,42.9,4,8,0,8,9,15,6,0,2021
ESP-La Liga,2020,Villarreal,Pau Torres,ESP,DF,23,1997,33.0,17,11,10,5,2,11,18,61.1,7,33,25,8,23,40,111,1,2021
ESP-La Liga,2020,Villarreal,Pervis Estupiñán,ECU,DF,22,1998,13.0,37,17,23,12,2,14,23,60.9,9,10,2,8,35,72,14,2,2021
ESP-La Liga,2020,Villarreal,Ramiro Funes Mori,ARG,DF,29,1991,8.1,12,8,7,5,0,7,11,63.6,4,7,5,2,8,20,42,1,2021
ESP-La Liga,2020,Villarreal,Raúl Albiol,ESP,DF,34,1985,34.6,22,15,19,3,0,13,18,72.2,5,32,22,10,22,44,146,2,2021
ESP-La Liga,2020,Villarreal,Rubén Peña,ESP,DF,29,1991,12.4,25,14,8,15,2,19,33,57.6,14,20,1,19,13,38,19,0,2021
ESP-La Liga,2020,Villarreal,Samuel Chukwueze,NGA,"MF,FW",21,1999,15.2,12,7,4,4,4,3,17,17.6,14,8,0,8,10,22,3,0,2021
ESP-La Liga,2020,Villarreal,Sergio Asenjo,ESP,GK,31,1989,36.0,0,0,0,0,0,0,1,0.0,1,0,0,0,0,0,13,2,2021
ESP-La Liga,2020,Villarreal,Sofian Chakla,MAR,DF,26,1993,0.1,0,0,0,0,0,0,0,,0,0,0,0,0,0,0,0,2021
ESP-La Liga,2020,Villarreal,Takefusa Kubo,JPN,"MF,FW",19,2001,3.3,1,1,0,0,1,1,5,20.0,4,2,0,2,1,2,2,0,2021
ESP-La Liga,2020,Villarreal,Vicente Iborra,ESP,MF,32,1988,10.3,18,8,8,7,3,8,24,33.3,16,14,7,7,14,32,25,1,2021
ESP-La Liga,2020,Villarreal,Yeremi Pino,ESP,"FW,MF",17,2002,8.9,19,11,10,7,2,8,28,28.6,20,20,1,19,9,28,8,0,2021
ESP-La Liga,2020,Villarreal,Álex Millán,ESP,FW,20,1999,0.0,0,0,0,0,0,0,0,,0,0,0,0,0,0,0,0,2021
ESP-La Liga,2020,Villarreal,Étienne Capoue,FRA,MF,32,1988,13.2,20,10,14,6,0,8,18,44.4,10,7,1,6,20,40,23,0,2021
ESP-La Liga,2021,Alavés,Antonio Sivera,ESP,GK,24,1996,3.1,0,0,0,0,0,0,1,0.0,1,0,0,0,0,0,0,0,2022
ESP-La Liga,2021,Alavés,Facundo Pellistri,URU,"MF,FW",19,2001,7.5,9,5,4,3,2,1,10,10.0,9,13,2,11,6,15,7,0,2022
ESP-La Liga,2021,Alavés,Fernando Pacheco,ESP,GK,29,1992,33.9,2,1,2,0,0,2,2,100.0,0,0,0,0,0,2,18,1,2022
ESP-La Liga,2021,Alavés,Florian Lejeune,FRA,DF,30,1991,30.0,33,24,22,10,1,12,20,60.0,8,30,19,11,31,64,158,0,2022
ESP-La Liga,2021,Alavés,Gonzalo Escalante,ARG,MF,28,1993,14.4,30,14,9,20,1,13,34,38.2,21,27,2,25,21,51,28,0,2022
ESP-La Liga,2021,Alavés,Iván Martín,ESP,"MF,FW",22,1999,1.8,1,1,1,0,0,0,1,0.0,1,2,0,2,1,2,1,0,2022
ESP-La Liga,2021,Alavés,Jason,ESP,"MF,FW",27,1994,7.5,11,7,6,4,1,7,20,35.0,13,7,0,7,7,18,5,0,2022
ESP-La Liga,2021,Alavés,Javi López,ESP,DF,19,2002,5.1,8,6,6,2,0,4,6,66.7,2,7,1,6,4,12,15,0,2022
ESP-La Liga,2021,Alavés,Jesús Owono,EQG,GK,20,2001,1.0,0,0,0,0,0,0,0,,0,0,0,0,0,0,1,0,2022
ESP-La Liga,2021,Alavés,John Guidetti,SWE,"FW,MF",29,1992,3.1,2,1,0,0,2,0,1,0.0,1,1,0,1,0,2,0,0,2022
ESP-La Liga,2021,Alavés,Joselu,ESP,FW,31,1990,34.7,16,11,1,9,6,7,25,28.0,18,21,4,17,7,23,45,0,2022
ESP-La Liga,2021,Alavés,Luis Rioja,ESP,"MF,FW",27,1993,34.6,28,15,11,10,7,14,58,24.1,44,22,1,21,25,53,20,0,2022
ESP-La Liga,2021,Alavés,Mamadou Loum,SEN,MF,24,1996,25.7,49,22,26,22,1,17,45,37.8,28,30,11,19,37,86,68,1,2022
ESP-La Liga,2021,Alavés,Mamadou Sylla,SEN,"FW,MF",27,1994,4.4,2,2,0,1,1,0,1,0.0,1,0,0,0,1,3,5,0,2022
ESP-La Liga,2021,Alavés,Manu García,ESP,MF,23,1998,12.0,18,9,6,9,3,9,27,33.3,18,8,2,6,13,31,4,0,2022
ESP-La Liga,2021,Alavés,Manu Vallejo,ESP,"MF,FW",24,1997,4.1,8,2,1,4,3,4,13,30.8,9,7,0,7,0,8,4,0,2022
ESP-La Liga,2021,Alavés,Marc Tenas,ESP,"FW,MF",20,2001,0.6,1,1,1,0,0,1,1,100.0,0,1,0,1,0,1,0,1,2022
ESP-La Liga,2021,Alavés,Martin Agirregabiria,ESP,DF,25,1996,18.0,34,22,17,11,6,18,37,48.6,19,20,3,17,25,59,38,0,2022
ESP-La Liga,2021,Alavés,Matt Miazga,USA,DF,26,1995,9.3,7,7,3,4,0,2,7,28.6,5,14,12,2,11,18,55,1,2022
ESP-La Liga,2021,Alavés,Miguel,ESP,"FW,MF",21,1999,9.2,7,3,1,5,1,2,15,13.3,13,6,0,6,1,8,7,0,2022
ESP-La Liga,2021,Alavés,Mircea Ţîrlea,ROU,DF,21,2000,0.2,0,0,0,0,0,0,0,,0,0,0,0,0,0,1,0,2022
ESP-La Liga,2021,Alavés,Nahuel Tenaglia,ARG,DF,25,1996,11.9,42,27,30,9,3,24,37,64.9,13,10,2,8,26,68,42,0,2022
ESP-La Liga,2021,Alavés,Pere Pons,ESP,MF,28,1993,15.2,26,18,4,20,2,7,21,33.3,14,10,1,9,6,32,11,0,2022
ESP-La Liga,2021,Alavés,Rubén Duarte,ESP,DF,25,1995,29.1,76,47,43,27,6,43,85,50.6,42,40,6,34,57,133,82,0,2022
ESP-La Liga,2021,Alavés,Saúl García,ESP,MF,26,1994,0.0,1,1,1,0,0,0,0,,0,0,0,0,0,1,0,0,2022
ESP-La Liga,2021,Alavés,Tachi,ESP,DF,23,1997,2.7,6,3,3,3,0,5,7,71.4,2,4,3,1,1,7,9,0,2022
ESP-La Liga,2021,Alavés,Tomás Mendes,ESP,MF,16,2004,0.1,0,0,0,0,0,0,0,,0,0,0,0,0,0,1,0,2022
ESP-La Liga,2021,Alavés,Tomás Pina Isla,ESP,MF,33,1987,16.0,28,16,13,11,4,14,29,48.3,15,12,3,9,22,50,23,0,2022
ESP-La Liga,2021,Alavés,Toni Moya,ESP,MF,23,1998,15.4,23,10,7,13,3,13,43,30.2,30,18,5,13,20,43,18,0,2022
ESP-La Liga,2021,Alavés,Unai Ropero,ESP,MF,19,2001,0.1,0,0,0,0,0,0,0,,0,0,0,0,1,1,0,0,2022
ESP-La Liga,2021,Alavés,Víctor Laguardia,ESP,DF,31,1989,33.8,29,16,21,8,0,19,30,63.3,11,36,24,12,27,56,151,1,2022
ESP-La Liga,2021,Alavés,Ximo Navarro,ESP,DF,31,1990,15.0,28,19,21,6,1,13,27,48.1,14,11,5,6,22,50,56,2,2022
ESP-La Liga,2021,Alavés,Édgar Méndez,ESP,"FW,MF",31,1990,17.9,25,14,11,10,4,11,34,32.4,23,16,0,16,4,29,17,0,2022
ESP-La Liga,2021,Athletic Club,Alex Petxa,ESP,"DF,MF",24,1997,4.6,12,9,4,7,1,4,8,50.0,4,8,2,6,4,16,6,0,2022
ESP-La Liga,2021,Athletic Club,Ander Capa,ESP,DF,29,1992,0.0,0,0,0,0,0,0,0,,0,0,0,0,0,0,0,0,2022
ESP-La Liga,2021,Athletic Club,Asier Villalibre,ESP,FW,23,1997,6.1,4,3,2,1,1,1,2,50.0,1,3,1,2,1,5,7,0,2022
ESP-La Liga,2021,Athletic Club,Dani García,ESP,MF,31,1990,24.2,36,22,15,17,4,14,47,29.8,33,27,10,17,24,60,41,1,2022
ESP-La Liga,2021,Athletic Club,Daniel Vivian,ESP,DF,22,1999,22.1,32,21,24,7,1,17,24,70.8,7,20,15,5,26,58,107,1,2022
ESP-La Liga,2021,Athletic Club,Iker Muniain,ESP,MF,28,1992,30.9,32,10,8,19,5,12,40,30.0,28,20,1,19,17,49,8,1,2022
ESP-La Liga,2021,Athletic Club,Iñaki Williams,GHA,FW,27,1994,30.9,14,5,1,6,7,5,17,29.4,12,18,3,15,3,17,20,0,2022
ESP-La Liga,2021,Athletic Club,Iñigo Lekue,ESP,DF,28,1993,21.4,32,23,16,12,4,22,44,50.0,22,37,12,25,23,55,63,0,2022
ESP-La Liga,2021,Athletic Club,Iñigo Martínez,ESP,DF,30,1991,26.0,28,13,18,7,3,14,23,60.9,9,22,10,12,39,67,143,0,2022
ESP-La Liga,2021,Athletic Club,Jon Morcillo,ESP,"MF,FW",22,1998,0.6,3,0,1,2,0,3,4,75.0,1,1,0,1,0,3,0,0,2022
ESP-La Liga,2021,Athletic Club,Julen Agirrezabala,ESP,GK,20,2000,4.0,0,0,0,0,0,0,0,,0,0,0,0,0,0,2,0,2022
ESP-La Liga,2021,Athletic Club,Mikel Balenziaga,ESP,DF,33,1988,22.5,33,24,15,15,3,25,43,58.1,18,27,4,23,21,54,79,0,2022
ESP-La Liga,2021,Athletic Club,Mikel Vesga,ESP,MF,28,1993,15.1,27,14,7,18,2,11,31,35.5,20,16,5,11,20,47,34,2,2022
ESP-La Liga,2021,Athletic Club,Nico Williams,ESP,MF,19,2002,14.9,20,10,6,11,3,10,31,32.3,21,18,2,16,5,25,9,0,2022
ESP-La Liga,2021,Athletic Club,Nicolás Serrano,ESP,"MF,FW",18,2003,3.5,9,6,3,5,1,3,10,30.0,7,5,1,4,2,11,3,0,2022
ESP-La Liga,2021,Athletic Club,Oier Zarraga,ESP,MF,22,1999,13.0,13,5,4,7,2,3,28,10.7,25,17,10,7,19,32,10,0,2022
ESP-La Liga,2021,Athletic Club,Oihan Sancet,ESP,FW,21,2000,15.8,12,7,2,8,2,5,20,25.0,15,2,0,2,5,17,13,0,2022
ESP-La Liga,2021,Athletic Club,Peru Nolaskoain,ESP,DF,22,1998,0.0,0,0,0,0,0,0,0,,0,0,0,0,0,0,0,0,2022
ESP-La Liga,2021,Athletic Club,Raúl García,ESP,FW,35,1986,20.0,27,17,6,11,10,8,36,22.2,28,30,4,26,9,36,21,0,2022
ESP-La Liga,2021,Athletic Club,Unai Núñez,ESP,DF,24,1997,6.9,4,4,2,2,0,3,6,50.0,3,9,8,1,8,12,26,2,2022
ESP-La Liga,2021,Athletic Club,Unai Simón,ESP,GK,24,1997,34.0,0,0,0,0,0,0,0,,0,0,0,0,1,1,5,1,2022
ESP-La Liga,2021,Athletic Club,Unai Vencedor Paris,ESP,MF,20,2000,26.5,26,11,11,9,6,8,42,19.0,34,31,13,18,19,45,22,0,2022
ESP-La Liga,2021,Athletic Club,Yeray Álvarez,ESP,DF,26,1995,20.7,24,14,15,8,1,10,18,55.6,8,21,16,5,45,69,97,0,2022
ESP-La Liga,2021,Athletic Club,Yuri Berchiche,ESP,DF,31,1990,11.3,25,11,10,11,4,7,14,50.0,7,19,6,13,13,38,25,0,2022
ESP-La Liga,2021,Athletic Club,Álex Berenguer,ESP,MF,26,1995,24.1,45,26,23,14,8,11,51,21.6,40,40,2,38,16,61,20,0,2022
ESP-La Liga,2021,Athletic Club,Óscar de Marcos,ESP,DF,32,1989,18.7,50,37,24,19,7,28,43,65.1,15,20,3,17,19,69,27,0,2022
ESP-La Liga,2021,Atlético Madrid,Antoine Griezmann,FRA,"FW,MF",30,1991,18.8,30,14,11,15,4,12,32,37.5,20,18,1,17,7,37,18,0,2022
ESP-La Liga,2021,Atlético Madrid,Carlos Martín,ESP,DF,19,2002,0.1,0,0,0,0,0,0,0,,0,0,0,0,0,0,1,0,2022
ESP-La Liga,2021,Atlético Madrid,Daniel Wass,DEN,"DF,FW",32,1989,0.5,0,0,0,0,0,0,0,,0,0,0,0,0,0,3,0,2022
ESP-La Liga,2021,Atlético Madrid,Felipe,BRA,DF,32,1989,16.7,20,15,11,8,1,8,18,44.4,10,17,11,6,28,48,77,0,2022
ESP-La Liga,2021,Atlético Madrid,Geoffrey Kondogbia,CTA,"MF,DF",28,1993,20.9,74,44,25,40,9,21,49,42.9,28,16,5,11,44,118,24,0,2022
ESP-La Liga,2021,Atlético Madrid,Giuliano Simeone,ARG,MF,18,2002,0.0,0,0,0,0,0,0,0,,0,0,0,0,0,0,0,0,2022
ESP-La Liga,2021,Atlético Madrid,Héctor Herrera,MEX,MF,31,1990,9.5,16,8,11,4,1,7,20,35.0,13,13,2,11,12,28,16,0,2022
ESP-La Liga,2021,Atlético Madrid,Jan Oblak,SVN,GK,28,1993,38.0,0,0,0,0,0,0,0,,0,0,0,0,1,1,10,4,2022
ESP-La Liga,2021,Atlético Madrid,Javier Serrano,ESP,MF,18,2003,0.8,3,1,0,3,0,2,4,50.0,2,0,0,0,3,6,2,0,2022
ESP-La Liga,2021,Atlético Madrid,José María Giménez,URU,DF,26,1995,22.7,18,12,12,6,0,8,16,50.0,8,25,19,6,25,43,96,1,2022
ESP-La Liga,2021,Atlético Madrid,João Félix,POR,"FW,MF",21,1999,14.0,5,2,1,4,0,1,5,20.0,4,4,1,3,7,12,8,0,2022
ESP-La Liga,2021,Atlético Madrid,Kieran Trippier,ENG,"DF,FW",30,1990,10.8,22,12,12,5,5,12,21,57.1,9,12,1,11,10,32,11,0,2022
ESP-La Liga,2021,Atlético Madrid,Koke,ESP,MF,29,1992,27.9,55,30,19,29,7,26,63,41.3,37,21,5,16,24,79,31,1,2022
ESP-La Liga,2021,Atlético Madrid,Luis Suárez,URU,FW,34,1987,20.4,8,5,2,4,2,2,10,20.0,8,8,1,7,1,9,14,0,2022
ESP-La Liga,2021,Atlético Madrid,Marcos Llorente,ESP,"MF,DF",26,1995,27.2,51,23,25,22,4,28,43,65.1,15,33,10,23,27,78,44,0,2022
ESP-La Liga,2021,Atlético Madrid,Mario Hermoso,ESP,DF,26,1995,20.7,30,15,23,4,3,20,38,52.6,18,18,3,15,29,59,49,2,2022
ESP-La Liga,2021,Atlético Madrid,Matheus Cunha,BRA,FW,22,1999,11.8,19,12,3,11,5,5,20,25.0,15,18,2,16,6,25,9,0,2022
ESP-La Liga,2021,Atlético Madrid,Reinildo Mandava,MOZ,DF,27,1994,14.4,45,25,30,14,1,22,30,73.3,8,18,9,9,21,66,38,0,2022
ESP-La Liga,2021,Atlético Madrid,Renan Lodi,BRA,DF,23,1998,13.1,31,18,14,13,4,11,27,40.7,16,22,4,18,13,44,19,1,2022
ESP-La Liga,2021,Atlético Madrid,Rodrigo De Paul,ARG,MF,27,1994,23.9,55,30,22,25,8,30,60,50.0,30,24,3,21,21,76,17,2,2022
ESP-La Liga,2021,Atlético Madrid,Saúl Ñíguez,ESP,"FW,MF",26,1994,2.2,7,2,0,6,1,3,4,75.0,1,7,1,6,0,7,3,0,2022
ESP-La Liga,2021,Atlético Madrid,Stefan Savić,MNE,DF,30,1991,27.1,46,20,25,20,1,29,43,67.4,14,19,12,7,37,83,102,1,2022
ESP-La Liga,2021,Atlético Madrid,Thomas Lemar,FRA,MF,25,1995,16.0,24,14,9,12,3,8,23,34.8,15,18,0,18,8,32,11,0,2022
ESP-La Liga,2021,Atlético Madrid,Yannick Carrasco,BEL,"FW,MF",27,1993,28.7,34,19,16,12,6,19,44,43.2,25,26,5,21,19,53,12,2,2022
ESP-La Liga,2021,Atlético Madrid,Ángel Correa,ARG,"FW,MF",26,1995,20.6,16,8,5,10,1,7,29,24.1,22,25,2,23,10,26,4,0,2022
ESP-La Liga,2021,Atlético Madrid,Šime Vrsaljko,CRO,DF,29,1992,10.2,27,17,14,12,1,12,20,60.0,8,10,1,9,12,39,30,0,2022
ESP-La Liga,2021,Barcelona,Abdessamad Ezzalzouli,MAR,FW,19,2001,6.4,17,9,9,5,3,5,8,62.5,3,3,0,3,9,26,0,0,2022
ESP-La Liga,2021,Barcelona,Adama Traoré,ESP,FW,25,1996,4.2,4,2,0,3,1,3,5,60.0,2,2,0,2,4,8,3,1,2022
ESP-La Liga,2021,Barcelona,Alejandro Balde,ESP,"DF,FW",17,2003,2.1,2,1,1,0,1,0,0,,0,2,2,0,1,3,1,0,2022
ESP-La Liga,2021,Barcelona,Alvaro Sanz,ESP,MF,20,2001,0.3,0,0,0,0,0,0,1,0.0,1,0,0,0,0,0,0,0,2022
ESP-La Liga,2021,Barcelona,Ansu Fati,ESP,FW,18,2002,3.7,3,2,0,2,1,1,1,100.0,0,4,0,4,1,4,0,0,2022
ESP-La Liga,2021,Barcelona,Antoine Griezmann,FRA,FW,30,1991,2.9,13,5,3,10,0,2,6,33.3,4,4,0,4,3,16,5,0,2022
ESP-La Liga,2021,Barcelona,Clément Lenglet,FRA,DF,26,1995,9.2,20,11,11,7,2,8,13,61.5,5,7,3,4,13,33,21,0,2022
ESP-La Liga,2021,Barcelona,Dani Alves,BRA,DF,38,1983,12.2,30,19,13,13,4,14,26,53.8,12,10,3,7,11,41,10,2,2022
ESP-La Liga,2021,Barcelona,Emerson,BRA,DF,22,1999,1.0,3,3,2,1,0,1,2,50.0,1,1,0,1,2,5,1,0,2022
ESP-La Liga,2021,Barcelona,Eric García,ESP,DF,20,2001,22.7,27,18,13,13,1,11,26,42.3,15,22,12,10,44,71,53,3,2022
ESP-La Liga,2021,Barcelona,Estanis,ESP,FW,17,2003,0.1,1,1,0,1,0,1,1,100.0,0,0,0,0,0,1,0,0,2022
ESP-La Liga,2021,Barcelona,Ferrán Torres,ESP,FW,21,2000,15.7,10,5,3,4,3,3,7,42.9,4,12,3,9,6,16,7,0,2022
ESP-La Liga,2021,Barcelona,Frenkie de Jong,NED,MF,24,1997,27.5,35,19,12,18,5,12,23,52.2,11,19,5,14,20,55,16,0,2022
ESP-La Liga,2021,Barcelona,Gavi,ESP,"MF,FW",16,2004,25.7,38,18,13,18,7,9,33,27.3,24,36,0,36,25,63,13,0,2022
ESP-La Liga,2021,Barcelona,Gerard Piqué,ESP,DF,34,1987,23.2,22,12,18,4,0,11,14,78.6,3,19,16,3,34,56,86,1,2022
ESP-La Liga,2021,Barcelona,Ilias Akhomach,ESP,FW,17,2004,1.4,2,0,0,1,1,0,0,,0,0,0,0,0,2,0,0,2022
ESP-La Liga,2021,Barcelona,Jordi Alba,ESP,DF,32,1989,29.4,47,34,12,26,9,27,47,57.4,20,26,6,20,33,80,41,1,2022
ESP-La Liga,2021,Barcelona,Jutglà,ESP,FW,22,1999,3.3,2,1,0,1,1,0,1,0.0,1,2,0,2,1,3,1,0,2022
ESP-La Liga,2021,Barcelona,Luuk de Jong,NED,FW,30,1990,7.3,9,7,1,5,3,1,2,50.0,1,4,0,4,0,9,12,0,2022
ESP-La Liga,2021,Barcelona,Marc-André ter Stegen,GER,GK,29,1992,35.0,0,0,0,0,0,0,1,0.0,1,0,0,0,1,1,13,5,2022
ESP-La Liga,2021,Barcelona,Martin Braithwaite,DEN,FW,30,1991,2.6,1,1,0,0,1,0,0,,0,2,0,2,1,2,1,0,2022
ESP-La Liga,2021,Barcelona,Memphis,NED,FW,27,1994,20.6,10,4,2,4,4,3,13,23.1,10,9,1,8,3,13,4,0,2022
ESP-La Liga,2021,Barcelona,Mika Màrmol,ESP,DF,19,2002,0.0,0,0,0,0,0,0,0,,0,0,0,0,0,0,0,0,2022
ESP-La Liga,2021,Barcelona,Neto,BRA,GK,32,1989,3.0,0,0,0,0,0,0,0,,0,0,0,0,0,0,2,1,2022
ESP-La Liga,2021,Barcelona,Nicolás González,ESP,MF,19,2002,12.4,31,20,5,23,3,11,27,40.7,16,12,0,12,6,37,12,0,2022
ESP-La Liga,2021,Barcelona,Ousmane Dembélé,FRA,FW,24,1997,15.7,24,16,6,10,8,7,23,30.4,16,8,0,8,8,32,3,0,2022
ESP-La Liga,2021,Barcelona,Pedri,ESP,MF,18,2002,9.8,20,12,9,8,3,7,20,35.0,13,13,0,13,5,25,7,1,2022
ESP-La Liga,2021,Barcelona,Philippe Coutinho,BRA,"MF,FW",29,1992,5.6,6,3,3,3,0,3,11,27.3,8,3,0,3,4,10,3,0,2022
ESP-La Liga,2021,Barcelona,Pierre-Emerick Aubameyang,GAB,FW,32,1989,12.0,2,2,0,1,1,0,5,0.0,5,9,1,8,2,4,4,0,2022
ESP-La Liga,2021,Barcelona,Riqui Puig,ESP,MF,21,1999,5.4,6,3,2,4,0,2,14,14.3,12,5,0,5,3,9,0,0,2022
ESP-La Liga,2021,Barcelona,Ronald Araújo,URU,DF,22,1999,25.2,41,23,29,12,0,21,25,84.0,4,37,20,17,23,64,66,1,2022
ESP-La Liga,2021,Barcelona,Samuel Umtiti,FRA,DF,27,1993,1.0,2,2,2,0,0,1,2,50.0,1,1,1,0,0,2,4,0,2022
ESP-La Liga,2021,Barcelona,Sergi Roberto,ESP,"MF,DF",29,1992,4.4,5,1,2,3,0,3,5,60.0,2,2,0,2,4,9,6,0,2022
ESP-La Liga,2021,Barcelona,Sergio Agüero,ARG,FW,33,1988,1.7,1,1,0,0,1,0,2,0.0,2,0,0,0,0,1,0,0,2022
ESP-La Liga,2021,Barcelona,Sergio Busquets,ESP,MF,33,1988,35.5,93,49,31,48,14,46,83,55.4,37,44,8,36,45,138,31,0,2022
ESP-La Liga,2021,Barcelona,Sergiño Dest,USA,"DF,FW",20,2000,16.8,32,15,21,10,1,13,18,72.2,5,22,4,18,2,34,18,0,2022
ESP-La Liga,2021,Barcelona,Yusuf Demir,AUT,FW,18,2003,2.1,3,1,1,1,1,2,5,40.0,3,1,0,1,2,5,1,0,2022
ESP-La Liga,2021,Barcelona,Óscar Mingueza,ESP,DF,22,1999,9.9,25,11,12,11,2,16,23,69.6,7,5,0,5,9,34,22,1,2022
ESP-La Liga,2021,Betis,Aitor Ruibal,ESP,"FW,DF",25,1996,9.5,21,15,13,3,5,10,34,29.4,24,8,0,8,8,29,6,0,2022
ESP-La Liga,2021,Betis,Andrés Guardado,MEX,MF,34,1986,15.5,30,13,12,17,1,13,34,38.2,21,18,4,14,21,51,29,1,2022
ESP-La Liga,2021,Betis,Borja Iglesias,ESP,FW,28,1993,17.5,6,4,1,2,3,0,8,0.0,8,11,1,10,4,10,7,0,2022
ESP-La Liga,2021,Betis,Calderón,ESP,DF,21,2000,0.7,2,0,1,0,1,1,3,33.3,2,0,0,0,0,2,2,0,2022
ESP-La Liga,2021,Betis,Claudio Bravo,CHI,GK,38,1983,16.2,0,0,0,0,0,0,0,,0,0,0,0,0,0,6,2,2022
ESP-La Liga,2021,Betis,Cristian Tello,ESP,FW,29,1991,9.1,17,11,6,7,4,13,31,41.9,18,9,0,9,10,27,6,0,2022
ESP-La Liga,2021,Betis,Diego Lainez,MEX,FW,21,2000,1.6,1,1,0,1,0,0,3,0.0,3,3,0,3,1,2,0,0,2022
ESP-La Liga,2021,Betis,Germán Pezzella,ARG,DF,30,1991,22.1,21,9,16,5,0,16,29,55.2,13,29,18,11,39,60,106,0,2022
ESP-La Liga,2021,Betis,Guido Rodríguez,ARG,MF,27,1994,28.1,97,53,46,45,6,54,98,55.1,44,55,12,43,31,128,56,0,2022
ESP-La Liga,2021,Betis,Héctor Bellerín,ESP,DF,26,1995,22.0,52,32,29,20,3,31,44,70.5,13,11,2,9,23,75,57,1,2022
ESP-La Liga,2021,Betis,Joaquín,ESP,"FW,MF",40,1981,5.2,6,2,4,2,0,3,8,37.5,5,5,2,3,3,9,10,0,2022
ESP-La Liga,2021,Betis,Juan Miranda,ESP,DF,21,2000,8.7,21,11,16,4,1,12,22,54.5,10,10,4,6,15,36,22,0,2022
ESP-La Liga,2021,Betis,Juanmi,ESP,FW,28,1993,23.7,39,25,11,19,9,19,49,38.8,30,24,1,23,9,48,10,1,2022
ESP-La Liga,2021,Betis,Kike Hermoso,ESP,DF,21,1999,1.0,2,1,2,0,0,2,2,100.0,0,2,1,1,0,2,5,1,2022
ESP-La Liga,2021,Betis,Loren Morón,ESP,FW,27,1993,0.0,1,1,1,0,0,1,1,100.0,0,0,0,0,0,1,0,0,2022
ESP-La Liga,2021,Betis,Marc Bartra,ESP,DF,30,1991,22.1,39,14,18,17,4,19,35,54.3,16,39,22,17,33,72,105,1,2022
ESP-La Liga,2021,Betis,Martín Montoya,ESP,DF,30,1991,5.8,20,12,11,7,2,15,26,57.7,11,6,0,6,11,31,20,0,2022
ESP-La Liga,2021,Betis,Nabil Fekir,FRA,MF,28,1993,31.0,43,29,5,25,13,7,36,19.4,29,14,0,14,7,50,7,0,2022
ESP-La Liga,2021,Betis,Paul Akouokou,CIV,MF,23,1997,5.7,14,9,5,7,2,8,12,66.7,4,6,0,6,11,25,6,0,2022
ESP-La Liga,2021,Betis,Raúl,ESP,"FW,DF",20,2000,0.0,0,0,0,0,0,0,0,,0,0,0,0,0,0,0,0,2022
ESP-La Liga,2021,Betis,Roberto González,ESP,"FW,MF",20,2001,1.5,5,4,3,2,0,4,6,66.7,2,5,0,5,1,6,1,0,2022
ESP-La Liga,2021,Betis,Rodri,ESP,FW,21,2000,9.8,10,7,4,5,1,5,22,22.7,17,11,0,11,3,13,4,0,2022
ESP-La Liga,2021,Betis,Rui Silva,POR,GK,27,1994,21.8,1,0,1,0,0,1,2,50.0,1,0,0,0,1,2,11,1,2022
ESP-La Liga,2021,Betis,Sergio Canales,ESP,"FW,MF",30,1991,31.0,24,14,8,12,4,10,35,28.6,25,16,1,15,10,34,12,0,2022
ESP-La Liga,2021,Betis,Víctor Camarasa,ESP,"MF,FW",27,1994,1.2,2,1,1,1,0,0,1,0.0,1,2,1,1,2,4,2,0,2022
ESP-La Liga,2021,Betis,Víctor Ruiz,ESP,DF,32,1989,15.8,11,9,7,2,2,6,9,66.7,3,18,13,5,29,40,71,1,2022
ESP-La Liga,2021,Betis,William Carvalho,POR,MF,29,1992,20.1,49,33,20,25,4,15,40,37.5,25,18,7,11,16,65,20,0,2022
ESP-La Liga,2021,Betis,Willian José,BRA,FW,29,1991,17.8,15,13,2,10,3,2,8,25.0,6,10,2,8,3,18,16,0,2022
ESP-La Liga,2021,Betis,Youssouf Sabaly,SEN,DF,28,1993,8.8,12,10,11,0,1,7,13,53.8,6,11,4,7,13,25,16,1,2022
ESP-La Liga,2021,Betis,Álex Moreno,ESP,DF,28,1993,26.7,76,40,53,15,8,33,60,55.0,27,28,6,22,34,110,82,1,2022
ESP-La Liga,2021,Betis,Édgar González,ESP,DF,24,1997,16.3,25,19,15,8,2,17,24,70.8,7,17,11,6,23,48,82,0,2022
ESP-La Liga,2021,Celta Vigo,Augusto Solari,ARG,"MF,DF",29,1992,7.9,24,12,9,12,3,12,32,37.5,20,14,4,10,7,31,10,1,2022
ESP-La Liga,2021,Celta Vigo,Brais Méndez,ESP,MF,24,1997,33.6,68,35,24,35,9,26,87,29.9,61,52,6,46,37,105,30,0,2022
ESP-La Liga,2021,Celta Vigo,Carlos Dominguez,ESP,DF,20,2001,3.8,4,1,4,0,0,4,6,66.7,2,2,1,1,4,8,21,0,2022
ESP-La Liga,2021,Celta Vigo,Denis Suárez,ESP,MF,27,1994,31.3,61,29,20,33,8,25,82,30.5,57,32,4,28,16,77,11,0,2022
ESP-La Liga,2021,Celta Vigo,Fran Beltrán,ESP,MF,22,1999,28.9,56,41,27,23,6,28,68,41.2,40,29,5,24,32,88,39,0,2022
ESP-La Liga,2021,Celta Vigo,Franco Cervi,ARG,MF,27,1994,20.0,73,41,35,22,16,33,77,42.9,44,38,2,36,21,94,19,0,2022
ESP-La Liga,2021,Celta Vigo,Gabriel Veiga,ESP,MF,19,2002,1.2,5,4,0,4,1,3,12,25.0,9,2,0,2,4,9,1,0,2022
ESP-La Liga,2021,Celta Vigo,Hugo Mallo,ESP,DF,30,1991,20.3,45,25,24,19,2,16,31,51.6,15,23,9,14,20,65,53,0,2022
ESP-La Liga,2021,Celta Vigo,Hugo Sotelo,ESP,FW,17,2003,0.0,0,0,0,0,0,0,0,,0,0,0,0,0,0,0,0,2022
ESP-La Liga,2021,Celta Vigo,Hugo Álvarez,ESP,FW,18,2003,0.1,1,0,1,0,0,0,0,,0,0,0,0,0,1,1,0,2022
ESP-La Liga,2021,Celta Vigo,Iago Aspas,ESP,FW,33,1987,34.3,14,7,1,5,8,4,24,16.7,20,23,2,21,11,25,19,0,2022
ESP-La Liga,2021,Celta Vigo,Javi Galán,ESP,DF,26,1994,36.6,108,66,60,37,11,42,99,42.4,57,48,8,40,45,153,52,0,2022
ESP-La Liga,2021,Celta Vigo,Jeison Murillo,COL,DF,29,1992,12.4,15,10,13,2,0,9,13,69.2,4,11,8,3,17,32,37,0,2022
ESP-La Liga,2021,Celta Vigo,Joseph Aidoo,GHA,DF,25,1995,29.3,39,26,28,10,1,17,31,54.8,14,23,13,10,38,77,96,3,2022
ESP-La Liga,2021,Celta Vigo,José Fontán,ESP,DF,21,2000,3.1,5,3,3,2,0,1,5,20.0,4,3,1,2,10,15,10,0,2022
ESP-La Liga,2021,Celta Vigo,Kevin Vázquez,ESP,DF,28,1993,14.8,34,24,12,13,9,14,28,50.0,14,20,7,13,36,70,34,0,2022
ESP-La Liga,2021,Celta Vigo,Matías Dituro,ARG,GK,34,1987,38.0,0,0,0,0,0,0,0,,0,0,0,0,0,0,10,5,2022
ESP-La Liga,2021,Celta Vigo,Miguel Baeza,ESP,DF,21,2000,0.0,0,0,0,0,0,0,0,,0,0,0,0,0,0,0,0,2022
ESP-La Liga,2021,Celta Vigo,Nolito,ESP,MF,34,1986,15.4,25,15,14,7,4,13,47,27.7,34,20,1,19,9,34,5,0,2022
ESP-La Liga,2021,Celta Vigo,Néstor Araujo,MEX,DF,29,1991,29.1,22,14,17,5,0,9,21,42.9,12,17,10,7,27,49,105,2,2022
ESP-La Liga,2021,Celta Vigo,Okay Yokuşlu,TUR,"DF,MF",27,1994,1.6,4,1,2,1,1,2,3,66.7,1,2,1,1,2,6,6,0,2022
ESP-La Liga,2021,Celta Vigo,Orbelín Pineda,MEX,"MF,FW",25,1996,1.1,4,1,4,0,0,1,2,50.0,1,0,0,0,0,4,1,0,2022
ESP-La Liga,2021,Celta Vigo,Renato Tapia,PER,MF,26,1995,15.7,50,31,15,31,4,20,50,40.0,30,21,5,16,28,78,43,0,2022
ESP-La Liga,2021,Celta Vigo,Santi Mina,ESP,FW,25,1995,26.3,27,17,8,15,4,5,32,15.6,27,28,2,26,6,33,22,0,2022
ESP-La Liga,2021,Celta Vigo,Thiago Galhardo,BRA,"FW,MF",32,1989,12.8,12,6,3,3,6,2,12,16.7,10,15,2,13,6,18,9,0,2022
ESP-La Liga,2021,Cádiz,Alberto Perea,ESP,MF,30,1990,8.6,19,9,7,9,3,6,20,30.0,14,15,1,14,9,28,4,0,2022
ESP-La Liga,2021,Cádiz,Alfonso Espino,URU,DF,29,1992,37.0,107,63,58,39,10,44,112,39.3,68,45,10,35,54,161,87,1,2022
ESP-La Liga,2021,Cádiz,Anthony Lozano,HON,"FW,MF",28,1993,18.6,8,4,2,3,3,5,18,27.8,13,16,2,14,2,10,7,0,2022
ESP-La Liga,2021,Cádiz,Cala,ESP,DF,31,1989,10.5,9,4,9,0,0,8,17,47.1,9,12,6,6,12,21,56,0,2022
ESP-La Liga,2021,Cádiz,Carlos Akapo,EQG,DF,28,1993,20.5,43,31,26,15,2,21,37,56.8,16,26,7,19,51,94,61,0,2022
ESP-La Liga,2021,Cádiz,Chapela,ESP,"MF,FW",22,1999,4.4,4,2,1,0,3,2,4,50.0,2,6,1,5,4,8,5,0,2022
ESP-La Liga,2021,Cádiz,Fali,ESP,"DF,MF",27,1993,20.0,32,19,24,8,0,17,32,53.1,15,26,16,10,24,56,82,0,2022
ESP-La Liga,2021,Cádiz,Fede San Emeterio,ESP,MF,24,1997,9.2,16,5,5,8,3,5,15,33.3,10,5,0,5,8,24,6,0,2022
ESP-La Liga,2021,Cádiz,Florin Andone,ROU,FW,28,1993,2.0,1,1,1,0,0,0,1,0.0,1,2,0,2,0,1,1,0,2022
ESP-La Liga,2021,Cádiz,Isaac Carcelen,ESP,"DF,MF",28,1993,17.2,43,29,29,12,2,28,56,50.0,28,25,6,19,34,77,42,0,2022
ESP-La Liga,2021,Cádiz,Iván Alejo,ESP,"MF,FW",26,1995,11.8,33,15,21,10,2,15,44,34.1,29,12,0,12,8,41,17,0,2022
ESP-La Liga,2021,Cádiz,Jens Jønsson,DEN,MF,28,1993,14.5,40,29,22,17,1,17,35,48.6,18,17,7,10,34,74,32,0,2022
ESP-La Liga,2021,Cádiz,Jeremías Ledesma,ARG,GK,28,1993,38.0,3,1,3,0,0,3,4,75.0,1,0,0,0,1,4,21,4,2022
ESP-La Liga,2021,Cádiz,José Mari,ESP,MF,33,1987,4.3,14,7,3,10,1,7,8,87.5,1,4,1,3,7,21,2,0,2022
ESP-La Liga,2021,Cádiz,Lucas Pérez,ESP,"FW,MF",32,1988,11.8,3,3,2,1,0,0,10,0.0,10,3,1,2,0,3,1,0,2022
ESP-La Liga,2021,Cádiz,Luis Hernández,ESP,DF,32,1989,15.2,9,5,9,0,0,5,8,62.5,3,5,3,2,16,25,34,0,2022
ESP-La Liga,2021,Cádiz,Marcos Mauro López Gutiérrez,ARG,DF,30,1991,1.5,1,0,0,1,0,0,2,0.0,2,2,1,1,1,2,9,0,2022
ESP-La Liga,2021,Cádiz,Martín,ESP,MF,22,1999,1.3,2,2,0,2,0,0,0,,0,1,0,1,1,3,3,0,2022
ESP-La Liga,2021,Cádiz,Milutin Osmajić,MNE,"FW,MF",22,1999,2.9,1,1,0,1,0,0,0,,0,0,0,0,1,2,3,0,2022
ESP-La Liga,2021,Cádiz,Oussama Idrissi,MAR,MF,25,1996,10.0,8,4,3,4,1,4,15,26.7,11,8,0,8,3,11,5,0,2022
ESP-La Liga,2021,Cádiz,Pedro Benito,ESP,FW,21,2000,0.3,0,0,0,0,0,0,1,0.0,1,0,0,0,0,0,0,0,2022
ESP-La Liga,2021,Cádiz,Raúl Parra,ESP,DF,21,1999,1.0,2,1,2,0,0,1,3,33.3,2,0,0,0,0,2,5,0,2022
ESP-La Liga,2021,Cádiz,Rubén Alcaraz,ESP,MF,30,1991,12.3,41,20,14,24,3,22,45,48.9,23,10,2,8,13,54,14,0,2022
ESP-La Liga,2021,Cádiz,Rubén Sobrino,ESP,"FW,MF",29,1992,20.7,28,17,11,10,7,5,35,14.3,30,21,1,20,21,49,18,0,2022
ESP-La Liga,2021,Cádiz,Salvi,ESP,"MF,FW",30,1991,15.5,20,10,9,8,3,8,20,40.0,12,17,2,15,6,26,11,0,2022
ESP-La Liga,2021,Cádiz,Santiago Arzamendia,PAR,MF,23,1998,5.2,14,6,6,5,3,6,13,46.2,7,6,0,6,4,18,7,0,2022
ESP-La Liga,2021,Cádiz,Tomás Alarcón,CHI,MF,22,1999,15.8,31,20,17,10,4,10,31,32.3,21,19,7,12,30,61,31,0,2022
ESP-La Liga,2021,Cádiz,Varazdat Haroyan,ARM,DF,28,1992,16.0,31,21,20,10,1,19,29,65.5,10,22,12,10,15,46,62,0,2022
ESP-La Liga,2021,Cádiz,Víctor Chust,ESP,DF,21,2000,20.3,19,10,14,4,1,11,17,64.7,6,20,8,12,16,35,87,0,2022
ESP-La Liga,2021,Cádiz,Álex Fernández,ESP,MF,28,1992,22.8,47,31,22,17,8,21,61,34.4,40,30,7,23,30,77,31,0,2022
ESP-La Liga,2021,Cádiz,Álvaro Bastida,ESP,MF,17,2004,2.2,7,4,2,4,1,4,5,80.0,1,1,0,1,3,10,1,0,2022
ESP-La Liga,2021,Cádiz,Álvaro Jiménez,ESP,"MF,FW",26,1995,2.6,6,3,3,2,1,4,7,57.1,3,3,0,3,3,9,0,0,2022
ESP-La Liga,2021,Cádiz,Álvaro Negredo,ESP,FW,35,1985,24.0,5,3,1,4,0,3,6,50.0,3,11,5,6,2,7,23,0,2022
ESP-La Liga,2021,Elche,Antonio Barragán,ESP,DF,34,1987,11.3,21,14,13,7,1,11,17,64.7,6,5,3,2,17,38,34,0,2022
ESP-La Liga,2021,Elche,Darío Benedetto,ARG,"FW,MF",31,1990,6.6,5,1,2,2,1,3,6,50.0,3,4,0,4,1,6,1,0,2022
ESP-La Liga,2021,Elche,Diego González,ESP,DF,26,1995,19.9,25,16,18,7,0,9,16,56.3,7,21,13,8,19,44,87,0,2022
ESP-La Liga,2021,Elche,Enzo Roco,CHI,DF,28,1992,28.4,36,20,24,11,1,15,24,62.5,9,38,27,11,28,64,110,3,2022
ESP-La Liga,2021,Elche,Ezequiel Ponce,ARG,FW,24,1997,7.4,5,4,1,3,1,3,10,30.0,7,5,0,5,1,6,7,0,2022
ESP-La Liga,2021,Elche,Fidel,ESP,MF,31,1989,25.1,44,23,18,17,9,14,57,24.6,43,9,1,8,7,51,20,0,2022
ESP-La Liga,2021,Elche,Gerard Gumbau,ESP,MF,26,1994,21.0,46,19,22,19,5,22,51,43.1,29,18,4,14,23,69,25,0,2022
ESP-La Liga,2021,Elche,Gonzalo Verdú,ESP,DF,32,1988,15.5,19,9,15,4,0,8,16,50.0,8,20,14,6,13,32,59,1,2022
ESP-La Liga,2021,Elche,Guido Carrillo,ARG,FW,30,1991,13.0,7,4,2,4,1,3,13,23.1,10,9,2,7,1,8,27,0,2022
ESP-La Liga,2021,Elche,Helibelton Palacios,COL,DF,28,1993,21.5,69,38,56,10,3,37,55,67.3,18,21,8,13,18,87,61,0,2022
ESP-La Liga,2021,Elche,Iván Marcone,ARG,MF,31,1990,9.0,24,14,17,6,1,12,24,50.0,12,8,3,5,12,36,13,0,2022
ESP-La Liga,2021,Elche,Javier Pastore,ARG,"MF,FW",32,1989,5.8,7,3,3,2,2,3,12,25.0,9,5,1,4,4,11,2,0,2022
ESP-La Liga,2021,Elche,Johan Mojica,COL,DF,28,1992,31.7,46,25,34,7,5,23,31,74.2,8,22,3,19,25,71,61,3,2022
ESP-La Liga,2021,Elche,John Donald,ESP,DF,20,2000,2.0,7,4,4,2,1,5,8,62.5,3,5,3,2,3,10,3,0,2022
ESP-La Liga,2021,Elche,Josan,ESP,"DF,MF",31,1989,13.5,36,22,23,9,4,26,44,59.1,18,11,4,7,10,46,21,0,2022
ESP-La Liga,2021,Elche,Josema,ESP,DF,25,1996,2.0,3,2,1,1,1,0,2,0.0,2,1,1,0,0,3,11,0,2022
ESP-La Liga,2021,Elche,Kike Pérez,ESP,"MF,FW",24,1997,5.8,8,6,1,3,4,0,10,0.0,10,6,1,5,3,11,4,0,2022
ESP-La Liga,2021,Elche,Kiko Casilla,ESP,GK,34,1986,14.0,0,0,0,0,0,0,1,0.0,1,0,0,0,1,1,2,2,2022
ESP-La Liga,2021,Elche,Lucas Boyé,ARG,FW,25,1996,19.0,27,13,5,15,7,9,24,37.5,15,24,1,23,2,29,23,0,2022
ESP-La Liga,2021,Elche,Lucas Olaza,URU,DF,27,1994,3.3,5,3,3,1,1,1,1,100.0,0,5,1,4,4,9,6,0,2022
ESP-La Liga,2021,Elche,Lucas Pérez,ESP,FW,32,1988,14.1,4,1,2,1,1,3,10,30.0,7,2,0,2,3,7,4,0,2022
ESP-La Liga,2021,Elche,Omar Mascarell,ESP,MF,28,1993,27.7,46,26,16,23,7,24,60,40.0,36,42,14,28,48,94,52,2,2022
ESP-La Liga,2021,Elche,Pablo Piatti,ARG,"MF,FW",32,1989,3.5,9,4,5,3,1,3,8,37.5,5,5,1,4,2,11,3,0,2022
ESP-La Liga,2021,Elche,Pedro Bigas,ESP,DF,30,1990,17.2,24,10,16,8,0,9,20,45.0,11,21,16,5,18,42,77,1,2022
ESP-La Liga,2021,Elche,Pere Milla,ESP,"MF,FW",28,1992,18.3,20,15,14,5,1,8,44,18.2,36,21,1,20,5,25,21,0,2022
ESP-La Liga,2021,Elche,Raúl Guti,ESP,MF,24,1996,18.1,25,15,7,14,4,10,30,33.3,20,9,3,6,25,50,7,0,2022
ESP-La Liga,2021,Elche,Tete Morente,ESP,MF,24,1996,18.1,21,14,13,7,1,7,28,25.0,21,30,1,29,12,33,12,0,2022
ESP-La Liga,2021,Elche,Édgar Badía,ESP,GK,29,1992,24.0,0,0,0,0,0,0,0,,0,0,0,0,0,0,16,2,2022
ESP-La Liga,2021,Espanyol,Adri Embarba,ESP,"FW,MF",29,1992,22.1,44,29,22,15,7,26,69,37.7,43,35,3,32,19,63,30,0,2022
ESP-La Liga,2021,Espanyol,Aleix Vidal,ESP,"DF,MF",31,1989,21.1,31,25,17,9,5,19,39,48.7,20,19,6,13,25,56,35,2,2022
ESP-La Liga,2021,Espanyol,Daniel Villahermosa,ESP,MF,20,2001,0.3,0,0,0,0,0,0,0,,0,0,0,0,0,0,1,0,2022
ESP-La Liga,2021,Espanyol,David López,ESP,"MF,DF",31,1989,8.3,18,13,9,8,1,9,16,56.3,7,10,8,2,10,28,25,2,2022
ESP-La Liga,2021,Espanyol,Diego López,ESP,GK,39,1981,35.3,0,0,0,0,0,0,2,0.0,2,0,0,0,1,1,21,1,2022
ESP-La Liga,2021,Espanyol,Dídac Vilà,ESP,"DF,MF",32,1989,2.3,7,5,2,5,0,4,9,44.4,5,2,1,1,3,10,8,0,2022
ESP-La Liga,2021,Espanyol,Fernando Calero,ESP,DF,25,1995,12.1,17,10,12,5,0,8,13,61.5,5,7,2,5,16,33,63,1,2022
ESP-La Liga,2021,Espanyol,Fran Mérida,ESP,MF,31,1990,3.0,7,3,5,2,0,4,10,40.0,6,1,0,1,6,13,1,0,2022
ESP-La Liga,2021,Espanyol,Gori,ESP,MF,19,2002,0.1,0,0,0,0,0,0,0,,0,2,0,2,0,0,0,0,2022
ESP-La Liga,2021,Espanyol,Javi Puado,ESP,"MF,FW",23,1998,24.9,24,14,18,5,1,12,37,32.4,25,18,2,16,11,35,24,0,2022
ESP-La Liga,2021,Espanyol,Joan García,ESP,GK,20,2001,1.2,0,0,0,0,0,0,0,,0,0,0,0,1,1,1,2,2022
ESP-La Liga,2021,Espanyol,Jofre,ESP,"MF,DF",20,2001,0.2,1,1,0,0,1,1,1,100.0,0,0,0,0,0,1,0,0,2022
ESP-La Liga,2021,Espanyol,Keidi Bare,ALB,MF,23,1997,16.5,27,17,14,12,1,11,31,35.5,20,20,10,10,15,42,26,1,2022
ESP-La Liga,2021,Espanyol,Landry Dimata,BEL,"FW,MF",23,1997,6.0,2,2,1,1,0,1,4,25.0,3,0,0,0,1,3,7,0,2022
ESP-La Liga,2021,Espanyol,Leandro Cabrera,URU,DF,30,1991,37.0,37,24,27,10,0,21,34,61.8,13,32,23,9,44,81,222,2,2022
ESP-La Liga,2021,Espanyol,Lluís Recasens,ESP,DF,19,2002,0.5,2,0,2,0,0,1,1,100.0,0,0,0,0,2,4,2,0,2022
ESP-La Liga,2021,Espanyol,Loren Morón,ESP,"FW,MF",27,1993,6.3,6,4,1,3,2,0,12,0.0,12,11,1,10,2,8,9,0,2022
ESP-La Liga,2021,Espanyol,Luca Koleosho,ITA,FW,16,2004,0.0,0,0,0,0,0,0,0,,0,0,0,0,0,0,0,0,2022
ESP-La Liga,2021,Espanyol,Manu Morlanes,ESP,MF,22,1999,12.7,36,15,16,17,3,18,43,41.9,25,24,5,19,13,49,17,0,2022
ESP-La Liga,2021,Espanyol,Miguel Juan Llambrich,ESP,DF,25,1996,0.8,2,2,1,1,0,0,0,,0,1,0,1,0,2,5,0,2022
ESP-La Liga,2021,Espanyol,Nico Ribaudo,ESP,"MF,FW",20,2001,12.4,15,6,9,5,1,11,34,32.4,23,14,2,12,7,22,3,0,2022
ESP-La Liga,2021,Espanyol,Oier Olazábal,ESP,GK,31,1989,1.5,0,0,0,0,0,0,0,,0,0,0,0,0,0,0,0,2022
ESP-La Liga,2021,Espanyol,Pedrosa,ESP,DF,23,1998,30.2,58,30,38,14,6,26,57,45.6,31,25,7,18,25,83,92,2,2022
ESP-La Liga,2021,Espanyol,Raúl de Tomás,ESP,FW,26,1994,32.4,15,11,6,7,2,6,17,35.3,11,12,3,9,6,21,42,1,2022
ESP-La Liga,2021,Espanyol,Rubén,ESP,DF,20,2001,1.7,6,1,4,2,0,4,7,57.1,3,0,0,0,2,8,4,0,2022
ESP-La Liga,2021,Espanyol,Sergi Darder,ESP,MF,27,1993,34.7,45,22,16,19,10,18,54,33.3,36,16,1,15,26,71,32,1,2022
ESP-La Liga,2021,Espanyol,Sergi Gómez,ESP,DF,29,1992,30.2,33,24,29,3,1,18,27,66.7,9,33,23,10,40,73,125,2,2022
ESP-La Liga,2021,Espanyol,Tonny Vilhena,NED,"MF,FW",26,1995,10.3,16,6,7,8,1,7,21,33.3,14,10,2,8,8,24,17,0,2022
ESP-La Liga,2021,Espanyol,Victor Perea,ESP,DF,21,2000,0.0,0,0,0,0,0,0,0,,0,0,0,0,0,0,0,0,2022
ESP-La Liga,2021,Espanyol,Wu Lei,CHN,"FW,MF",29,1991,5.3,3,2,1,2,0,3,8,37.5,5,4,0,4,4,7,3,0,2022
ESP-La Liga,2021,Espanyol,Yangel Herrera,VEN,MF,23,1998,18.3,41,31,19,19,3,18,39,46.2,21,27,5,22,19,60,33,1,2022
ESP-La Liga,2021,Espanyol,Álvaro Vadillo,ESP,"DF,MF",26,1994,0.1,1,1,1,0,0,1,2,50.0,1,0,0,0,0,1,1,0,2022
ESP-La Liga,2021,Espanyol,Óscar Gil,ESP,DF,24,1997,18.8,52,35,27,20,5,25,46,54.3,21,33,9,24,19,71,33,2,2022
ESP-La Liga,2021,Espanyol,Óscar Melendo,ESP,"MF,FW",23,1997,11.0,11,5,4,4,3,3,13,23.1,10,4,1,3,1,12,10,0,2022
ESP-La Liga,2021,Getafe,Allan Nyom,CMR,DF,33,1988,2.7,3,1,2,1,0,2,2,100.0,0,2,1,1,2,5,7,0,2022
ESP-La Liga,2021,Getafe,Borja Mayoral,ESP,FW,24,1997,11.6,7,5,2,3,2,1,2,50.0,1,10,4,6,4,11,3,0,2022
ESP-La Liga,2021,Getafe,Carles Aleñá,ESP,MF,23,1998,25.8,27,19,11,13,3,9,48,18.8,39,21,2,19,15,42,16,0,2022
ESP-La Liga,2021,Getafe,Chema,ESP,MF,29,1992,0.5,0,0,0,0,0,0,1,0.0,1,0,0,0,0,0,0,0,2022
ESP-La Liga,2021,Getafe,Damián Suárez,URU,DF,33,1988,30.1,74,47,34,30,10,42,91,46.2,49,46,5,41,31,105,30,0,2022
ESP-La Liga,2021,Getafe,Darío Poveda,ESP,"FW,MF",24,1997,4.2,2,0,1,0,1,0,5,0.0,5,7,1,6,1,3,1,0,2022
ESP-La Liga,2021,Getafe,David Soria,ESP,GK,28,1993,37.9,1,0,1,0,0,1,2,50.0,1,0,0,0,0,1,22,2,2022
ESP-La Liga,2021,Getafe,David Timor,ESP,MF,31,1989,3.8,1,1,1,0,0,0,3,0.0,3,3,2,1,1,2,4,1,2022
ESP-La Liga,2021,Getafe,Diego Conde,ESP,GK,22,1998,0.1,0,0,0,0,0,0,0,,0,0,0,0,0,0,0,0,2022
ESP-La Liga,2021,Getafe,Djené,TOG,DF,29,1991,34.6,44,26,24,16,4,23,34,67.6,11,24,5,19,59,103,109,2,2022
ESP-La Liga,2021,Getafe,Emmanuel Amankwaa Akurugu,GHA,DF,19,2001,0.9,0,0,0,0,0,0,2,0.0,2,1,0,1,0,0,0,0,2022
ESP-La Liga,2021,Getafe,Enes Ünal,TUR,FW,24,1997,31.1,37,22,2,18,17,5,42,11.9,37,25,5,20,5,42,36,0,2022
ESP-La Liga,2021,Getafe,Erick Cabaco,URU,DF,26,1995,4.5,2,1,1,1,0,2,5,40.0,3,5,2,3,4,6,10,0,2022
ESP-La Liga,2021,Getafe,Florentino Luís,POR,MF,21,1999,11.0,42,25,22,17,3,17,35,48.6,18,21,2,19,21,63,11,1,2022
ESP-La Liga,2021,Getafe,Gonzalo Villar,ESP,MF,23,1998,3.3,5,3,4,1,0,2,5,40.0,3,4,1,3,1,6,1,0,2022
ESP-La Liga,2021,Getafe,Hugo Duro,ESP,"DF,MF",21,1999,0.1,0,0,0,0,0,0,0,,0,0,0,0,0,0,0,0,2022
ESP-La Liga,2021,Getafe,Iglesias,ESP,DF,23,1998,8.0,19,10,11,8,0,7,17,41.2,10,8,2,6,10,29,28,0,2022
ESP-La Liga,2021,Getafe,Jaime Mata,ESP,FW,32,1988,7.5,7,5,3,1,3,1,9,11.1,8,4,1,3,1,8,5,0,2022
ESP-La Liga,2021,Getafe,Jakub Jankto,CZE,"DF,MF",25,1996,6.5,11,7,5,5,1,10,17,58.8,7,4,0,4,4,15,7,0,2022
ESP-La Liga,2021,Getafe,Jonathan Silva,ARG,"DF,FW",27,1994,2.5,10,8,4,4,2,7,12,58.3,5,4,0,4,3,13,7,0,2022
ESP-La Liga,2021,Getafe,Jorge Cuenca,ESP,DF,21,1999,29.8,46,32,30,15,1,21,28,75.0,7,29,14,15,39,85,155,0,2022
ESP-La Liga,2021,Getafe,José Juan Macías,MEX,"FW,MF",21,1999,2.2,1,0,0,0,1,0,1,0.0,1,1,0,1,1,2,0,0,2022
ESP-La Liga,2021,Getafe,Marc Cucurella,ESP,"MF,DF",23,1998,0.3,0,0,0,0,0,0,0,,0,0,0,0,0,0,0,0,2022
ESP-La Liga,2021,Getafe,Mathías Olivera,URU,DF,23,1997,31.1,79,47,39,34,6,40,69,58.0,29,45,4,41,55,134,67,1,2022
ESP-La Liga,2021,Getafe,Mauro Arambarri,URU,MF,25,1995,29.6,62,37,19,32,11,20,68,29.4,48,35,5,30,32,94,18,0,2022
ESP-La Liga,2021,Getafe,Nemanja Maksimović,SRB,MF,26,1995,32.6,56,32,24,26,6,18,49,36.7,31,42,13,29,71,127,41,0,2022
ESP-La Liga,2021,Getafe,Okay Yokuşlu,TUR,"DF,MF",27,1994,5.2,9,8,6,2,1,5,5,100.0,0,7,5,2,5,14,17,0,2022
ESP-La Liga,2021,Getafe,Sandro Ramírez,ESP,FW,26,1995,16.2,7,3,1,3,3,1,12,8.3,11,14,3,11,2,9,3,0,2022
ESP-La Liga,2021,Getafe,Stefan Mitrović,SRB,DF,31,1990,29.6,16,8,12,4,0,8,13,61.5,5,28,18,10,22,38,114,1,2022
ESP-La Liga,2021,Getafe,Vitolo,ESP,MF,31,1989,2.5,3,2,1,1,1,2,5,40.0,3,3,0,3,1,4,1,0,2022
ESP-La Liga,2021,Getafe,Óscar Rodríguez Arnaiz,ESP,"MF,FW",23,1998,10.5,16,11,6,8,2,4,12,33.3,8,7,1,6,11,27,6,0,2022
ESP-La Liga,2021,Granada,Aarón Escandell,ESP,GK,25,1995,3.2,0,0,0,0,0,0,1,0.0,1,0,0,0,0,0,4,0,2022
ESP-La Liga,2021,Granada,Adrián Butzke,ESP,FW,22,1999,0.0,0,0,0,0,0,0,0,,0,0,0,0,0,0,0,0,2022
ESP-La Liga,2021,Granada,Alberto Soro,ESP,"MF,FW",22,1999,6.4,12,10,3,6,3,1,7,14.3,6,21,2,19,3,15,4,0,2022
ESP-La Liga,2021,Granada,Antonio Puertas,ESP,"MF,FW",29,1992,25.1,34,20,18,12,4,17,44,38.6,27,33,3,30,11,45,36,0,2022
ESP-La Liga,2021,Granada,Barcia,ESP,DF,20,2000,0.8,0,0,0,0,0,0,0,,0,1,1,0,1,1,0,1,2022
ESP-La Liga,2021,Granada,Carlos Bacca,COL,FW,34,1986,5.7,4,4,2,0,2,0,3,0.0,3,5,0,5,1,5,5,0,2022
ESP-La Liga,2021,Granada,Carlos Neva,ESP,DF,25,1996,23.4,31,19,24,7,0,16,28,57.1,12,27,9,18,32,63,81,0,2022
ESP-La Liga,2021,Granada,Dani Raba,ESP,"MF,FW",25,1995,0.3,2,2,1,0,1,2,3,66.7,1,0,0,0,1,3,0,0,2022
ESP-La Liga,2021,Granada,Darwin Machís,VEN,"MF,FW",28,1993,15.3,23,13,11,8,4,9,23,39.1,14,10,0,10,15,38,17,0,2022
ESP-La Liga,2021,Granada,Dimitri Foulquier,FRA,DF,28,1993,2.0,0,0,0,0,0,0,1,0.0,1,2,1,1,1,1,2,0,2022
ESP-La Liga,2021,Granada,Domingos Duarte,POR,DF,26,1995,18.7,18,14,9,9,0,6,11,54.5,5,27,20,7,22,40,82,0,2022
ESP-La Liga,2021,Granada,Germán Sánchez,ESP,DF,34,1986,25.5,27,19,18,9,0,11,20,55.0,9,19,16,3,28,55,137,0,2022
ESP-La Liga,2021,Granada,Isma Ruiz,ESP,MF,20,2001,3.1,3,1,3,0,0,1,9,11.1,8,5,2,3,3,6,2,0,2022
ESP-La Liga,2021,Granada,Jorge Molina,ESP,FW,39,1982,21.8,4,2,2,1,1,2,18,11.1,16,13,2,11,6,10,11,0,2022
ESP-La Liga,2021,Granada,Luis Abram,PER,DF,25,1996,6.2,6,3,3,3,0,2,4,50.0,2,6,5,1,5,11,37,1,2022
ESP-La Liga,2021,Granada,Luis Javier Suárez,COL,FW,23,1997,31.6,26,14,9,9,8,8,27,29.6,19,25,3,22,6,32,23,0,2022
ESP-La Liga,2021,Granada,Luis Milla,ESP,MF,26,1994,30.8,59,29,25,30,4,25,64,39.1,39,28,4,24,25,84,34,0,2022
ESP-La Liga,2021,Granada,Luís Maximiano,POR,GK,22,1999,34.8,3,1,3,0,0,3,6,50.0,3,0,0,0,1,4,16,2,2022
ESP-La Liga,2021,Granada,Matias Arezo,URU,"FW,MF",18,2002,1.8,5,3,2,1,2,4,9,44.4,5,1,0,1,1,6,1,0,2022
ESP-La Liga,2021,Granada,Maxime Gonalons,FRA,MF,32,1989,17.2,43,28,17,22,4,14,39,35.9,25,33,10,23,18,61,29,0,2022
ESP-La Liga,2021,Granada,Monchu,ESP,MF,21,1999,7.4,15,6,5,9,1,5,10,50.0,5,8,3,5,4,19,4,0,2022
ESP-La Liga,2021,Granada,Myrto Uzuni,ALB,"FW,MF",26,1995,9.5,7,4,6,1,0,0,2,0.0,2,13,1,12,10,17,7,0,2022
ESP-La Liga,2021,Granada,Njegoš Petrović,SRB,MF,22,1999,10.2,24,11,4,19,1,8,14,57.1,6,16,4,12,9,33,11,0,2022
ESP-La Liga,2021,Granada,Quini,ESP,DF,31,1989,25.6,73,34,48,21,4,42,79,53.2,37,28,10,18,36,109,62,0,2022
ESP-La Liga,2021,Granada,Raúl Torrente,ESP,DF,19,2001,14.2,31,21,18,11,2,16,29,55.2,13,14,9,5,12,43,69,0,2022
ESP-La Liga,2021,Granada,Rubén Rochina,ESP,"MF,FW",30,1991,8.3,21,13,7,8,6,8,28,28.6,20,11,1,10,6,27,5,1,2022
ESP-La Liga,2021,Granada,Santiago Arias,COL,DF,29,1992,4.9,12,5,8,3,1,4,9,44.4,5,8,4,4,5,17,10,0,2022
ESP-La Liga,2021,Granada,Sergio Escudero,ESP,"DF,MF",31,1989,15.9,46,24,25,17,4,26,54,48.1,28,18,3,15,26,72,35,0,2022
ESP-La Liga,2021,Granada,Víctor Díaz,ESP,DF,33,1988,16.7,23,15,14,9,0,12,25,48.0,13,19,11,8,17,40,71,1,2022
ESP-La Liga,2021,Granada,Yan Brice Eteki,CMR,MF,23,1997,3.8,6,3,3,2,1,3,7,42.9,4,7,3,4,4,10,6,1,2022
ESP-La Liga,2021,Granada,Álex Collado,ESP,"MF,FW",22,1999,11.3,27,12,6,16,5,12,31,38.7,19,28,2,26,6,33,11,0,2022
ESP-La Liga,2021,Granada,Ángel Montoro,ESP,MF,33,1988,14.8,26,13,16,7,3,17,27,63.0,10,11,1,10,11,37,29,1,2022
ESP-La Liga,2021,Levante,Aitor Fernández,ESP,GK,30,1991,13.0,2,1,2,0,0,2,2,100.0,0,0,0,0,0,2,7,0,2022
ESP-La Liga,2021,Levante,Alejandro Primo,ESP,GK,17,2004,1.0,0,0,0,0,0,0,0,,0,0,0,0,0,0,0,0,2022
ESP-La Liga,2021,Levante,Carlos Clerc,ESP,DF,29,1992,16.8,35,17,21,10,4,7,19,36.8,12,8,3,5,26,61,32,1,2022
ESP-La Liga,2021,Levante,Coke,ESP,DF,34,1987,1.3,3,2,1,1,1,3,4,75.0,1,1,0,1,2,5,7,0,2022
ESP-La Liga,2021,Levante,Cárdenas,ESP,GK,24,1997,24.0,1,1,1,0,0,0,3,0.0,3,0,0,0,1,2,19,0,2022
ESP-La Liga,2021,Levante,Dani Gómez,ESP,FW,23,1998,11.8,7,4,3,2,2,4,12,33.3,8,3,0,3,3,10,5,0,2022
ESP-La Liga,2021,Levante,Enis Bardhi,MKD,"MF,FW",26,1995,18.9,29,12,12,14,3,12,35,34.3,23,13,2,11,10,39,7,0,2022
ESP-La Liga,2021,Levante,Enric Franquesa,ESP,"DF,FW",24,1997,6.9,5,3,4,0,1,0,1,0.0,1,4,0,4,7,12,11,0,2022
ESP-La Liga,2021,Levante,Gonzalo Melero,ESP,MF,27,1994,18.8,29,16,10,15,4,16,36,44.4,20,21,8,13,7,36,22,0,2022
ESP-La Liga,2021,Levante,Jorge Miramón,ESP,DF,32,1989,22.0,36,19,16,12,8,15,44,34.1,29,15,3,12,35,71,58,0,2022
ESP-La Liga,2021,Levante,Jorge de Frutos,ESP,"MF,FW",24,1997,19.6,33,15,14,11,8,10,51,19.6,41,11,1,10,12,45,13,0,2022
ESP-La Liga,2021,Levante,José Campaña,ESP,MF,28,1993,15.8,27,16,13,10,4,12,32,37.5,20,13,2,11,21,48,19,1,2022
ESP-La Liga,2021,Levante,José Luis García Vayá,ESP,MF,22,1998,22.4,46,27,10,31,5,16,41,39.0,25,24,5,19,38,84,30,0,2022
ESP-La Liga,2021,Levante,José Luis Morales,ESP,"FW,MF",34,1987,30.2,27,17,6,9,12,12,42,28.6,30,29,0,29,4,31,7,0,2022
ESP-La Liga,2021,Levante,Marcelo Saracchi,URU,DF,23,1998,2.1,8,5,6,1,1,2,4,50.0,2,3,0,3,4,12,7,1,2022
ESP-La Liga,2021,Levante,Martín Cáceres,URU,DF,34,1987,7.4,2,2,2,0,0,1,5,20.0,4,2,2,0,11,13,16,1,2022
ESP-La Liga,2021,Levante,Mickael Malsa,MTQ,MF,25,1995,12.7,37,17,16,18,3,15,42,35.7,27,20,8,12,18,55,15,0,2022
ESP-La Liga,2021,Levante,Nemanja Radoja,SRB,MF,28,1993,13.5,25,8,9,13,3,8,20,40.0,12,16,9,7,22,47,16,2,2022
ESP-La Liga,2021,Levante,Nikola Vukčević,MNE,MF,29,1991,1.3,3,2,2,1,0,0,1,0.0,1,2,0,2,2,5,1,0,2022
ESP-La Liga,2021,Levante,Omar Faraj,SWE,FW,19,2002,0.0,1,0,1,0,0,1,1,100.0,0,0,0,0,0,1,0,0,2022
ESP-La Liga,2021,Levante,Pablo Martínez,ESP,MF,23,1998,7.3,15,8,7,8,0,4,13,30.8,9,6,3,3,15,30,5,0,2022
ESP-La Liga,2021,Levante,Pubill,ESP,"DF,MF",18,2003,5.7,12,6,10,2,0,4,8,50.0,4,7,2,5,4,16,8,2,2022
ESP-La Liga,2021,Levante,Rober,ESP,DF,26,1995,22.3,36,20,27,7,2,23,39,59.0,16,25,15,10,30,66,90,1,2022
ESP-La Liga,2021,Levante,Roberto Soldado,ESP,FW,36,1985,7.4,3,1,0,1,2,1,3,33.3,2,4,0,4,1,4,7,0,2022
ESP-La Liga,2021,Levante,Roger Martí,ESP,FW,30,1991,23.5,23,14,3,13,7,8,30,26.7,22,14,0,14,2,25,8,0,2022
ESP-La Liga,2021,Levante,Rúben Vezo,POR,DF,27,1994,26.9,41,29,28,12,1,26,41,63.4,15,41,25,16,36,77,105,1,2022
ESP-La Liga,2021,Levante,Sergio Postigo,ESP,DF,32,1988,9.4,11,7,8,2,1,4,8,50.0,4,7,5,2,7,18,45,1,2022
ESP-La Liga,2021,Levante,Shkodran Mustafi,GER,DF,29,1992,7.3,9,6,6,3,0,5,9,55.6,4,6,3,3,15,24,40,0,2022
ESP-La Liga,2021,Levante,Son,ESP,DF,27,1994,21.9,28,18,16,7,5,17,34,50.0,17,11,5,6,19,47,33,1,2022
ESP-La Liga,2021,Levante,Álex Cantero,ESP,"FW,MF",21,2000,6.8,6,4,2,3,1,1,8,12.5,7,2,0,2,1,7,0,0,2022
ESP-La Liga,2021,Levante,Óscar Duarte,CRC,DF,32,1989,19.7,18,8,12,6,0,8,23,34.8,15,18,9,9,24,42,102,0,2022
ESP-La Liga,2021,Mallorca,Abdón Prats,ESP,FW,28,1992,7.1,2,2,1,0,1,1,5,20.0,4,5,0,5,1,3,6,0,2022
ESP-La Liga,2021,Mallorca,Aleix Febas,ESP,MF,25,1996,1.3,4,1,0,4,0,2,4,50.0,2,0,0,0,0,4,0,0,2022
ESP-La Liga,2021,Mallorca,Aleksandar Sedlar,SRB,"DF,MF",29,1991,4.5,5,3,4,1,0,3,5,60.0,2,4,4,0,5,10,19,0,2022
ESP-La Liga,2021,Mallorca,Amath,SEN,"FW,MF",25,1996,9.8,21,11,11,6,4,7,17,41.2,10,12,0,12,7,28,7,0,2022
ESP-La Liga,2021,Mallorca,Antonio Raillo,ESP,DF,29,1991,17.0,16,7,10,4,2,5,6,83.3,1,17,14,3,18,34,81,0,2022
ESP-La Liga,2021,Mallorca,Antonio Sánchez,ESP,"MF,FW",24,1997,18.0,53,24,29,17,7,19,49,38.8,30,32,2,30,32,85,32,1,2022
ESP-La Liga,2021,Mallorca,Brian Oliván,ESP,DF,27,1994,24.3,33,20,22,9,2,12,23,52.2,11,17,7,10,28,61,63,0,2022
ESP-La Liga,2021,Mallorca,Clément Grenier,FRA,MF,30,1991,0.7,0,0,0,0,0,0,0,,0,1,1,0,0,0,1,0,2022
ESP-La Liga,2021,Mallorca,Dani Rodríguez,ESP,"MF,FW",33,1988,31.5,53,31,20,24,9,15,46,32.6,31,28,3,25,20,73,27,0,2022
ESP-La Liga,2021,Mallorca,Dominik Greif,SVK,GK,24,1997,1.0,0,0,0,0,0,0,0,,0,0,0,0,0,0,0,0,2022
ESP-La Liga,2021,Mallorca,Fernando Niño,ESP,FW,20,2000,9.8,10,4,3,2,5,2,12,16.7,10,9,2,7,3,13,15,0,2022
ESP-La Liga,2021,Mallorca,Franco Russo,ARG,DF,26,1994,16.3,19,10,10,9,0,13,31,41.9,18,14,9,5,27,46,73,1,2022
ESP-La Liga,2021,Mallorca,Giovanni González,URU,DF,26,1994,4.1,9,3,4,4,1,3,5,60.0,2,7,2,5,4,13,14,0,2022
ESP-La Liga,2021,Mallorca,Iddrisu Baba,GHA,MF,25,1996,21.5,57,30,31,23,3,25,43,58.1,18,19,5,14,24,81,34,1,2022
ESP-La Liga,2021,Mallorca,Iñigo Ruiz de Galarreta,ESP,MF,27,1993,15.3,40,21,14,21,5,14,30,46.7,16,16,2,14,20,60,21,0,2022
ESP-La Liga,2021,Mallorca,Jaume Costa,ESP,DF,33,1988,20.3,35,26,23,7,5,23,31,74.2,8,22,7,15,23,58,55,0,2022
ESP-La Liga,2021,Mallorca,Javier Llabrés,ESP,"FW,MF",18,2002,1.5,2,1,0,1,1,1,2,50.0,1,1,0,1,0,2,0,0,2022
ESP-La Liga,2021,Mallorca,Joan Sastre Vanrell,ESP,DF,24,1997,2.9,6,3,5,0,1,3,4,75.0,1,3,0,3,2,8,10,0,2022
ESP-La Liga,2021,Mallorca,Jordi Mboula,ESP,FW,22,1999,4.8,8,2,3,3,2,5,9,55.6,4,7,1,6,3,11,3,0,2022
ESP-La Liga,2021,Mallorca,Josep Antoni Gayá,ESP,DF,21,2000,0.6,0,0,0,0,0,0,0,,0,1,0,1,1,1,3,1,2022
ESP-La Liga,2021,Mallorca,Lago Junior,CIV,"FW,MF",30,1990,2.0,3,2,3,0,0,3,5,60.0,2,0,0,0,2,5,2,0,2022
ESP-La Liga,2021,Mallorca,Lee Kangin,KOR,"MF,FW",20,2001,15.7,13,6,2,9,2,5,29,17.2,24,11,1,10,5,18,7,0,2022
ESP-La Liga,2021,Mallorca,Leonardo Román,ESP,GK,21,2000,2.0,0,0,0,0,0,0,0,,0,0,0,0,0,0,2,0,2022
ESP-La Liga,2021,Mallorca,Manolo Reina,ESP,GK,36,1985,21.0,0,0,0,0,0,0,0,,0,0,0,0,1,1,6,2,2022
ESP-La Liga,2021,Mallorca,Martin Valjent,SVK,DF,25,1995,35.3,31,19,18,12,1,13,24,54.2,11,34,26,8,31,62,173,1,2022
ESP-La Liga,2021,Mallorca,Matthew Hoppe,USA,"FW,MF",20,2001,1.5,1,0,0,0,1,0,3,0.0,3,0,0,0,0,1,0,0,2022
ESP-La Liga,2021,Mallorca,Pablo Maffeo,ESP,DF,24,1997,32.7,84,47,48,28,8,38,69,55.1,31,30,13,17,46,130,74,0,2022
ESP-La Liga,2021,Mallorca,Rodrigo Battaglia,ARG,MF,30,1991,13.1,32,16,13,19,0,15,30,50.0,15,21,10,11,10,42,36,0,2022
ESP-La Liga,2021,Mallorca,Salva Sevilla,ESP,MF,37,1984,16.7,18,12,8,8,2,6,17,35.3,11,12,6,6,14,32,11,0,2022
ESP-La Liga,2021,Mallorca,Sergio Rico,ESP,GK,27,1993,14.0,0,0,0,0,0,0,0,,0,0,0,0,0,0,5,2,2022
ESP-La Liga,2021,Mallorca,Takefusa Kubo,JPN,"FW,MF",20,2001,17.8,31,19,12,14,5,10,24,41.7,14,24,3,21,8,39,4,0,2022
ESP-La Liga,2021,Mallorca,Vedat Muriqi,KVX,FW,27,1994,16.0,6,3,1,3,2,1,7,14.3,6,12,0,12,6,12,29,0,2022
ESP-La Liga,2021,Mallorca,Ángel Rodríguez,ESP,"FW,MF",34,1987,17.2,15,9,6,7,2,4,21,19.0,17,15,1,14,3,18,13,0,2022
ESP-La Liga,2021,Osasuna,Ante Budimir,CRO,FW,30,1991,19.3,24,10,3,15,6,6,19,31.6,13,22,4,18,3,27,16,0,2022
ESP-La Liga,2021,Osasuna,Aridane Hernández,EQG,DF,32,1989,12.9,12,9,10,2,0,3,13,23.1,10,11,9,2,20,32,71,0,2022
ESP-La Liga,2021,Osasuna,Barbero,ESP,"FW,MF",22,1998,0.2,0,0,0,0,0,0,0,,0,0,0,0,0,0,1,0,2022
ESP-La Liga,2021,Osasuna,Darko Brašanac,SRB,MF,29,1992,26.7,35,22,19,14,2,14,40,35.0,26,25,8,17,25,60,15,0,2022
ESP-La Liga,2021,Osasuna,David García,ESP,DF,27,1994,34.5,28,14,15,11,2,12,22,54.5,10,27,21,6,52,80,168,0,2022
ESP-La Liga,2021,Osasuna,Ezequiel Ávila,ARG,"FW,MF",27,1994,20.8,17,7,6,7,4,7,21,33.3,14,14,2,12,13,30,15,1,2022
ESP-La Liga,2021,Osasuna,Iker Benito,ESP,"FW,MF",18,2002,1.3,2,1,1,0,1,0,1,0.0,1,2,0,2,0,2,2,0,2022
ESP-La Liga,2021,Osasuna,Iñigo Pérez,ESP,MF,33,1988,3.8,3,2,2,1,0,2,4,50.0,2,1,0,1,0,3,3,0,2022
ESP-La Liga,2021,Osasuna,Jaume Grau,ESP,MF,24,1997,0.0,1,1,1,0,0,0,1,0.0,1,0,0,0,0,1,0,0,2022
ESP-La Liga,2021,Osasuna,Javi Martínez,ESP,"MF,FW",21,1999,9.8,21,14,8,11,2,10,29,34.5,19,6,0,6,9,30,10,0,2022
ESP-La Liga,2021,Osasuna,Javier Ontiveros,ESP,"FW,MF",23,1997,0.4,0,0,0,0,0,0,2,0.0,2,0,0,0,1,1,0,1,2022
ESP-La Liga,2021,Osasuna,Jesús Areso,ESP,DF,22,1999,2.1,3,3,2,1,0,0,2,0.0,2,0,0,0,0,3,2,1,2022
ESP-La Liga,2021,Osasuna,Jon Moncayola,ESP,MF,23,1998,32.4,40,20,18,18,4,17,44,38.6,27,26,9,17,20,60,43,0,2022
ESP-La Liga,2021,Osasuna,Jonás Ramalho,ESP,DF,28,1993,2.7,4,2,2,2,0,2,3,66.7,1,4,1,3,3,7,9,0,2022
ESP-La Liga,2021,Osasuna,José Ángel,ESP,DF,31,1989,12.0,20,13,9,9,2,9,14,64.3,5,6,1,5,10,30,21,0,2022
ESP-La Liga,2021,Osasuna,Juan Cruz Armada,ESP,DF,29,1992,21.5,28,21,15,12,1,8,16,50.0,8,15,12,3,16,44,58,1,2022
ESP-La Liga,2021,Osasuna,Juan Pérez,ESP,GK,25,1996,2.0,0,0,0,0,0,0,1,0.0,1,0,0,0,0,0,1,1,2022
ESP-La Liga,2021,Osasuna,Kike,ESP,FW,31,1989,20.7,11,7,3,4,4,3,23,13.0,20,10,1,9,3,14,12,0,2022
ESP-La Liga,2021,Osasuna,Kike Barja,ESP,"MF,FW",24,1997,9.6,15,11,4,7,4,8,22,36.4,14,10,1,9,9,24,4,0,2022
ESP-La Liga,2021,Osasuna,Lucas Torró,ESP,MF,27,1994,30.3,71,40,25,38,8,29,57,50.9,28,32,11,21,47,118,55,0,2022
ESP-La Liga,2021,Osasuna,Manuel Sánchez,ESP,DF,20,2000,25.1,72,34,41,22,9,43,79,54.4,36,28,3,25,18,90,43,0,2022
ESP-La Liga,2021,Osasuna,Nacho Vidal,ESP,DF,26,1995,32.2,83,47,49,25,9,39,77,50.6,38,32,14,18,58,141,79,0,2022
ESP-La Liga,2021,Osasuna,Oier Sanjurjo,ESP,MF,35,1986,8.4,10,6,3,7,0,2,19,10.5,17,8,3,5,1,11,9,0,2022
ESP-La Liga,2021,Osasuna,Robert Ibáñez,ESP,"MF,FW",28,1993,1.0,3,3,2,0,1,1,2,50.0,1,1,0,1,1,4,1,0,2022
ESP-La Liga,2021,Osasuna,Roberto Torres,ESP,"MF,FW",32,1989,9.0,7,4,3,1,3,3,15,20.0,12,8,0,8,8,15,4,0,2022
ESP-La Liga,2021,Osasuna,Rubén García,ESP,"MF,FW",28,1993,26.4,43,26,12,23,8,16,49,32.7,33,31,4,27,24,67,16,0,2022
ESP-La Liga,2021,Osasuna,Sergio Herrera,ESP,GK,28,1993,36.0,3,2,3,0,0,3,6,50.0,3,1,0,1,1,4,18,0,2022
ESP-La Liga,2021,Osasuna,Unai Dufur,ESP,DF,22,1999,1.0,0,0,0,0,0,0,0,,0,1,0,1,4,4,4,0,2022
ESP-La Liga,2021,Osasuna,Unai García,ESP,DF,29,1992,15.6,21,12,14,6,1,14,17,82.4,3,19,11,8,22,43,78,0,2022
ESP-La Liga,2021,Rayo Vallecano,Alejandro Asensio,ESP,FW,20,2000,0.1,0,0,0,0,0,0,0,,0,0,0,0,0,0,0,0,2022
ESP-La Liga,2021,Rayo Vallecano,Andrés Martín,ESP,"FW,MF",22,1999,2.1,0,0,0,0,0,0,1,0.0,1,1,0,1,0,0,0,0,2022
ESP-La Liga,2021,Rayo Vallecano,Bebé,CPV,FW,31,1990,9.6,6,5,1,3,2,4,16,25.0,12,18,0,18,3,9,6,0,2022
ESP-La Liga,2021,Rayo Vallecano,Catena,ESP,DF,26,1994,36.0,39,23,24,15,0,25,42,59.5,17,26,19,7,30,69,168,3,2022
ESP-La Liga,2021,Rayo Vallecano,Esteban Saveljich,MNE,DF,30,1991,18.9,18,11,11,7,0,9,15,60.0,6,20,12,8,16,34,69,0,2022
ESP-La Liga,2021,Rayo Vallecano,Fran Garcia,ESP,DF,21,1999,33.6,60,35,44,12,4,39,73,53.4,34,34,8,26,45,105,53,0,2022
ESP-La Liga,2021,Rayo Vallecano,Isaac Palazón Camacho,ESP,"FW,MF",26,1994,25.4,42,28,20,19,3,18,59,30.5,41,31,3,28,13,55,22,0,2022
ESP-La Liga,2021,Rayo Vallecano,Iván Balliu,ALB,DF,29,1992,35.0,45,22,25,11,9,19,31,61.3,12,24,5,19,39,84,64,0,2022
ESP-La Liga,2021,Rayo Vallecano,José Pozo,ESP,"MF,DF",25,1996,0.8,2,2,0,2,0,2,3,66.7,1,1,0,1,0,2,1,0,2022
ESP-La Liga,2021,Rayo Vallecano,Kévin Rodrigues,POR,"DF,FW",27,1994,4.8,15,11,8,7,0,6,10,60.0,4,10,1,9,7,22,6,0,2022
ESP-La Liga,2021,Rayo Vallecano,Luca Zidane,FRA,GK,23,1998,7.2,0,0,0,0,0,0,1,0.0,1,0,0,0,0,0,1,1,2022
ESP-La Liga,2021,Rayo Vallecano,Mamadou Sylla,SEN,FW,27,1994,2.8,1,1,1,0,0,0,1,0.0,1,2,0,2,4,5,3,0,2022
ESP-La Liga,2021,Rayo Vallecano,Mario Hernández,ESP,"DF,FW",22,1999,4.4,10,4,7,3,0,5,9,55.6,4,1,0,1,4,14,7,0,2022
ESP-La Liga,2021,Rayo Vallecano,Mario Suárez,ESP,DF,34,1987,7.9,9,4,7,2,0,3,9,33.3,6,6,4,2,7,16,37,1,2022
ESP-La Liga,2021,Rayo Vallecano,Martín Merquelanz,ESP,"FW,MF",26,1995,1.9,2,1,2,0,0,2,6,33.3,4,2,0,2,0,2,1,0,2022
ESP-La Liga,2021,Rayo Vallecano,Nikola Maraš,SRB,DF,25,1995,11.6,13,9,12,1,0,9,15,60.0,6,17,13,4,15,28,51,0,2022
ESP-La Liga,2021,Rayo Vallecano,Pathé Ciss,SEN,MF,27,1994,12.2,31,15,20,8,3,12,26,46.2,14,16,6,10,30,61,27,0,2022
ESP-La Liga,2021,Rayo Vallecano,Radamel Falcao,COL,FW,35,1986,9.3,2,1,0,1,1,1,4,25.0,3,4,1,3,2,4,11,0,2022
ESP-La Liga,2021,Rayo Vallecano,Randy Ntekja,FRA,"FW,MF",23,1997,16.2,24,13,9,11,4,8,19,42.1,11,21,1,20,8,32,12,0,2022
ESP-La Liga,2021,Rayo Vallecano,Santi Comesaña,ESP,MF,24,1996,29.8,87,56,45,33,9,40,104,38.5,64,46,6,40,33,120,30,0,2022
ESP-La Liga,2021,Rayo Vallecano,Sergi Guardiola,ESP,FW,30,1991,19.0,10,9,3,5,2,1,21,4.8,20,14,2,12,4,14,17,0,2022
ESP-La Liga,2021,Rayo Vallecano,Stole Dimitrievski,MKD,GK,27,1993,30.8,0,0,0,0,0,0,0,,0,0,0,0,1,1,14,3,2022
ESP-La Liga,2021,Rayo Vallecano,Unai López,ESP,MF,25,1995,12.9,19,9,6,10,3,10,33,30.3,23,7,0,7,10,29,8,1,2022
ESP-La Liga,2021,Rayo Vallecano,Yacine Qasmi,MAR,FW,30,1991,0.0,0,0,0,0,0,0,0,,0,0,0,0,0,0,0,0,2022
ESP-La Liga,2021,Rayo Vallecano,Álvaro Aguirre,ESP,FW,21,2000,0.1,0,0,0,0,0,0,0,,0,0,0,0,0,0,0,0,2022
ESP-La Liga,2021,Rayo Vallecano,Álvaro García,ESP,"FW,MF",28,1992,33.3,42,23,15,18,9,8,35,22.9,27,27,3,24,42,84,24,0,2022
ESP-La Liga,2021,Rayo Vallecano,Óscar Trejo,ARG,MF,33,1988,22.3,42,24,14,18,10,15,50,30.0,35,26,1,25,13,55,11,0,2022
ESP-La Liga,2021,Rayo Vallecano,Óscar Valentín,ESP,MF,26,1994,28.5,102,53,46,51,5,44,105,41.9,61,56,10,46,39,141,43,0,2022
ESP-La Liga,2021,Real Madrid,Andriy Lunin,UKR,GK,22,1999,2.0,0,0,0,0,0,0,0,,0,0,0,0,0,0,2,0,2022
ESP-La Liga,2021,Real Madrid,Blanco,ESP,MF,21,2000,0.3,2,0,1,1,0,0,0,,0,1,1,0,1,3,0,0,2022
ESP-La Liga,2021,Real Madrid,Casemiro,BRA,MF,29,1992,28.5,79,51,45,30,4,30,67,44.8,37,65,19,46,38,117,65,3,2022
ESP-La Liga,2021,Real Madrid,Dani Carvajal,ESP,DF,29,1992,17.2,43,28,21,15,7,15,26,57.7,11,22,8,14,20,63,38,2,2022
ESP-La Liga,2021,Real Madrid,Dani Ceballos,ESP,MF,24,1996,3.1,7,5,4,3,0,1,5,20.0,4,8,2,6,4,11,2,0,2022
ESP-La Liga,2021,Real Madrid,David Alaba,AUT,DF,29,1992,29.4,23,13,15,6,2,9,19,47.4,10,26,15,11,22,45,70,1,2022
ESP-La Liga,2021,Real Madrid,Eden Hazard,BEL,"FW,MF",30,1991,8.0,6,3,3,2,1,3,7,42.9,4,3,0,3,2,8,0,0,2022
ESP-La Liga,2021,Real Madrid,Eduardo Camavinga,FRA,MF,18,2002,13.7,52,35,22,20,10,20,38,52.6,18,20,2,18,17,69,14,1,2022
ESP-La Liga,2021,Real Madrid,Federico Valverde,URU,MF,23,1998,20.4,36,16,11,16,9,12,31,38.7,19,23,5,18,24,60,12,0,2022
ESP-La Liga,2021,Real Madrid,Ferland Mendy,FRA,DF,26,1995,19.3,24,14,11,10,3,8,14,57.1,6,8,2,6,18,42,27,3,2022
ESP-La Liga,2021,Real Madrid,Gareth Bale,WAL,FW,32,1989,3.1,2,1,1,0,1,1,4,25.0,3,2,0,2,2,4,1,0,2022
ESP-La Liga,2021,Real Madrid,Isco,ESP,"MF,FW",29,1992,3.7,9,5,4,4,1,5,12,41.7,7,1,0,1,2,11,1,0,2022
ESP-La Liga,2021,Real Madrid,Jesús Vallejo,ESP,DF,24,1997,3.8,7,5,7,0,0,5,6,83.3,1,9,8,1,6,13,16,0,2022
ESP-La Liga,2021,Real Madrid,Karim Benzema,FRA,FW,33,1987,28.8,11,9,5,3,3,2,9,22.2,7,10,0,10,4,15,13,0,2022
ESP-La Liga,2021,Real Madrid,Latasa,ESP,FW,20,2001,0.1,0,0,0,0,0,0,0,,0,0,0,0,0,0,0,0,2022
ESP-La Liga,2021,Real Madrid,Lucas Vázquez,ESP,DF,30,1991,20.4,43,22,24,9,10,17,35,48.6,18,25,7,18,20,63,41,1,2022
ESP-La Liga,2021,Real Madrid,Luka Jović,SRB,FW,23,1997,4.1,1,1,0,1,0,0,1,0.0,1,3,0,3,1,2,4,0,2022
ESP-La Liga,2021,Real Madrid,Luka Modrić,CRO,MF,35,1985,22.6,18,10,8,7,3,6,27,22.2,21,10,4,6,20,38,9,0,2022
ESP-La Liga,2021,Real Madrid,Marcelo,BRA,DF,33,1988,5.8,8,4,2,3,3,5,10,50.0,5,7,2,5,1,9,11,0,2022
ESP-La Liga,2021,Real Madrid,Marco Asensio,ESP,"FW,MF",25,1996,19.2,12,8,6,4,2,4,18,22.2,14,8,1,7,12,24,6,1,2022
ESP-La Liga,2021,Real Madrid,Mariano,DOM,FW,27,1993,3.8,2,0,2,0,0,0,0,,0,2,0,2,1,3,3,0,2022
ESP-La Liga,2021,Real Madrid,Mario Gila,ESP,DF,20,2000,0.3,1,0,1,0,0,0,1,0.0,1,0,0,0,1,2,1,0,2022
ESP-La Liga,2021,Real Madrid,Miguel Gutiérrez,ESP,DF,20,2001,2.9,7,5,5,0,2,3,5,60.0,2,0,0,0,2,9,2,0,2022
ESP-La Liga,2021,Real Madrid,Nacho,ESP,DF,31,1990,17.3,18,14,9,9,0,12,22,54.5,10,22,15,7,34,52,50,0,2022
ESP-La Liga,2021,Real Madrid,Peter González,DOM,"MF,DF",19,2002,0.3,0,0,0,0,0,0,0,,0,0,0,0,1,1,0,0,2022
ESP-La Liga,2021,Real Madrid,Rodrygo,BRA,FW,20,2001,16.9,18,14,7,4,7,3,18,16.7,15,21,0,21,11,29,3,0,2022
ESP-La Liga,2021,Real Madrid,Sergio Santos,ESP,DF,20,2001,0.1,0,0,0,0,0,0,0,,0,0,0,0,0,0,0,0,2022
ESP-La Liga,2021,Real Madrid,Thibaut Courtois,BEL,GK,29,1992,36.0,1,0,1,0,0,1,2,50.0,1,0,0,0,0,1,9,1,2022
ESP-La Liga,2021,Real Madrid,Toni Kroos,GER,MF,31,1990,23.4,34,26,13,17,4,14,36,38.9,22,16,3,13,12,46,13,1,2022
ESP-La Liga,2021,Real Madrid,Vinicius Júnior,BRA,FW,21,2000,29.9,46,24,23,19,4,15,50,30.0,35,25,0,25,6,52,6,0,2022
ESP-La Liga,2021,Real Madrid,Éder Militão,BRA,DF,23,1998,33.7,50,32,30,12,8,20,39,51.3,19,42,20,22,52,102,107,3,2022
ESP-La Liga,2021,Real Sociedad,Adnan Januzaj,BEL,"FW,MF",26,1995,18.1,17,11,5,8,4,9,24,37.5,15,15,3,12,12,29,15,0,2022
ESP-La Liga,2021,Real Sociedad,Aihen Muñoz,ESP,DF,23,1997,14.9,28,17,14,13,1,18,29,62.1,11,11,1,10,17,45,34,0,2022
ESP-La Liga,2021,Real Sociedad,Alex Sola,ESP,"DF,FW",22,1999,0.5,1,1,1,0,0,1,3,33.3,2,1,0,1,2,3,3,0,2022
ESP-La Liga,2021,Real Sociedad,Alexander Isak,SWE,FW,21,1999,23.8,7,4,1,3,3,2,12,16.7,10,14,2,12,3,10,10,0,2022
ESP-La Liga,2021,Real Sociedad,Alexander Sørloth,NOR,FW,25,1995,19.6,20,7,4,10,6,7,17,41.2,10,14,1,13,4,24,15,0,2022
ESP-La Liga,2021,Real Sociedad,Ander Barrenetxea,ESP,"FW,MF",19,2001,6.1,15,10,9,6,0,8,18,44.4,10,7,0,7,2,17,2,0,2022
ESP-La Liga,2021,Real Sociedad,Ander Guevara,ESP,MF,24,1997,9.6,18,13,6,10,2,10,17,58.8,7,12,6,6,12,30,8,0,2022
ESP-La Liga,2021,Real Sociedad,Ander Martin,ESP,"FW,MF",20,2000,1.0,1,0,0,1,0,1,1,100.0,0,0,0,0,3,4,1,0,2022
ESP-La Liga,2021,Real Sociedad,Andoni Gorosabel,ESP,DF,24,1996,25.4,47,31,32,9,6,25,47,53.2,22,16,3,13,18,65,49,0,2022
ESP-La Liga,2021,Real Sociedad,Aritz Elustondo,ESP,DF,27,1994,23.4,21,14,16,5,0,10,20,50.0,10,19,13,6,29,50,86,0,2022
ESP-La Liga,2021,Real Sociedad,Asier Illarramendi,ESP,MF,31,1990,4.2,9,5,5,3,1,1,10,10.0,9,5,1,4,4,13,12,0,2022
ESP-La Liga,2021,Real Sociedad,Beñat Turrientes,ESP,MF,19,2002,2.3,0,0,0,0,0,0,4,0.0,4,1,0,1,2,2,2,0,2022
ESP-La Liga,2021,Real Sociedad,Cristo,ESP,DF,21,2000,0.2,0,0,0,0,0,0,0,,0,0,0,0,0,0,0,0,2022
ESP-La Liga,2021,Real Sociedad,David Silva,ESP,MF,35,1986,19.1,28,17,10,11,7,3,20,15.0,17,13,3,10,7,35,12,0,2022
ESP-La Liga,2021,Real Sociedad,Diego Rico,ESP,DF,28,1993,18.3,41,20,19,17,5,22,45,48.9,23,29,4,25,30,71,54,0,2022
ESP-La Liga,2021,Real Sociedad,Germán Valera,ESP,FW,19,2002,0.6,3,2,3,0,0,1,1,100.0,0,0,0,0,0,3,1,0,2022
ESP-La Liga,2021,Real Sociedad,Igor Zubeldia,ESP,DF,24,1997,18.3,20,10,12,8,0,12,18,66.7,6,16,6,10,27,47,53,0,2022
ESP-La Liga,2021,Real Sociedad,Jon Bautista,ESP,MF,26,1995,0.5,3,0,0,3,0,0,1,0.0,1,1,0,1,1,4,1,0,2022
ESP-La Liga,2021,Real Sociedad,Jon Guridi,ESP,MF,26,1995,2.3,5,3,2,3,0,1,4,25.0,3,3,1,2,3,8,4,0,2022
ESP-La Liga,2021,Real Sociedad,Jon Pacheco,ESP,DF,20,2001,4.2,6,4,4,2,0,3,3,100.0,0,6,4,2,6,12,18,0,2022
ESP-La Liga,2021,Real Sociedad,Joseba Zaldúa,ESP,DF,29,1992,13.0,31,22,20,8,3,16,22,72.7,6,14,4,10,13,44,35,0,2022
ESP-La Liga,2021,Real Sociedad,Julen Lobete,ESP,"FW,MF",20,2000,3.2,4,3,3,0,1,1,2,50.0,1,6,1,5,1,5,1,0,2022
ESP-La Liga,2021,Real Sociedad,Martín Zubimendi,ESP,MF,22,1999,28.8,52,25,19,30,3,22,44,50.0,22,30,13,17,49,101,48,1,2022
ESP-La Liga,2021,Real Sociedad,Mathew Ryan,AUS,GK,29,1992,3.0,0,0,0,0,0,0,0,,0,0,0,0,0,0,2,0,2022
ESP-La Liga,2021,Real Sociedad,Mikel Merino,ESP,MF,25,1996,32.1,71,38,21,40,10,26,67,38.8,41,50,10,40,21,92,56,2,2022
ESP-La Liga,2021,Real Sociedad,Mikel Oyarzabal,ESP,"FW,MF",24,1997,18.6,18,10,7,7,4,7,21,33.3,14,18,2,16,10,28,16,1,2022
ESP-La Liga,2021,Real Sociedad,Naïs Djouahra,FRA,"FW,MF",21,1999,2.4,7,3,2,2,3,4,8,50.0,4,3,0,3,2,9,2,0,2022
ESP-La Liga,2021,Real Sociedad,Portu,ESP,"FW,MF",29,1992,17.7,16,7,2,6,8,3,19,15.8,16,21,3,18,7,23,8,0,2022
ESP-La Liga,2021,Real Sociedad,Rafinha,BRA,MF,28,1993,11.7,43,27,17,20,6,16,28,57.1,12,21,2,19,12,55,4,0,2022
ESP-La Liga,2021,Real Sociedad,Roberto Navarro,ESP,"MF,FW",19,2002,2.2,5,3,1,1,3,3,5,60.0,2,2,0,2,2,7,2,0,2022
ESP-La Liga,2021,Real Sociedad,Robin Le Normand,ESP,DF,24,1996,37.0,49,32,36,8,5,28,36,77.8,8,34,22,12,48,97,125,0,2022
ESP-La Liga,2021,Real Sociedad,Álex Remiro,ESP,GK,26,1995,35.0,0,0,0,0,0,0,0,,0,0,0,0,1,1,24,2,2022
ESP-La Liga,2021,Sevilla,Anthony Martial,FRA,"FW,MF",25,1995,5.4,2,1,0,0,2,2,6,33.3,4,4,0,4,0,2,3,0,2022
ESP-La Liga,2021,Sevilla,Carmona,ESP,DF,19,2002,0.3,0,0,0,0,0,0,0,,0,0,0,0,1,1,0,0,2022
ESP-La Liga,2021,Sevilla,Diego Carlos,BRA,DF,28,1993,32.9,35,24,20,13,2,16,24,66.7,8,48,33,15,24,59,120,5,2022
ESP-La Liga,2021,Sevilla,Fernando,BRA,"MF,DF",34,1987,20.6,24,17,14,9,1,12,33,36.4,21,21,13,8,29,53,32,2,2022
ESP-La Liga,2021,Sevilla,Gonzalo Montiel,ARG,DF,24,1997,11.8,15,4,8,5,2,12,24,50.0,12,8,2,6,10,25,22,0,2022
ESP-La Liga,2021,Sevilla,Ivan Rakitić,CRO,MF,33,1988,24.2,40,22,12,23,5,13,40,32.5,27,31,8,23,23,63,35,0,2022
ESP-La Liga,2021,Sevilla,Iván Romero,ESP,FW,20,2001,2.0,2,2,0,2,0,0,0,,0,1,0,1,2,4,0,0,2022
ESP-La Liga,2021,Sevilla,Javier Díaz,ESP,GK,24,1997,1.0,0,0,0,0,0,0,0,,0,0,0,0,0,0,0,0,2022
ESP-La Liga,2021,Sevilla,Jesús Corona,MEX,"FW,DF",28,1993,12.9,12,7,7,5,0,3,6,50.0,3,4,0,4,8,20,6,0,2022
ESP-La Liga,2021,Sevilla,Jesús Navas,ESP,DF,35,1985,19.8,18,13,11,5,2,9,17,52.9,8,15,2,13,17,35,26,1,2022
ESP-La Liga,2021,Sevilla,Joan Jordán,ESP,MF,27,1994,27.9,61,30,22,31,8,28,65,43.1,37,27,6,21,30,91,18,1,2022
ESP-La Liga,2021,Sevilla,Juan Sánchez,ESP,,17,2003,0.1,,0,,,,,,,,,,,0,,,,2022
ESP-La Liga,2021,Sevilla,Jules Koundé,FRA,DF,22,1998,30.4,40,17,27,10,3,18,28,64.3,10,33,18,15,21,61,101,2,2022
ESP-La Liga,2021,Sevilla,Karim Rekik,NED,DF,26,1994,12.2,11,8,4,6,1,2,9,22.2,7,11,6,5,9,20,19,0,2022
ESP-La Liga,2021,Sevilla,Lucas Ocampos,ARG,FW,27,1994,23.6,45,24,23,18,4,23,55,41.8,32,35,1,34,9,54,24,1,2022
ESP-La Liga,2021,Sevilla,Ludwig Augustinsson,SWE,"DF,FW",27,1994,8.8,18,14,11,3,4,8,13,61.5,5,10,3,7,5,23,21,0,2022
ESP-La Liga,2021,Sevilla,Luismi,ESP,"FW,MF",20,2001,0.1,0,0,0,0,0,0,0,,0,0,0,0,0,0,0,0,2022
ESP-La Liga,2021,Sevilla,Marcos Acuña,ARG,DF,29,1991,25.1,50,29,27,14,9,30,46,65.2,16,22,5,17,14,64,25,1,2022
ESP-La Liga,2021,Sevilla,Marko Dmitrović,SRB,GK,29,1992,6.0,0,0,0,0,0,0,0,,0,0,0,0,0,0,3,1,2022
ESP-La Liga,2021,Sevilla,Munir El Haddadi,MAR,"FW,MF",25,1995,5.3,8,4,1,6,1,2,8,25.0,6,7,1,6,5,13,2,0,2022
ESP-La Liga,2021,Sevilla,Nemanja Gudelj,SRB,"DF,MF",29,1991,11.6,16,7,10,4,2,5,8,62.5,3,14,9,5,22,38,37,0,2022
ESP-La Liga,2021,Sevilla,Oussama Idrissi,MAR,"MF,FW",25,1996,1.4,1,0,0,1,0,0,1,0.0,1,1,0,1,1,2,1,0,2022
ESP-La Liga,2021,Sevilla,Papu Gómez,ARG,"FW,MF",33,1988,19.8,19,11,9,5,5,9,35,25.7,26,15,2,13,7,26,12,2,2022
ESP-La Liga,2021,Sevilla,Pedro Ortiz,ESP,MF,20,2000,0.1,0,0,0,0,0,0,0,,0,0,0,0,0,0,1,0,2022
ESP-La Liga,2021,Sevilla,Rafa Mir,ESP,FW,24,1997,20.1,4,3,1,1,2,0,11,0.0,11,4,3,1,0,4,17,0,2022
ESP-La Liga,2021,Sevilla,Suso,ESP,FW,27,1993,4.3,4,3,1,3,0,3,13,23.1,10,4,0,4,0,4,0,0,2022
ESP-La Liga,2021,Sevilla,Thomas Delaney,DEN,MF,29,1991,17.2,41,24,17,21,3,16,30,53.3,14,19,10,9,13,54,35,0,2022
ESP-La Liga,2021,Sevilla,Valentino Scotta,ESP,DF,19,2001,0.0,0,0,0,0,0,0,0,,0,0,0,0,0,0,0,0,2022
ESP-La Liga,2021,Sevilla,Yassine Bounou,MAR,GK,30,1991,31.0,0,0,0,0,0,0,0,,0,0,0,0,0,0,11,1,2022
ESP-La Liga,2021,Sevilla,Youssef En-Nesyri,MAR,FW,24,1997,14.2,10,5,5,2,3,4,11,36.4,7,9,1,8,4,14,18,0,2022
ESP-La Liga,2021,Sevilla,Érik Lamela,ARG,"FW,MF",29,1992,11.3,31,18,12,14,5,10,29,34.5,19,11,0,11,5,36,3,0,2022
ESP-La Liga,2021,Sevilla,Óliver Torres,ESP,"MF,FW",26,1994,11.2,22,12,8,7,7,8,25,32.0,17,10,1,9,6,28,4,0,2022
ESP-La Liga,2021,Sevilla,Óscar Rodríguez Arnaiz,ESP,"FW,MF",23,1998,4.6,4,3,1,3,0,2,3,66.7,1,2,0,2,5,9,7,1,2022
ESP-La Liga,2021,Valencia,Bryan,ESP,"MF,FW",20,2001,8.4,13,8,6,3,4,2,13,15.4,11,13,0,13,1,14,4,0,2022
ESP-La Liga,2021,Valencia,Carlos Soler,ESP,MF,24,1997,27.5,29,19,10,15,4,11,37,29.7,26,19,4,15,14,43,28,0,2022
ESP-La Liga,2021,Valencia,Cristhian Mosquera,COL,DF,17,2004,2.4,4,2,3,0,1,3,6,50.0,3,1,0,1,3,7,1,1,2022
ESP-La Liga,2021,Valencia,Cristiano Piccini,ITA,DF,28,1992,3.6,14,8,9,5,0,5,7,71.4,2,3,2,1,1,15,11,0,2022
ESP-La Liga,2021,Valencia,Daniel Wass,DEN,MF,32,1989,17.6,23,13,6,14,3,8,31,25.8,23,13,2,11,13,36,19,0,2022
ESP-La Liga,2021,Valencia,Denis Cheryshev,RUS,"MF,FW",30,1990,6.3,14,5,6,1,7,6,15,40.0,9,9,1,8,9,23,9,0,2022
ESP-La Liga,2021,Valencia,Dimitri Foulquier,FRA,DF,28,1993,26.0,36,17,17,15,4,21,34,61.8,13,19,3,16,29,65,49,0,2022
ESP-La Liga,2021,Valencia,Eray Cömert,SUI,DF,23,1998,4.5,5,3,4,1,0,3,6,50.0,3,3,2,1,2,7,6,0,2022
ESP-La Liga,2021,Valencia,Gabriel Paulista,BRA,DF,30,1990,17.7,21,12,16,5,0,14,20,70.0,6,18,12,6,39,60,88,0,2022
ESP-La Liga,2021,Valencia,Giorgi Mamardashvili,GEO,GK,20,2000,18.0,0,0,0,0,0,0,0,,0,0,0,0,0,0,6,1,2022
ESP-La Liga,2021,Valencia,Gonçalo Guedes,POR,"FW,MF",24,1996,29.0,21,14,6,7,8,2,22,9.1,20,14,0,14,9,30,1,0,2022
ESP-La Liga,2021,Valencia,Hugo Duro,ESP,"FW,MF",21,1999,20.4,25,19,11,13,1,15,38,39.5,23,24,2,22,4,29,20,1,2022
ESP-La Liga,2021,Valencia,Hugo Guillamón,ESP,"MF,DF",21,2000,26.2,43,27,20,16,7,18,44,40.9,26,26,10,16,30,73,53,1,2022
ESP-La Liga,2021,Valencia,Hélder Costa,ANG,"MF,FW",27,1994,12.4,27,16,11,9,7,14,41,34.1,27,12,1,11,3,30,9,0,2022
ESP-La Liga,2021,Valencia,Ilaix Moriba,GUI,MF,18,2003,9.1,26,18,10,13,3,14,35,40.0,21,15,0,15,12,38,14,0,2022
ESP-La Liga,2021,Valencia,Jason,ESP,"MF,DF",27,1994,0.8,4,1,2,1,1,0,1,0.0,1,2,0,2,1,5,1,0,2022
ESP-La Liga,2021,Valencia,Jasper Cillessen,NED,GK,32,1989,16.2,0,0,0,0,0,0,1,0.0,1,0,0,0,1,1,6,0,2022
ESP-La Liga,2021,Valencia,Jaume Doménech,ESP,GK,30,1990,3.8,0,0,0,0,0,0,0,,0,0,0,0,0,0,3,1,2022
ESP-La Liga,2021,Valencia,Jesus Vazquez,ESP,DF,18,2003,9.0,24,13,10,8,6,10,22,45.5,12,16,3,13,9,33,19,0,2022
ESP-La Liga,2021,Valencia,Jesús Santiago,ESP,MF,17,2004,0.9,2,2,1,1,0,0,2,0.0,2,1,0,1,0,2,1,0,2022
ESP-La Liga,2021,Valencia,José Luis Gayà,ESP,DF,26,1995,20.8,35,21,24,10,1,16,34,47.1,18,17,3,14,19,54,37,0,2022
ESP-La Liga,2021,Valencia,Koba Koindredi,FRA,MF,19,2001,2.0,4,3,2,1,1,2,6,33.3,4,3,0,3,4,8,5,0,2022
ESP-La Liga,2021,Valencia,Manu Vallejo,ESP,"FW,MF",24,1997,1.1,2,1,1,1,0,0,1,0.0,1,0,0,0,0,2,1,0,2022
ESP-La Liga,2021,Valencia,Maranhão,BRA,"FW,MF",24,1996,10.8,15,11,4,6,5,5,16,31.3,11,15,0,15,7,22,13,0,2022
ESP-La Liga,2021,Valencia,Mario Dominguez,ESP,FW,17,2004,0.3,0,0,0,0,0,0,0,,0,0,0,0,0,0,1,0,2022
ESP-La Liga,2021,Valencia,Maxi Gómez,URU,FW,24,1996,21.7,5,3,1,2,2,5,8,62.5,3,5,1,4,3,8,22,0,2022
ESP-La Liga,2021,Valencia,Mouctar Diakhaby,GUI,DF,24,1996,21.6,35,24,18,15,2,13,23,56.5,10,29,17,12,30,65,87,3,2022
ESP-La Liga,2021,Valencia,Omar Alderete,PAR,DF,24,1996,26.7,53,34,34,17,2,34,53,64.2,19,30,18,12,35,88,153,0,2022
ESP-La Liga,2021,Valencia,Ruben Lendinez,ESP,DF,18,2003,1.5,3,3,1,2,0,3,8,37.5,5,4,0,4,2,5,6,0,2022
ESP-La Liga,2021,Valencia,Rubén Sobrino,ESP,MF,29,1992,0.2,1,1,1,0,0,1,1,100.0,0,1,0,1,2,3,0,0,2022
ESP-La Liga,2021,Valencia,Thierry Correia,POR,DF,22,1999,15.7,35,23,26,6,3,14,29,48.3,15,20,5,15,19,54,27,0,2022
ESP-La Liga,2021,Valencia,Toni Lato,ESP,DF,23,1997,6.6,17,12,12,3,2,9,16,56.3,7,6,0,6,8,25,14,0,2022
ESP-La Liga,2021,Valencia,Uroš Račić,SRB,MF,23,1998,13.4,32,18,9,19,4,12,33,36.4,21,16,6,10,16,48,21,0,2022
ESP-La Liga,2021,Valencia,Yunus Musah,USA,"MF,FW",18,2002,14.0,23,13,8,8,7,6,20,30.0,14,19,1,18,14,37,11,0,2022
ESP-La Liga,2021,Villarreal,Alberto Moreno,ESP,"MF,DF",29,1992,13.6,13,7,5,7,1,5,18,27.8,13,13,1,12,27,40,15,0,2022
ESP-La Liga,2021,Villarreal,Alfonso Pedraza,ESP,DF,25,1996,18.9,34,16,17,12,5,10,28,35.7,18,12,3,9,31,65,32,0,2022
ESP-La Liga,2021,Villarreal,Arnaut Danjuma,NED,FW,24,1997,16.4,7,6,3,0,4,2,4,50.0,2,5,0,5,2,9,3,0,2022
ESP-La Liga,2021,Villarreal,Aïssa Mandi,ALG,DF,29,1991,15.3,11,5,2,8,1,3,6,50.0,3,17,14,3,13,24,49,3,2022
ESP-La Liga,2021,Villarreal,Boulaye Dia,SEN,FW,24,1996,14.1,8,6,3,4,1,2,5,40.0,3,6,1,5,5,13,4,0,2022
ESP-La Liga,2021,Villarreal,Carlo,ESP,MF,20,2001,0.1,0,0,0,0,0,0,0,,0,0,0,0,0,0,0,0,2022
ESP-La Liga,2021,Villarreal,Dani Raba,ESP,"MF,FW",25,1995,1.0,1,0,0,1,0,1,2,50.0,1,2,0,2,0,1,2,0,2022
ESP-La Liga,2021,Villarreal,Daniel Parejo,ESP,MF,32,1989,30.0,43,29,15,15,13,20,52,38.5,32,32,7,25,29,72,19,1,2022
ESP-La Liga,2021,Villarreal,Francis Coquelin,FRA,MF,30,1991,9.2,26,17,9,11,6,11,20,55.0,9,15,5,10,19,45,11,0,2022
ESP-La Liga,2021,Villarreal,Gerard Moreno,ESP,FW,29,1992,13.2,5,2,2,2,1,1,7,14.3,6,6,1,5,6,11,14,0,2022
ESP-La Liga,2021,Villarreal,Gerónimo Rulli,ARG,GK,29,1992,32.0,0,0,0,0,0,0,4,0.0,4,0,0,0,1,1,15,5,2022
ESP-La Liga,2021,Villarreal,Giovani Lo Celso,ARG,"FW,MF",25,1996,11.0,22,12,8,10,4,9,22,40.9,13,4,0,4,5,27,3,0,2022
ESP-La Liga,2021,Villarreal,Juan Foyth,ARG,DF,23,1998,21.4,69,49,35,28,6,35,47,74.5,12,29,7,22,20,89,50,0,2022
ESP-La Liga,2021,Villarreal,Manu Trigueros,ESP,"MF,FW",29,1991,24.2,45,25,16,18,11,23,66,34.8,43,19,3,16,13,58,17,0,2022
ESP-La Liga,2021,Villarreal,Mario Gaspar,ESP,DF,30,1990,6.9,10,4,2,5,3,6,10,60.0,4,6,3,3,6,16,15,0,2022
ESP-La Liga,2021,Villarreal,Moi Gómez,ESP,"MF,FW",27,1994,14.3,15,7,8,3,4,5,17,29.4,12,5,0,5,6,21,6,0,2022
ESP-La Liga,2021,Villarreal,Nicolas Jackson,SEN,"FW,MF",20,2001,1.8,2,0,1,0,1,0,0,,0,0,0,0,1,3,1,0,2022
ESP-La Liga,2021,Villarreal,Nikita Iosifov,RUS,MF,20,2001,0.0,0,0,0,0,0,0,0,,0,0,0,0,0,0,0,0,2022
ESP-La Liga,2021,Villarreal,Paco Alcácer,ESP,FW,27,1993,8.7,9,3,2,4,3,1,5,20.0,4,7,0,7,6,15,1,0,2022
ESP-La Liga,2021,Villarreal,Pau Torres,ESP,DF,24,1997,31.7,32,19,23,7,2,18,25,72.0,7,32,23,9,19,51,105,2,2022
ESP-La Liga,2021,Villarreal,Pervis Estupiñán,ECU,DF,23,1998,17.5,36,22,20,11,5,17,24,70.8,7,13,5,8,25,61,29,2,2022
ESP-La Liga,2021,Villarreal,Raúl Albiol,ESP,DF,35,1985,27.4,26,15,20,5,1,14,18,77.8,4,24,15,9,21,47,126,1,2022
ESP-La Liga,2021,Villarreal,Rubén Peña,ESP,"MF,FW",30,1991,1.5,2,0,1,1,0,2,6,33.3,4,1,0,1,5,7,2,0,2022
ESP-La Liga,2021,Villarreal,Samuel Chukwueze,NGA,"MF,FW",22,1999,14.8,13,9,6,5,2,3,6,50.0,3,7,0,7,5,18,4,0,2022
ESP-La Liga,2021,Villarreal,Serge Aurier,CIV,DF,28,1992,11.2,14,9,11,2,1,4,7,57.1,3,14,7,7,11,25,25,0,2022
ESP-La Liga,2021,Villarreal,Sergio Asenjo,ESP,GK,32,1989,6.0,0,0,0,0,0,0,1,0.0,1,0,0,0,1,1,6,0,2022
ESP-La Liga,2021,Villarreal,Vicente Iborra,ESP,MF,33,1988,11.5,19,10,9,7,3,12,24,50.0,12,11,5,6,11,30,27,1,2022
ESP-La Liga,2021,Villarreal,Yeremi Pino,ESP,"MF,FW",18,2002,18.6,32,14,14,8,10,10,24,41.7,14,33,4,29,6,38,12,1,2022
ESP-La Liga,2021,Villarreal,Étienne Capoue,FRA,MF,33,1988,25.4,44,26,18,23,3,15,28,53.6,13,17,5,12,35,79,51,0,2022
ESP-La Liga,2022,Almería,Adri Embarba,ESP,"FW,MF",30,1992,16.4,50,27,21,26,3,22,46,47.8,24,23,0,23,9,59,9,0,2023
ESP-La Liga,2022,Almería,Alejandro Pozo Pozo,ESP,DF,23,1999,20.9,37,19,17,17,3,27,53,50.9,26,30,5,25,26,63,45,1,2023
ESP-La Liga,2022,Almería,Arnau Puigmal,ESP,"MF,FW",21,2001,8.5,22,14,10,7,5,12,17,70.6,5,7,0,7,11,33,6,0,2023
ESP-La Liga,2022,Almería,Curro,ESP,MF,26,1996,0.5,2,0,1,1,0,1,2,50.0,1,0,0,0,0,2,0,0,2023
ESP-La Liga,2022,Almería,César de la Hoz,ESP,MF,30,1992,18.6,37,20,17,18,2,19,37,51.4,18,26,6,20,13,50,37,0,2023
ESP-La Liga,2022,Almería,Diego Mariño,ESP,GK,32,1990,0.5,0,0,0,0,0,0,0,,0,0,0,0,0,0,0,0,2023
ESP-La Liga,2022,Almería,Dyego Sousa,POR,FW,32,1989,5.9,10,6,5,4,1,4,5,80.0,1,4,2,2,1,11,14,0,2023
ESP-La Liga,2022,Almería,El Bilal Touré,MLI,FW,20,2001,14.0,4,3,2,1,1,0,3,0.0,3,6,1,5,1,5,23,0,2023
ESP-La Liga,2022,Almería,Fernando,ESP,GK,32,1990,36.5,0,0,0,0,0,0,2,0.0,2,2,0,2,1,1,20,3,2023
ESP-La Liga,2022,Almería,Fernando Pacheco,ESP,GK,30,1992,1.0,0,0,0,0,0,0,0,,0,0,0,0,0,0,1,0,2023
ESP-La Liga,2022,Almería,Francisco Portillo,ESP,"MF,FW",32,1990,8.0,13,6,4,5,4,3,16,18.8,13,7,1,6,7,20,8,0,2023
ESP-La Liga,2022,Almería,Gonzalo Melero,ESP,MF,28,1994,20.6,32,16,9,18,5,11,39,28.2,28,23,2,21,7,39,19,1,2023
ESP-La Liga,2022,Almería,Houboulang Mendes,FRA,DF,24,1998,9.8,19,11,16,3,0,11,27,40.7,16,12,2,10,7,26,23,1,2023
ESP-La Liga,2022,Almería,José Carlos Lazo,ESP,"MF,FW",26,1996,0.2,0,0,0,0,0,0,0,,0,0,0,0,0,0,0,0,2023
ESP-La Liga,2022,Almería,Juan Brandáriz,ESP,DF,23,1999,16.5,29,16,18,9,2,14,23,60.9,9,20,7,13,15,44,53,0,2023
ESP-La Liga,2022,Almería,Kaiky,BRA,DF,18,2004,6.5,5,5,5,0,0,3,7,42.9,4,18,10,8,11,16,28,0,2023
ESP-La Liga,2022,Almería,Largie Ramazani,BEL,"FW,MF",21,2001,15.6,15,9,6,3,6,8,27,29.6,19,11,0,11,15,30,10,0,2023
ESP-La Liga,2022,Almería,Lucas Robertone,ARG,MF,25,1997,31.6,50,28,20,21,9,28,64,43.8,36,45,7,38,46,96,46,1,2023
ESP-La Liga,2022,Almería,Luis Javier Suárez,COL,FW,24,1997,16.6,17,11,5,6,6,6,26,23.1,20,13,3,10,3,20,10,0,2023
ESP-La Liga,2022,Almería,Lázaro,BRA,"FW,MF",20,2002,8.0,4,3,3,0,1,3,15,20.0,12,16,1,15,2,6,1,0,2023
ESP-La Liga,2022,Almería,Léo Baptistão,BRA,"FW,MF",29,1992,19.2,32,20,13,16,3,13,33,39.4,20,17,2,15,19,51,12,0,2023
ESP-La Liga,2022,Almería,Marko Milovanović,SRB,FW,18,2003,0.2,0,0,0,0,0,0,0,,0,0,0,0,0,0,0,0,2023
ESP-La Liga,2022,Almería,Rodrigo Ely,BRA,DF,28,1993,35.1,30,21,26,4,0,18,25,72.0,7,46,33,13,31,61,203,1,2023
ESP-La Liga,2022,Almería,Samu Costa,POR,MF,21,2000,22.1,61,31,35,20,6,29,61,47.5,32,29,7,22,37,98,64,4,2023
ESP-La Liga,2022,Almería,Sergio Akieme,ESP,DF,24,1997,25.5,27,16,19,6,2,12,22,54.5,10,22,6,16,14,41,41,0,2023
ESP-La Liga,2022,Almería,Srđan Babić,SRB,DF,26,1996,33.3,28,18,20,8,0,15,32,46.9,17,34,22,12,29,57,124,1,2023
ESP-La Liga,2022,Almería,Umar Sadiq,NGA,FW,25,1997,2.7,0,0,0,0,0,0,1,0.0,1,2,0,2,0,0,3,0,2023
ESP-La Liga,2022,Almería,Álex Centelles,ESP,DF,24,1997,12.5,22,14,16,3,3,16,22,72.7,6,13,2,11,11,33,40,0,2023
ESP-La Liga,2022,Almería,Íñigo Eguaras,ESP,MF,30,1992,10.7,11,8,4,6,1,5,18,27.8,13,9,3,6,6,17,15,0,2023
ESP-La Liga,2022,Athletic Club,Aitor Paredes,ESP,DF,22,2000,9.5,7,6,4,2,1,6,11,54.5,5,11,7,4,14,21,26,0,2023
ESP-La Liga,2022,Athletic Club,Ander Capa,ESP,DF,30,1992,1.2,1,1,1,0,0,1,5,20.0,4,5,0,5,0,1,2,0,2023
ESP-La Liga,2022,Athletic Club,Ander Herrera,ESP,MF,32,1989,7.7,18,10,8,7,3,6,18,33.3,12,12,3,9,11,29,12,0,2023
ESP-La Liga,2022,Athletic Club,Asier Villalibre,ESP,FW,24,1997,1.1,0,0,0,0,0,0,0,,0,0,0,0,0,0,1,0,2023
ESP-La Liga,2022,Athletic Club,Dani García,ESP,MF,32,1990,16.5,46,27,17,25,4,29,47,61.7,18,21,6,15,19,65,21,1,2023
ESP-La Liga,2022,Athletic Club,Daniel Vivian,ESP,DF,23,1999,26.4,57,32,36,16,5,36,45,80.0,9,27,14,13,24,81,90,3,2023
ESP-La Liga,2022,Athletic Club,Gorka Guruzeta,ESP,FW,25,1996,15.8,24,20,6,12,6,11,24,45.8,13,23,2,21,4,28,8,0,2023
ESP-La Liga,2022,Athletic Club,Iker Muniain,ESP,"MF,FW",29,1992,18.8,21,16,7,11,3,6,17,35.3,11,10,1,9,4,25,2,0,2023
ESP-La Liga,2022,Athletic Club,Iñaki Williams,GHA,FW,28,1994,31.5,22,16,5,14,3,9,24,37.5,15,18,3,15,7,29,34,0,2023
ESP-La Liga,2022,Athletic Club,Iñigo Lekue,ESP,DF,29,1993,14.7,24,17,20,4,0,12,19,63.2,7,16,2,14,13,37,31,1,2023
ESP-La Liga,2022,Athletic Club,Iñigo Martínez,ESP,DF,31,1991,14.9,18,8,11,7,0,6,9,66.7,3,17,11,6,18,36,55,0,2023
ESP-La Liga,2022,Athletic Club,Jon Morcillo,ESP,"FW,MF",23,1998,0.8,1,0,1,0,0,0,1,0.0,1,0,0,0,1,2,0,0,2023
ESP-La Liga,2022,Athletic Club,Julen Agirrezabala,ESP,GK,21,2000,7.5,0,0,0,0,0,0,0,,0,0,0,0,0,0,2,0,2023
ESP-La Liga,2022,Athletic Club,Malcom Abdulai Ares Djalo,ESP,"FW,MF",20,2001,0.9,4,2,2,1,1,4,4,100.0,0,1,0,1,2,6,1,0,2023
ESP-La Liga,2022,Athletic Club,Mikel Balenziaga,ESP,DF,34,1988,1.3,4,4,1,2,1,4,4,100.0,0,0,0,0,1,5,2,0,2023
ESP-La Liga,2022,Athletic Club,Mikel Vesga,ESP,MF,29,1993,28.6,57,35,21,31,5,25,68,36.8,43,39,8,31,36,93,39,3,2023
ESP-La Liga,2022,Athletic Club,Nico Williams,ESP,FW,20,2002,29.5,31,16,10,15,6,19,41,46.3,22,40,2,38,8,39,14,1,2023
ESP-La Liga,2022,Athletic Club,Oier Zarraga,ESP,MF,23,1999,9.5,14,9,5,7,2,8,20,40.0,12,7,0,7,10,24,5,0,2023
ESP-La Liga,2022,Athletic Club,Oihan Sancet,ESP,MF,22,2000,28.1,27,16,2,19,6,11,37,29.7,26,10,0,10,4,31,9,1,2023
ESP-La Liga,2022,Athletic Club,Raúl García,ESP,"FW,MF",36,1986,10.7,12,8,3,4,5,5,15,33.3,10,13,1,12,6,18,9,0,2023
ESP-La Liga,2022,Athletic Club,Unai Simón,ESP,GK,25,1997,30.5,2,0,2,0,0,1,1,100.0,0,1,0,1,0,2,9,3,2023
ESP-La Liga,2022,Athletic Club,Unai Vencedor Paris,ESP,MF,21,2000,2.1,3,1,0,3,0,1,6,16.7,5,5,0,5,1,4,1,0,2023
ESP-La Liga,2022,Athletic Club,Yeray Álvarez,ESP,DF,27,1995,25.9,34,23,26,7,1,24,31,77.4,7,23,13,10,48,82,101,0,2023
ESP-La Liga,2022,Athletic Club,Yuri Berchiche,ESP,DF,32,1990,26.7,56,32,28,20,8,35,59,59.3,24,37,12,25,40,96,59,1,2023
ESP-La Liga,2022,Athletic Club,Álex Berenguer,ESP,FW,27,1995,25.5,58,37,17,25,16,23,60,38.3,37,37,4,33,10,68,6,0,2023
ESP-La Liga,2022,Athletic Club,Óscar de Marcos,ESP,DF,33,1989,31.3,67,33,34,22,11,40,76,52.6,36,42,6,36,29,96,59,0,2023
ESP-La Liga,2022,Atlético Madrid,Antoine Griezmann,FRA,"FW,MF",31,1991,31.8,49,34,15,23,11,20,66,30.3,46,34,3,31,24,73,31,0,2023
ESP-La Liga,2022,Atlético Madrid,Antonio Gomis,ESP,GK,19,2003,0.1,0,0,0,0,0,0,0,,0,0,0,0,0,0,0,0,2023
ESP-La Liga,2022,Atlético Madrid,Axel Witsel,BEL,"DF,MF",33,1989,25.1,36,22,22,11,3,17,31,54.8,14,20,11,9,23,59,76,0,2023
ESP-La Liga,2022,Atlético Madrid,Carlos Martín,ESP,"FW,MF",20,2002,0.3,2,2,0,2,0,2,3,66.7,1,0,0,0,1,3,0,0,2023
ESP-La Liga,2022,Atlético Madrid,Felipe,BRA,DF,33,1989,2.2,3,2,1,2,0,2,4,50.0,2,2,2,0,0,3,7,0,2023
ESP-La Liga,2022,Atlético Madrid,Geoffrey Kondogbia,CTA,MF,29,1993,11.2,40,23,19,20,1,17,25,68.0,8,9,1,8,26,66,12,1,2023
ESP-La Liga,2022,Atlético Madrid,Ivo Grbić,CRO,GK,26,1996,10.2,0,0,0,0,0,0,0,,0,0,0,0,0,0,9,1,2023
ESP-La Liga,2022,Atlético Madrid,Jan Oblak,SVN,GK,29,1993,27.7,0,0,0,0,0,0,0,,0,0,0,0,1,1,8,0,2023
ESP-La Liga,2022,Atlético Madrid,José María Giménez,URU,DF,27,1995,26.9,43,25,28,14,1,24,35,68.6,11,37,17,20,24,67,138,1,2023
ESP-La Liga,2022,Atlético Madrid,João Félix,POR,"FW,MF",22,1999,7.2,10,7,2,3,5,1,6,16.7,5,1,0,1,3,13,2,0,2023
ESP-La Liga,2022,Atlético Madrid,Koke,ESP,MF,30,1992,28.3,55,38,23,25,7,28,72,38.9,44,35,13,22,20,75,19,0,2023
ESP-La Liga,2022,Atlético Madrid,Marcos Llorente,ESP,"MF,DF",27,1995,18.9,32,15,16,10,6,17,30,56.7,13,26,2,24,17,49,19,0,2023
ESP-La Liga,2022,Atlético Madrid,Mario Hermoso,ESP,DF,27,1995,23.4,22,15,14,6,2,9,30,30.0,21,19,9,10,19,41,85,1,2023
ESP-La Liga,2022,Atlético Madrid,Matheus Cunha,BRA,"FW,MF",23,1999,4.2,4,1,1,3,0,0,3,0.0,3,4,1,3,2,6,3,0,2023
ESP-La Liga,2022,Atlético Madrid,Matt Doherty,IRL,DF,30,1992,0.2,0,0,0,0,0,0,0,,0,2,0,2,0,0,0,0,2023
ESP-La Liga,2022,Atlético Madrid,Memphis,NED,FW,28,1994,3.0,1,0,0,0,1,0,1,0.0,1,0,0,0,0,1,0,0,2023
ESP-La Liga,2022,Atlético Madrid,Nahuel Molina,ARG,DF,24,1998,31.9,69,43,38,18,13,39,91,42.9,52,38,7,31,18,87,63,1,2023
ESP-La Liga,2022,Atlético Madrid,Pablo Barrios,ESP,MF,19,2003,8.0,19,10,3,10,6,8,15,53.3,7,12,2,10,9,28,6,1,2023
ESP-La Liga,2022,Atlético Madrid,Reinildo Mandava,MOZ,DF,28,1994,20.6,66,43,46,19,1,38,49,77.6,11,27,12,15,30,96,59,0,2023
ESP-La Liga,2022,Atlético Madrid,Rodrigo De Paul,ARG,MF,28,1994,21.4,35,21,11,18,6,18,35,51.4,17,20,3,17,8,43,7,0,2023
ESP-La Liga,2022,Atlético Madrid,Saúl Ñíguez,ESP,"MF,DF",27,1994,12.2,42,27,18,18,6,22,37,59.5,15,27,5,22,15,57,29,0,2023
ESP-La Liga,2022,Atlético Madrid,Sergio Reguilón,ESP,DF,25,1996,3.4,7,5,5,2,0,5,7,71.4,2,3,0,3,2,9,4,0,2023
ESP-La Liga,2022,Atlético Madrid,Stefan Savić,MNE,DF,31,1991,21.6,39,26,29,7,3,26,39,66.7,13,17,8,9,33,72,67,2,2023
ESP-La Liga,2022,Atlético Madrid,Thomas Lemar,FRA,MF,26,1995,13.9,30,18,10,13,7,10,28,35.7,18,12,3,9,7,37,12,0,2023
ESP-La Liga,2022,Atlético Madrid,Yannick Carrasco,BEL,"DF,MF",28,1993,25.7,35,14,21,10,4,23,54,42.6,31,23,1,22,12,47,19,0,2023
ESP-La Liga,2022,Atlético Madrid,Álvaro Morata,ESP,FW,29,1992,21.1,16,11,4,8,4,3,8,37.5,5,11,3,8,0,16,23,0,2023
ESP-La Liga,2022,Atlético Madrid,Ángel Correa,ARG,"FW,MF",27,1995,16.2,12,6,6,3,3,5,16,31.3,11,17,0,17,10,22,6,1,2023
ESP-La Liga,2022,Barcelona,Aleix Garrido,ESP,FW,18,2004,0.1,2,1,1,0,1,1,1,100.0,0,1,0,1,0,2,0,0,2023
ESP-La Liga,2022,Barcelona,Alejandro Balde,ESP,DF,18,2003,27.5,42,30,22,16,4,24,41,58.5,17,25,3,22,12,54,17,1,2023
ESP-La Liga,2022,Barcelona,Andreas Christensen,DEN,DF,26,1996,19.6,20,15,9,11,0,10,16,62.5,6,14,12,2,21,41,47,0,2023
ESP-La Liga,2022,Barcelona,Ansu Fati,ESP,FW,19,2002,15.5,16,9,8,4,4,5,18,27.8,13,19,0,19,5,21,6,0,2023
ESP-La Liga,2022,Barcelona,Chadi Riad,MAR,MF,19,2003,0.0,0,0,0,0,0,0,0,,0,0,0,0,0,0,0,0,2023
ESP-La Liga,2022,Barcelona,Eric García,ESP,"DF,MF",21,2001,15.7,24,16,16,5,3,9,20,45.0,11,23,10,13,19,43,36,1,2023
ESP-La Liga,2022,Barcelona,Ferrán Torres,ESP,"FW,MF",22,2000,15.5,13,7,4,5,4,5,20,25.0,15,11,2,9,3,16,5,0,2023
ESP-La Liga,2022,Barcelona,Franck Kessié,CIV,MF,25,1996,11.0,15,9,6,6,3,8,18,44.4,10,10,2,8,12,27,11,2,2023
ESP-La Liga,2022,Barcelona,Frenkie de Jong,NED,MF,25,1997,28.2,46,26,16,21,9,17,41,41.5,24,11,1,10,35,81,22,1,2023
ESP-La Liga,2022,Barcelona,Gavi,ESP,"MF,FW",17,2004,28.1,47,31,7,30,10,21,55,38.2,34,32,5,27,18,65,22,0,2023
ESP-La Liga,2022,Barcelona,Gerard Piqué,ESP,DF,35,1987,4.3,5,4,1,4,0,4,4,100.0,0,2,1,1,2,7,19,0,2023
ESP-La Liga,2022,Barcelona,Héctor Bellerín,ESP,DF,27,1995,1.6,2,0,0,2,0,2,3,66.7,1,2,0,2,3,5,2,0,2023
ESP-La Liga,2022,Barcelona,Iñaki Peña,ESP,GK,23,1999,0.8,0,0,0,0,0,0,0,,0,0,0,0,0,0,0,1,2023
ESP-La Liga,2022,Barcelona,Jordi Alba,ESP,DF,33,1989,15.8,25,18,13,11,1,12,28,42.9,16,12,5,7,11,36,23,0,2023
ESP-La Liga,2022,Barcelona,Jules Koundé,FRA,DF,23,1998,27.0,37,23,18,13,6,21,31,67.7,10,24,9,15,19,56,61,3,2023
ESP-La Liga,2022,Barcelona,Lamine Yamal,ESP,FW,15,2007,0.1,0,0,0,0,0,0,0,,0,0,0,0,0,0,0,0,2023
ESP-La Liga,2022,Barcelona,Marc-André ter Stegen,GER,GK,30,1992,37.2,0,0,0,0,0,0,0,,0,0,0,0,1,1,7,3,2023
ESP-La Liga,2022,Barcelona,Marcos Alonso,ESP,DF,31,1990,13.0,15,10,10,5,0,9,12,75.0,3,14,10,4,11,26,32,0,2023
ESP-La Liga,2022,Barcelona,Memphis,NED,FW,28,1994,1.3,1,1,1,0,0,0,1,0.0,1,0,0,0,0,1,0,0,2023
ESP-La Liga,2022,Barcelona,Ousmane Dembélé,FRA,FW,25,1997,15.7,19,12,4,8,7,4,15,26.7,11,10,1,9,0,19,2,0,2023
ESP-La Liga,2022,Barcelona,Pablo Torre,ESP,"FW,MF",19,2003,1.6,2,1,0,1,1,2,4,50.0,2,1,0,1,2,4,1,0,2023
ESP-La Liga,2022,Barcelona,Pedri,ESP,MF,19,2002,22.0,39,22,15,17,7,13,45,28.9,32,27,0,27,13,52,8,1,2023
ESP-La Liga,2022,Barcelona,Pierre-Emerick Aubameyang,GAB,FW,33,1989,0.1,0,0,0,0,0,0,0,,0,0,0,0,0,0,0,0,2023
ESP-La Liga,2022,Barcelona,Raphinha,BRA,FW,25,1996,23.0,29,19,10,7,12,11,31,35.5,20,33,1,32,14,43,11,1,2023
ESP-La Liga,2022,Barcelona,Robert Lewandowski,POL,FW,33,1988,31.6,17,11,2,5,10,7,14,50.0,7,20,0,20,2,19,14,0,2023
ESP-La Liga,2022,Barcelona,Ronald Araújo,URU,DF,23,1999,20.0,26,18,12,13,1,6,9,66.7,3,15,7,8,12,38,41,1,2023
ESP-La Liga,2022,Barcelona,Sergi Roberto,ESP,"DF,MF",30,1992,14.5,22,15,12,6,4,7,18,38.9,11,15,7,8,11,33,16,0,2023
ESP-La Liga,2022,Barcelona,Sergio Busquets,ESP,MF,34,1988,26.0,58,26,24,26,8,29,51,56.9,22,32,6,26,27,85,36,2,2023
ESP-La Liga,2022,Barcelona,Ángel Alarcón,ESP,FW,18,2004,0.3,,0,,,,,,,,,,,0,,,,2023
ESP-La Liga,2022,Betis,Abner,BRA,DF,22,2000,6.7,12,9,9,2,1,7,16,43.8,9,8,2,6,8,20,24,0,2023
ESP-La Liga,2022,Betis,Aitor Ruibal,ESP,"DF,FW",26,1996,16.2,47,29,35,9,3,31,58,53.4,27,17,2,15,24,71,41,0,2023
ESP-La Liga,2022,Betis,Andrés Guardado,MEX,MF,35,1986,15.3,41,25,17,20,4,18,43,41.9,25,14,5,9,23,64,29,0,2023
ESP-La Liga,2022,Betis,Ayoze Pérez,ESP,"FW,MF",29,1993,15.4,31,15,9,16,6,10,40,25.0,30,22,0,22,13,44,5,0,2023
ESP-La Liga,2022,Betis,Borja Iglesias,ESP,FW,29,1993,26.3,8,4,3,3,2,2,13,15.4,11,9,1,8,1,9,17,0,2023
ESP-La Liga,2022,Betis,Claudio Bravo,CHI,GK,39,1983,12.0,0,0,0,0,0,0,0,,0,0,0,0,2,2,1,1,2023
ESP-La Liga,2022,Betis,Felix Garreta,ESP,DF,18,2004,1.0,1,0,0,1,0,0,0,,0,1,1,0,1,2,4,0,2023
ESP-La Liga,2022,Betis,Fran Delgado,ESP,DF,21,2001,0.1,0,0,0,0,0,0,0,,0,0,0,0,0,0,0,0,2023
ESP-La Liga,2022,Betis,Germán Pezzella,ARG,DF,31,1991,27.9,41,28,32,9,0,26,38,68.4,12,32,15,17,50,91,129,1,2023
ESP-La Liga,2022,Betis,Guido Rodríguez,ARG,MF,28,1994,31.9,115,75,59,50,6,54,101,53.5,47,58,14,44,42,157,76,1,2023
ESP-La Liga,2022,Betis,Joaquín,ESP,"MF,FW",41,1981,5.5,3,3,2,1,0,1,3,33.3,2,7,2,5,4,7,5,0,2023
ESP-La Liga,2022,Betis,Juan Cruz,ESP,FW,22,2000,2.0,1,0,0,1,0,1,3,33.3,2,1,0,1,0,1,0,0,2023
ESP-La Liga,2022,Betis,Juan Miranda,ESP,DF,22,2000,16.4,23,16,16,6,1,14,29,48.3,15,20,7,13,20,43,63,0,2023
ESP-La Liga,2022,Betis,Juanmi,ESP,FW,29,1993,10.3,14,10,4,7,3,7,31,22.6,24,10,0,10,4,18,4,0,2023
ESP-La Liga,2022,Betis,Loren Morón,ESP,FW,28,1993,0.2,2,2,0,1,1,0,0,,0,0,0,0,0,2,1,0,2023
ESP-La Liga,2022,Betis,Luiz Felipe,ITA,DF,25,1997,19.6,34,23,23,11,0,18,34,52.9,16,43,24,19,28,62,106,0,2023
ESP-La Liga,2022,Betis,Luiz Henrique,BRA,FW,21,2001,20.1,48,34,27,15,6,20,44,45.5,24,22,0,22,14,62,17,0,2023
ESP-La Liga,2022,Betis,Martín Montoya,ESP,DF,31,1991,5.0,13,8,9,4,0,10,12,83.3,2,6,1,5,9,22,14,1,2023
ESP-La Liga,2022,Betis,Nabil Fekir,FRA,MF,29,1993,10.7,11,5,3,3,5,2,9,22.2,7,6,2,4,1,12,0,0,2023
ESP-La Liga,2022,Betis,Paul Akouokou,CIV,"MF,DF",24,1997,5.0,16,9,13,3,0,13,20,65.0,7,2,2,0,12,28,17,1,2023
ESP-La Liga,2022,Betis,Roberto González,ESP,"FW,MF",21,2001,0.6,0,0,0,0,0,0,1,0.0,1,0,0,0,1,1,0,0,2023
ESP-La Liga,2022,Betis,Rodri,ESP,"FW,MF",22,2000,17.8,16,11,5,9,2,8,17,47.1,9,10,0,10,13,29,2,0,2023
ESP-La Liga,2022,Betis,Rui Silva,POR,GK,28,1994,26.0,4,1,4,0,0,4,4,100.0,0,0,0,0,0,4,12,1,2023
ESP-La Liga,2022,Betis,Sergio Canales,ESP,"FW,MF",31,1991,26.7,25,14,10,8,7,14,33,42.4,19,18,0,18,14,39,8,0,2023
ESP-La Liga,2022,Betis,Víctor Ruiz,ESP,DF,33,1989,6.2,5,3,3,2,0,3,3,100.0,0,10,7,3,6,11,34,0,2023
ESP-La Liga,2022,Betis,William Carvalho,POR,MF,30,1992,27.1,43,27,18,23,2,17,44,38.6,27,27,6,21,16,59,22,0,2023
ESP-La Liga,2022,Betis,Willian José,BRA,FW,30,1991,8.1,9,6,6,3,0,4,9,44.4,5,4,0,4,1,10,15,0,2023
ESP-La Liga,2022,Betis,Youssouf Sabaly,SEN,DF,29,1993,18.7,45,23,29,14,2,22,33,66.7,11,35,8,27,19,64,52,1,2023
ESP-La Liga,2022,Betis,Álex Moreno,ESP,DF,29,1993,15.0,29,22,19,10,0,18,36,50.0,18,17,4,13,17,46,39,0,2023
ESP-La Liga,2022,Betis,Édgar González,ESP,DF,25,1997,19.7,28,19,18,7,3,14,27,51.9,13,12,9,3,21,49,120,0,2023
ESP-La Liga,2022,Celta Vigo,Agustín Marchesín,ARG,GK,34,1988,19.0,0,0,0,0,0,0,1,0.0,1,0,0,0,0,0,7,0,2023
ESP-La Liga,2022,Celta Vigo,Augusto Solari,ARG,MF,30,1992,2.9,10,6,6,3,1,3,11,27.3,8,5,0,5,4,14,3,0,2023
ESP-La Liga,2022,Celta Vigo,Carles Pérez,ESP,"MF,FW",24,1998,23.8,39,23,12,17,10,22,66,33.3,44,29,3,26,6,45,9,0,2023
ESP-La Liga,2022,Celta Vigo,Carlos Dominguez,ESP,DF,21,2001,1.2,1,1,0,1,0,1,2,50.0,1,1,1,0,0,1,7,0,2023
ESP-La Liga,2022,Celta Vigo,Fernando Medrano,ESP,DF,22,2000,0.1,2,1,2,0,0,1,1,100.0,0,0,0,0,1,3,1,0,2023
ESP-La Liga,2022,Celta Vigo,Fran Beltrán,ESP,MF,23,1999,31.7,34,22,15,14,5,14,55,25.5,41,29,5,24,53,87,35,2,2023
ESP-La Liga,2022,Celta Vigo,Franco Cervi,ARG,"MF,DF",28,1994,21.0,76,46,29,36,11,33,66,50.0,33,33,1,32,36,112,16,0,2023
ESP-La Liga,2022,Celta Vigo,Gabriel Veiga,ESP,MF,20,2002,25.5,43,19,14,25,4,16,52,30.8,36,30,3,27,21,64,6,0,2023
ESP-La Liga,2022,Celta Vigo,Gonçalo Paciência,POR,"FW,MF",27,1994,7.4,8,5,0,5,3,2,7,28.6,5,9,1,8,0,8,4,0,2023
ESP-La Liga,2022,Celta Vigo,Haris Seferović,SUI,FW,30,1992,9.9,6,3,1,4,1,3,8,37.5,5,7,1,6,1,7,6,1,2023
ESP-La Liga,2022,Celta Vigo,Hugo Mallo,ESP,DF,31,1991,24.0,53,29,34,14,5,28,42,66.7,14,28,7,21,24,77,73,0,2023
ESP-La Liga,2022,Celta Vigo,Hugo Sotelo,ESP,MF,18,2003,0.2,0,0,0,0,0,0,0,,0,0,0,0,0,0,0,0,2023
ESP-La Liga,2022,Celta Vigo,Iago Aspas,ESP,FW,34,1987,31.9,8,4,0,4,4,3,22,13.6,19,10,1,9,7,15,23,0,2023
ESP-La Liga,2022,Celta Vigo,Iván Villar,ESP,GK,25,1997,19.0,0,0,0,0,0,0,1,0.0,1,0,0,0,0,0,7,0,2023
ESP-La Liga,2022,Celta Vigo,Javi Galán,ESP,DF,27,1994,35.1,104,72,60,40,4,48,98,49.0,50,54,5,49,41,145,63,1,2023
ESP-La Liga,2022,Celta Vigo,Joseph Aidoo,GHA,DF,26,1995,34.7,51,36,33,17,1,16,28,57.1,12,26,14,12,31,82,150,0,2023
ESP-La Liga,2022,Celta Vigo,Jørgen Strand Larsen,NOR,FW,22,2000,18.9,15,7,3,5,7,7,30,23.3,23,14,5,9,3,18,24,0,2023
ESP-La Liga,2022,Celta Vigo,Kevin Vázquez,ESP,"DF,MF",29,1993,4.9,13,8,5,7,1,8,12,66.7,4,4,1,3,2,15,8,0,2023
ESP-La Liga,2022,Celta Vigo,Luca de la Torre,USA,MF,24,1998,16.5,28,19,11,14,3,12,32,37.5,20,22,1,21,9,37,6,0,2023
ESP-La Liga,2022,Celta Vigo,Miguel Rodríguez,ESP,"MF,FW",19,2003,2.8,7,5,4,3,0,4,11,36.4,7,6,0,6,1,8,3,0,2023
ESP-La Liga,2022,Celta Vigo,Pablo Durán,ESP,"MF,DF",21,2001,0.4,0,0,0,0,0,0,0,,0,2,1,1,1,1,2,0,2023
ESP-La Liga,2022,Celta Vigo,Renato Tapia,PER,"MF,DF",27,1995,16.1,47,25,21,21,5,18,37,48.6,19,29,11,18,19,66,37,0,2023
ESP-La Liga,2022,Celta Vigo,Unai Núñez,ESP,DF,25,1997,35.0,47,35,29,15,3,18,34,52.9,16,27,17,10,72,119,135,1,2023
ESP-La Liga,2022,Celta Vigo,Williot Swedberg,SWE,MF,18,2004,0.6,3,1,1,0,2,0,0,,0,2,0,2,0,3,1,0,2023
ESP-La Liga,2022,Celta Vigo,Óscar Mingueza,ESP,DF,23,1999,14.3,37,21,27,9,1,25,32,78.1,7,10,4,6,12,49,25,0,2023
ESP-La Liga,2022,Celta Vigo,Óscar Rodríguez Arnaiz,ESP,MF,24,1998,19.7,32,25,12,15,5,13,28,46.4,15,16,2,14,24,56,15,0,2023
ESP-La Liga,2022,Cádiz,Alberto Perea,ESP,MF,31,1990,0.5,2,0,2,0,0,0,0,,0,2,0,2,0,2,0,0,2023
ESP-La Liga,2022,Cádiz,Alfonso Espino,URU,DF,30,1992,34.7,87,56,55,20,12,48,96,50.0,48,52,11,41,48,135,99,3,2023
ESP-La Liga,2022,Cádiz,Anthony Lozano,HON,FW,29,1993,16.0,6,4,1,4,1,1,7,14.3,6,12,1,11,3,9,17,0,2023
ESP-La Liga,2022,Cádiz,Awer Mabil,AUS,"MF,FW",26,1995,1.8,2,0,0,1,1,1,3,33.3,2,1,1,0,0,2,1,0,2023
ESP-La Liga,2022,Cádiz,Blanco,ESP,MF,22,2000,1.8,6,4,5,1,0,4,6,66.7,2,5,0,5,1,7,3,0,2023
ESP-La Liga,2022,Cádiz,Brian Ocampo,URU,"MF,FW",23,1999,12.4,18,15,12,5,1,8,21,38.1,13,13,0,13,3,21,3,0,2023
ESP-La Liga,2022,Cádiz,Cala,ESP,DF,32,1989,1.5,2,1,1,1,0,1,2,50.0,1,2,1,1,1,3,12,0,2023
ESP-La Liga,2022,Cádiz,Carlos García,ESP,DF,22,2000,0.3,0,0,0,0,0,0,0,,0,0,0,0,0,0,2,0,2023
ESP-La Liga,2022,Cádiz,Chris Ramos,ESP,FW,25,1997,7.9,12,9,2,7,3,4,11,36.4,7,8,3,5,1,13,19,0,2023
ESP-La Liga,2022,Cádiz,David Gil,ESP,GK,28,1994,4.0,0,0,0,0,0,0,0,,0,0,0,0,0,0,3,0,2023
ESP-La Liga,2022,Cádiz,Fali,ESP,"DF,MF",28,1993,19.0,27,19,19,8,0,18,29,62.1,11,24,15,9,13,40,70,1,2023
ESP-La Liga,2022,Cádiz,Fede San Emeterio,ESP,MF,25,1997,20.5,41,22,23,16,2,22,46,47.8,24,34,14,20,17,58,28,0,2023
ESP-La Liga,2022,Cádiz,Francisco Mwepu,ZAM,FW,22,2000,0.2,1,0,0,1,0,0,0,,0,0,0,0,0,1,0,0,2023
ESP-La Liga,2022,Cádiz,Gonzalo Escalante,ARG,MF,29,1993,12.5,36,24,15,20,1,15,29,51.7,14,18,4,14,17,53,26,1,2023
ESP-La Liga,2022,Cádiz,Isaac Carcelen,ESP,DF,29,1993,24.4,69,51,41,22,6,41,63,65.1,22,35,11,24,19,88,80,1,2023
ESP-La Liga,2022,Cádiz,Iván Alejo,ESP,"MF,FW",27,1995,14.6,32,21,19,9,4,17,37,45.9,20,18,3,15,5,37,12,1,2023
ESP-La Liga,2022,Cádiz,Jeremías Ledesma,ARG,GK,29,1993,34.0,3,2,3,0,0,3,7,42.9,4,1,0,1,2,5,23,3,2023
ESP-La Liga,2022,Cádiz,Jorge Meré,ESP,DF,25,1997,6.7,11,7,9,2,0,5,8,62.5,3,9,6,3,6,17,32,0,2023
ESP-La Liga,2022,Cádiz,Joseba Zaldúa,ESP,DF,30,1992,7.1,15,8,10,4,1,7,10,70.0,3,4,2,2,11,26,22,0,2023
ESP-La Liga,2022,Cádiz,José Antonio,ESP,"MF,DF",18,2004,0.5,2,1,0,0,2,0,0,,0,0,0,0,0,2,0,0,2023
ESP-La Liga,2022,Cádiz,José Mari,ESP,MF,34,1987,4.4,16,7,12,3,1,10,16,62.5,6,3,1,2,5,21,9,0,2023
ESP-La Liga,2022,Cádiz,Lucas Pérez,ESP,FW,33,1988,7.0,3,2,2,1,0,1,3,33.3,2,2,0,2,1,4,3,0,2023
ESP-La Liga,2022,Cádiz,Luis Hernández,ESP,DF,33,1989,35.0,33,21,25,7,1,22,36,61.1,14,31,24,7,31,64,145,0,2023
ESP-La Liga,2022,Cádiz,Mamadou Mbaye,SEN,DF,24,1998,8.4,10,7,7,3,0,6,8,75.0,2,10,8,2,7,17,50,1,2023
ESP-La Liga,2022,Cádiz,Mamady Diarra,MLI,"MF,DF",22,2000,0.7,2,1,2,0,0,1,2,50.0,1,2,0,2,0,2,0,0,2023
ESP-La Liga,2022,Cádiz,Raúl Parra,ESP,DF,22,1999,3.4,4,2,4,0,0,4,9,44.4,5,5,3,2,1,5,9,0,2023
ESP-La Liga,2022,Cádiz,Roger Martí,ESP,FW,31,1991,7.1,6,4,2,3,1,1,8,12.5,7,7,0,7,2,8,7,0,2023
ESP-La Liga,2022,Cádiz,Rubén Alcaraz,ESP,MF,31,1991,22.7,43,31,24,18,1,19,54,35.2,35,23,8,15,19,62,37,0,2023
ESP-La Liga,2022,Cádiz,Rubén Sobrino,ESP,"MF,FW",30,1992,27.4,55,37,29,17,9,23,56,41.1,33,33,3,30,24,79,20,1,2023
ESP-La Liga,2022,Cádiz,Santiago Arzamendia,PAR,"DF,MF",24,1998,5.4,9,8,7,1,1,6,21,28.6,15,11,1,10,2,11,15,1,2023
ESP-La Liga,2022,Cádiz,Sergi Guardiola,ESP,FW,31,1991,12.9,9,7,0,6,3,3,12,25.0,9,5,0,5,3,12,7,0,2023
ESP-La Liga,2022,Cádiz,Theo Bongonda,COD,"MF,FW",26,1995,21.5,28,20,11,14,3,17,40,42.5,23,21,2,19,6,34,14,0,2023
ESP-La Liga,2022,Cádiz,Tomás Alarcón,CHI,MF,23,1999,2.5,3,2,0,2,1,1,2,50.0,1,1,0,1,2,5,2,0,2023
ESP-La Liga,2022,Cádiz,Víctor Chust,ESP,DF,22,2000,10.7,9,6,7,2,0,4,7,57.1,3,8,3,5,10,19,53,0,2023
ESP-La Liga,2022,Cádiz,Youba Diarra,MLI,MF,24,1998,1.1,3,0,2,1,0,1,5,20.0,4,7,1,6,2,5,3,0,2023
ESP-La Liga,2022,Cádiz,Álex Fernández,ESP,"MF,FW",29,1992,17.5,13,7,6,4,3,4,14,28.6,10,14,1,13,8,21,19,0,2023
ESP-La Liga,2022,Cádiz,Álvaro Giménez,ESP,FW,31,1991,0.2,0,0,0,0,0,0,1,0.0,1,0,0,0,0,0,0,0,2023
ESP-La Liga,2022,Cádiz,Álvaro Negredo,ESP,FW,36,1985,8.4,5,4,1,2,2,2,2,100.0,0,4,1,3,0,5,8,0,2023
ESP-La Liga,2022,Elche,Alejandro Alfaro,ESP,MF,20,2002,0.2,0,0,0,0,0,0,0,,0,0,0,0,0,0,0,0,2023
ESP-La Liga,2022,Elche,Axel Werner,ARG,GK,26,1996,2.0,0,0,0,0,0,0,1,0.0,1,0,0,0,0,0,0,0,2023
ESP-La Liga,2022,Elche,Carlos Clerc,ESP,"DF,MF",30,1992,29.3,75,51,55,16,4,31,50,62.0,19,29,7,22,28,103,94,1,2023
ESP-La Liga,2022,Elche,Carmona,ESP,"MF,DF",20,2002,6.5,16,9,7,6,3,6,16,37.5,10,14,2,12,8,24,9,0,2023
ESP-La Liga,2022,Elche,Diego González,ESP,DF,27,1995,10.6,12,7,9,3,0,7,11,63.6,4,14,12,2,7,19,50,1,2023
ESP-La Liga,2022,Elche,Domingos Quina,POR,MF,22,1999,3.1,3,2,2,1,0,1,3,33.3,2,5,0,5,3,6,1,0,2023
ESP-La Liga,2022,Elche,Enzo Roco,CHI,DF,29,1992,18.4,33,13,23,10,0,15,24,62.5,9,22,15,7,17,50,63,1,2023
ESP-La Liga,2022,Elche,Ezequiel Ponce,ARG,"FW,MF",25,1997,12.5,9,7,0,6,3,0,7,0.0,7,6,1,5,1,10,13,0,2023
ESP-La Liga,2022,Elche,Federico Fernández,ARG,DF,33,1989,1.0,1,1,1,0,0,1,1,100.0,0,0,0,0,2,3,12,0,2023
ESP-La Liga,2022,Elche,Fidel,ESP,"MF,FW",32,1989,19.0,15,10,8,5,2,4,38,10.5,34,9,0,9,5,20,8,0,2023
ESP-La Liga,2022,Elche,Gerard Gumbau,ESP,MF,27,1994,30.4,44,25,17,23,4,18,51,35.3,33,32,8,24,28,72,40,0,2023
ESP-La Liga,2022,Elche,Gonzalo Verdú,ESP,DF,33,1988,7.8,10,5,8,2,0,4,8,50.0,4,8,6,2,10,20,33,0,2023
ESP-La Liga,2022,Elche,Helibelton Palacios,COL,DF,29,1993,21.3,38,20,21,15,2,19,26,73.1,7,26,12,14,20,58,55,0,2023
ESP-La Liga,2022,Elche,Javier Pastore,ARG,MF,33,1989,0.1,0,0,0,0,0,0,0,,0,0,0,0,0,0,0,0,2023
ESP-La Liga,2022,Elche,Johan Mojica,COL,"DF,MF",29,1992,3.0,6,3,5,1,0,2,3,66.7,1,3,2,1,4,10,5,0,2023
ESP-La Liga,2022,Elche,John Donald,ESP,"MF,DF",21,2000,12.1,20,11,9,9,2,7,14,50.0,7,14,7,7,14,34,23,1,2023
ESP-La Liga,2022,Elche,Josan,ESP,"DF,MF",32,1989,12.0,25,20,20,5,0,14,27,51.9,13,8,0,8,7,32,15,1,2023
ESP-La Liga,2022,Elche,Lautaro Blanco,ARG,"DF,MF",23,1999,9.7,16,9,10,4,2,9,26,34.6,17,8,1,7,2,18,10,1,2023
ESP-La Liga,2022,Elche,Lisandro Magallán,ARG,DF,28,1993,10.0,19,11,11,5,3,10,12,83.3,2,14,5,9,13,32,30,1,2023
ESP-La Liga,2022,Elche,Lucas Boyé,ARG,FW,26,1996,27.4,36,16,12,16,8,17,35,48.6,18,33,5,28,15,51,46,0,2023
ESP-La Liga,2022,Elche,Nicolás Ezequiel Fernández,ARG,"MF,DF",22,2000,5.7,23,12,10,7,6,9,17,52.9,8,7,0,7,5,28,2,1,2023
ESP-La Liga,2022,Elche,Omar Mascarell,ESP,"MF,DF",29,1993,27.2,53,26,32,19,2,31,64,48.4,33,51,19,32,45,98,54,1,2023
ESP-La Liga,2022,Elche,Pape Cheikh Diop,SEN,MF,24,1997,0.4,0,0,0,0,0,0,1,0.0,1,0,0,0,0,0,0,0,2023
ESP-La Liga,2022,Elche,Pedro Bigas,ESP,DF,31,1990,22.4,37,20,30,7,0,18,29,62.1,11,25,14,11,33,70,95,0,2023
ESP-La Liga,2022,Elche,Pere Milla,ESP,"FW,MF",29,1992,20.5,31,20,18,8,5,14,41,34.1,27,18,3,15,9,40,19,1,2023
ESP-La Liga,2022,Elche,Pol Lirola,ESP,DF,24,1997,7.0,13,6,9,3,1,8,13,61.5,5,3,2,1,7,20,16,0,2023
ESP-La Liga,2022,Elche,Randy Ntekja,FRA,"FW,MF",24,1997,8.1,15,10,7,6,2,2,11,18.2,9,15,3,12,4,19,9,0,2023
ESP-La Liga,2022,Elche,Raúl Guti,ESP,MF,25,1996,12.4,18,12,8,9,1,8,18,44.4,10,10,3,7,8,26,6,0,2023
ESP-La Liga,2022,Elche,Roger Martí,ESP,FW,31,1991,7.3,5,2,3,2,0,1,5,20.0,4,4,0,4,1,6,7,0,2023
ESP-La Liga,2022,Elche,Tete Morente,ESP,"MF,DF",25,1996,23.0,33,21,18,13,2,15,36,41.7,21,23,3,20,25,58,28,0,2023
ESP-La Liga,2022,Elche,Álex Collado,ESP,MF,23,1999,8.1,26,14,13,11,2,8,13,61.5,5,12,1,11,2,28,4,0,2023
ESP-La Liga,2022,Elche,Édgar Badía,ESP,GK,30,1992,36.0,1,0,1,0,0,1,2,50.0,1,0,0,0,0,1,19,3,2023
ESP-La Liga,2022,Espanyol,Adri Embarba,ESP,FW,30,1992,0.4,1,0,0,1,0,1,1,100.0,0,1,0,1,0,1,0,0,2023
ESP-La Liga,2022,Espanyol,Aleix Vidal,ESP,"MF,FW",32,1989,11.4,11,5,6,3,2,4,22,18.2,18,21,2,19,15,26,14,0,2023
ESP-La Liga,2022,Espanyol,Benjamin Lecomte,FRA,GK,31,1991,10.0,0,0,0,0,0,0,0,,0,0,0,0,0,0,3,2,2023
ESP-La Liga,2022,Espanyol,Brian Oliván,ESP,DF,28,1994,26.7,47,27,30,12,5,17,26,65.4,9,26,6,20,22,69,67,0,2023
ESP-La Liga,2022,Espanyol,César Montes,MEX,DF,25,1997,17.7,17,9,10,7,0,10,18,55.6,8,19,12,7,14,31,101,0,2023
ESP-La Liga,2022,Espanyol,Dani Gómez,ESP,"MF,FW",24,1998,1.0,2,1,1,1,0,1,2,50.0,1,0,0,0,1,3,0,0,2023
ESP-La Liga,2022,Espanyol,Denis Suárez,ESP,"MF,FW",28,1994,10.5,26,20,12,12,2,13,45,28.9,32,11,1,10,5,31,4,0,2023
ESP-La Liga,2022,Espanyol,Edu Expósito,ESP,MF,25,1996,12.9,34,20,16,15,3,13,23,56.5,10,7,0,7,12,46,20,0,2023
ESP-La Liga,2022,Espanyol,Fernando Calero,ESP,"DF,MF",26,1995,17.9,46,29,27,15,4,21,34,61.8,13,31,13,18,13,59,52,0,2023
ESP-La Liga,2022,Espanyol,Fernando Pacheco,ESP,GK,30,1992,16.0,0,0,0,0,0,0,1,0.0,1,0,0,0,1,1,11,0,2023
ESP-La Liga,2022,Espanyol,Javi Puado,ESP,"FW,MF",24,1998,26.0,20,11,12,5,3,12,28,42.9,16,12,2,10,10,30,14,0,2023
ESP-La Liga,2022,Espanyol,Joan García,ESP,GK,21,2001,1.0,0,0,0,0,0,0,0,,0,0,0,0,0,0,0,0,2023
ESP-La Liga,2022,Espanyol,Joselu,ESP,FW,32,1990,33.2,13,11,3,4,6,4,17,23.5,13,25,4,21,8,21,43,0,2023
ESP-La Liga,2022,Espanyol,José Carlos Lazo,ESP,"MF,FW",26,1996,1.8,5,3,2,2,1,3,3,100.0,0,2,0,2,3,8,5,0,2023
ESP-La Liga,2022,Espanyol,José Gragera,ESP,"MF,DF",21,2000,5.1,19,9,11,6,2,6,11,54.5,5,10,4,6,7,26,18,0,2023
ESP-La Liga,2022,Espanyol,Keidi Bare,ALB,MF,24,1997,5.6,15,8,7,5,3,7,13,53.8,6,8,2,6,11,26,8,0,2023
ESP-La Liga,2022,Espanyol,Leandro Cabrera,URU,DF,31,1991,29.7,46,24,34,12,0,28,43,65.1,15,37,23,14,43,89,114,2,2023
ESP-La Liga,2022,Espanyol,Luca Koleosho,ITA,"FW,DF",17,2004,0.7,2,2,0,0,2,1,2,50.0,1,1,0,1,0,2,0,0,2023
ESP-La Liga,2022,Espanyol,Martin Braithwaite,DEN,"FW,MF",31,1991,27.3,12,2,2,4,6,5,14,35.7,9,10,0,10,5,17,11,0,2023
ESP-La Liga,2022,Espanyol,Nabil Touaizi,MAR,MF,21,2001,0.0,0,0,0,0,0,0,0,,0,0,0,0,0,0,0,0,2023
ESP-La Liga,2022,Espanyol,Nico Ribaudo,ESP,"MF,FW",21,2001,13.9,18,13,5,9,4,11,30,36.7,19,19,1,18,5,23,1,0,2023
ESP-La Liga,2022,Espanyol,Omar El Hilali,MAR,"DF,MF",18,2003,1.0,3,2,3,0,0,1,2,50.0,1,1,0,1,1,4,6,0,2023
ESP-La Liga,2022,Espanyol,Pedrosa,ESP,"DF,MF",24,1998,2.5,5,1,5,0,0,4,7,57.1,3,1,1,0,5,10,3,0,2023
ESP-La Liga,2022,Espanyol,Pol Lozano,ESP,MF,22,1999,0.2,0,0,0,0,0,0,0,,0,1,0,1,0,0,1,0,2023
ESP-La Liga,2022,Espanyol,Roger Martínez,ESP,DF,18,2004,0.1,0,0,0,0,0,0,0,,0,0,0,0,0,0,0,0,2023
ESP-La Liga,2022,Espanyol,Ronaël Pierre-Gabriel,FRA,DF,24,1998,2.6,17,9,12,4,1,5,11,45.5,6,5,2,3,9,26,11,0,2023
ESP-La Liga,2022,Espanyol,Rubén,ESP,"DF,MF",21,2001,9.9,30,15,18,9,3,20,29,69.0,9,14,4,10,18,48,18,0,2023
ESP-La Liga,2022,Espanyol,Sergi Darder,ESP,MF,28,1993,36.9,69,38,12,43,14,29,73,39.7,44,34,2,32,24,93,23,0,2023
ESP-La Liga,2022,Espanyol,Sergi Gómez,ESP,DF,30,1992,26.0,29,16,20,9,0,18,22,81.8,4,33,19,14,27,56,125,1,2023
ESP-La Liga,2022,Espanyol,Vinicius Souza,BRA,MF,23,1999,27.0,99,66,41,45,13,33,59,55.9,26,31,14,17,48,147,50,1,2023
ESP-La Liga,2022,Espanyol,Wassim Boullif,ESP,DF,17,2005,1.6,3,1,3,0,0,2,3,66.7,1,5,4,1,0,3,3,0,2023
ESP-La Liga,2022,Espanyol,Álvaro Fernández,ESP,GK,24,1998,11.0,0,0,0,0,0,0,0,,0,0,0,0,0,0,7,2,2023
ESP-La Liga,2022,Espanyol,Óscar Gil,ESP,DF,25,1997,28.4,63,37,38,16,9,32,61,52.5,29,51,18,33,31,94,55,1,2023
ESP-La Liga,2022,Getafe,Alejandro Revuelta Montero,ESP,DF,22,2000,0.0,0,0,0,0,0,0,0,,0,0,0,0,0,0,1,0,2023
ESP-La Liga,2022,Getafe,Borja Mayoral,ESP,FW,25,1997,30.7,9,4,7,2,0,5,31,16.1,26,18,0,18,3,12,10,0,2023
ESP-La Liga,2022,Getafe,Carles Aleñá,ESP,"MF,FW",24,1998,23.5,18,10,7,5,6,5,34,14.7,29,19,1,18,4,22,18,0,2023
ESP-La Liga,2022,Getafe,Damián Suárez,URU,"DF,MF",34,1988,21.6,49,33,23,19,7,26,48,54.2,22,40,0,40,15,64,36,0,2023
ESP-La Liga,2022,Getafe,David Soria,ESP,GK,29,1993,38.0,0,0,0,0,0,0,1,0.0,1,0,0,0,1,1,20,4,2023
ESP-La Liga,2022,Getafe,Djené,TOG,DF,30,1991,31.6,41,28,23,17,1,22,38,57.9,16,25,10,15,42,83,81,1,2023
ESP-La Liga,2022,Getafe,Domingos Duarte,POR,DF,27,1995,29.5,26,18,21,5,0,19,26,73.1,7,29,23,6,39,65,145,0,2023
ESP-La Liga,2022,Getafe,Enes Ünal,TUR,FW,25,1997,33.0,26,14,5,19,2,7,25,28.0,18,19,2,17,6,32,35,0,2023
ESP-La Liga,2022,Getafe,Fabrizio Angileri,ARG,DF,28,1994,6.5,12,9,8,3,1,10,17,58.8,7,8,3,5,7,19,10,0,2023
ESP-La Liga,2022,Getafe,Gastón Álvarez,URU,DF,22,2000,16.7,38,30,24,9,5,23,42,54.8,19,15,5,10,15,53,35,0,2023
ESP-La Liga,2022,Getafe,Gonzalo Villar,ESP,MF,24,1998,5.1,10,5,1,6,3,6,14,42.9,8,9,2,7,6,16,5,0,2023
ESP-La Liga,2022,Getafe,Iglesias,ESP,"DF,MF",24,1998,23.8,61,35,40,18,3,33,65,50.8,32,40,5,35,21,82,91,1,2023
ESP-La Liga,2022,Getafe,Jaime Mata,ESP,"FW,MF",33,1988,4.9,13,10,4,5,4,7,22,31.8,15,7,2,5,3,16,6,0,2023
ESP-La Liga,2022,Getafe,Jaime Seoane,ESP,"MF,FW",25,1997,3.6,10,4,3,4,3,2,8,25.0,6,7,3,4,1,11,2,0,2023
ESP-La Liga,2022,Getafe,Jordan Amavi,FRA,DF,28,1994,2.2,3,2,3,0,0,1,3,33.3,2,3,0,3,4,7,7,0,2023
ESP-La Liga,2022,Getafe,Latasa,ESP,FW,21,2001,5.0,5,4,2,0,3,1,1,100.0,0,3,1,2,1,6,8,0,2023
ESP-La Liga,2022,Getafe,Luis Milla,ESP,MF,27,1994,20.6,48,30,21,18,9,19,44,43.2,25,13,1,12,32,80,25,1,2023
ESP-La Liga,2022,Getafe,Mauro Arambarri,URU,MF,26,1995,11.0,14,6,9,4,1,3,17,17.6,14,17,5,12,14,28,19,0,2023
ESP-La Liga,2022,Getafe,Moises Parra Gutierrez,ESP,FW,20,2002,0.1,1,0,0,1,0,0,0,,0,0,0,0,0,1,0,0,2023
ESP-La Liga,2022,Getafe,Munir El Haddadi,MAR,"MF,FW",26,1995,12.8,12,7,3,7,2,2,10,20.0,8,23,2,21,9,21,7,0,2023
ESP-La Liga,2022,Getafe,Nemanja Maksimović,SRB,MF,27,1995,22.8,41,30,17,18,6,19,32,59.4,13,36,14,22,34,75,27,0,2023
ESP-La Liga,2022,Getafe,Omar Alderete,PAR,DF,25,1996,22.7,35,20,21,14,0,28,40,70.0,12,23,16,7,26,61,85,0,2023
ESP-La Liga,2022,Getafe,Portu,ESP,"MF,DF",30,1992,19.7,28,21,14,10,4,18,42,42.9,24,23,3,20,17,45,20,1,2023
ESP-La Liga,2022,Getafe,Stefan Mitrović,SRB,DF,32,1990,18.7,14,6,12,2,0,7,11,63.6,4,12,10,2,17,31,90,2,2023
ESP-La Liga,2022,Getafe,Ángel Algobia,ESP,MF,23,1999,12.6,27,13,14,13,0,22,48,45.8,26,15,5,10,3,30,11,0,2023
ESP-La Liga,2022,Girona,Aleix García,ESP,MF,25,1997,26.0,37,20,9,18,10,15,33,45.5,18,24,8,16,31,68,35,1,2023
ESP-La Liga,2022,Girona,Alexander Callens,PER,DF,30,1992,1.3,3,3,2,1,0,3,4,75.0,1,3,1,2,1,4,9,0,2023
ESP-La Liga,2022,Girona,Arnau Martinez,ESP,DF,19,2003,30.4,69,45,41,19,9,38,85,44.7,47,44,10,34,25,94,54,2,2023
ESP-La Liga,2022,Girona,Bernardo Espinosa,COL,DF,33,1989,13.6,6,2,2,4,0,3,9,33.3,6,17,10,7,12,18,70,2,2023
ESP-La Liga,2022,Girona,Borja García,ESP,"MF,FW",31,1990,7.5,10,4,7,2,1,2,9,22.2,7,3,1,2,5,15,6,1,2023
ESP-La Liga,2022,Girona,Cristhian Stuani,URU,FW,35,1986,12.1,13,6,2,7,4,5,14,35.7,9,10,0,10,2,15,5,0,2023
ESP-La Liga,2022,Girona,David López,ESP,DF,32,1989,18.4,31,18,17,13,1,19,27,70.4,8,29,19,10,14,45,64,1,2023
ESP-La Liga,2022,Girona,Iván Martín,ESP,MF,23,1999,17.6,9,7,4,4,1,8,23,34.8,15,12,0,12,9,18,12,0,2023
ESP-La Liga,2022,Girona,Javi,ESP,DF,24,1998,12.4,21,12,12,7,2,13,21,61.9,8,10,5,5,7,28,38,0,2023
ESP-La Liga,2022,Girona,Joel Roca,ESP,"MF,FW",17,2005,0.9,2,2,2,0,0,2,5,40.0,3,1,1,0,0,2,1,0,2023
ESP-La Liga,2022,Girona,Juan Carlos,ESP,GK,34,1988,10.0,0,0,0,0,0,0,0,,0,0,0,0,1,1,7,1,2023
ESP-La Liga,2022,Girona,Juanpe,ESP,DF,31,1991,15.8,19,11,10,9,0,11,17,64.7,6,12,9,3,10,29,60,1,2023
ESP-La Liga,2022,Girona,Manu Vallejo,ESP,"FW,MF",25,1997,2.3,4,1,1,2,1,1,6,16.7,5,2,0,2,1,5,3,0,2023
ESP-La Liga,2022,Girona,Miguel Gutiérrez,ESP,DF,21,2001,26.6,41,23,23,13,5,23,37,62.2,14,23,5,18,18,59,42,1,2023
ESP-La Liga,2022,Girona,Oriol Romeu,ESP,MF,30,1991,32.8,70,38,36,26,8,26,51,51.0,25,48,10,38,37,107,54,0,2023
ESP-La Liga,2022,Girona,Oscar Ureña,ESP,MF,19,2003,1.1,4,2,2,2,0,2,3,66.7,1,2,0,2,1,5,0,0,2023
ESP-La Liga,2022,Girona,Paulo Gazzaniga,ARG,GK,30,1992,28.0,0,0,0,0,0,0,1,0.0,1,0,0,0,1,1,9,5,2023
ESP-La Liga,2022,Girona,Ramón Terrats,ESP,MF,21,2000,2.4,4,2,1,3,0,2,6,33.3,4,6,2,4,3,7,3,1,2023
ESP-La Liga,2022,Girona,Reinier,BRA,"MF,FW",20,2002,7.2,12,10,7,3,2,2,8,25.0,6,6,0,6,5,17,4,0,2023
ESP-La Liga,2022,Girona,Ricard Artero,ESP,"MF,FW",19,2003,1.5,3,3,2,1,0,1,1,100.0,0,2,0,2,1,4,3,0,2023
ESP-La Liga,2022,Girona,Rodrigo Riquelme,ESP,"MF,FW",22,2000,24.2,20,8,8,8,4,9,35,25.7,26,16,0,16,11,31,5,0,2023
ESP-La Liga,2022,Girona,Samuel Sáiz,ESP,MF,31,1991,2.7,2,2,0,2,0,1,2,50.0,1,3,0,3,0,2,1,1,2023
ESP-La Liga,2022,Girona,Santiago Bueno,URU,DF,23,1998,33.4,63,38,43,19,1,24,36,66.7,12,34,22,12,31,94,105,2,2023
ESP-La Liga,2022,Girona,Toni Villa,ESP,"MF,FW",27,1995,9.9,25,18,9,11,5,10,23,43.5,13,8,0,8,8,33,3,0,2023
ESP-La Liga,2022,Girona,Valentín Castellanos,ARG,FW,23,1998,28.9,12,5,2,7,3,0,18,0.0,18,22,2,20,6,18,26,0,2023
ESP-La Liga,2022,Girona,Valery,ESP,"MF,DF",22,1999,10.7,12,6,4,6,2,5,9,55.6,4,8,1,7,10,22,9,1,2023
ESP-La Liga,2022,Girona,Viktor Tsyhankov,UKR,MF,24,1997,16.5,8,8,5,1,2,1,14,7.1,13,13,2,11,7,15,12,0,2023
ESP-La Liga,2022,Girona,Yan Couto,BRA,"DF,MF",20,2002,12.9,25,18,11,11,3,12,20,60.0,8,7,2,5,5,30,10,0,2023
ESP-La Liga,2022,Girona,Yangel Herrera,VEN,"MF,FW",24,1998,10.7,26,9,9,14,3,6,15,40.0,9,14,1,13,4,30,12,0,2023
ESP-La Liga,2022,Mallorca,Abdón Prats,ESP,"FW,MF",29,1992,4.6,1,0,1,0,0,0,0,,0,5,0,5,0,1,2,0,2023
ESP-La Liga,2022,Mallorca,Amath,SEN,"MF,FW",26,1996,13.6,29,19,14,8,7,14,22,63.6,8,13,1,12,5,34,5,0,2023
ESP-La Liga,2022,Mallorca,Antonio Raillo,ESP,DF,30,1991,30.7,34,21,23,11,0,10,15,66.7,5,38,29,9,31,65,158,1,2023
ESP-La Liga,2022,Mallorca,Antonio Sánchez,ESP,"MF,DF",25,1997,12.0,19,8,13,4,2,10,34,29.4,24,18,0,18,22,41,14,1,2023
ESP-La Liga,2022,Mallorca,Braian Cufré,ARG,DF,25,1996,2.4,5,2,2,1,2,2,5,40.0,3,2,1,1,2,7,1,0,2023
ESP-La Liga,2022,Mallorca,Clément Grenier,FRA,MF,31,1991,8.0,20,8,6,12,2,10,20,50.0,10,9,1,8,6,26,7,0,2023
ESP-La Liga,2022,Mallorca,Copete,ESP,DF,22,1999,24.5,53,28,35,16,2,26,36,72.2,10,38,17,21,44,97,111,2,2023
ESP-La Liga,2022,Mallorca,Dani Rodríguez,ESP,MF,34,1988,23.3,42,23,18,22,2,21,46,45.7,25,31,8,23,21,63,14,0,2023
ESP-La Liga,2022,Mallorca,Dennis Hadzikadunic,BIH,DF,24,1998,6.8,9,6,4,5,0,4,4,100.0,0,5,4,1,3,12,27,0,2023
ESP-La Liga,2022,Mallorca,Dominik Greif,SVK,GK,25,1997,1.0,0,0,0,0,0,0,0,,0,0,0,0,0,0,0,0,2023
ESP-La Liga,2022,Mallorca,Franco Russo,ARG,DF,27,1994,1.6,2,1,2,0,0,0,1,0.0,1,5,0,5,3,5,5,0,2023
ESP-La Liga,2022,Mallorca,Giovanni González,URU,DF,27,1994,10.3,16,8,11,2,3,9,22,40.9,13,8,2,6,7,23,22,0,2023
ESP-La Liga,2022,Mallorca,Iddrisu Baba,GHA,"MF,DF",26,1996,18.9,31,17,15,16,0,15,32,46.9,17,18,8,10,11,42,39,0,2023
ESP-La Liga,2022,Mallorca,Iñigo Ruiz de Galarreta,ESP,MF,28,1993,27.2,54,38,27,23,4,20,52,38.5,32,26,9,17,30,84,19,0,2023
ESP-La Liga,2022,Mallorca,Jaume Costa,ESP,DF,34,1988,28.9,50,34,26,17,7,29,51,56.9,22,13,5,8,22,72,44,1,2023
ESP-La Liga,2022,Mallorca,Javier Llabrés,ESP,FW,19,2002,0.2,0,0,0,0,0,0,0,,0,0,0,0,0,0,1,0,2023
ESP-La Liga,2022,Mallorca,Josep Antoni Gayá,ESP,"DF,MF",22,2000,1.1,0,0,0,0,0,0,0,,0,4,2,2,1,1,6,0,2023
ESP-La Liga,2022,Mallorca,Lago Junior,CIV,"FW,MF",31,1990,0.6,1,0,0,1,0,1,1,100.0,0,0,0,0,0,1,0,0,2023
ESP-La Liga,2022,Mallorca,Lee Kangin,KOR,"MF,FW",21,2001,31.4,42,24,10,22,10,18,61,29.5,43,25,2,23,11,53,7,0,2023
ESP-La Liga,2022,Mallorca,Leonardo Román,ESP,GK,22,2000,1.0,0,0,0,0,0,0,0,,0,0,0,0,0,0,0,0,2023
ESP-La Liga,2022,Mallorca,Ludwig Augustinsson,SWE,DF,28,1994,1.5,2,1,2,0,0,1,3,33.3,2,1,0,1,1,3,3,0,2023
ESP-La Liga,2022,Mallorca,Manu Morlanes,ESP,MF,23,1999,7.8,22,9,12,8,2,13,24,54.2,11,10,5,5,5,27,9,0,2023
ESP-La Liga,2022,Mallorca,Martin Valjent,SVK,DF,26,1995,29.5,35,27,22,12,1,19,28,67.9,9,39,21,18,29,64,137,0,2023
ESP-La Liga,2022,Mallorca,Matija Nastasić,SRB,DF,29,1993,10.1,10,8,7,1,2,3,6,50.0,3,11,4,7,18,28,43,1,2023
ESP-La Liga,2022,Mallorca,Pablo Maffeo,ESP,DF,25,1997,33.1,75,46,54,16,5,45,78,57.7,33,38,11,27,26,101,76,0,2023
ESP-La Liga,2022,Mallorca,Predrag Rajković,SRB,GK,26,1995,36.0,0,0,0,0,0,0,2,0.0,2,0,0,0,0,0,16,1,2023
ESP-La Liga,2022,Mallorca,Rodrigo Battaglia,ARG,MF,31,1991,7.6,12,5,7,5,0,6,14,42.9,8,16,7,9,5,17,18,0,2023
ESP-La Liga,2022,Mallorca,Rubén Quintanilla,ESP,DF,20,2002,0.0,0,0,0,0,0,0,0,,0,1,0,1,0,0,0,0,2023
ESP-La Liga,2022,Mallorca,Tino Kadewere,ZIM,"FW,MF",26,1996,6.0,6,3,3,3,0,4,9,44.4,5,6,2,4,2,8,1,0,2023
ESP-La Liga,2022,Mallorca,Vedat Muriqi,KVX,FW,28,1994,32.6,12,7,4,7,1,3,13,23.1,10,19,7,12,12,24,73,0,2023
ESP-La Liga,2022,Mallorca,Ángel Rodríguez,ESP,"FW,MF",35,1987,4.4,1,1,0,1,0,0,2,0.0,2,3,0,3,1,2,1,0,2023
ESP-La Liga,2022,Osasuna,Abdessamad Ezzalzouli,MAR,"FW,MF",20,2001,16.7,29,19,13,12,4,13,23,56.5,10,20,0,20,4,33,6,0,2023
ESP-La Liga,2022,Osasuna,Aimar Oroz,ESP,"MF,FW",20,2001,22.4,26,14,8,10,8,8,30,26.7,22,24,1,23,24,50,6,0,2023
ESP-La Liga,2022,Osasuna,Aitor Fernández,ESP,GK,31,1991,21.0,1,1,1,0,0,0,1,0.0,1,0,0,0,2,3,17,0,2023
ESP-La Liga,2022,Osasuna,Ante Budimir,CRO,FW,31,1991,20.0,19,9,0,12,7,2,10,20.0,8,10,0,10,5,24,19,0,2023
ESP-La Liga,2022,Osasuna,Aridane Hernández,EQG,DF,33,1989,19.9,21,15,17,4,0,12,25,48.0,13,34,21,13,28,49,96,1,2023
ESP-La Liga,2022,Osasuna,Darko Brašanac,SRB,MF,30,1992,11.6,29,20,12,10,7,12,23,52.2,11,14,2,12,12,41,9,0,2023
ESP-La Liga,2022,Osasuna,David García,ESP,DF,28,1994,29.8,34,20,22,12,0,19,22,86.4,3,28,13,15,45,79,151,0,2023
ESP-La Liga,2022,Osasuna,Diego Moreno,ESP,DF,21,2001,7.1,4,4,2,2,0,3,8,37.5,5,7,4,3,5,9,21,0,2023
ESP-La Liga,2022,Osasuna,Ezequiel Ávila,ARG,"FW,MF",28,1994,19.0,8,5,2,4,2,6,23,26.1,17,12,1,11,8,16,16,0,2023
ESP-La Liga,2022,Osasuna,Iker Benito,ESP,"FW,MF",19,2002,2.0,4,3,0,3,1,2,4,50.0,2,0,0,0,2,6,4,0,2023
ESP-La Liga,2022,Osasuna,Iker Muñoz,ESP,MF,19,2002,2.8,1,0,0,1,0,0,3,0.0,3,2,1,1,3,4,8,0,2023
ESP-La Liga,2022,Osasuna,Jon Moncayola,ESP,"MF,DF",24,1998,27.2,55,39,24,22,9,30,76,39.5,46,37,5,32,17,72,32,2,2023
ESP-La Liga,2022,Osasuna,Jorge Herrando,ESP,DF,21,2001,0.3,0,0,0,0,0,0,0,,0,1,0,1,0,0,3,0,2023
ESP-La Liga,2022,Osasuna,Juan Cruz Armada,ESP,DF,30,1992,22.9,24,14,17,4,3,13,23,56.5,10,21,8,13,13,37,58,0,2023
ESP-La Liga,2022,Osasuna,Kike,ESP,FW,32,1989,11.3,6,3,0,4,2,2,5,40.0,3,6,1,5,1,7,13,0,2023
ESP-La Liga,2022,Osasuna,Kike Barja,ESP,"FW,MF",25,1997,14.6,15,9,6,5,4,8,24,33.3,16,7,0,7,4,19,3,0,2023
ESP-La Liga,2022,Osasuna,Lucas Torró,ESP,MF,28,1994,27.5,48,32,28,15,5,18,42,42.9,24,24,3,21,42,90,64,1,2023
ESP-La Liga,2022,Osasuna,Manuel Sánchez,ESP,DF,21,2000,23.6,51,35,35,9,7,33,63,52.4,30,33,5,28,14,65,51,0,2023
ESP-La Liga,2022,Osasuna,Moi Gómez,ESP,"MF,FW",28,1994,27.3,26,17,9,14,3,15,32,46.9,17,15,3,12,10,36,5,1,2023
ESP-La Liga,2022,Osasuna,Nacho Vidal,ESP,DF,27,1995,13.9,27,14,16,6,5,17,32,53.1,15,17,4,13,19,46,33,1,2023
ESP-La Liga,2022,Osasuna,Pablo Ibáñez,ESP,MF,23,1998,11.8,29,13,7,17,5,12,35,34.3,23,19,2,17,8,37,24,0,2023
ESP-La Liga,2022,Osasuna,Roberto Torres,ESP,"FW,MF",33,1989,0.1,0,0,0,0,0,0,0,,0,0,0,0,0,0,0,0,2023
ESP-La Liga,2022,Osasuna,Rubén García,ESP,"FW,MF",29,1993,12.9,20,11,12,4,4,7,24,29.2,17,14,1,13,12,32,13,0,2023
ESP-La Liga,2022,Osasuna,Rubén Peña,ESP,"DF,MF",31,1991,14.2,32,18,10,18,4,20,41,48.8,21,23,8,15,17,49,31,0,2023
ESP-La Liga,2022,Osasuna,Sergio Herrera,ESP,GK,29,1993,17.0,2,0,2,0,0,2,2,100.0,0,1,0,1,1,3,6,2,2023
ESP-La Liga,2022,Osasuna,Unai García,ESP,DF,30,1992,19.0,23,13,13,8,2,12,17,70.6,5,23,14,9,19,42,60,2,2023
ESP-La Liga,2022,Rayo Vallecano,Abdul Mumin,GHA,DF,24,1998,10.2,11,9,5,6,0,3,7,42.9,4,13,5,8,9,20,36,2,2023
ESP-La Liga,2022,Rayo Vallecano,Andrés Martín,ESP,"FW,MF",23,1999,2.3,4,2,2,1,1,3,5,60.0,2,2,0,2,1,5,2,0,2023
ESP-La Liga,2022,Rayo Vallecano,Bebé,CPV,FW,32,1990,0.7,0,0,0,0,0,0,2,0.0,2,1,0,1,0,0,0,0,2023
ESP-La Liga,2022,Rayo Vallecano,Catena,ESP,DF,27,1994,34.5,29,14,23,4,2,13,27,48.1,14,32,25,7,28,57,159,1,2023
ESP-La Liga,2022,Rayo Vallecano,Diego López,ESP,GK,40,1981,1.1,0,0,0,0,0,0,0,,0,0,0,0,0,0,0,1,2023
ESP-La Liga,2022,Rayo Vallecano,Diego Méndez,ESP,MF,18,2003,0.0,0,0,0,0,0,0,0,,0,0,0,0,1,1,0,0,2023
ESP-La Liga,2022,Rayo Vallecano,Esteban Saveljich,MNE,FW,31,1991,0.0,0,0,0,0,0,0,0,,0,0,0,0,0,0,0,0,2023
ESP-La Liga,2022,Rayo Vallecano,Florian Lejeune,FRA,DF,31,1991,28.5,28,17,19,8,1,17,25,68.0,8,24,16,8,15,43,123,0,2023
ESP-La Liga,2022,Rayo Vallecano,Fran Garcia,ESP,DF,22,1999,37.9,84,54,53,23,8,55,96,57.3,41,49,8,41,44,128,66,0,2023
ESP-La Liga,2022,Rayo Vallecano,Isaac Palazón Camacho,ESP,"FW,MF",27,1994,32.9,45,30,11,23,11,24,66,36.4,42,42,3,39,17,62,30,0,2023
ESP-La Liga,2022,Rayo Vallecano,Iván Balliu,ALB,DF,30,1992,35.9,52,29,26,20,6,18,30,60.0,12,26,3,23,25,77,72,1,2023
ESP-La Liga,2022,Rayo Vallecano,José Pozo,ESP,"MF,FW",26,1996,1.0,2,2,0,2,0,0,0,,0,0,0,0,1,3,1,0,2023
ESP-La Liga,2022,Rayo Vallecano,Mario Hernández,ESP,DF,23,1999,1.1,3,2,2,1,0,3,7,42.9,4,2,0,2,2,5,0,0,2023
ESP-La Liga,2022,Rayo Vallecano,Mario Suárez,ESP,"MF,DF",35,1987,0.1,0,0,0,0,0,0,0,,0,1,0,1,0,0,0,0,2023
ESP-La Liga,2022,Rayo Vallecano,Pablo Muñoz,ESP,MF,18,2003,0.1,0,0,0,0,0,0,1,0.0,1,0,0,0,0,0,0,0,2023
ESP-La Liga,2022,Rayo Vallecano,Pathé Ciss,SEN,"MF,DF",28,1994,14.2,39,29,11,23,5,15,34,44.1,19,23,10,13,22,61,34,0,2023
ESP-La Liga,2022,Rayo Vallecano,Pep Chavarría,ESP,"FW,MF",24,1998,4.1,6,4,2,1,3,1,5,20.0,4,8,0,8,2,8,8,0,2023
ESP-La Liga,2022,Rayo Vallecano,Radamel Falcao,COL,"FW,MF",36,1986,6.8,4,4,1,3,0,1,8,12.5,7,5,1,4,2,6,10,0,2023
ESP-La Liga,2022,Rayo Vallecano,Randy Ntekja,FRA,"FW,MF",24,1997,1.3,4,2,2,2,0,1,1,100.0,0,2,0,2,2,6,3,0,2023
ESP-La Liga,2022,Rayo Vallecano,Raúl de Tomás,ESP,FW,27,1994,8.9,3,2,0,1,2,2,6,33.3,4,4,0,4,0,3,6,0,2023
ESP-La Liga,2022,Rayo Vallecano,Salvi,ESP,"FW,MF",31,1991,5.4,13,8,5,5,3,2,8,25.0,6,0,0,0,2,15,2,0,2023
ESP-La Liga,2022,Rayo Vallecano,Santi Comesaña,ESP,MF,25,1996,27.2,71,44,24,41,6,38,82,46.3,44,39,3,36,32,103,17,0,2023
ESP-La Liga,2022,Rayo Vallecano,Sergio Camello,ESP,FW,21,2001,26.7,16,10,3,9,4,5,17,29.4,12,9,1,8,2,18,26,0,2023
ESP-La Liga,2022,Rayo Vallecano,Stole Dimitrievski,MKD,GK,28,1993,36.9,1,0,1,0,0,1,2,50.0,1,2,0,2,1,2,17,3,2023
ESP-La Liga,2022,Rayo Vallecano,Unai López,ESP,MF,26,1995,13.9,32,20,10,17,5,13,37,35.1,24,12,1,11,15,47,6,1,2023
ESP-La Liga,2022,Rayo Vallecano,Álvaro García,ESP,"FW,MF",29,1992,31.9,49,28,21,13,15,11,33,33.3,22,41,4,37,34,83,24,1,2023
ESP-La Liga,2022,Rayo Vallecano,Óscar Trejo,ARG,"MF,FW",34,1988,23.8,48,32,12,23,13,9,44,20.5,35,31,3,28,8,56,8,1,2023
ESP-La Liga,2022,Rayo Vallecano,Óscar Valentín,ESP,MF,27,1994,28.4,92,51,29,50,13,46,121,38.0,75,60,9,51,44,136,30,0,2023
ESP-La Liga,2022,Real Madrid,Andriy Lunin,UKR,GK,23,1999,7.0,0,0,0,0,0,0,0,,0,0,0,0,0,0,1,0,2023
ESP-La Liga,2022,Real Madrid,Antonio Rüdiger,GER,DF,29,1993,26.8,18,16,12,5,1,14,23,60.9,9,23,13,10,19,37,74,0,2023
ESP-La Liga,2022,Real Madrid,Aurélien Tchouaméni,FRA,MF,22,2000,23.5,64,40,23,36,5,23,38,60.5,15,20,6,14,49,113,50,0,2023
ESP-La Liga,2022,Real Madrid,Casemiro,BRA,MF,30,1992,0.1,0,0,0,0,0,0,0,,0,0,0,0,0,0,1,0,2023
ESP-La Liga,2022,Real Madrid,Dani Carvajal,ESP,DF,30,1992,19.8,32,18,15,12,5,18,35,51.4,17,24,6,18,15,47,49,0,2023
ESP-La Liga,2022,Real Madrid,Dani Ceballos,ESP,MF,25,1996,17.4,43,29,13,15,15,25,64,39.1,39,23,2,21,25,68,6,1,2023
ESP-La Liga,2022,Real Madrid,David Alaba,AUT,DF,30,1992,20.4,15,11,8,4,3,9,15,60.0,6,18,9,9,14,29,37,1,2023
ESP-La Liga,2022,Real Madrid,Eden Hazard,BEL,FW,31,1991,2.2,0,0,0,0,0,0,2,0.0,2,1,0,1,1,1,0,0,2023
ESP-La Liga,2022,Real Madrid,Eduardo Camavinga,FRA,"MF,DF",19,2002,22.3,68,48,32,21,15,24,64,37.5,40,24,5,19,17,85,25,0,2023
ESP-La Liga,2022,Real Madrid,Federico Valverde,URU,"MF,FW",24,1998,27.8,31,20,14,11,6,13,26,50.0,13,31,4,27,17,48,15,0,2023
ESP-La Liga,2022,Real Madrid,Ferland Mendy,FRA,DF,27,1995,15.0,21,12,14,6,1,12,20,60.0,8,7,2,5,14,35,16,0,2023
ESP-La Liga,2022,Real Madrid,Jesús Vallejo,ESP,DF,25,1997,0.2,0,0,0,0,0,0,0,,0,0,0,0,0,0,0,0,2023
ESP-La Liga,2022,Real Madrid,Karim Benzema,FRA,FW,34,1987,22.6,9,5,2,4,3,2,11,18.2,9,11,0,11,2,11,5,0,2023
ESP-La Liga,2022,Real Madrid,Lucas Vázquez,ESP,DF,31,1991,12.7,34,23,22,10,2,20,28,71.4,8,10,0,10,7,41,13,0,2023
ESP-La Liga,2022,Real Madrid,Luka Modrić,CRO,MF,36,1985,19.4,19,9,6,6,7,10,25,40.0,15,15,5,10,10,29,7,0,2023
ESP-La Liga,2022,Real Madrid,Marco Asensio,ESP,"FW,MF",26,1996,16.0,16,10,8,6,2,8,19,42.1,11,8,3,5,5,21,4,0,2023
ESP-La Liga,2022,Real Madrid,Mariano,DOM,FW,28,1993,1.7,1,0,0,1,0,0,0,,0,1,0,1,0,1,0,0,2023
ESP-La Liga,2022,Real Madrid,Nacho,ESP,DF,32,1990,18.2,24,16,17,5,2,12,29,41.4,17,11,6,5,18,42,37,0,2023
ESP-La Liga,2022,Real Madrid,Rodrygo,BRA,"FW,MF",21,2001,26.4,17,10,3,7,7,4,23,17.4,19,23,0,23,8,25,5,0,2023
ESP-La Liga,2022,Real Madrid,Sergio Arribas,ESP,"MF,FW",20,2001,0.2,0,0,0,0,0,0,0,,0,1,0,1,0,0,0,0,2023
ESP-La Liga,2022,Real Madrid,Thibaut Courtois,BEL,GK,30,1992,31.0,1,0,1,0,0,1,1,100.0,0,0,0,0,3,4,7,1,2023
ESP-La Liga,2022,Real Madrid,Toni Kroos,GER,MF,32,1990,23.9,51,32,16,33,2,23,69,33.3,46,23,4,19,24,75,11,0,2023
ESP-La Liga,2022,Real Madrid,Vinicius Júnior,BRA,FW,22,2000,31.4,30,21,10,12,8,14,39,35.9,25,24,1,23,6,36,1,0,2023
ESP-La Liga,2022,Real Madrid,Álvaro Muñoz,URU,FW,18,2004,0.9,2,1,1,0,1,1,1,100.0,0,0,0,0,0,2,1,0,2023
ESP-La Liga,2022,Real Madrid,Álvaro Odriozola,ESP,DF,26,1995,0.4,0,0,0,0,0,0,0,,0,0,0,0,0,0,0,0,2023
ESP-La Liga,2022,Real Madrid,Éder Militão,BRA,DF,24,1998,30.0,46,32,25,18,3,26,33,78.8,7,67,39,28,42,88,104,2,2023
ESP-La Liga,2022,Real Sociedad,Aihen Muñoz,ESP,DF,24,1997,19.5,38,23,17,17,4,22,47,46.8,25,26,5,21,9,47,38,0,2023
ESP-La Liga,2022,Real Sociedad,Alex Sola,ESP,DF,23,1999,3.9,18,9,14,3,1,7,10,70.0,3,7,2,5,7,25,10,0,2023
ESP-La Liga,2022,Real Sociedad,Alexander Isak,SWE,FW,22,1999,1.7,1,1,0,0,1,0,0,,0,0,0,0,0,1,2,0,2023
ESP-La Liga,2022,Real Sociedad,Alexander Sørloth,NOR,FW,26,1995,26.5,18,9,3,6,9,7,14,50.0,7,15,1,14,2,20,26,1,2023
ESP-La Liga,2022,Real Sociedad,Ander Barrenetxea,ESP,"FW,DF",20,2001,9.8,21,15,15,6,0,12,28,42.9,16,15,1,14,5,26,7,0,2023
ESP-La Liga,2022,Real Sociedad,Ander Guevara,ESP,MF,25,1997,2.5,5,2,2,2,1,1,4,25.0,3,6,1,5,2,7,3,0,2023
ESP-La Liga,2022,Real Sociedad,Ander Martin,ESP,"MF,FW",21,2000,0.5,2,2,1,1,0,1,4,25.0,3,0,0,0,0,2,1,0,2023
ESP-La Liga,2022,Real Sociedad,Andoni Gorosabel,ESP,DF,25,1996,19.0,41,25,23,9,9,26,43,60.5,17,21,2,19,17,58,23,0,2023
ESP-La Liga,2022,Real Sociedad,Aritz Elustondo,ESP,DF,28,1994,16.1,26,17,15,10,1,14,26,53.8,12,15,6,9,20,46,43,1,2023
ESP-La Liga,2022,Real Sociedad,Asier Illarramendi,ESP,MF,32,1990,12.0,36,18,10,22,4,16,44,36.4,28,27,8,19,18,54,20,0,2023
ESP-La Liga,2022,Real Sociedad,Beñat Turrientes,ESP,"MF,FW",20,2002,1.2,3,3,3,0,0,1,5,20.0,4,2,0,2,0,3,3,0,2023
ESP-La Liga,2022,Real Sociedad,Brais Méndez,ESP,MF,25,1997,26.7,58,34,18,30,10,24,64,37.5,40,27,3,24,12,70,14,1,2023
ESP-La Liga,2022,Real Sociedad,Carlos Fernández,ESP,FW,26,1996,7.0,6,4,1,3,2,1,15,6.7,14,1,0,1,1,7,4,0,2023
ESP-La Liga,2022,Real Sociedad,David Silva,ESP,MF,36,1986,21.5,36,21,11,18,7,11,19,57.9,8,17,2,15,15,51,16,0,2023
ESP-La Liga,2022,Real Sociedad,Diego Rico,ESP,DF,29,1993,18.3,35,21,17,11,7,12,27,44.4,15,18,5,13,20,55,51,1,2023
ESP-La Liga,2022,Real Sociedad,Igor Zubeldia,ESP,DF,25,1997,28.2,35,18,28,7,0,25,35,71.4,10,23,17,6,21,56,93,0,2023
ESP-La Liga,2022,Real Sociedad,Jon Karrikaburu,ESP,FW,19,2002,1.0,1,0,0,1,0,0,0,,0,2,0,2,0,1,0,0,2023
ESP-La Liga,2022,Real Sociedad,Jon Magunacelaya,ESP,"MF,FW",22,2000,0.7,1,0,0,0,1,0,2,0.0,2,0,0,0,0,1,1,0,2023
ESP-La Liga,2022,Real Sociedad,Jon Pacheco,ESP,DF,21,2001,13.3,16,10,10,6,0,6,10,60.0,4,9,6,3,12,28,37,1,2023
ESP-La Liga,2022,Real Sociedad,Martín Zubimendi,ESP,MF,23,1999,34.5,59,33,23,30,6,24,45,53.3,21,44,17,27,37,96,55,4,2023
ESP-La Liga,2022,Real Sociedad,Mikel Merino,ESP,MF,26,1996,27.7,77,49,28,33,16,31,62,50.0,31,38,8,30,20,97,51,1,2023
ESP-La Liga,2022,Real Sociedad,Mikel Oyarzabal,ESP,"FW,MF",25,1997,13.5,13,7,5,3,5,5,19,26.3,14,14,4,10,3,16,5,0,2023
ESP-La Liga,2022,Real Sociedad,Mohamed Ali Cho,FRA,"FW,MF",18,2004,6.5,13,10,6,5,2,4,10,40.0,6,9,0,9,2,15,2,0,2023
ESP-La Liga,2022,Real Sociedad,Olasagasti,ESP,"MF,DF",21,2000,0.7,4,4,1,2,1,1,2,50.0,1,2,0,2,0,4,1,0,2023
ESP-La Liga,2022,Real Sociedad,Pablo Marín,ESP,"MF,FW",19,2003,4.0,10,5,5,4,1,2,7,28.6,5,1,0,1,4,14,2,0,2023
ESP-La Liga,2022,Real Sociedad,Roberto Navarro,ESP,"MF,FW",20,2002,3.9,5,4,4,0,1,1,2,50.0,1,7,0,7,2,7,2,0,2023
ESP-La Liga,2022,Real Sociedad,Robin Le Normand,ESP,DF,25,1996,31.1,36,23,25,9,2,14,27,51.9,13,22,14,8,33,69,93,0,2023
ESP-La Liga,2022,Real Sociedad,Takefusa Kubo,JPN,"FW,MF",21,2001,27.1,44,26,18,16,10,16,38,42.1,22,29,1,28,9,53,4,0,2023
ESP-La Liga,2022,Real Sociedad,Umar Sadiq,NGA,FW,25,1997,0.9,1,1,0,0,1,0,1,0.0,1,2,0,2,0,1,0,0,2023
ESP-La Liga,2022,Real Sociedad,Álex Remiro,ESP,GK,27,1995,38.0,1,1,1,0,0,1,3,33.3,2,0,0,0,0,1,17,3,2023
ESP-La Liga,2022,Sevilla,Adnan Januzaj,BEL,FW,27,1995,0.5,0,0,0,0,0,0,1,0.0,1,0,0,0,1,1,0,0,2023
ESP-La Liga,2022,Sevilla,Alex Telles,BRA,DF,29,1992,15.9,21,13,15,6,0,13,25,52.0,12,17,5,12,20,41,38,0,2023
ESP-La Liga,2022,Sevilla,Bryan,ESP,"FW,DF",21,2001,10.2,22,11,11,7,4,10,23,43.5,13,10,0,10,8,30,10,0,2023
ESP-La Liga,2022,Sevilla,Carlos Álvarez,ESP,FW,18,2003,0.1,,1,,,,,,,,,,,0,,,,2023
ESP-La Liga,2022,Sevilla,Carmona,ESP,DF,20,2002,5.9,13,11,5,3,5,9,16,56.3,7,10,6,4,7,20,17,1,2023
ESP-La Liga,2022,Sevilla,Diego Iturralde,ESP,DF,19,2003,0.5,1,0,1,0,0,0,2,0.0,2,0,0,0,0,1,1,0,2023
ESP-La Liga,2022,Sevilla,Enrique Valiente,ESP,DF,20,2002,4.1,1,1,1,0,0,0,0,,0,4,3,1,5,6,23,0,2023
ESP-La Liga,2022,Sevilla,Fernando,BRA,"MF,DF",35,1987,17.5,34,23,14,17,3,18,30,60.0,12,21,10,11,24,58,29,0,2023
ESP-La Liga,2022,Sevilla,Gonzalo Montiel,ARG,DF,25,1997,16.9,26,15,12,14,0,15,29,51.7,14,25,7,18,19,45,38,0,2023
ESP-La Liga,2022,Sevilla,Isco,ESP,"MF,FW",30,1992,8.9,15,9,6,5,4,8,14,57.1,6,3,0,3,10,25,3,0,2023
ESP-La Liga,2022,Sevilla,Ivan Rakitić,CRO,MF,34,1988,19.9,37,26,10,18,9,19,40,47.5,21,21,1,20,27,64,20,0,2023
ESP-La Liga,2022,Sevilla,Iván Romero,ESP,MF,21,2001,0.1,0,0,0,0,0,0,0,,0,0,0,0,0,0,0,0,2023
ESP-La Liga,2022,Sevilla,Jesús Corona,MEX,FW,29,1993,1.2,1,0,1,0,0,0,1,0.0,1,0,0,0,1,2,1,0,2023
ESP-La Liga,2022,Sevilla,Jesús Navas,ESP,"DF,FW",36,1985,22.0,19,12,8,3,8,11,22,50.0,11,18,7,11,22,41,52,1,2023
ESP-La Liga,2022,Sevilla,Joan Jordán,ESP,MF,28,1994,17.7,32,17,13,17,2,16,38,42.1,22,14,7,7,16,48,14,2,2023
ESP-La Liga,2022,Sevilla,Karim Rekik,NED,DF,27,1994,13.1,11,5,8,3,0,4,5,80.0,1,12,5,7,10,21,24,0,2023
ESP-La Liga,2022,Sevilla,Kasper Dolberg,DEN,FW,24,1997,2.2,1,0,0,1,0,1,3,33.3,2,0,0,0,0,1,5,0,2023
ESP-La Liga,2022,Sevilla,Loïc Bade,FRA,DF,22,2000,16.1,27,20,23,3,1,17,30,56.7,13,21,13,8,23,50,77,0,2023
ESP-La Liga,2022,Sevilla,Lucas Ocampos,ARG,"FW,MF",28,1994,12.9,22,14,9,9,4,8,31,25.8,23,17,2,15,8,30,5,0,2023
ESP-La Liga,2022,Sevilla,Manuel Sebastián,ESP,MF,18,2004,1.7,7,4,3,3,1,5,8,62.5,3,0,0,0,0,7,2,0,2023
ESP-La Liga,2022,Sevilla,Marcos Acuña,ARG,DF,30,1991,21.2,57,36,34,17,6,30,42,71.4,12,16,5,11,23,80,36,0,2023
ESP-La Liga,2022,Sevilla,Marcão,BRA,DF,26,1996,4.2,2,2,1,1,0,1,1,100.0,0,3,3,0,6,8,14,0,2023
ESP-La Liga,2022,Sevilla,Marko Dmitrović,SRB,GK,30,1992,14.1,0,0,0,0,0,0,0,,0,0,0,0,0,0,6,0,2023
ESP-La Liga,2022,Sevilla,Nemanja Gudelj,SRB,"DF,MF",30,1991,30.9,43,33,22,18,3,20,33,60.6,13,39,29,10,34,77,102,1,2023
ESP-La Liga,2022,Sevilla,Pape Gueye,SEN,MF,23,1999,13.0,37,22,13,21,3,16,33,48.5,17,21,5,16,22,59,10,0,2023
ESP-La Liga,2022,Sevilla,Papu Gómez,ARG,"FW,MF",34,1988,11.8,6,4,3,3,0,2,10,20.0,8,8,1,7,4,10,5,0,2023
ESP-La Liga,2022,Sevilla,Pedro Ortiz,ESP,MF,21,2000,0.0,0,0,0,0,0,0,0,,0,0,0,0,0,0,0,0,2023
ESP-La Liga,2022,Sevilla,Rafa Mir,ESP,FW,25,1997,14.4,8,2,2,4,2,2,5,40.0,3,5,1,4,4,12,11,0,2023
ESP-La Liga,2022,Sevilla,Suso,ESP,"MF,FW",28,1993,11.8,16,10,5,7,4,10,22,45.5,12,7,1,6,2,18,3,0,2023
ESP-La Liga,2022,Sevilla,Tanguy Nianzou,FRA,DF,20,2002,15.2,20,15,10,9,1,8,11,72.7,3,8,5,3,16,36,44,3,2023
ESP-La Liga,2022,Sevilla,Thomas Delaney,DEN,MF,30,1991,3.4,4,2,0,4,0,3,5,60.0,2,3,2,1,4,8,3,0,2023
ESP-La Liga,2022,Sevilla,Yassine Bounou,MAR,GK,31,1991,23.9,2,1,2,0,0,1,4,25.0,3,0,0,0,2,4,11,1,2023
ESP-La Liga,2022,Sevilla,Youssef En-Nesyri,MAR,FW,25,1997,18.5,16,8,3,7,6,4,14,28.6,10,6,2,4,4,20,16,0,2023
ESP-La Liga,2022,Sevilla,Érik Lamela,ARG,"FW,MF",30,1992,20.5,46,27,14,16,16,12,34,35.3,22,26,2,24,7,53,3,0,2023
ESP-La Liga,2022,Sevilla,Óliver Torres,ESP,"MF,FW",27,1994,23.7,39,23,12,13,14,18,59,30.5,41,26,5,21,10,49,10,0,2023
ESP-La Liga,2022,Valencia,Alberto Marí,ESP,"FW,MF",21,2001,1.0,0,0,0,0,0,0,2,0.0,2,0,0,0,0,0,1,0,2023
ESP-La Liga,2022,Valencia,Carlos Soler,ESP,MF,25,1997,2.7,2,0,0,1,1,2,3,66.7,1,1,0,1,0,2,2,0,2023
ESP-La Liga,2022,Valencia,Cenk Özkacar,TUR,DF,21,2000,15.2,27,20,17,10,0,14,19,73.7,5,14,2,12,12,39,47,4,2023
ESP-La Liga,2022,Valencia,Cristhian Mosquera,COL,DF,18,2004,1.6,4,2,3,1,0,4,5,80.0,1,1,0,1,1,5,5,0,2023
ESP-La Liga,2022,Valencia,Diego Noguerol,ESP,"FW,MF",20,2002,5.0,2,2,1,1,0,2,15,13.3,13,9,0,9,3,5,5,0,2023
ESP-La Liga,2022,Valencia,Dimitri Foulquier,FRA,DF,29,1993,19.3,31,19,17,8,6,20,28,71.4,8,19,3,16,14,45,40,0,2023
ESP-La Liga,2022,Valencia,Domingos André Ribeiro Almeida,POR,MF,22,2000,28.2,66,42,23,32,11,26,57,45.6,31,26,0,26,20,86,16,1,2023
ESP-La Liga,2022,Valencia,Edinson Cavani,URU,FW,35,1987,16.1,7,4,3,3,1,3,15,20.0,12,10,3,7,2,9,11,0,2023
ESP-La Liga,2022,Valencia,Eray Cömert,SUI,DF,24,1998,18.6,35,23,24,10,1,17,33,51.5,16,23,8,15,29,64,76,1,2023
ESP-La Liga,2022,Valencia,Francisco Perez,ESP,"FW,MF",19,2002,1.6,1,1,1,0,0,0,3,0.0,3,0,0,0,0,1,1,0,2023
ESP-La Liga,2022,Valencia,Gabriel Paulista,BRA,DF,31,1990,16.7,17,9,13,4,0,13,19,68.4,6,22,14,8,32,49,79,2,2023
ESP-La Liga,2022,Valencia,Giorgi Mamardashvili,GEO,GK,21,2000,38.0,0,0,0,0,0,0,0,,0,0,0,0,1,1,11,4,2023
ESP-La Liga,2022,Valencia,Hugo Duro,ESP,FW,22,1999,15.4,15,12,2,6,7,7,17,41.2,10,11,1,10,2,17,7,1,2023
ESP-La Liga,2022,Valencia,Hugo Guillamón,ESP,MF,22,2000,18.1,20,12,10,8,2,8,24,33.3,16,14,2,12,19,39,30,2,2023
ESP-La Liga,2022,Valencia,Ilaix Moriba,GUI,MF,19,2003,11.2,35,16,14,17,4,14,24,58.3,10,11,1,10,4,39,12,0,2023
ESP-La Liga,2022,Valencia,Javier Guerra,ESP,MF,19,2003,6.7,16,13,7,4,5,9,20,45.0,11,8,1,7,11,27,9,0,2023
ESP-La Liga,2022,Valencia,Jesus Vazquez,ESP,"DF,MF",19,2003,3.4,13,8,9,1,3,6,11,54.5,5,4,0,4,1,14,8,0,2023
ESP-La Liga,2022,Valencia,José Luis Gayà,ESP,DF,27,1995,30.1,80,46,61,16,3,43,74,58.1,31,28,9,19,23,103,48,0,2023
ESP-La Liga,2022,Valencia,Justin Kluivert,NED,"FW,MF",23,1999,16.1,17,14,7,4,6,6,12,50.0,6,4,0,4,7,24,4,0,2023
ESP-La Liga,2022,Valencia,Maranhão,BRA,"FW,MF",25,1996,5.0,4,1,1,1,2,1,2,50.0,1,4,1,3,0,4,0,0,2023
ESP-La Liga,2022,Valencia,Maxi Gómez,URU,FW,25,1996,1.2,0,0,0,0,0,0,0,,0,0,0,0,0,0,2,0,2023
ESP-La Liga,2022,Valencia,Mouctar Diakhaby,GUI,DF,25,1996,27.2,30,16,19,11,0,13,20,65.0,7,30,17,13,20,50,111,2,2023
ESP-La Liga,2022,Valencia,Nicolás González,ESP,MF,20,2002,15.6,27,15,11,13,3,9,25,36.0,16,21,7,14,19,46,16,0,2023
ESP-La Liga,2022,Valencia,Samu Castillejo,ESP,"FW,MF",27,1995,15.1,21,12,8,9,4,8,40,20.0,32,21,2,19,9,30,2,0,2023
ESP-La Liga,2022,Valencia,Samuel,BRA,"FW,MF",22,1999,32.1,66,43,17,37,12,26,72,36.1,46,34,0,34,18,84,16,0,2023
ESP-La Liga,2022,Valencia,Thierry Correia,POR,DF,23,1999,22.3,71,52,46,22,3,31,54,57.4,23,25,2,23,24,95,54,2,2023
ESP-La Liga,2022,Valencia,Toni Lato,ESP,"DF,MF",24,1997,10.2,23,11,9,12,2,9,21,42.9,12,10,1,9,6,29,14,0,2023
ESP-La Liga,2022,Valencia,Yunus Musah,USA,MF,19,2002,23.4,48,35,17,23,8,20,30,66.7,10,20,1,19,11,59,16,2,2023
ESP-La Liga,2022,Valladolid,Anuar,MAR,"MF,FW",27,1995,2.3,4,4,0,1,3,0,0,,0,5,2,3,3,7,3,0,2023
ESP-La Liga,2022,Valladolid,Babatunde Akinsola,NGA,FW,19,2003,0.1,1,1,0,0,1,0,0,,0,0,0,0,0,1,0,0,2023
ESP-La Liga,2022,Valladolid,Cyle Larin,CAN,FW,27,1995,16.3,9,3,2,4,3,3,7,42.9,4,6,3,3,0,9,15,0,2023
ESP-La Liga,2022,Valladolid,Darwin Machís,VEN,FW,29,1993,6.7,3,2,0,2,1,1,8,12.5,7,5,0,5,3,6,4,0,2023
ESP-La Liga,2022,Valladolid,David Torres,ESP,DF,19,2003,4.3,1,1,0,1,0,1,1,100.0,0,4,2,2,3,4,8,0,2023
ESP-La Liga,2022,Valladolid,Gonzalo Plata,ECU,FW,21,2000,25.6,66,35,31,24,11,23,70,32.9,47,40,0,40,12,78,10,1,2023
ESP-La Liga,2022,Valladolid,Iván Fresneda,ESP,DF,17,2004,19.4,48,34,31,13,4,29,47,61.7,18,32,8,24,15,63,60,0,2023
ESP-La Liga,2022,Valladolid,Iván Sánchez,ESP,"MF,FW",29,1992,12.8,20,14,8,8,4,10,27,37.0,17,14,1,13,8,28,4,0,2023
ESP-La Liga,2022,Valladolid,Javi Sánchez,ESP,DF,25,1997,26.6,43,26,27,15,1,17,26,65.4,9,32,22,10,46,89,116,0,2023
ESP-La Liga,2022,Valladolid,Jawad El Yamiq,MAR,DF,30,1992,17.9,17,11,10,7,0,6,11,54.5,5,27,19,8,37,54,101,0,2023
ESP-La Liga,2022,Valladolid,Joaquín Fernández,ESP,DF,26,1996,24.0,35,28,20,11,4,19,30,63.3,11,31,22,9,27,62,98,1,2023
ESP-La Liga,2022,Valladolid,Jordi Masip,ESP,GK,33,1989,27.9,0,0,0,0,0,0,2,0.0,2,0,0,0,1,1,3,2,2023
ESP-La Liga,2022,Valladolid,Juanjo Narváez,COL,"MF,FW",27,1995,1.6,1,1,1,0,0,1,1,100.0,0,2,0,2,0,1,0,0,2023
ESP-La Liga,2022,Valladolid,Kenedy,BRA,"FW,DF",26,1996,3.1,6,2,3,3,0,2,4,50.0,2,2,0,2,1,7,0,0,2023
ESP-La Liga,2022,Valladolid,Kike Pérez,ESP,MF,25,1997,25.6,67,33,30,32,5,25,68,36.8,43,26,7,19,20,87,28,0,2023
ESP-La Liga,2022,Valladolid,Lucas Olaza,URU,DF,28,1994,16.6,24,14,12,10,2,17,26,65.4,9,20,8,12,14,38,34,0,2023
ESP-La Liga,2022,Valladolid,Lucas Oliveira Rosa,BRA,DF,22,2000,10.3,39,18,23,10,6,12,20,60.0,8,12,2,10,15,54,24,0,2023
ESP-La Liga,2022,Valladolid,Luis Pérez,ESP,DF,27,1995,13.5,44,24,26,12,6,27,38,71.1,11,13,4,9,16,60,29,0,2023
ESP-La Liga,2022,Valladolid,Manuel Pozo,ESP,FW,20,2001,0.2,0,0,0,0,0,0,0,,0,2,0,2,2,2,0,0,2023
ESP-La Liga,2022,Valladolid,Martin Hongla,CMR,"DF,MF",24,1998,14.5,18,13,13,5,0,11,21,52.4,10,15,12,3,8,26,46,1,2023
ESP-La Liga,2022,Valladolid,Mickael Malsa,MTQ,MF,26,1995,0.8,2,2,1,1,0,1,4,25.0,3,1,1,0,2,4,3,0,2023
ESP-La Liga,2022,Valladolid,Monchu,ESP,MF,22,1999,22.6,50,29,20,21,9,19,46,41.3,27,28,11,17,18,68,22,1,2023
ESP-La Liga,2022,Valladolid,Roberto Arroyo,ESP,MF,18,2003,0.2,1,1,0,1,0,1,1,100.0,0,0,0,0,0,1,0,0,2023
ESP-La Liga,2022,Valladolid,Roque Mesa,ESP,MF,33,1989,18.0,27,15,16,10,1,12,38,31.6,26,16,4,12,13,40,18,0,2023
ESP-La Liga,2022,Valladolid,Selim Amallah,MAR,"MF,FW",25,1996,3.0,15,9,7,8,0,5,8,62.5,3,2,0,2,5,20,2,0,2023
ESP-La Liga,2022,Valladolid,Sergi Guardiola,ESP,FW,31,1991,5.6,12,7,6,5,1,2,4,50.0,2,6,0,6,2,14,7,0,2023
ESP-La Liga,2022,Valladolid,Sergio Asenjo,ESP,GK,33,1989,10.0,0,0,0,0,0,0,0,,0,0,0,0,0,0,10,2,2023
ESP-La Liga,2022,Valladolid,Sergio Escudero,ESP,DF,32,1989,16.0,33,19,21,8,4,15,35,42.9,20,26,6,20,26,59,46,0,2023
ESP-La Liga,2022,Valladolid,Sergio León,ESP,FW,33,1989,14.8,6,4,0,4,2,3,6,50.0,3,6,0,6,0,6,4,0,2023
ESP-La Liga,2022,Valladolid,Shon Weissman,ISR,FW,26,1996,8.3,2,1,1,1,0,0,4,0.0,4,8,0,8,1,3,7,0,2023
ESP-La Liga,2022,Valladolid,Sékou Gassama,SEN,FW,27,1995,0.4,0,0,0,0,0,0,0,,0,0,0,0,0,0,0,0,2023
ESP-La Liga,2022,Valladolid,Toni Villa,ESP,MF,27,1995,1.0,6,3,2,3,1,4,9,44.4,5,0,0,0,0,6,0,0,2023
ESP-La Liga,2022,Valladolid,Zouhair Feddal,MAR,DF,33,1989,4.2,4,2,1,3,0,3,4,75.0,1,9,9,0,5,9,27,0,2023
ESP-La Liga,2022,Valladolid,Álvaro Aceves,ESP,GK,19,2003,0.1,0,0,0,0,0,0,0,,0,0,0,0,0,0,0,0,2023
ESP-La Liga,2022,Valladolid,Álvaro Aguado,ESP,MF,26,1996,21.0,27,15,13,11,3,15,25,60.0,10,16,4,12,13,40,15,0,2023
ESP-La Liga,2022,Valladolid,Óscar Plano,ESP,"FW,MF",31,1991,22.6,40,25,9,17,14,12,37,32.4,25,26,2,24,29,69,23,0,2023
ESP-La Liga,2022,Villarreal,Alberto Del Moral,ESP,MF,22,2000,0.1,0,0,0,0,0,0,0,,0,0,0,0,0,0,0,0,2023
ESP-La Liga,2022,Villarreal,Alberto Moreno,ESP,DF,30,1992,14.4,23,12,10,10,3,11,24,45.8,13,12,1,11,23,46,26,0,2023
ESP-La Liga,2022,Villarreal,Alex Baena,ESP,"MF,FW",21,2001,21.6,30,17,9,15,6,15,45,33.3,30,15,3,12,7,37,16,0,2023
ESP-La Liga,2022,Villarreal,Alfonso Pedraza,ESP,DF,26,1996,18.1,35,26,20,10,5,19,29,65.5,10,19,1,18,18,53,31,0,2023
ESP-La Liga,2022,Villarreal,Arnaut Danjuma,NED,FW,25,1997,5.3,3,3,1,0,2,1,2,50.0,1,0,0,0,0,3,1,1,2023
ESP-La Liga,2022,Villarreal,Aïssa Mandi,ALG,DF,30,1991,16.2,18,10,14,3,1,6,12,50.0,6,19,14,5,21,39,58,0,2023
ESP-La Liga,2022,Villarreal,Daniel Parejo,ESP,MF,33,1989,36.5,71,40,32,23,16,30,75,40.0,45,40,12,28,29,100,31,2,2023
ESP-La Liga,2022,Villarreal,Diego Collado,ESP,FW,21,2001,0.1,0,0,0,0,0,0,0,,0,0,0,0,0,0,0,0,2023
ESP-La Liga,2022,Villarreal,Fernando Niño,ESP,"MF,FW",21,2000,0.2,0,0,0,0,0,0,0,,0,0,0,0,0,0,0,0,2023
ESP-La Liga,2022,Villarreal,Filip Jørgensen,DEN,GK,20,2002,2.0,0,0,0,0,0,0,1,0.0,1,0,0,0,0,0,0,0,2023
ESP-La Liga,2022,Villarreal,Francis Coquelin,FRA,MF,31,1991,8.3,18,13,7,9,2,7,7,100.0,0,8,2,6,9,27,7,0,2023
ESP-La Liga,2022,Villarreal,Gerard Moreno,ESP,FW,30,1992,13.7,11,6,0,6,5,3,6,50.0,3,6,2,4,5,16,10,0,2023
ESP-La Liga,2022,Villarreal,Gerónimo Rulli,ARG,GK,30,1992,14.0,0,0,0,0,0,0,0,,0,1,0,1,1,1,6,2,2023
ESP-La Liga,2022,Villarreal,Giovani Lo Celso,ARG,"MF,FW",26,1996,12.5,32,28,7,15,10,12,21,57.1,9,14,2,12,6,38,5,0,2023
ESP-La Liga,2022,Villarreal,Haissem Hassan,FRA,"FW,MF",20,2002,0.6,0,0,0,0,0,0,2,0.0,2,0,0,0,1,1,0,0,2023
ESP-La Liga,2022,Villarreal,Johan Mojica,COL,DF,29,1992,7.1,13,9,9,3,1,5,9,55.6,4,8,3,5,4,17,14,1,2023
ESP-La Liga,2022,Villarreal,Jorge Cuenca,ESP,DF,22,1999,5.6,9,7,7,2,0,4,7,57.1,3,10,8,2,6,15,44,0,2023
ESP-La Liga,2022,Villarreal,José Luis Morales,ESP,"FW,MF",35,1987,13.5,7,6,1,2,4,5,17,29.4,12,12,1,11,2,9,2,0,2023
ESP-La Liga,2022,Villarreal,Juan Foyth,ARG,DF,24,1998,21.8,73,48,49,22,2,41,57,71.9,16,32,11,21,20,93,68,0,2023
ESP-La Liga,2022,Villarreal,Kiko Femenía,ESP,DF,31,1991,12.6,18,9,14,3,1,13,18,72.2,5,15,6,9,20,38,22,0,2023
ESP-La Liga,2022,Villarreal,Mamadou Fall,SEN,DF,19,2002,0.3,0,0,0,0,0,0,0,,0,1,0,1,0,0,1,0,2023
ESP-La Liga,2022,Villarreal,Manu Morlanes,ESP,MF,23,1999,1.8,3,2,2,1,0,3,3,100.0,0,3,2,1,1,4,2,0,2023
ESP-La Liga,2022,Villarreal,Manu Trigueros,ESP,MF,30,1991,9.2,20,14,9,5,6,9,22,40.9,13,9,2,7,5,25,4,0,2023
ESP-La Liga,2022,Villarreal,Nicolas Jackson,SEN,FW,21,2001,17.8,14,11,2,10,2,2,8,25.0,6,18,2,16,2,16,4,0,2023
ESP-La Liga,2022,Villarreal,Pascu,ESP,"DF,FW",19,2003,0.1,0,0,0,0,0,0,0,,0,0,0,0,0,0,0,0,2023
ESP-La Liga,2022,Villarreal,Pau Torres,ESP,DF,25,1997,33.9,43,25,25,13,5,23,36,63.9,13,36,27,9,13,56,146,3,2023
ESP-La Liga,2022,Villarreal,Pepe Reina,ESP,GK,39,1982,22.0,0,0,0,0,0,0,1,0.0,1,0,0,0,1,1,4,4,2023
ESP-La Liga,2022,Villarreal,Ramón Terrats,ESP,MF,21,2000,9.1,15,10,3,8,4,9,17,52.9,8,11,4,7,8,23,6,2,2023
ESP-La Liga,2022,Villarreal,Raúl Albiol,ESP,DF,36,1985,23.5,25,17,17,6,2,14,18,77.8,4,17,13,4,14,39,111,0,2023
ESP-La Liga,2022,Villarreal,Samuel Chukwueze,NGA,"FW,MF",23,1999,26.0,14,7,7,2,5,7,23,30.4,16,13,0,13,12,26,16,0,2023
ESP-La Liga,2022,Villarreal,Yeremi Pino,ESP,"FW,MF",19,2002,27.2,62,38,25,20,17,21,56,37.5,35,41,4,37,15,77,36,0,2023
ESP-La Liga,2022,Villarreal,Étienne Capoue,FRA,MF,34,1988,21.7,21,12,6,13,2,10,18,55.6,8,12,5,7,19,40,20,1,2023
FRA-Ligue 1,2017,Amiens,Bakaye Dibassy,MLI,DF,27,1989,30.9,71,51,45,22,4,24,50,48.0,26,52,26,26,58,129,148,0,2018
FRA-Ligue 1,2017,Amiens,Bongani Zungu,RSA,MF,24,1992,23.2,54,37,21,26,7,24,56,42.9,32,30,5,25,38,92,41,2,2018
FRA-Ligue 1,2017,Amiens,Brighton Labeau,MTQ,FW,21,1996,0.3,0,0,0,0,0,0,0,,0,0,0,0,0,0,0,0,2018
FRA-Ligue 1,2017,Amiens,Charly Charrier,FRA,"MF,FW",31,1986,1.2,1,0,1,0,0,0,2,0.0,2,1,0,1,2,3,0,0,2018
FRA-Ligue 1,2017,Amiens,Danilo Avelar,BRA,DF,28,1989,19.2,41,33,27,9,5,14,45,31.1,31,16,7,9,37,78,83,1,2018
FRA-Ligue 1,2017,Amiens,Emmanuel Bourgaud,FRA,"FW,MF",29,1987,6.0,17,11,5,9,3,10,23,43.5,13,5,0,5,6,23,11,0,2018
FRA-Ligue 1,2017,Amiens,Gaël Kakuta,COD,"MF,FW",26,1991,34.3,54,32,14,27,13,9,40,22.5,31,33,3,30,26,80,19,0,2018
FRA-Ligue 1,2017,Amiens,Georges Gope-Fenepej,NCL,FW,28,1988,0.5,0,0,0,0,0,0,0,,0,0,0,0,0,0,0,0,2018
FRA-Ligue 1,2017,Amiens,Guessouma Fofana,MTN,MF,24,1992,8.3,20,13,8,12,0,6,13,46.2,7,7,1,6,12,32,11,0,2018
FRA-Ligue 1,2017,Amiens,Guy Ngosso,CMR,MF,32,1985,6.8,8,5,4,4,0,4,20,20.0,16,5,3,2,9,17,19,0,2018
FRA-Ligue 1,2017,Amiens,Harrison Manzala,COD,"FW,MF",23,1994,20.7,32,23,16,9,7,8,25,32.0,17,22,3,19,18,50,15,0,2018
FRA-Ligue 1,2017,Amiens,Issa Cissokho,SEN,DF,32,1985,18.1,31,23,22,9,0,18,32,56.3,14,18,8,10,34,65,87,1,2018
FRA-Ligue 1,2017,Amiens,Jean-Christophe Bouet,FRA,GK,34,1983,1.0,0,0,0,0,0,0,0,,0,0,0,0,0,0,0,0,2018
FRA-Ligue 1,2017,Amiens,Jean-Luc Dompé,FRA,FW,21,1995,0.3,0,0,0,0,0,0,0,,0,0,0,0,0,0,0,0,2018
FRA-Ligue 1,2017,Amiens,Julien Ielsch,FRA,"MF,DF",34,1983,6.8,28,18,12,11,5,7,25,28.0,18,16,3,13,11,39,15,2,2018
FRA-Ligue 1,2017,Amiens,Khaled Adénon,BEN,DF,32,1985,32.5,38,24,26,12,0,15,32,46.9,17,42,26,16,65,103,221,1,2018
FRA-Ligue 1,2017,Amiens,Lacina Traoré,CIV,FW,27,1990,8.7,9,9,2,3,4,3,7,42.9,4,6,3,3,2,11,21,0,2018
FRA-Ligue 1,2017,Amiens,Mathieu Bodmer,FRA,"DF,MF",34,1982,4.4,6,3,5,1,0,5,6,83.3,1,6,3,3,1,7,15,0,2018
FRA-Ligue 1,2017,Amiens,Moussa Konaté,SEN,FW,24,1993,27.5,8,6,1,4,3,3,23,13.0,20,10,2,8,3,11,11,0,2018
FRA-Ligue 1,2017,Amiens,Nathan,BRA,MF,21,1996,0.1,0,0,0,0,0,0,0,,0,0,0,0,0,0,0,0,2018
FRA-Ligue 1,2017,Amiens,Oualid El Hajjam,MAR,DF,26,1991,24.4,64,44,37,22,5,23,49,46.9,26,25,5,20,59,123,91,1,2018
FRA-Ligue 1,2017,Amiens,Prince-Désir Gouano,FRA,DF,23,1993,30.5,42,29,32,8,2,22,31,71.0,9,58,47,11,49,91,191,6,2018
FRA-Ligue 1,2017,Amiens,Quentin Cornette,FRA,"FW,MF",23,1994,5.0,11,8,5,3,3,3,13,23.1,10,7,0,7,3,14,5,0,2018
FRA-Ligue 1,2017,Amiens,Régis Gurtner,FRA,GK,30,1986,37.0,1,0,1,0,0,1,1,100.0,0,0,0,0,4,5,15,4,2018
FRA-Ligue 1,2017,Amiens,Sekou Baradji,FRA,MF,33,1984,0.1,0,0,0,0,0,0,0,,0,0,0,0,1,1,0,0,2018
FRA-Ligue 1,2017,Amiens,Serge Gakpé,TOG,"FW,MF",30,1987,20.3,16,11,9,7,0,6,27,22.2,21,18,1,17,10,26,15,0,2018
FRA-Ligue 1,2017,Amiens,Seybou Koita,NIG,FW,23,1994,2.4,1,1,1,0,0,1,1,100.0,0,0,0,0,0,1,2,0,2018
FRA-Ligue 1,2017,Amiens,Stiven Mendoza,COL,"FW,MF",25,1992,11.5,18,10,7,7,4,2,11,18.2,9,11,1,10,15,33,8,0,2018
FRA-Ligue 1,2017,Amiens,Tanguy Ndombele,FRA,MF,20,1996,2.6,6,5,2,4,0,1,4,25.0,3,4,0,4,5,11,3,0,2018
FRA-Ligue 1,2017,Amiens,Thomas Monconduit,FRA,MF,26,1991,32.8,81,49,33,43,5,34,87,39.1,53,52,17,35,55,136,81,2,2018
FRA-Ligue 1,2017,Angers,Abdoulaye Bamba,CIV,DF,27,1990,17.0,29,22,23,6,0,16,30,53.3,14,8,1,7,11,40,52,0,2018
FRA-Ligue 1,2017,Angers,Alexandre Letellier,FRA,GK,26,1990,13.0,0,0,0,0,0,0,0,,0,0,0,0,0,0,1,2,2018
FRA-Ligue 1,2017,Angers,Angelo Fulgini,FRA,MF,20,1996,17.0,21,11,9,8,4,8,27,29.6,19,21,2,19,20,41,7,0,2018
FRA-Ligue 1,2017,Angers,Baptiste Guillaume,BEL,"FW,MF",22,1995,5.1,4,1,0,2,2,0,5,0.0,5,4,1,3,2,6,1,0,2018
FRA-Ligue 1,2017,Angers,Baptiste Santamaria,FRA,MF,22,1995,28.8,59,40,25,29,5,23,83,27.7,60,39,8,31,43,102,48,2,2018
FRA-Ligue 1,2017,Angers,Billy Ketkeophomphone,LAO,MF,27,1990,4.9,14,9,4,5,5,5,15,33.3,10,9,0,9,5,19,8,0,2018
FRA-Ligue 1,2017,Angers,Enzo Crivelli,FRA,FW,22,1995,11.4,13,9,2,6,5,1,5,20.0,4,4,0,4,2,15,6,0,2018
FRA-Ligue 1,2017,Angers,Flavien Tait,FRA,MF,24,1993,24.8,50,36,26,18,6,18,78,23.1,60,43,4,39,20,70,17,1,2018
FRA-Ligue 1,2017,Angers,Gilles Sunu,TOG,"MF,FW",26,1991,7.3,4,4,1,3,0,0,4,0.0,4,7,0,7,3,7,3,0,2018
FRA-Ligue 1,2017,Angers,Ismaël Traoré,CIV,DF,30,1986,31.7,54,32,40,13,1,14,29,48.3,15,25,10,15,52,106,132,2,2018
FRA-Ligue 1,2017,Angers,Jeff Reine-Adélaïde,FRA,MF,19,1998,4.9,13,8,7,5,1,6,17,35.3,11,7,2,5,1,14,9,0,2018
FRA-Ligue 1,2017,Angers,Karl Toko Ekambi,CMR,"FW,MF",24,1992,33.8,17,8,2,5,10,5,29,17.2,24,13,0,13,15,32,2,0,2018
FRA-Ligue 1,2017,Angers,Lassana Coulibaly,MLI,MF,21,1996,9.3,26,17,13,10,3,10,35,28.6,25,15,1,14,8,34,10,0,2018
FRA-Ligue 1,2017,Angers,Loïc Puyo,FRA,MF,28,1988,1.9,9,5,2,5,2,3,4,75.0,1,7,3,4,4,13,2,0,2018
FRA-Ligue 1,2017,Angers,Ludovic Butelle,FRA,GK,34,1983,18.4,0,0,0,0,0,0,0,,0,0,0,0,1,1,10,2,2018
FRA-Ligue 1,2017,Angers,Mateo Pavlović,BIH,DF,27,1990,21.8,13,7,10,3,0,7,20,35.0,13,14,11,3,21,34,120,0,2018
FRA-Ligue 1,2017,Angers,Mathieu Michel,FRA,GK,25,1991,6.6,0,0,0,0,0,0,1,0.0,1,0,0,0,0,0,0,1,2018
FRA-Ligue 1,2017,Angers,Mehdi Tahrat,ALG,MF,27,1990,4.9,7,6,4,3,0,2,5,40.0,3,3,1,2,9,16,15,1,2018
FRA-Ligue 1,2017,Angers,Pierrick Capelle,FRA,MF,30,1987,20.9,50,37,29,17,4,16,70,22.9,54,29,0,29,34,84,26,0,2018
FRA-Ligue 1,2017,Angers,Prince Oniangué,CGO,MF,28,1988,11.7,16,11,5,9,2,8,31,25.8,23,20,4,16,11,27,8,0,2018
FRA-Ligue 1,2017,Angers,Romain Thomas,FRA,DF,29,1988,27.4,31,21,16,15,0,14,29,48.3,15,32,19,13,34,65,151,1,2018
FRA-Ligue 1,2017,Angers,Saliou Ciss,SEN,"DF,MF",27,1989,1.6,3,2,1,1,1,2,5,40.0,3,0,0,0,2,5,1,0,2018
FRA-Ligue 1,2017,Angers,Thomas Mangani,FRA,MF,30,1987,33.6,92,59,35,46,11,28,120,23.3,92,40,5,35,40,132,45,1,2018
FRA-Ligue 1,2017,Angers,Thomas Touré,CIV,MF,23,1993,1.4,2,1,0,1,1,0,7,0.0,7,5,0,5,1,3,0,0,2018
FRA-Ligue 1,2017,Angers,Vincent Manceau,FRA,DF,28,1989,33.0,84,49,56,22,6,42,76,55.3,34,34,2,32,34,118,103,0,2018
FRA-Ligue 1,2017,Angers,Wilfried Kanga,CIV,"FW,MF",19,1998,1.9,2,2,0,2,0,0,2,0.0,2,0,0,0,0,2,1,0,2018
FRA-Ligue 1,2017,Angers,Yoann Andreu,FRA,DF,28,1989,23.0,48,30,40,6,2,16,39,41.0,23,23,5,18,37,85,75,1,2018
FRA-Ligue 1,2017,Bordeaux,Alexandre Mendy,GNB,FW,23,1994,8.8,4,4,1,2,1,1,6,16.7,5,5,1,4,1,5,4,0,2018
FRA-Ligue 1,2017,Bordeaux,Benoît Costil,FRA,GK,30,1987,36.0,0,0,0,0,0,0,2,0.0,2,0,0,0,3,3,13,4,2018
FRA-Ligue 1,2017,Bordeaux,Diego Contento,GER,"DF,MF",27,1990,1.2,3,0,1,2,0,1,1,100.0,0,2,1,1,1,4,9,0,2018
FRA-Ligue 1,2017,Bordeaux,Ervin Taha,FRA,FW,18,1999,0.4,1,1,0,1,0,0,1,0.0,1,0,0,0,0,1,0,0,2018
FRA-Ligue 1,2017,Bordeaux,François Kamano,GUI,FW,21,1996,22.4,32,24,11,14,7,10,35,28.6,25,18,2,16,15,47,8,0,2018
FRA-Ligue 1,2017,Bordeaux,Gaëtan Laborde,FRA,FW,23,1994,10.6,9,7,1,6,2,2,7,28.6,5,8,2,6,1,10,7,1,2018
FRA-Ligue 1,2017,Bordeaux,Igor Lewczuk,POL,DF,32,1985,4.9,9,7,5,3,1,3,6,50.0,3,2,2,0,7,16,11,0,2018
FRA-Ligue 1,2017,Bordeaux,Jaroslav Plašil,CZE,MF,35,1982,11.6,24,14,7,17,0,7,31,22.6,24,18,6,12,21,45,15,0,2018
FRA-Ligue 1,2017,Bordeaux,Jonathan Cafu,BRA,"FW,MF",26,1991,7.0,16,9,7,6,3,5,13,38.5,8,6,1,5,10,26,1,0,2018
FRA-Ligue 1,2017,Bordeaux,Jules Koundé,FRA,DF,18,1998,17.7,26,19,19,7,0,13,17,76.5,4,14,11,3,14,40,97,0,2018
FRA-Ligue 1,2017,Bordeaux,Jérémy Toulalan,FRA,DF,33,1983,21.0,43,25,35,7,1,17,39,43.6,22,25,16,9,28,71,121,0,2018
FRA-Ligue 1,2017,Bordeaux,Jérôme Prior,FRA,GK,21,1995,2.0,0,0,0,0,0,0,0,,0,0,0,0,0,0,2,2,2018
FRA-Ligue 1,2017,Bordeaux,Lukas Lerager,DEN,MF,24,1993,36.5,107,74,33,61,13,33,107,30.8,74,44,8,36,67,174,66,1,2018
FRA-Ligue 1,2017,Bordeaux,Malcom,BRA,FW,20,1997,31.7,15,10,3,7,5,1,28,3.6,27,13,1,12,14,29,6,0,2018
FRA-Ligue 1,2017,Bordeaux,Martin Braithwaite,DEN,FW,26,1991,10.2,6,4,0,4,2,1,6,16.7,5,6,2,4,0,6,3,0,2018
FRA-Ligue 1,2017,Bordeaux,Maxime Poundjé,FRA,DF,24,1992,18.9,53,29,32,16,5,28,51,54.9,23,14,6,8,35,88,63,1,2018
FRA-Ligue 1,2017,Bordeaux,Milan Gajić,SRB,DF,21,1996,4.0,6,3,4,2,0,2,4,50.0,2,7,0,7,4,10,14,0,2018
FRA-Ligue 1,2017,Bordeaux,Nicolas de Préville,FRA,FW,26,1991,21.5,34,27,10,15,9,9,33,27.3,24,25,4,21,21,55,12,0,2018
FRA-Ligue 1,2017,Bordeaux,Olivier Verdon,BEN,DF,21,1995,0.1,0,0,0,0,0,0,0,,0,0,0,0,0,0,3,0,2018
FRA-Ligue 1,2017,Bordeaux,Otávio,BRA,MF,23,1994,16.5,64,42,25,37,2,20,61,32.8,41,26,4,22,32,96,35,0,2018
FRA-Ligue 1,2017,Bordeaux,Pablo,BRA,DF,26,1991,14.3,16,15,13,3,0,10,16,62.5,6,13,7,6,16,32,96,1,2018
FRA-Ligue 1,2017,Bordeaux,Paul Baysse,FRA,DF,29,1988,6.3,4,2,3,1,0,1,5,20.0,4,4,3,1,7,11,38,1,2018
FRA-Ligue 1,2017,Bordeaux,Soualiho Meïté,FRA,MF,23,1994,14.8,25,13,4,19,2,9,32,28.1,23,22,6,16,23,48,13,1,2018
FRA-Ligue 1,2017,Bordeaux,Thomas Carrique,FRA,DF,18,1999,1.0,1,0,0,1,0,1,3,33.3,2,0,0,0,2,3,3,0,2018
FRA-Ligue 1,2017,Bordeaux,Thomas Touré,CIV,FW,23,1993,0.1,0,0,0,0,0,0,0,,0,0,0,0,1,1,0,0,2018
FRA-Ligue 1,2017,Bordeaux,Théo Pellenard,FRA,DF,23,1994,15.9,32,20,13,15,4,10,28,35.7,18,15,6,9,32,64,31,0,2018
FRA-Ligue 1,2017,Bordeaux,Valentín Vada,ARG,MF,21,1996,9.6,22,11,7,14,1,8,32,25.0,24,8,1,7,6,28,5,1,2018
FRA-Ligue 1,2017,Bordeaux,Vukašin Jovanović,SRB,DF,21,1996,16.0,18,14,11,7,0,6,14,42.9,8,18,10,8,27,45,67,0,2018
FRA-Ligue 1,2017,Bordeaux,Younousse Sankharé,SEN,MF,27,1989,20.9,33,23,10,20,3,4,34,11.8,30,15,4,11,21,54,7,0,2018
FRA-Ligue 1,2017,Bordeaux,Youssouf Sabaly,SEN,DF,24,1993,34.4,93,61,54,34,5,43,68,63.2,25,26,6,20,54,147,104,0,2018
FRA-Ligue 1,2017,Bordeaux,Zaydou Youssouf,FRA,FW,18,1999,1.5,3,1,2,1,0,1,2,50.0,1,1,0,1,1,4,1,0,2018
FRA-Ligue 1,2017,Caen,Adama Mbengue,SEN,DF,23,1993,17.7,71,48,48,18,5,41,65,63.1,24,21,1,20,28,99,50,0,2018
FRA-Ligue 1,2017,Caen,Alexander Djiku,GHA,DF,22,1994,28.0,65,43,52,11,2,25,52,48.1,27,34,5,29,57,122,155,2,2018
FRA-Ligue 1,2017,Caen,Baissama Sankoh,GUI,"MF,DF",25,1992,17.1,27,19,8,18,1,8,28,28.6,20,20,8,12,25,52,64,1,2018
FRA-Ligue 1,2017,Caen,Brice Samba,FRA,GK,23,1994,3.5,0,0,0,0,0,0,0,,0,0,0,0,0,0,2,0,2018
FRA-Ligue 1,2017,Caen,Christian Kouakou,CIV,"MF,FW",26,1991,9.4,24,13,14,8,2,5,19,26.3,14,16,1,15,8,32,6,1,2018
FRA-Ligue 1,2017,Caen,Damien Da Silva,FRA,DF,29,1988,31.5,52,35,40,12,0,20,33,60.6,13,45,25,20,36,88,184,2,2018
FRA-Ligue 1,2017,Caen,Durel Avounou,CGO,"DF,MF",19,1997,7.2,16,11,6,9,1,5,17,29.4,12,12,1,11,10,26,25,0,2018
FRA-Ligue 1,2017,Caen,Emmanuel Imorou,BEN,DF,28,1988,0.4,0,0,0,0,0,0,0,,0,0,0,0,1,1,1,0,2018
FRA-Ligue 1,2017,Caen,Enzo Crivelli,FRA,FW,22,1995,8.1,4,2,2,1,1,1,5,20.0,4,1,0,1,2,6,2,0,2018
FRA-Ligue 1,2017,Caen,Frederic Guilbert,FRA,DF,22,1994,36.0,136,89,71,58,7,50,105,47.6,55,43,13,30,88,224,136,0,2018
FRA-Ligue 1,2017,Caen,Hervé Bazile,HAI,"MF,FW",27,1990,9.7,21,15,9,7,5,5,15,33.3,10,22,0,22,15,36,8,0,2018
FRA-Ligue 1,2017,Caen,Ismaël Diomandé,CIV,"DF,MF",24,1992,7.9,14,8,7,6,1,10,15,66.7,5,11,5,6,5,19,20,0,2018
FRA-Ligue 1,2017,Caen,Ivan Santini,CRO,FW,28,1989,30.9,19,12,5,8,6,4,29,13.8,25,13,5,8,4,23,33,0,2018
FRA-Ligue 1,2017,Caen,Jan Repas,SVN,"MF,FW",20,1997,10.0,14,11,5,5,4,4,18,22.2,14,10,0,10,7,21,3,0,2018
FRA-Ligue 1,2017,Caen,Jessy Deminguet,FRA,"MF,FW",19,1998,5.9,12,9,4,6,2,4,14,28.6,10,5,0,5,10,22,13,0,2018
FRA-Ligue 1,2017,Caen,Jonathan Delaplace,FRA,MF,31,1986,6.5,10,8,1,8,1,3,10,30.0,7,13,5,8,8,18,8,0,2018
FRA-Ligue 1,2017,Caen,Jordan Nkololo,COD,"MF,FW",24,1992,4.7,9,6,4,5,0,1,4,25.0,3,7,1,6,1,10,0,0,2018
FRA-Ligue 1,2017,Caen,Julien Féret,FRA,MF,35,1982,34.0,40,27,10,25,5,14,75,18.7,61,52,7,45,49,89,58,2,2018
FRA-Ligue 1,2017,Caen,Romain Genevois,HAI,DF,29,1987,20.1,48,28,27,13,8,21,39,53.8,18,25,11,14,31,79,76,0,2018
FRA-Ligue 1,2017,Caen,Ronny Rodelin,FRA,"FW,MF",27,1989,35.1,33,22,7,18,8,8,42,19.0,34,21,2,19,28,61,41,1,2018
FRA-Ligue 1,2017,Caen,Rémy Vercoutre,FRA,GK,37,1980,34.5,2,2,2,0,0,2,2,100.0,0,0,0,0,2,4,14,2,2018
FRA-Ligue 1,2017,Caen,Stef Peeters,BEL,MF,25,1992,12.3,22,11,6,14,2,6,31,19.4,25,17,3,14,7,29,11,0,2018
FRA-Ligue 1,2017,Caen,Timo Stavitski,FIN,"MF,FW",18,1999,4.5,4,3,1,1,2,1,16,6.3,15,7,0,7,3,7,1,0,2018
FRA-Ligue 1,2017,Caen,Vincent Bessat,FRA,"DF,MF",31,1985,17.4,41,27,23,16,2,22,48,45.8,26,19,1,18,18,59,18,0,2018
FRA-Ligue 1,2017,Caen,Youssef Aït Bennasser,MAR,MF,21,1996,22.7,47,28,17,27,3,15,64,23.4,49,35,2,33,32,79,30,0,2018
FRA-Ligue 1,2017,Caen,Yoël Armougom,FRA,"DF,MF",19,1998,1.5,2,1,0,1,1,1,1,100.0,0,1,1,0,1,3,2,1,2018
FRA-Ligue 1,2017,Dijon,Adrián Sahibeddine,FRA,"FW,MF",22,1994,0.4,0,0,0,0,0,0,1,0.0,1,1,0,1,0,0,0,0,2018
FRA-Ligue 1,2017,Dijon,Arnold Bouka Moutou,CGO,DF,28,1988,3.7,8,5,6,0,2,6,8,75.0,2,4,1,3,4,12,5,0,2018
FRA-Ligue 1,2017,Dijon,Baptiste Reynet,FRA,GK,26,1990,38.0,6,4,5,1,0,5,7,71.4,2,2,0,2,2,8,35,1,2018
FRA-Ligue 1,2017,Dijon,Benjamin Jeannot,FRA,FW,25,1992,15.6,12,7,5,6,1,1,13,7.7,12,9,3,6,6,18,26,0,2018
FRA-Ligue 1,2017,Dijon,Cédric Varrault,FRA,DF,37,1980,9.8,13,7,6,7,0,9,12,75.0,3,14,11,3,16,29,72,0,2018
FRA-Ligue 1,2017,Dijon,Cédric Yamberé,CTA,DF,26,1990,31.4,58,42,46,12,0,16,34,47.1,18,24,16,8,54,112,138,5,2018
FRA-Ligue 1,2017,Dijon,Dylan Bahamboula,CGO,"FW,MF",22,1995,0.3,0,0,0,0,0,0,0,,0,0,0,0,0,0,0,0,2018
FRA-Ligue 1,2017,Dijon,Eden Massouema,CGO,"MF,FW",20,1997,2.1,2,1,2,0,0,2,2,100.0,0,3,0,3,5,7,2,0,2018
FRA-Ligue 1,2017,Dijon,Enzo Loiodice,FRA,MF,16,2000,1.9,9,5,4,5,0,4,7,57.1,3,0,0,0,2,11,0,0,2018
FRA-Ligue 1,2017,Dijon,Florent Balmont,FRA,MF,37,1980,9.6,14,9,4,9,1,4,25,16.0,21,15,1,14,8,22,5,0,2018
FRA-Ligue 1,2017,Dijon,Fouad Chafik,MAR,DF,30,1986,17.9,58,49,31,19,8,20,35,57.1,15,17,1,16,33,91,46,1,2018
FRA-Ligue 1,2017,Dijon,Frédéric Sammaritano,FRA,"FW,MF",31,1986,15.9,29,25,17,9,3,10,36,27.8,26,14,0,14,5,34,15,0,2018
FRA-Ligue 1,2017,Dijon,Jordan Marié,FRA,MF,25,1991,20.9,63,38,22,36,5,18,66,27.3,48,26,9,17,40,103,25,2,2018
FRA-Ligue 1,2017,Dijon,Júlio Tavares,CPV,FW,28,1988,22.8,3,1,1,1,1,1,11,9.1,10,11,6,5,3,6,36,0,2018
FRA-Ligue 1,2017,Dijon,Kwon Chang-hoon,KOR,"FW,MF",23,1994,23.7,37,22,10,18,9,11,35,31.4,24,32,1,31,24,61,30,0,2018
FRA-Ligue 1,2017,Dijon,Mehdi Abeid,ALG,MF,24,1992,13.1,23,15,8,14,1,8,32,25.0,24,11,6,5,18,41,25,2,2018
FRA-Ligue 1,2017,Dijon,Naïm Sliti,TUN,"FW,MF",25,1992,25.4,47,32,20,17,10,20,52,38.5,32,22,2,20,13,60,7,0,2018
FRA-Ligue 1,2017,Dijon,Oussama Haddadi,TUN,DF,25,1992,27.8,44,29,33,9,2,14,47,29.8,33,29,12,17,43,87,79,1,2018
FRA-Ligue 1,2017,Dijon,Papy Djilobodji,SEN,DF,28,1988,30.0,45,29,34,11,0,21,43,48.8,22,38,25,13,71,116,211,5,2018
FRA-Ligue 1,2017,Dijon,Romain Amalfitano,FRA,MF,27,1989,30.0,59,37,18,38,3,25,69,36.2,44,29,7,22,85,144,35,2,2018
FRA-Ligue 1,2017,Dijon,Valentin Rosier,FRA,DF,20,1996,30.9,73,54,47,23,3,26,68,38.2,42,43,9,34,58,131,124,0,2018
FRA-Ligue 1,2017,Dijon,Vincent Rüfli,SUI,"DF,FW",29,1988,0.3,4,1,3,1,0,3,3,100.0,0,1,0,1,1,5,0,0,2018
FRA-Ligue 1,2017,Dijon,Wesley Lautoa,NCL,"DF,MF",29,1987,6.9,17,13,11,6,0,6,12,50.0,6,10,4,6,19,36,24,1,2018
FRA-Ligue 1,2017,Dijon,Wesley Saïd,FRA,"FW,MF",22,1995,20.4,33,22,17,11,5,7,26,26.9,19,15,1,14,15,48,4,0,2018
FRA-Ligue 1,2017,Dijon,Xeka,POR,MF,22,1994,15.5,25,14,10,11,4,10,38,26.3,28,13,2,11,16,41,21,0,2018
FRA-Ligue 1,2017,Dijon,Ádám Lang,HUN,DF,24,1993,2.6,3,1,3,0,0,3,5,60.0,2,2,1,1,3,6,12,0,2018
FRA-Ligue 1,2017,Guingamp,Abdoul Camara,GUI,"FW,MF",27,1990,9.9,6,4,2,3,1,3,11,27.3,8,7,1,6,7,13,4,0,2018
FRA-Ligue 1,2017,Guingamp,Christophe Kerbrat,FRA,DF,30,1986,36.9,62,45,47,14,1,35,65,53.8,30,49,40,9,62,124,249,2,2018
FRA-Ligue 1,2017,Guingamp,Clément Grenier,FRA,MF,26,1991,13.4,23,14,3,13,7,12,42,28.6,30,16,1,15,14,37,15,1,2018
FRA-Ligue 1,2017,Guingamp,Franck Tabanou,FRA,DF,28,1989,11.6,23,17,17,5,1,10,26,38.5,16,5,3,2,26,49,48,0,2018
FRA-Ligue 1,2017,Guingamp,Félix Eboa Eboa,CMR,DF,20,1997,16.9,19,11,12,7,0,8,16,50.0,8,21,11,10,39,58,119,2,2018
FRA-Ligue 1,2017,Guingamp,Jimmy Briand,FRA,FW,31,1985,35.7,33,21,13,15,5,4,42,9.5,38,17,2,15,12,45,51,0,2018
FRA-Ligue 1,2017,Guingamp,Jonathan Martins Pereira,FRA,DF,31,1986,12.6,34,18,21,10,3,8,23,34.8,15,9,3,6,37,71,39,1,2018
FRA-Ligue 1,2017,Guingamp,Jordan Ikoko,COD,DF,23,1994,26.9,44,29,24,15,5,22,42,52.4,20,20,2,18,48,92,74,0,2018
FRA-Ligue 1,2017,Guingamp,Jérémy Sorbon,FRA,DF,33,1983,29.0,32,19,24,7,1,10,32,31.3,22,37,24,13,53,85,152,4,2018
FRA-Ligue 1,2017,Guingamp,Karl-Johan Johnsson,SWE,GK,27,1990,38.0,0,0,0,0,0,0,1,0.0,1,0,0,0,0,0,14,4,2018
FRA-Ligue 1,2017,Guingamp,Lebogang Phiri,RSA,MF,22,1994,11.5,28,17,14,12,2,11,43,25.6,32,9,2,7,19,47,13,0,2018
FRA-Ligue 1,2017,Guingamp,Lucas Deaux,FRA,MF,28,1988,21.6,62,45,21,37,4,20,67,29.9,47,41,6,35,32,94,19,0,2018
FRA-Ligue 1,2017,Guingamp,Ludovic Blas,FRA,MF,19,1997,19.9,23,14,10,12,1,7,36,19.4,29,15,3,12,19,42,9,1,2018
FRA-Ligue 1,2017,Guingamp,Marcus Coco,FRA,"FW,MF",21,1996,17.6,40,28,17,13,10,7,35,20.0,28,22,3,19,15,55,9,0,2018
FRA-Ligue 1,2017,Guingamp,Marcus Thuram,FRA,FW,19,1997,21.4,20,15,6,10,4,6,25,24.0,19,14,0,14,5,25,12,0,2018
FRA-Ligue 1,2017,Guingamp,Mustapha Diallo,SEN,MF,31,1986,15.4,48,36,15,29,4,15,33,45.5,18,20,4,16,20,68,29,0,2018
FRA-Ligue 1,2017,Guingamp,Nicolas Benezet,FRA,"FW,MF",26,1991,18.3,38,30,18,16,4,11,37,29.7,26,8,2,6,12,50,7,0,2018
FRA-Ligue 1,2017,Guingamp,Pedro Rebocho,POR,DF,22,1995,19.1,29,22,18,8,3,12,28,42.9,16,20,6,14,19,48,76,0,2018
FRA-Ligue 1,2017,Guingamp,Sloan Privat,FRA,FW,28,1989,0.0,0,0,0,0,0,0,0,,0,0,0,0,0,0,0,0,2018
FRA-Ligue 1,2017,Guingamp,Thibault Giresse,FRA,"FW,MF",36,1981,0.3,0,0,0,0,0,0,0,,0,0,0,0,1,1,0,0,2018
FRA-Ligue 1,2017,Guingamp,Yannis Salibur,FRA,"FW,MF",26,1991,16.9,11,9,4,6,1,4,15,26.7,11,7,1,6,7,18,2,0,2018
FRA-Ligue 1,2017,Guingamp,Yeni Ngbakoto,COD,"FW,MF",25,1992,6.4,11,10,4,6,1,3,10,30.0,7,10,0,10,9,20,6,0,2018
FRA-Ligue 1,2017,Guingamp,Étienne Didot,FRA,MF,34,1983,18.0,54,33,20,33,1,20,43,46.5,23,21,7,14,19,73,29,0,2018
FRA-Ligue 1,2017,Lille,Adama Soumaoro,FRA,DF,25,1992,13.2,9,5,7,2,0,2,3,66.7,1,22,16,6,16,25,50,1,2018
FRA-Ligue 1,2017,Lille,Anwar El Ghazi,NED,"FW,MF",22,1995,18.3,23,18,7,13,3,9,29,31.0,20,11,1,10,7,30,7,1,2018
FRA-Ligue 1,2017,Lille,Boubakary Soumaré,FRA,MF,18,1999,5.7,13,9,8,5,0,3,14,21.4,11,8,1,7,7,20,6,1,2018
FRA-Ligue 1,2017,Lille,Edgar Ié,GNB,DF,23,1994,35.0,74,42,55,18,1,31,69,44.9,38,57,26,31,84,158,135,3,2018
FRA-Ligue 1,2017,Lille,Ezequiel Ponce,ARG,FW,20,1997,12.2,9,8,3,5,1,0,7,0.0,7,2,1,1,3,12,11,0,2018
FRA-Ligue 1,2017,Lille,Farès Bahlouli,FRA,"MF,FW",22,1995,3.4,10,8,4,3,3,2,7,28.6,5,7,0,7,1,11,1,0,2018
FRA-Ligue 1,2017,Lille,Fodé Ballo-Touré,SEN,DF,20,1997,22.8,50,36,29,16,5,21,47,44.7,26,27,2,25,28,78,47,1,2018
FRA-Ligue 1,2017,Lille,Hamza Mendyl,MAR,"DF,MF",19,1997,9.5,18,10,12,6,0,11,20,55.0,9,5,0,5,17,35,26,0,2018
FRA-Ligue 1,2017,Lille,Hervé Koffi,BFA,GK,20,1996,4.0,0,0,0,0,0,0,0,,0,0,0,0,1,1,1,1,2018
FRA-Ligue 1,2017,Lille,Ibrahim Amadou,FRA,"MF,DF",24,1993,26.7,43,29,24,19,0,14,27,51.9,13,30,13,17,41,84,70,3,2018
FRA-Ligue 1,2017,Lille,Imad Faraj,MAR,"MF,DF",18,1999,1.8,5,2,2,1,2,4,8,50.0,4,1,0,1,4,9,3,0,2018
FRA-Ligue 1,2017,Lille,Júnior Alonso,PAR,DF,24,1993,30.9,58,31,36,22,0,28,50,56.0,22,26,16,10,56,114,153,1,2018
FRA-Ligue 1,2017,Lille,Kouadio-Yves Dabila,CIV,DF,20,1997,10.5,20,11,14,4,2,6,10,60.0,4,14,6,8,10,30,46,0,2018
FRA-Ligue 1,2017,Lille,Kévin Malcuit,MAR,DF,26,1991,20.2,51,37,31,16,4,17,25,68.0,8,13,5,8,38,89,47,0,2018
FRA-Ligue 1,2017,Lille,Lebo Mothiba,RSA,FW,21,1996,13.2,8,5,4,0,4,0,7,0.0,7,6,2,4,2,10,11,0,2018
FRA-Ligue 1,2017,Lille,Luiz Araújo,BRA,"FW,MF",21,1996,22.4,41,31,23,17,1,10,47,21.3,37,24,0,24,16,57,11,1,2018
FRA-Ligue 1,2017,Lille,Mike Maignan,FRA,GK,22,1995,33.7,1,1,1,0,0,1,1,100.0,0,0,0,0,0,1,8,6,2018
FRA-Ligue 1,2017,Lille,Nicolas Pépé,CIV,"FW,MF",22,1995,31.6,30,18,14,11,5,11,42,26.2,31,23,0,23,10,40,20,0,2018
FRA-Ligue 1,2017,Lille,Nicolas de Préville,FRA,"FW,MF",26,1991,3.2,3,3,0,1,2,1,5,20.0,4,3,0,3,0,3,2,0,2018
FRA-Ligue 1,2017,Lille,Rominigue Kouamé,MLI,"DF,MF",20,1996,2.2,5,2,2,2,1,2,3,66.7,1,1,0,1,5,10,0,0,2018
FRA-Ligue 1,2017,Lille,Thiago Maia,BRA,"MF,DF",20,1997,27.4,55,40,26,26,3,15,61,24.6,46,32,10,22,61,116,47,1,2018
FRA-Ligue 1,2017,Lille,Thiago Mendes,BRA,MF,25,1992,25.5,25,16,10,11,4,5,23,21.7,18,21,3,18,25,50,29,0,2018
FRA-Ligue 1,2017,Lille,Xeka,POR,MF,22,1994,0.2,1,0,1,0,0,0,0,,0,1,0,1,1,2,0,0,2018
FRA-Ligue 1,2017,Lille,Yassine Benzia,ALG,"MF,FW",22,1994,25.4,62,41,21,31,10,17,62,27.4,45,31,4,27,28,90,14,0,2018
FRA-Ligue 1,2017,Lille,Yves Bissouma,MLI,"MF,DF",20,1996,17.3,67,50,30,32,5,19,39,48.7,20,13,2,11,31,98,31,1,2018
FRA-Ligue 1,2017,Lyon,Amine Gouiri,FRA,"FW,MF",17,2000,0.9,1,1,1,0,0,0,1,0.0,1,0,0,0,2,3,0,0,2018
FRA-Ligue 1,2017,Lyon,Anthony Lopes,POR,GK,26,1990,34.0,0,0,0,0,0,0,0,,0,0,0,0,1,1,17,4,2018
FRA-Ligue 1,2017,Lyon,Bertrand Traoré,BFA,FW,21,1995,25.4,32,20,7,20,5,10,35,28.6,25,24,3,21,39,71,31,1,2018
FRA-Ligue 1,2017,Lyon,Christopher Martins,LUX,MF,20,1997,0.8,3,2,0,3,0,1,2,50.0,1,0,0,0,1,4,0,0,2018
FRA-Ligue 1,2017,Lyon,Clément Grenier,FRA,FW,26,1991,0.1,1,1,1,0,0,0,0,,0,0,0,0,0,1,0,0,2018
FRA-Ligue 1,2017,Lyon,Ferland Mendy,FRA,DF,22,1995,23.6,45,28,29,13,3,20,31,64.5,11,18,5,13,25,70,43,0,2018
FRA-Ligue 1,2017,Lyon,Fernando Marçal,BRA,DF,28,1989,14.4,34,20,22,8,4,14,29,48.3,15,14,6,8,26,60,69,0,2018
FRA-Ligue 1,2017,Lyon,Houssem Aouar,ALG,"MF,FW",19,1998,27.0,66,42,22,39,5,20,66,30.3,46,30,0,30,39,105,34,0,2018
FRA-Ligue 1,2017,Lyon,Jordan Ferri,FRA,MF,25,1992,7.1,20,11,8,11,1,7,20,35.0,13,11,1,10,5,25,11,2,2018
FRA-Ligue 1,2017,Lyon,Jérémy Morel,MAD,DF,33,1984,32.4,39,27,23,15,1,18,23,78.3,5,28,23,5,46,85,129,5,2018
FRA-Ligue 1,2017,Lyon,Kenny Tete,NED,DF,21,1995,17.9,37,25,24,10,3,15,26,57.7,11,20,7,13,29,66,52,0,2018
FRA-Ligue 1,2017,Lyon,Lucas Tousart,FRA,MF,20,1997,34.8,98,59,41,55,2,38,98,38.8,60,41,16,25,52,150,79,0,2018
FRA-Ligue 1,2017,Lyon,Mapou Yanga-Mbiwa,FRA,DF,28,1989,1.4,3,2,3,0,0,1,1,100.0,0,0,0,0,1,4,2,0,2018
FRA-Ligue 1,2017,Lyon,Marcelo,BRA,DF,30,1987,34.5,27,25,16,10,1,9,25,36.0,16,32,18,14,57,84,235,4,2018
FRA-Ligue 1,2017,Lyon,Mariano,DOM,FW,23,1993,27.9,16,11,0,5,11,2,23,8.7,21,9,1,8,3,19,20,0,2018
FRA-Ligue 1,2017,Lyon,Mathieu Gorgelin,FRA,GK,26,1990,4.0,0,0,0,0,0,0,0,,0,0,0,0,0,0,0,1,2018
FRA-Ligue 1,2017,Lyon,Maxwel Cornet,CIV,FW,20,1996,14.1,17,12,6,9,2,3,25,12.0,22,11,1,10,14,31,14,0,2018
FRA-Ligue 1,2017,Lyon,Memphis,NED,FW,23,1994,28.4,13,9,4,3,6,3,28,10.7,25,15,0,15,9,22,5,0,2018
FRA-Ligue 1,2017,Lyon,Mouctar Diakhaby,GUI,DF,20,1996,8.1,10,6,7,3,0,4,7,57.1,3,14,9,5,12,22,52,1,2018
FRA-Ligue 1,2017,Lyon,Myziane Maolida,FRA,"FW,MF",18,1999,3.7,5,5,3,2,0,0,2,0.0,2,1,0,1,0,5,0,0,2018
FRA-Ligue 1,2017,Lyon,Nabil Fekir,FRA,"MF,FW",24,1993,27.5,45,33,11,24,10,8,40,20.0,32,11,0,11,8,53,5,0,2018
FRA-Ligue 1,2017,Lyon,Pape Cheikh Diop,SEN,MF,19,1997,0.1,0,0,0,0,0,0,0,,0,0,0,0,0,0,0,0,2018
FRA-Ligue 1,2017,Lyon,Rafael,BRA,DF,27,1990,20.1,54,28,30,18,6,22,43,51.2,21,20,3,17,42,96,53,0,2018
FRA-Ligue 1,2017,Lyon,Sergi Darder,ESP,MF,23,1993,2.3,9,3,1,5,3,1,7,14.3,6,0,0,0,3,12,3,0,2018
FRA-Ligue 1,2017,Lyon,Tanguy Ndombele,FRA,MF,20,1996,26.1,62,39,23,31,8,11,40,27.5,29,53,8,45,36,98,9,0,2018
FRA-Ligue 1,2017,Lyon,Willem Geubbels,FRA,"FW,MF",15,2001,0.4,2,2,1,1,0,0,1,0.0,1,0,0,0,0,2,0,0,2018
FRA-Ligue 1,2017,Marseille,Adil Rami,FRA,DF,31,1985,32.8,39,29,22,15,2,22,41,53.7,19,25,19,6,45,84,163,3,2018
FRA-Ligue 1,2017,Marseille,Andre-Frank Zambo Anguissa,CMR,MF,21,1995,27.1,88,65,23,57,8,32,94,34.0,62,50,7,43,67,155,46,3,2018
FRA-Ligue 1,2017,Marseille,Aymen Abdennour,TUN,DF,27,1989,5.5,7,3,5,2,0,4,7,57.1,3,5,5,0,4,11,20,0,2018
FRA-Ligue 1,2017,Marseille,Boubacar Kamara,FRA,"DF,MF",17,1999,5.1,14,14,9,5,0,8,12,66.7,4,7,3,4,3,17,18,0,2018
FRA-Ligue 1,2017,Marseille,Bouna Sarr,SEN,"DF,FW",25,1992,19.9,65,42,42,20,3,22,38,57.9,16,20,4,16,32,97,53,2,2018
FRA-Ligue 1,2017,Marseille,Clinton N'Jie,CMR,FW,23,1993,9.7,10,6,2,5,3,2,9,22.2,7,5,0,5,3,13,0,0,2018
FRA-Ligue 1,2017,Marseille,Dimitri Payet,FRA,"MF,FW",30,1987,26.1,22,11,5,13,4,8,37,21.6,29,19,2,17,19,41,7,1,2018
FRA-Ligue 1,2017,Marseille,Dória,BRA,DF,22,1994,0.9,2,2,0,2,0,0,0,,0,3,1,2,1,3,1,0,2018
FRA-Ligue 1,2017,Marseille,Florian Thauvin,FRA,FW,24,1993,32.8,44,28,16,20,8,15,46,32.6,31,22,1,21,17,61,20,0,2018
FRA-Ligue 1,2017,Marseille,Grégory Sertic,FRA,"DF,MF",27,1989,3.9,5,3,3,2,0,2,6,33.3,4,8,7,1,6,11,23,0,2018
FRA-Ligue 1,2017,Marseille,Henri Bedimo,CMR,"DF,FW",33,1984,0.5,0,0,0,0,0,0,1,0.0,1,0,0,0,1,1,1,0,2018
FRA-Ligue 1,2017,Marseille,Hiroki Sakai,JPN,DF,27,1990,28.0,66,45,30,30,6,32,49,65.3,17,32,7,25,45,111,90,1,2018
FRA-Ligue 1,2017,Marseille,Jordan Amavi,FRA,DF,23,1994,24.4,52,35,32,12,8,23,56,41.1,33,28,11,17,45,97,86,1,2018
FRA-Ligue 1,2017,Marseille,Kostas Mitroglou,GRE,FW,29,1988,9.7,3,2,1,2,0,1,4,25.0,3,1,1,0,0,3,2,0,2018
FRA-Ligue 1,2017,Marseille,Lucas Ocampos,ARG,FW,23,1994,22.6,83,57,30,44,9,30,93,32.3,63,42,3,39,30,113,26,0,2018
FRA-Ligue 1,2017,Marseille,Luiz Gustavo,BRA,"MF,DF",30,1987,33.5,89,54,45,40,4,26,62,41.9,36,44,13,31,50,139,56,1,2018
FRA-Ligue 1,2017,Marseille,Maxime Lopez,FRA,"MF,FW",19,1997,15.3,30,20,12,12,6,12,56,21.4,44,16,2,14,7,37,6,1,2018
FRA-Ligue 1,2017,Marseille,Morgan Sanson,FRA,MF,22,1994,24.1,64,40,13,34,17,21,71,29.6,50,30,0,30,25,89,5,1,2018
FRA-Ligue 1,2017,Marseille,Patrice Evra,FRA,DF,36,1981,3.9,6,5,5,1,0,3,6,50.0,3,2,2,0,3,9,16,0,2018
FRA-Ligue 1,2017,Marseille,Rolando,POR,DF,31,1985,27.9,44,29,28,15,1,23,40,57.5,17,22,14,8,37,81,126,0,2018
FRA-Ligue 1,2017,Marseille,Rémy Cabella,FRA,"FW,MF",27,1990,0.7,7,4,2,2,3,2,4,50.0,2,0,0,0,1,8,0,0,2018
FRA-Ligue 1,2017,Marseille,Steve Mandanda,FRA,GK,32,1985,30.0,0,0,0,0,0,0,0,,0,0,0,0,0,0,10,3,2018
FRA-Ligue 1,2017,Marseille,Tomáš Hubočan,SVK,DF,31,1985,1.0,1,0,1,0,0,0,4,0.0,4,0,0,0,0,1,1,0,2018
FRA-Ligue 1,2017,Marseille,Valère Germain,FRA,FW,27,1990,24.1,16,11,5,7,4,3,18,16.7,15,11,0,11,6,22,19,0,2018
FRA-Ligue 1,2017,Marseille,Yohann Pelé,FRA,GK,34,1982,8.2,0,0,0,0,0,0,1,0.0,1,0,0,0,1,1,2,0,2018
FRA-Ligue 1,2017,Marseille,Yusuf Sari,TUR,FW,18,1998,0.0,0,0,0,0,0,0,0,,0,0,0,0,0,0,0,0,2018
FRA-Ligue 1,2017,Metz,Ablie Jallow,GAM,FW,18,1998,1.4,1,1,1,0,0,0,5,0.0,5,1,0,1,3,4,1,0,2018
FRA-Ligue 1,2017,Metz,Benoît Assou-Ekotto,CMR,DF,33,1984,11.7,12,9,5,6,1,5,15,33.3,10,7,4,3,46,58,21,0,2018
FRA-Ligue 1,2017,Metz,Brian Fernández,ARG,FW,22,1994,1.4,0,0,0,0,0,0,1,0.0,1,2,0,2,0,0,0,0,2018
FRA-Ligue 1,2017,Metz,Cafú,POR,MF,24,1993,7.6,9,7,3,4,2,3,11,27.3,8,3,1,2,12,21,13,0,2018
FRA-Ligue 1,2017,Metz,Chris Philipps,LUX,"MF,DF",23,1994,9.4,22,12,10,10,2,5,26,19.2,21,13,5,8,30,52,18,0,2018
FRA-Ligue 1,2017,Metz,Danijel Milićević,BIH,"MF,FW",31,1986,7.9,8,4,0,4,4,1,9,11.1,8,5,0,5,3,11,2,0,2018
FRA-Ligue 1,2017,Metz,Dylan Lempereur,FRA,DF,18,1998,1.6,5,3,3,1,1,2,6,33.3,4,1,0,1,0,5,6,0,2018
FRA-Ligue 1,2017,Metz,Eiji Kawashima,JPN,GK,34,1983,28.5,1,1,1,0,0,1,3,33.3,2,0,0,0,3,4,9,2,2018
FRA-Ligue 1,2017,Metz,Emmanuel Rivière,FRA,FW,27,1990,22.3,10,3,1,6,3,1,12,8.3,11,8,0,8,2,12,5,0,2018
FRA-Ligue 1,2017,Metz,Fallou Diagne,SEN,"DF,MF",27,1989,24.9,33,20,21,12,0,7,22,31.8,15,33,18,15,46,79,116,3,2018
FRA-Ligue 1,2017,Metz,Farid Boulaya,ALG,"MF,FW",24,1993,2.0,5,1,4,1,0,3,6,50.0,3,1,0,1,1,6,2,0,2018
FRA-Ligue 1,2017,Metz,Florent Mollet,FRA,"MF,FW",25,1991,15.7,25,18,10,12,3,3,25,12.0,22,8,1,7,11,36,8,0,2018
FRA-Ligue 1,2017,Metz,Gauthier Hein,FRA,FW,20,1996,0.9,2,2,2,0,0,2,4,50.0,2,1,0,1,2,4,1,0,2018
FRA-Ligue 1,2017,Metz,Georges Mandjeck,CMR,"MF,DF",28,1988,10.8,25,14,8,16,1,8,18,44.4,10,9,3,6,18,43,21,1,2018
FRA-Ligue 1,2017,Metz,Gerónimo Poblete,ARG,MF,24,1993,18.4,58,37,23,29,6,25,66,37.9,41,19,0,19,24,82,22,1,2018
FRA-Ligue 1,2017,Metz,Habib Diallo,SEN,"FW,MF",22,1995,0.2,0,0,0,0,0,0,0,,0,0,0,0,0,0,0,0,2018
FRA-Ligue 1,2017,Metz,Ibrahima Niane,SEN,"FW,MF",18,1999,9.4,6,5,4,1,1,2,8,25.0,6,6,0,6,4,10,8,0,2018
FRA-Ligue 1,2017,Metz,Iván Balliu,ALB,DF,25,1992,21.7,34,22,22,6,6,12,28,42.9,16,23,9,14,27,61,64,1,2018
FRA-Ligue 1,2017,Metz,Jonathan Rivierez,MTQ,DF,28,1989,22.9,81,59,50,26,5,41,80,51.3,39,21,7,14,39,120,73,0,2018
FRA-Ligue 1,2017,Metz,Julian Palmieri,FRA,DF,30,1986,12.5,29,15,17,9,3,17,29,58.6,12,16,2,14,22,51,31,0,2018
FRA-Ligue 1,2017,Metz,Lemouya Goudiaby,SEN,DF,20,1997,0.9,2,1,0,2,0,1,3,33.3,2,2,1,1,0,2,3,0,2018
FRA-Ligue 1,2017,Metz,Lilian Fournier,FRA,FW,19,1998,0.2,0,0,0,0,0,0,0,,0,0,0,0,0,0,0,0,2018
FRA-Ligue 1,2017,Metz,Mathieu Dossevi,TOG,"FW,MF",29,1988,27.9,35,25,15,15,5,7,39,17.9,32,24,3,21,28,63,12,0,2018
FRA-Ligue 1,2017,Metz,Matthieu Udol,FRA,DF,21,1996,3.9,14,8,13,1,0,5,14,35.7,9,10,2,8,5,19,17,0,2018
FRA-Ligue 1,2017,Metz,Milan Biševac,SRB,DF,33,1983,7.9,7,5,5,1,1,5,7,71.4,2,2,0,2,5,12,43,0,2018
FRA-Ligue 1,2017,Metz,Moussa Niakhate,SEN,DF,21,1996,34.5,57,38,44,12,1,22,37,59.5,15,27,14,13,55,112,139,1,2018
FRA-Ligue 1,2017,Metz,Nicolas Basin,FRA,DF,19,1998,3.5,9,7,5,3,1,4,9,44.4,5,6,3,3,8,17,14,0,2018
FRA-Ligue 1,2017,Metz,Nolan Roux,FRA,"FW,MF",29,1988,31.5,24,17,8,10,6,7,38,18.4,31,32,2,30,25,49,22,0,2018
FRA-Ligue 1,2017,Metz,Opa Nguette,SEN,"FW,MF",23,1994,11.4,27,22,11,12,4,5,21,23.8,16,10,0,10,18,45,13,0,2018
FRA-Ligue 1,2017,Metz,Quentin Beunardeau,FRA,GK,23,1994,0.4,0,0,0,0,0,0,0,,0,0,0,0,0,0,0,0,2018
FRA-Ligue 1,2017,Metz,Renaud Cohade,FRA,MF,32,1984,36.6,143,86,63,71,9,46,119,38.7,73,70,10,60,53,196,91,0,2018
FRA-Ligue 1,2017,Metz,Simon Falette,GUI,DF,25,1992,1.0,0,0,0,0,0,0,0,,0,0,0,0,1,1,8,0,2018
FRA-Ligue 1,2017,Metz,Thomas Didillon,FRA,GK,21,1995,9.0,0,0,0,0,0,0,1,0.0,1,0,0,0,0,0,5,2,2018
FRA-Ligue 1,2017,Metz,Vahid Selimović,LUX,DF,20,1997,11.7,20,14,10,9,1,11,14,78.6,3,10,8,2,17,37,58,1,2018
FRA-Ligue 1,2017,Metz,Vincent Thill,LUX,MF,17,2000,0.3,0,0,0,0,0,0,0,,0,0,0,0,0,0,0,0,2018
FRA-Ligue 1,2017,Metz,Yann Jouffre,FRA,"FW,MF",33,1984,3.1,3,2,0,2,1,1,6,16.7,5,5,1,4,3,6,2,0,2018
FRA-Ligue 1,2017,Monaco,Adama Diakhaby,FRA,FW,21,1996,9.4,23,15,6,12,5,6,16,37.5,10,13,0,13,13,36,5,0,2018
FRA-Ligue 1,2017,Monaco,Adama Traoré,MLI,"MF,FW",22,1995,2.1,6,4,0,4,2,1,4,25.0,3,3,0,3,3,9,1,0,2018
FRA-Ligue 1,2017,Monaco,Allan Saint-Maximin,FRA,MF,20,1997,0.2,0,0,0,0,0,0,0,,0,0,0,0,0,0,0,0,2018
FRA-Ligue 1,2017,Monaco,Almamy Touré,MLI,DF,21,1996,13.9,51,29,31,13,7,18,30,60.0,12,15,2,13,22,73,61,0,2018
FRA-Ligue 1,2017,Monaco,Andrea Raggi,ITA,DF,33,1984,17.9,20,10,15,4,1,10,27,37.0,17,12,6,6,31,51,66,0,2018
FRA-Ligue 1,2017,Monaco,Danijel Subašić,CRO,GK,32,1984,32.7,0,0,0,0,0,0,2,0.0,2,1,0,1,0,0,13,2,2018
FRA-Ligue 1,2017,Monaco,Diego Benaglio,SUI,GK,33,1983,2.5,0,0,0,0,0,0,0,,0,0,0,0,0,0,0,0,2018
FRA-Ligue 1,2017,Monaco,Djibril Sidibé,FRA,DF,25,1992,23.9,59,39,24,27,8,23,45,51.1,22,20,4,16,46,105,52,1,2018
FRA-Ligue 1,2017,Monaco,Fabinho,BRA,MF,23,1993,34.0,114,64,38,67,9,48,112,42.9,64,48,13,35,43,157,62,0,2018
FRA-Ligue 1,2017,Monaco,Gabriel Boschilia,BRA,"FW,MF",21,1996,0.9,4,1,1,2,1,1,4,25.0,3,1,0,1,0,4,0,0,2018
FRA-Ligue 1,2017,Monaco,Gil Bastião Dias,POR,MF,20,1996,0.1,1,1,0,1,0,0,0,,0,0,0,0,0,1,0,0,2018
FRA-Ligue 1,2017,Monaco,Guido Carrillo,ARG,FW,26,1991,4.7,3,1,0,2,1,0,4,0.0,4,3,1,2,0,3,8,0,2018
FRA-Ligue 1,2017,Monaco,Jemerson,BRA,DF,24,1992,31.7,48,32,32,15,1,24,31,77.4,7,46,32,14,56,104,169,1,2018
FRA-Ligue 1,2017,Monaco,Jordi Mboula,ESP,MF,18,1999,0.3,0,0,0,0,0,0,0,,0,2,0,2,0,0,2,0,2018
FRA-Ligue 1,2017,Monaco,Jorge,BRA,DF,21,1996,21.3,69,40,34,25,10,23,38,60.5,15,19,2,17,66,135,86,0,2018
FRA-Ligue 1,2017,Monaco,João Moutinho,POR,MF,30,1986,31.1,65,41,19,37,9,27,80,33.8,53,52,12,40,36,101,54,0,2018
FRA-Ligue 1,2017,Monaco,Julien Serrano,FRA,DF,19,1998,3.1,2,2,1,0,1,1,2,50.0,1,2,0,2,4,6,14,0,2018
FRA-Ligue 1,2017,Monaco,Kamil Glik,POL,DF,29,1988,36.0,36,23,22,12,2,15,29,51.7,14,28,18,10,54,90,279,2,2018
FRA-Ligue 1,2017,Monaco,Keita Baldé,SEN,"FW,MF",22,1995,16.4,12,8,5,6,1,1,11,9.1,10,10,1,9,6,18,5,0,2018
FRA-Ligue 1,2017,Monaco,Kylian Mbappé,FRA,"FW,MF",18,1998,0.8,1,1,0,1,0,0,0,,0,0,0,0,1,2,0,0,2018
FRA-Ligue 1,2017,Monaco,Kévin N'Doram,FRA,"MF,DF",21,1996,8.0,16,10,6,9,1,6,24,25.0,18,6,2,4,16,32,29,0,2018
FRA-Ligue 1,2017,Monaco,Moussa Sylla,FRA,FW,17,1999,3.4,0,0,0,0,0,0,2,0.0,2,2,0,2,0,0,1,0,2018
FRA-Ligue 1,2017,Monaco,Pietro Pellegri,ITA,FW,16,2001,0.3,0,0,0,0,0,0,2,0.0,2,1,0,1,0,0,0,0,2018
FRA-Ligue 1,2017,Monaco,Rachid Ghezzal,ALG,"FW,MF",25,1992,11.2,31,24,6,22,3,7,34,20.6,27,17,0,17,11,42,2,1,2018
FRA-Ligue 1,2017,Monaco,Radamel Falcao,COL,FW,31,1986,23.7,11,6,0,8,3,2,13,15.4,11,13,3,10,10,21,11,0,2018
FRA-Ligue 1,2017,Monaco,Rony Lopes,POR,"FW,MF",21,1995,28.1,55,32,15,27,13,21,78,26.9,57,23,2,21,16,71,22,0,2018
FRA-Ligue 1,2017,Monaco,Seydou Sy,SEN,GK,21,1995,2.8,0,0,0,0,0,0,0,,0,0,0,0,0,0,2,0,2018
FRA-Ligue 1,2017,Monaco,Soualiho Meïté,FRA,MF,23,1994,1.1,2,1,1,1,0,2,5,40.0,3,1,0,1,3,5,3,0,2018
FRA-Ligue 1,2017,Monaco,Stevan Jovetić,MNE,FW,27,1989,8.4,4,4,0,3,1,0,9,0.0,9,5,0,5,3,7,3,0,2018
FRA-Ligue 1,2017,Monaco,Terence Kongolo,NED,DF,23,1994,2.9,6,4,4,2,0,0,2,0.0,2,5,3,2,5,11,14,0,2018
FRA-Ligue 1,2017,Monaco,Thomas Lemar,FRA,"MF,FW",21,1995,26.4,33,17,9,19,5,10,41,24.4,31,22,1,21,18,51,16,1,2018
FRA-Ligue 1,2017,Monaco,Youri Tielemans,BEL,MF,20,1997,17.4,47,24,14,28,5,17,55,30.9,38,24,5,19,34,81,20,1,2018
FRA-Ligue 1,2017,Montpellier,Ambroise Oyongo,CMR,DF,26,1991,2.2,2,1,1,1,0,0,1,0.0,1,2,1,1,6,8,6,0,2018
FRA-Ligue 1,2017,Montpellier,Benjamin Lecomte,FRA,GK,26,1991,38.0,1,1,1,0,0,0,0,,0,1,0,1,0,1,14,1,2018
FRA-Ligue 1,2017,Montpellier,Casimir Ninga,CHA,"FW,MF",24,1993,14.3,12,7,1,6,5,2,10,20.0,8,12,2,10,4,16,13,0,2018
FRA-Ligue 1,2017,Montpellier,Daniel Congré,FRA,DF,32,1985,29.3,62,46,36,24,2,31,59,52.5,28,29,16,13,56,118,124,2,2018
FRA-Ligue 1,2017,Montpellier,Ellyes Skhiri,TUN,MF,22,1995,33.9,89,54,34,47,8,37,88,42.0,51,59,10,49,77,166,57,4,2018
FRA-Ligue 1,2017,Montpellier,Facundo Píriz,URU,MF,27,1990,9.0,25,16,9,12,4,6,35,17.1,29,10,1,9,18,43,14,0,2018
FRA-Ligue 1,2017,Montpellier,Giovanni Sio,CIV,FW,28,1989,24.4,14,8,2,9,3,0,20,0.0,20,11,0,11,6,20,23,1,2018
FRA-Ligue 1,2017,Montpellier,Isaac Mbenza,BEL,"FW,MF",21,1996,23.3,16,11,4,8,4,6,16,37.5,10,8,1,7,4,20,5,0,2018
FRA-Ligue 1,2017,Montpellier,Jonathan Ikone,FRA,"MF,FW",19,1998,11.1,13,10,3,6,4,4,14,28.6,10,8,0,8,6,19,3,0,2018
FRA-Ligue 1,2017,Montpellier,Junior Sambia,FRA,MF,20,1996,17.1,21,12,6,11,4,6,28,21.4,22,16,0,16,20,41,18,0,2018
FRA-Ligue 1,2017,Montpellier,Jérémie Porsan-Clémenté,FRA,DF,19,1997,1.0,3,2,1,2,0,2,2,100.0,0,1,0,1,1,4,4,1,2018
FRA-Ligue 1,2017,Montpellier,Jérôme Roussillon,FRA,DF,24,1993,20.9,40,27,17,19,4,15,26,57.7,11,26,3,23,15,55,52,0,2018
FRA-Ligue 1,2017,Montpellier,Keagan Dolly,RSA,"MF,FW",24,1993,9.8,12,7,2,7,3,1,11,9.1,10,11,0,11,1,13,2,0,2018
FRA-Ligue 1,2017,Montpellier,Kévin Bérigaud,FRA,"FW,MF",29,1988,3.0,4,3,1,1,2,2,6,33.3,4,1,0,1,0,4,1,0,2018
FRA-Ligue 1,2017,Montpellier,Morgan Poaty,CGO,DF,20,1997,1.9,0,0,0,0,0,0,1,0.0,1,5,3,2,1,1,2,0,2018
FRA-Ligue 1,2017,Montpellier,Nicolas Cozza,FRA,"DF,MF",18,1999,6.4,21,11,12,8,1,7,16,43.8,9,5,2,3,13,34,12,0,2018
FRA-Ligue 1,2017,Montpellier,Nordi Mukiele,FRA,DF,19,1997,31.0,70,55,41,25,4,25,44,56.8,19,26,14,12,73,143,104,2,2018
FRA-Ligue 1,2017,Montpellier,Paul Lasne,FRA,MF,28,1989,34.0,68,45,27,39,2,12,54,22.2,42,20,1,19,57,125,26,0,2018
FRA-Ligue 1,2017,Montpellier,Pedro Mendes,POR,DF,26,1990,31.7,62,50,37,19,6,23,41,56.1,18,36,25,11,44,106,152,0,2018
FRA-Ligue 1,2017,Montpellier,Ruben Aguilar,FRA,DF,24,1993,27.3,91,50,37,41,13,36,71,50.7,35,25,3,22,37,128,90,0,2018
FRA-Ligue 1,2017,Montpellier,Souleymane Camara,SEN,FW,34,1982,10.4,6,4,0,5,1,0,3,0.0,3,3,1,2,2,8,15,0,2018
FRA-Ligue 1,2017,Montpellier,Stéphane Sessègnon,BEN,"MF,FW",33,1984,10.9,4,4,2,2,0,1,7,14.3,6,0,0,0,0,4,2,0,2018
FRA-Ligue 1,2017,Montpellier,Vitorino Hilton,BRA,DF,39,1977,27.0,44,26,33,11,0,13,36,36.1,23,28,14,14,58,102,140,5,2018
FRA-Ligue 1,2017,Nantes,Abdoulaye Touré,FRA,MF,23,1994,31.2,74,52,28,38,8,23,67,34.3,44,40,10,30,62,136,49,1,2018
FRA-Ligue 1,2017,Nantes,Adrien Thomasson,FRA,"MF,FW",23,1993,28.6,71,52,41,23,7,22,73,30.1,51,58,4,54,18,89,20,0,2018
FRA-Ligue 1,2017,Nantes,Alexander Kačaniklić,SWE,"MF,FW",25,1991,3.5,8,5,7,1,0,5,10,50.0,5,5,2,3,6,14,7,0,2018
FRA-Ligue 1,2017,Nantes,Andrei Girotto,BRA,MF,25,1992,16.9,57,38,15,37,5,21,52,40.4,31,32,7,25,15,72,45,1,2018
FRA-Ligue 1,2017,Nantes,Anthony Walongwa,COD,DF,23,1993,1.0,2,1,2,0,0,0,0,,0,0,0,0,1,3,8,0,2018
FRA-Ligue 1,2017,Nantes,Chidozie Awaziem,NGA,DF,20,1997,16.8,43,30,33,10,0,28,40,70.0,12,18,11,7,16,59,97,0,2018
FRA-Ligue 1,2017,Nantes,Ciprian Tătărușanu,ROU,GK,31,1986,37.0,1,0,1,0,0,1,2,50.0,1,0,0,0,1,2,12,3,2018
FRA-Ligue 1,2017,Nantes,David Alcibiade,FRA,DF,25,1991,2.3,9,5,5,3,1,2,4,50.0,2,5,3,2,7,16,8,0,2018
FRA-Ligue 1,2017,Nantes,Diego Carlos,BRA,DF,24,1993,25.5,70,42,51,15,4,28,38,73.7,10,50,29,21,29,99,155,3,2018
FRA-Ligue 1,2017,Nantes,Emiliano Sala,ARG,FW,26,1990,33.7,19,11,3,9,7,5,33,15.2,28,27,3,24,9,28,50,0,2018
FRA-Ligue 1,2017,Nantes,Enock Kwateng,FRA,DF,20,1997,1.0,8,6,6,2,0,7,11,63.6,4,2,0,2,1,9,7,0,2018
FRA-Ligue 1,2017,Nantes,Guillaume Gillet,BEL,MF,33,1984,0.2,0,0,0,0,0,0,0,,0,1,1,0,0,0,0,0,2018
FRA-Ligue 1,2017,Nantes,Joris Kayembe,BEL,"FW,MF",22,1994,1.0,1,0,1,0,0,0,4,0.0,4,0,0,0,0,1,4,0,2018
FRA-Ligue 1,2017,Nantes,Jules Iloki,FRA,"MF,FW",25,1992,15.8,13,9,1,9,3,3,16,18.8,13,8,0,8,12,25,16,0,2018
FRA-Ligue 1,2017,Nantes,Kalifa Coulibaly,MLI,FW,25,1991,3.8,6,6,3,1,2,2,4,50.0,2,0,0,0,0,6,6,0,2018
FRA-Ligue 1,2017,Nantes,Koffi Djidji,CIV,DF,24,1992,26.8,55,39,32,20,3,19,29,65.5,10,34,15,19,45,100,126,0,2018
FRA-Ligue 1,2017,Nantes,Kolbeinn Sigþórsson,ISL,FW,27,1990,0.3,0,0,0,0,0,0,0,,0,0,0,0,1,1,0,0,2018
FRA-Ligue 1,2017,Nantes,Leo Dubois,FRA,DF,22,1994,33.6,50,39,33,15,2,20,47,42.6,27,47,13,34,50,100,99,2,2018
FRA-Ligue 1,2017,Nantes,Lucas Lima,BRA,"DF,FW",25,1991,29.5,73,46,40,27,6,31,68,45.6,37,42,6,36,38,111,85,0,2018
FRA-Ligue 1,2017,Nantes,Mariusz Stępiński,POL,FW,22,1995,0.0,0,0,0,0,0,0,0,,0,0,0,0,0,0,0,0,2018
FRA-Ligue 1,2017,Nantes,Maxime Dupé,FRA,GK,24,1993,1.0,0,0,0,0,0,0,0,,0,0,0,0,0,0,2,0,2018
FRA-Ligue 1,2017,Nantes,Najib Gandi,FRA,"FW,MF",23,1994,1.1,6,5,3,2,1,4,6,66.7,2,4,1,3,4,10,3,0,2018
FRA-Ligue 1,2017,Nantes,Nicolas Pallois,FRA,DF,29,1987,27.0,39,28,25,9,5,18,36,50.0,18,34,19,15,35,74,182,3,2018
FRA-Ligue 1,2017,Nantes,Préjuce Nakoulma,BFA,FW,30,1987,12.8,10,8,3,6,1,2,7,28.6,5,2,0,2,5,15,0,0,2018
FRA-Ligue 1,2017,Nantes,Rene Krhin,SVN,MF,27,1990,14.6,18,12,7,11,0,3,17,17.6,14,11,2,9,16,34,39,0,2018
FRA-Ligue 1,2017,Nantes,Samuel Moutoussamy,COD,MF,20,1996,4.8,15,7,6,7,2,5,8,62.5,3,7,1,6,3,18,4,0,2018
FRA-Ligue 1,2017,Nantes,Santy Ngom,SEN,"FW,MF",24,1993,5.2,10,5,5,5,0,1,8,12.5,7,9,1,8,2,12,2,0,2018
FRA-Ligue 1,2017,Nantes,Valentin Rongier,FRA,MF,22,1994,26.1,73,49,25,39,9,17,64,26.6,47,42,6,36,40,113,13,1,2018
FRA-Ligue 1,2017,Nantes,Yacine Bammou,MAR,"MF,FW",25,1991,8.1,18,11,6,10,2,4,14,28.6,10,16,4,12,6,24,9,0,2018
FRA-Ligue 1,2017,Nantes,Yassine El Ghanassy,BEL,"MF,FW",27,1990,7.2,7,4,1,3,3,1,4,25.0,3,1,0,1,4,11,4,0,2018
FRA-Ligue 1,2017,Nice,Adrien Tameze,CMR,MF,23,1994,18.7,58,36,32,21,5,26,47,55.3,21,26,5,21,41,99,22,1,2018
FRA-Ligue 1,2017,Nice,Alassane Pléa,FRA,FW,24,1993,33.8,15,9,5,7,3,5,32,15.6,27,14,3,11,8,23,21,0,2018
FRA-Ligue 1,2017,Nice,Allan Saint-Maximin,FRA,"FW,MF",20,1997,25.0,18,14,13,2,3,12,28,42.9,16,12,1,11,11,29,10,0,2018
FRA-Ligue 1,2017,Nice,Arnaud Lusamba,COD,MF,20,1997,1.8,12,9,4,6,2,3,7,42.9,4,5,0,5,1,13,1,0,2018
FRA-Ligue 1,2017,Nice,Arnaud Souquet,FRA,DF,25,1992,26.8,89,68,58,26,5,36,56,64.3,20,46,16,30,39,128,72,2,2018
FRA-Ligue 1,2017,Nice,Bassem Srarfi,TUN,"FW,MF",20,1997,9.7,17,11,6,9,2,4,14,28.6,10,12,0,12,7,24,6,1,2018
FRA-Ligue 1,2017,Nice,Christophe Jallet,FRA,DF,33,1983,13.0,29,21,21,8,0,11,26,42.3,15,18,6,12,16,45,47,0,2018
FRA-Ligue 1,2017,Nice,Dante,BRA,DF,33,1983,32.4,43,28,32,10,1,21,36,58.3,15,44,25,19,47,90,130,2,2018
FRA-Ligue 1,2017,Nice,Hicham Mahou,FRA,"MF,FW",18,1999,0.6,1,1,1,0,0,1,3,33.3,2,0,0,0,3,4,0,0,2018
FRA-Ligue 1,2017,Nice,Ignatius Ganago,CMR,"FW,MF",18,1999,0.8,0,0,0,0,0,0,2,0.0,2,1,0,1,0,0,1,0,2018
FRA-Ligue 1,2017,Nice,Ihsan Sacko,FRA,"FW,MF",20,1997,2.9,1,1,0,1,0,0,1,0.0,1,1,0,1,2,3,1,0,2018
FRA-Ligue 1,2017,Nice,Jean Seri,CIV,MF,26,1991,29.1,25,14,9,12,4,9,56,16.1,47,16,4,12,26,51,15,4,2018
FRA-Ligue 1,2017,Nice,Jean-Victor Makengo,FRA,"FW,MF",19,1998,2.7,4,2,2,2,0,1,2,50.0,1,1,0,1,3,7,1,1,2018
FRA-Ligue 1,2017,Nice,Malang Sarr,FRA,DF,18,1999,14.7,24,18,17,7,0,8,18,44.4,10,14,6,8,31,55,44,2,2018
FRA-Ligue 1,2017,Nice,Mario Balotelli,ITA,FW,26,1990,25.2,7,4,1,3,3,0,6,0.0,6,9,2,7,8,15,26,0,2018
FRA-Ligue 1,2017,Nice,Marlon,BRA,DF,21,1995,21.4,36,26,22,13,1,15,22,68.2,7,19,15,4,15,51,72,2,2018
FRA-Ligue 1,2017,Nice,Maxime Le Marchand,FRA,DF,27,1989,28.2,48,36,28,18,2,20,41,48.8,21,36,13,23,65,113,105,4,2018
FRA-Ligue 1,2017,Nice,Mickaël Le Bihan,FRA,"FW,MF",27,1990,1.2,0,0,0,0,0,0,3,0.0,3,0,0,0,1,1,0,0,2018
FRA-Ligue 1,2017,Nice,Nampalys Mendy,SEN,MF,25,1992,10.7,13,6,8,5,0,5,17,29.4,12,9,1,8,13,26,10,1,2018
FRA-Ligue 1,2017,Nice,Patrick Burner,MTQ,DF,21,1996,10.0,18,12,13,5,0,7,20,35.0,13,6,0,6,13,31,23,0,2018
FRA-Ligue 1,2017,Nice,Pierre Lees-Melou,FRA,"MF,FW",24,1993,32.1,78,47,29,39,10,27,76,35.5,49,52,11,41,34,112,38,2,2018
FRA-Ligue 1,2017,Nice,Racine Coly,SEN,DF,21,1995,6.9,15,12,9,5,1,9,19,47.4,10,5,2,3,15,30,18,0,2018
FRA-Ligue 1,2017,Nice,Romain Perraud,FRA,FW,19,1997,0.0,0,0,0,0,0,0,0,,0,0,0,0,0,0,0,0,2018
FRA-Ligue 1,2017,Nice,Rémi Walter,FRA,"MF,FW",22,1995,5.5,11,7,4,6,1,3,7,42.9,4,2,1,1,5,16,3,0,2018
FRA-Ligue 1,2017,Nice,Valentin Eysseric,FRA,FW,25,1992,1.0,0,0,0,0,0,0,0,,0,4,0,4,1,1,0,0,2018
FRA-Ligue 1,2017,Nice,Vincent Koziello,FRA,MF,21,1995,9.0,16,8,9,5,2,5,16,31.3,11,8,3,5,19,35,7,1,2018
FRA-Ligue 1,2017,Nice,Vincent Marcel,FRA,"MF,FW",20,1997,0.5,1,1,0,1,0,0,1,0.0,1,1,0,1,0,1,0,0,2018
FRA-Ligue 1,2017,Nice,Walter Benítez,ARG,GK,24,1993,28.0,0,0,0,0,0,0,2,0.0,2,0,0,0,0,0,5,3,2018
FRA-Ligue 1,2017,Nice,Wesley Sneijder,NED,"MF,FW",33,1984,4.4,0,0,0,0,0,0,3,0.0,3,1,0,1,2,2,2,1,2018
FRA-Ligue 1,2017,Nice,Wylan Cyprien,FRA,MF,22,1995,10.6,9,7,4,4,1,2,11,18.2,9,7,1,6,11,20,7,2,2018
FRA-Ligue 1,2017,Nice,Yoan Cardinale,FRA,GK,23,1994,10.0,0,0,0,0,0,0,0,,0,0,0,0,0,0,0,3,2018
FRA-Ligue 1,2017,Paris S-G,Adrien Rabiot,FRA,MF,22,1995,26.2,59,36,27,23,9,15,36,41.7,21,29,10,19,33,92,22,1,2018
FRA-Ligue 1,2017,Paris S-G,Alphonse Areola,FRA,GK,24,1993,34.0,0,0,0,0,0,0,1,0.0,1,0,0,0,0,0,7,4,2018
FRA-Ligue 1,2017,Paris S-G,Blaise Matuidi,FRA,MF,30,1987,0.3,1,1,1,0,0,0,0,,0,2,1,1,0,1,0,0,2018
FRA-Ligue 1,2017,Paris S-G,Christopher Nkunku,FRA,"FW,MF",19,1997,7.0,5,2,2,2,1,3,14,21.4,11,8,2,6,5,10,2,1,2018
FRA-Ligue 1,2017,Paris S-G,Dani Alves,BRA,DF,34,1983,22.9,80,57,45,27,8,33,58,56.9,25,24,3,21,28,108,21,0,2018
FRA-Ligue 1,2017,Paris S-G,Edinson Cavani,URU,FW,30,1987,28.7,15,9,5,4,6,2,16,12.5,14,10,1,9,5,20,22,0,2018
FRA-Ligue 1,2017,Paris S-G,Giovani Lo Celso,ARG,MF,21,1996,19.7,77,58,26,36,15,26,74,35.1,48,30,5,25,19,96,12,1,2018
FRA-Ligue 1,2017,Paris S-G,Gonçalo Guedes,POR,FW,20,1996,0.1,0,0,0,0,0,0,0,,0,0,0,0,0,0,0,0,2018
FRA-Ligue 1,2017,Paris S-G,Javier Pastore,ARG,"MF,FW",28,1989,15.0,33,21,9,16,8,5,23,21.7,18,13,0,13,10,43,14,1,2018
FRA-Ligue 1,2017,Paris S-G,Julian Draxler,GER,"MF,FW",23,1993,18.9,20,14,4,13,3,6,32,18.8,26,18,2,16,28,48,8,0,2018
FRA-Ligue 1,2017,Paris S-G,Kevin Trapp,GER,GK,27,1990,4.0,0,0,0,0,0,0,0,,0,0,0,0,0,0,1,0,2018
FRA-Ligue 1,2017,Paris S-G,Kylian Mbappé,FRA,FW,18,1998,23.3,11,8,3,3,5,1,13,7.7,12,4,1,3,0,11,1,0,2018
FRA-Ligue 1,2017,Paris S-G,Kévin Rimane,GUF,DF,26,1991,0.1,0,0,0,0,0,0,0,,0,0,0,0,0,0,0,0,2018
FRA-Ligue 1,2017,Paris S-G,Lassana Diarra,FRA,MF,32,1985,6.7,12,4,4,7,1,8,12,66.7,4,3,1,2,6,18,6,0,2018
FRA-Ligue 1,2017,Paris S-G,Layvin Kurzawa,FRA,DF,24,1992,18.9,44,32,20,15,9,15,39,38.5,24,16,3,13,35,79,41,2,2018
FRA-Ligue 1,2017,Paris S-G,Lucas Moura,BRA,FW,24,1992,0.8,1,1,0,1,0,0,1,0.0,1,0,0,0,0,1,0,0,2018
FRA-Ligue 1,2017,Paris S-G,Marco Verratti,ITA,MF,24,1992,19.1,51,33,20,25,6,12,55,21.8,43,25,6,19,26,77,11,3,2018
FRA-Ligue 1,2017,Paris S-G,Marquinhos,BRA,DF,23,1994,25.1,28,14,14,14,0,13,21,61.9,8,36,22,14,14,42,114,2,2018
FRA-Ligue 1,2017,Paris S-G,Neymar,BRA,FW,25,1992,19.8,20,14,3,11,6,7,40,17.5,33,4,0,4,5,25,2,0,2018
FRA-Ligue 1,2017,Paris S-G,Presnel Kimpembe,FRA,DF,21,1995,26.9,39,28,20,18,1,9,14,64.3,5,17,10,7,24,63,80,1,2018
FRA-Ligue 1,2017,Paris S-G,Stanley N'Soki,FRA,DF,18,1999,0.3,0,0,0,0,0,0,1,0.0,1,0,0,0,0,0,1,0,2018
FRA-Ligue 1,2017,Paris S-G,Thiago Motta,ITA,MF,34,1982,12.8,28,21,14,11,3,8,24,33.3,16,15,6,9,21,49,26,1,2018
FRA-Ligue 1,2017,Paris S-G,Thiago Silva,BRA,DF,32,1984,23.5,31,23,19,12,0,12,21,57.1,9,28,18,10,18,49,114,0,2018
FRA-Ligue 1,2017,Paris S-G,Thomas Meunier,BEL,DF,25,1991,17.5,38,21,22,12,4,18,34,52.9,16,7,2,5,18,56,54,2,2018
FRA-Ligue 1,2017,Paris S-G,Timothy Weah,USA,FW,17,2000,1.4,1,1,1,0,0,1,1,100.0,0,0,0,0,0,1,0,0,2018
FRA-Ligue 1,2017,Paris S-G,Yacine Adli,FRA,FW,17,2000,0.1,0,0,0,0,0,0,0,,0,0,0,0,0,0,0,0,2018
FRA-Ligue 1,2017,Paris S-G,Yuri Berchiche,ESP,DF,27,1990,19.1,39,27,21,11,7,12,25,48.0,13,15,2,13,24,63,53,0,2018
FRA-Ligue 1,2017,Paris S-G,Ángel Di María,ARG,FW,29,1988,23.5,13,10,5,3,5,7,39,17.9,32,18,2,16,10,23,8,0,2018
FRA-Ligue 1,2017,Rennes,Abdoulaye Diallo,SEN,GK,25,1992,3.0,0,0,0,0,0,0,0,,0,0,0,0,0,0,4,1,2018
FRA-Ligue 1,2017,Rennes,Adrien Hunou,FRA,"FW,MF",23,1994,16.2,27,15,11,8,8,11,42,26.2,31,22,1,21,9,36,8,1,2018
FRA-Ligue 1,2017,Rennes,Afonso Figueiredo,POR,"DF,FW",24,1993,2.5,6,3,3,3,0,3,5,60.0,2,0,0,0,0,6,4,0,2018
FRA-Ligue 1,2017,Rennes,Benjamin André,FRA,MF,26,1990,33.5,93,54,36,50,7,43,113,38.1,70,56,4,52,57,150,96,1,2018
FRA-Ligue 1,2017,Rennes,Benjamin Bourigeaud,FRA,"MF,FW",23,1994,34.5,55,30,18,30,7,20,93,21.5,73,48,4,44,45,100,29,0,2018
FRA-Ligue 1,2017,Rennes,Brandon,ESP,"FW,MF",22,1995,4.0,10,9,3,4,3,1,11,9.1,10,11,1,10,5,15,1,0,2018
FRA-Ligue 1,2017,Rennes,Diafra Sakho,SEN,FW,27,1989,8.6,5,4,1,2,2,0,7,0.0,7,4,0,4,2,7,11,0,2018
FRA-Ligue 1,2017,Rennes,Faitout Maouassa,FRA,"MF,FW",19,1998,9.9,6,3,2,3,1,2,10,20.0,8,12,2,10,6,12,5,0,2018
FRA-Ligue 1,2017,Rennes,Gerzino Nyamsi,FRA,DF,20,1997,3.0,4,2,4,0,0,0,3,0.0,3,2,2,0,3,7,18,2,2018
FRA-Ligue 1,2017,Rennes,Hamari Traoré,MLI,DF,25,1992,29.3,79,55,43,31,5,41,66,62.1,25,31,12,19,61,140,117,0,2018
FRA-Ligue 1,2017,Rennes,Ismaila Sarr,SEN,"FW,MF",19,1998,20.6,20,10,5,10,5,7,29,24.1,22,17,0,17,9,29,3,1,2018
FRA-Ligue 1,2017,Rennes,James Lea Siliki,CMR,MF,21,1996,20.2,31,21,9,19,3,6,41,14.6,35,21,1,20,18,49,14,1,2018
FRA-Ligue 1,2017,Rennes,Jordan Tell,GLP,"FW,MF",20,1997,1.3,4,4,1,3,0,0,1,0.0,1,0,0,0,1,5,0,0,2018
FRA-Ligue 1,2017,Rennes,Joris Gnagnon,FRA,DF,20,1997,32.4,42,29,29,9,4,21,31,67.7,10,22,16,6,29,71,154,2,2018
FRA-Ligue 1,2017,Rennes,Jérémy Gélin,FRA,"DF,MF",20,1997,25.7,37,18,22,14,1,20,53,37.7,33,22,12,10,37,74,92,3,2018
FRA-Ligue 1,2017,Rennes,Ludovic Baal,GUF,DF,31,1986,12.9,41,27,29,8,4,13,35,37.1,22,13,2,11,15,56,37,1,2018
FRA-Ligue 1,2017,Rennes,Mehdi Zeffane,ALG,"DF,MF",25,1992,11.0,17,12,10,5,2,9,25,36.0,16,10,2,8,12,29,44,0,2018
FRA-Ligue 1,2017,Rennes,Mexer,MOZ,DF,28,1988,13.3,15,12,9,6,0,9,12,75.0,3,13,7,6,16,31,98,2,2018
FRA-Ligue 1,2017,Rennes,Morgan Amalfitano,FRA,"MF,FW",32,1985,8.3,8,5,3,3,2,2,5,40.0,3,6,0,6,4,12,7,0,2018
FRA-Ligue 1,2017,Rennes,Ndombe Mubele,COD,"FW,MF",23,1994,13.6,14,8,5,6,3,5,13,38.5,8,9,0,9,3,17,3,0,2018
FRA-Ligue 1,2017,Rennes,Nicolas Janvier,FRA,MF,18,1998,0.8,4,1,1,1,2,1,2,50.0,1,1,0,1,1,5,0,0,2018
FRA-Ligue 1,2017,Rennes,Ramy Bensebaini,ALG,DF,22,1995,26.0,56,39,31,21,4,26,55,47.3,29,24,16,8,37,93,177,1,2018
FRA-Ligue 1,2017,Rennes,Raïs M'Bolhi,ALG,GK,31,1986,1.0,0,0,0,0,0,0,1,0.0,1,0,0,0,0,0,0,0,2018
FRA-Ligue 1,2017,Rennes,Romain Danzé,FRA,DF,31,1986,7.6,12,7,3,4,5,8,13,61.5,5,11,2,9,3,15,34,0,2018
FRA-Ligue 1,2017,Rennes,Sanjin Prcić,BIH,MF,23,1993,17.4,37,18,9,24,4,8,39,20.5,31,19,5,14,30,67,25,0,2018
FRA-Ligue 1,2017,Rennes,Tomáš Koubek,CZE,GK,24,1992,34.0,0,0,0,0,0,0,1,0.0,1,0,0,0,3,3,22,3,2018
FRA-Ligue 1,2017,Rennes,Wahbi Khazri,TUN,"FW,MF",26,1991,21.3,26,18,7,10,9,7,39,17.9,32,29,0,29,7,33,7,0,2018
FRA-Ligue 1,2017,Rennes,Yoann Gourcuff,FRA,"MF,FW",31,1986,4.7,7,5,1,3,3,0,2,0.0,2,5,0,5,2,9,2,0,2018
FRA-Ligue 1,2017,Saint-Étienne,Alexander Søderlund,NOR,FW,29,1987,4.0,1,1,1,0,0,0,2,0.0,2,1,0,1,2,3,2,0,2018
FRA-Ligue 1,2017,Saint-Étienne,Assane Dioussé,SEN,MF,19,1997,14.9,32,21,14,14,4,13,34,38.2,21,29,2,27,11,43,16,2,2018
FRA-Ligue 1,2017,Saint-Étienne,Bryan Dabo,BFA,"MF,FW",25,1992,14.3,25,16,12,10,3,7,29,24.1,22,12,1,11,11,36,22,0,2018
FRA-Ligue 1,2017,Saint-Étienne,Cheikh M'Bengue,SEN,DF,29,1988,5.4,8,4,8,0,0,4,4,100.0,0,6,4,2,8,16,22,1,2018
FRA-Ligue 1,2017,Saint-Étienne,Florentin Pogba,GUI,DF,26,1990,3.6,6,0,4,2,0,3,5,60.0,2,2,2,0,1,7,12,0,2018
FRA-Ligue 1,2017,Saint-Étienne,Gabriel Silva,BRA,DF,26,1991,23.1,28,20,19,4,5,19,31,61.3,12,21,6,15,37,65,83,1,2018
FRA-Ligue 1,2017,Saint-Étienne,Habib Maïga,CIV,"MF,DF",21,1996,7.9,29,18,16,10,3,12,30,40.0,18,8,4,4,19,48,10,0,2018
FRA-Ligue 1,2017,Saint-Étienne,Hernani,BRA,"MF,FW",23,1994,6.0,21,13,9,9,3,10,22,45.5,12,15,2,13,6,27,5,0,2018
FRA-Ligue 1,2017,Saint-Étienne,Jessy Moulin,FRA,GK,31,1986,3.4,0,0,0,0,0,0,0,,0,0,0,0,0,0,3,2,2018
FRA-Ligue 1,2017,Saint-Étienne,Jonathan Bamba,CIV,FW,21,1996,28.6,30,21,18,11,1,12,61,19.7,49,30,4,26,19,49,17,0,2018
FRA-Ligue 1,2017,Saint-Étienne,Kévin Monnet-Paquet,FRA,"FW,MF",28,1988,19.6,33,25,9,19,5,11,48,22.9,37,15,2,13,13,46,23,1,2018
FRA-Ligue 1,2017,Saint-Étienne,Kévin Théophile-Catherine,FRA,DF,27,1989,24.1,36,27,23,13,0,11,24,45.8,13,19,15,4,31,67,113,1,2018
FRA-Ligue 1,2017,Saint-Étienne,Lois Diony,FRA,FW,24,1992,10.3,3,0,1,2,0,0,3,0.0,3,5,1,4,1,4,8,0,2018
FRA-Ligue 1,2017,Saint-Étienne,Loïc Perrin,FRA,DF,31,1985,27.4,39,26,28,10,1,21,31,67.7,10,35,22,13,36,75,142,1,2018
FRA-Ligue 1,2017,Saint-Étienne,Léo Lacroix,SUI,DF,25,1992,8.6,13,8,8,5,0,5,9,55.6,4,6,3,3,11,24,54,1,2018
FRA-Ligue 1,2017,Saint-Étienne,Mathieu Debuchy,FRA,DF,32,1985,14.6,34,25,22,8,4,17,30,56.7,13,16,10,6,27,61,73,0,2018
FRA-Ligue 1,2017,Saint-Étienne,Neven Subotić,SRB,DF,28,1988,16.0,23,14,16,7,0,10,27,37.0,17,13,9,4,18,41,96,1,2018
FRA-Ligue 1,2017,Saint-Étienne,Ole Selnæs,NOR,MF,23,1994,22.9,73,45,29,42,2,18,61,29.5,43,37,15,22,34,107,53,1,2018
FRA-Ligue 1,2017,Saint-Étienne,Oussama Tannane,MAR,FW,23,1994,2.3,12,6,4,5,3,2,5,40.0,3,2,0,2,3,15,2,0,2018
FRA-Ligue 1,2017,Saint-Étienne,Paul-Georges Ntep,CMR,"FW,MF",25,1992,5.7,14,8,8,5,1,8,17,47.1,9,4,1,3,3,17,4,0,2018
FRA-Ligue 1,2017,Saint-Étienne,Rayan Souici,FRA,MF,19,1998,0.1,0,0,0,0,0,0,0,,0,1,0,1,0,0,0,0,2018
FRA-Ligue 1,2017,Saint-Étienne,Robert Berić,SVN,FW,26,1991,11.6,6,4,1,3,2,1,16,6.3,15,9,1,8,5,11,4,0,2018
FRA-Ligue 1,2017,Saint-Étienne,Romain Hamouma,FRA,FW,30,1987,20.5,19,13,7,6,6,1,22,4.5,21,15,4,11,13,32,8,1,2018
FRA-Ligue 1,2017,Saint-Étienne,Ronaël Pierre-Gabriel,FRA,DF,19,1998,13.0,43,31,33,7,3,17,28,60.7,11,11,2,9,9,52,35,0,2018
FRA-Ligue 1,2017,Saint-Étienne,Rémy Cabella,FRA,"MF,FW",27,1990,25.1,58,39,29,22,7,17,73,23.3,56,31,0,31,14,72,4,2,2018
FRA-Ligue 1,2017,Saint-Étienne,Saidy Janko,GAM,DF,21,1995,15.8,43,30,25,14,4,14,24,58.3,10,21,1,20,14,57,50,0,2018
FRA-Ligue 1,2017,Saint-Étienne,Stéphane Ruffier,FRA,GK,30,1986,34.6,0,0,0,0,0,0,0,,0,0,0,0,0,0,14,1,2018
FRA-Ligue 1,2017,Saint-Étienne,Vagner Gonçalves,CPV,FW,21,1996,1.2,0,0,0,0,0,0,3,0.0,3,2,0,2,0,0,0,0,2018
FRA-Ligue 1,2017,Saint-Étienne,Vincent Pajot,FRA,MF,26,1990,14.3,24,16,9,13,2,3,17,17.6,14,21,9,12,24,48,34,0,2018
FRA-Ligue 1,2017,Saint-Étienne,Yann M'Vila,FRA,MF,27,1990,16.4,26,16,11,12,3,7,24,29.2,17,13,1,12,31,57,56,0,2018
FRA-Ligue 1,2017,Strasbourg,Abdallah N'dour,SEN,DF,23,1993,2.8,9,5,6,3,0,5,10,50.0,5,6,1,5,2,11,5,0,2018
FRA-Ligue 1,2017,Strasbourg,Alexandre Oukidja,ALG,GK,29,1988,16.2,0,0,0,0,0,0,1,0.0,1,0,0,0,3,3,9,1,2018
FRA-Ligue 1,2017,Strasbourg,Anthony Gonçalves,FRA,"MF,FW",31,1986,19.5,50,31,14,32,4,15,50,30.0,35,27,0,27,25,75,27,0,2018
FRA-Ligue 1,2017,Strasbourg,Bakary Koné,BFA,DF,29,1988,27.4,26,17,23,3,0,12,31,38.7,19,20,10,10,33,59,122,2,2018
FRA-Ligue 1,2017,Strasbourg,Benjamin Corgnet,FRA,"MF,FW",30,1987,15.3,28,19,5,16,7,6,28,21.4,22,18,1,17,11,39,11,0,2018
FRA-Ligue 1,2017,Strasbourg,Bingourou Kamara,SEN,GK,20,1996,18.8,0,0,0,0,0,0,2,0.0,2,0,0,0,1,1,6,3,2018
FRA-Ligue 1,2017,Strasbourg,Dimitri Foulquier,FRA,DF,24,1993,13.8,25,12,15,8,2,7,17,41.2,10,15,4,11,14,39,33,0,2018
FRA-Ligue 1,2017,Strasbourg,Dimitri Liénard,FRA,"MF,FW",29,1988,28.9,77,51,37,32,8,30,84,35.7,54,35,2,33,52,129,41,1,2018
FRA-Ligue 1,2017,Strasbourg,Ernest Seka,GUI,DF,30,1987,24.2,60,47,41,14,5,40,61,65.6,21,25,8,17,51,111,98,1,2018
FRA-Ligue 1,2017,Strasbourg,Idriss Saadi,ALG,FW,25,1992,10.5,6,5,2,3,1,2,11,18.2,9,3,2,1,5,11,1,0,2018
FRA-Ligue 1,2017,Strasbourg,Ihsan Sacko,FRA,"FW,MF",20,1997,7.9,10,8,6,0,4,2,10,20.0,8,2,0,2,5,15,6,0,2018
FRA-Ligue 1,2017,Strasbourg,Jean-Eudes Aholou,CIV,MF,23,1994,33.4,70,34,32,37,1,17,55,30.9,38,29,7,22,75,145,58,1,2018
FRA-Ligue 1,2017,Strasbourg,Jonas Martin,FRA,MF,27,1990,33.6,73,50,41,28,4,17,54,31.5,37,30,3,27,33,106,36,0,2018
FRA-Ligue 1,2017,Strasbourg,Jérémy Blayac,FRA,FW,34,1983,10.2,5,3,0,3,2,2,9,22.2,7,7,2,5,1,6,11,0,2018
FRA-Ligue 1,2017,Strasbourg,Jérémy Grimm,FRA,MF,30,1987,9.0,23,17,15,6,2,9,24,37.5,15,11,3,8,19,42,31,1,2018
FRA-Ligue 1,2017,Strasbourg,Kader Mangane,SEN,DF,34,1983,19.1,37,24,29,8,0,11,21,52.4,10,28,18,10,24,61,120,4,2018
FRA-Ligue 1,2017,Strasbourg,Kenny Lala,FRA,DF,25,1991,30.3,87,47,53,28,6,21,47,44.7,26,18,10,8,42,129,70,2,2018
FRA-Ligue 1,2017,Strasbourg,Kévin Zohi,MLI,MF,20,1996,0.0,0,0,0,0,0,0,0,,0,0,0,0,0,0,0,0,2018
FRA-Ligue 1,2017,Strasbourg,Landry Bonnefoi,FRA,GK,33,1983,3.0,0,0,0,0,0,0,0,,0,0,0,0,0,0,2,0,2018
FRA-Ligue 1,2017,Strasbourg,Martin Terrier,FRA,"FW,MF",20,1997,18.6,42,30,16,23,3,9,28,32.1,19,11,1,10,14,56,6,0,2018
FRA-Ligue 1,2017,Strasbourg,Nuno da Costa,CPV,"FW,MF",26,1991,19.2,50,32,12,29,9,7,35,20.0,28,21,0,21,19,69,9,0,2018
FRA-Ligue 1,2017,Strasbourg,Pablo Martinez,FRA,DF,28,1989,23.5,41,34,28,12,1,22,49,44.9,27,25,12,13,51,92,112,3,2018
FRA-Ligue 1,2017,Strasbourg,Stéphane Bahoken,CMR,FW,25,1992,18.5,16,11,3,8,5,4,22,18.2,18,18,1,17,9,25,1,0,2018
FRA-Ligue 1,2017,Strasbourg,Vincent Nogueira,FRA,MF,29,1988,0.7,0,0,0,0,0,0,0,,0,0,0,0,0,0,2,0,2018
FRA-Ligue 1,2017,Strasbourg,Yoann Salmier,GUF,DF,24,1992,12.3,15,13,10,5,0,5,12,41.7,7,11,6,5,26,41,62,1,2018
FRA-Ligue 1,2017,Toulouse,Alban Lafont,FRA,GK,18,1999,38.0,1,0,1,0,0,1,4,25.0,3,0,0,0,2,3,20,5,2018
FRA-Ligue 1,2017,Toulouse,Alexis Blin,FRA,MF,20,1996,21.0,57,37,23,30,4,22,69,31.9,47,27,6,21,31,88,31,0,2018
FRA-Ligue 1,2017,Toulouse,Andy Delort,ALG,FW,25,1991,25.9,20,13,2,9,9,4,19,21.1,15,10,0,10,12,32,22,0,2018
FRA-Ligue 1,2017,Toulouse,Christopher Jullien,FRA,DF,24,1993,28.9,36,25,27,9,0,15,32,46.9,17,29,19,10,40,76,182,5,2018
FRA-Ligue 1,2017,Toulouse,Clément Michelin,FRA,DF,20,1997,3.1,11,7,7,4,0,7,11,63.6,4,3,1,2,4,15,12,0,2018
FRA-Ligue 1,2017,Toulouse,Corentin Jean,FRA,"FW,MF",22,1995,18.8,12,8,4,7,1,5,21,23.8,16,14,1,13,14,26,10,0,2018
FRA-Ligue 1,2017,Toulouse,Driss Khalid,MAR,FW,18,1999,0.3,1,0,0,0,1,0,0,,0,0,0,0,0,1,2,0,2018
FRA-Ligue 1,2017,Toulouse,François Moubandje,SUI,DF,27,1990,18.9,28,15,20,7,1,10,34,29.4,24,23,7,16,27,55,75,0,2018
FRA-Ligue 1,2017,Toulouse,Giannelli Imbula,COD,MF,24,1992,24.9,29,19,10,15,4,7,29,24.1,22,17,2,15,20,49,13,3,2018
FRA-Ligue 1,2017,Toulouse,Ibrahim Sangaré,CIV,MF,19,1997,17.6,72,47,35,34,3,29,69,42.0,40,33,7,26,24,96,19,1,2018
FRA-Ligue 1,2017,Toulouse,Issa Diop,FRA,DF,20,1997,34.0,58,43,35,22,1,21,48,43.8,27,38,25,13,76,134,128,0,2018
FRA-Ligue 1,2017,Toulouse,Issiaga Sylla,GUI,"DF,FW",23,1994,17.8,44,32,22,16,6,19,47,40.4,28,31,4,27,34,78,65,1,2018
FRA-Ligue 1,2017,Toulouse,Jimmy Durmaz,SWE,"MF,FW",28,1989,11.4,16,9,5,5,6,6,14,42.9,8,2,0,2,14,30,9,0,2018
FRA-Ligue 1,2017,Toulouse,Kelvin Amian,FRA,DF,19,1998,35.0,59,43,45,10,4,22,31,71.0,9,25,7,18,45,104,127,1,2018
FRA-Ligue 1,2017,Toulouse,Max Gradel,CIV,"FW,MF",29,1987,26.8,63,36,28,21,14,24,72,33.3,48,39,2,37,14,77,30,0,2018
FRA-Ligue 1,2017,Toulouse,Ndombe Mubele,COD,"FW,MF",23,1994,4.1,8,4,6,2,0,4,10,40.0,6,11,0,11,9,17,4,0,2018
FRA-Ligue 1,2017,Toulouse,Ola Toivonen,SWE,"FW,MF",31,1986,8.9,4,4,1,0,3,0,7,0.0,7,2,0,2,2,6,12,0,2018
FRA-Ligue 1,2017,Toulouse,Quentin Boisgard,FRA,MF,20,1997,2.0,2,2,0,2,0,0,3,0.0,3,2,0,2,0,2,1,0,2018
FRA-Ligue 1,2017,Toulouse,Somália,BRA,"MF,FW",28,1988,22.2,65,45,21,36,8,14,54,25.9,40,34,2,32,34,99,35,0,2018
FRA-Ligue 1,2017,Toulouse,Steeve Yago,BFA,DF,24,1992,17.5,49,36,28,17,4,20,37,54.1,17,16,7,9,34,83,64,1,2018
FRA-Ligue 1,2017,Toulouse,Steven Fortes,CPV,DF,25,1992,1.7,4,2,3,1,0,1,3,33.3,2,0,0,0,3,7,6,0,2018
FRA-Ligue 1,2017,Toulouse,Yann Bodiger,FRA,MF,22,1995,2.5,3,1,0,3,0,1,6,16.7,5,0,0,0,2,5,3,0,2018
FRA-Ligue 1,2017,Toulouse,Yannick Cahuzac,FRA,MF,32,1985,16.9,39,28,20,19,0,15,26,57.7,11,29,10,19,30,69,42,0,2018
FRA-Ligue 1,2017,Toulouse,Yaya Sanogo,FRA,FW,24,1993,16.8,11,6,1,5,5,3,11,27.3,8,6,1,5,6,17,14,1,2018
FRA-Ligue 1,2017,Toulouse,Zinédine Machach,FRA,"FW,MF",21,1996,2.1,7,3,5,1,1,4,5,80.0,1,1,0,1,2,9,2,0,2018
FRA-Ligue 1,2017,Troyes,Adama Niane,MLI,FW,24,1993,24.0,22,12,5,10,7,6,26,23.1,20,11,2,9,9,31,13,0,2018
FRA-Ligue 1,2017,Troyes,Alois Confais,FRA,"MF,DF",20,1996,6.8,8,6,7,1,0,3,9,33.3,6,7,4,3,4,12,15,1,2018
FRA-Ligue 1,2017,Troyes,Benjamin Nivet,FRA,"MF,FW",40,1977,15.2,31,14,12,14,5,11,51,21.6,40,18,1,17,16,47,20,0,2018
FRA-Ligue 1,2017,Troyes,Bryan Mbeumo,CMR,"FW,MF",17,1999,0.7,0,0,0,0,0,0,3,0.0,3,2,0,2,0,0,2,0,2018
FRA-Ligue 1,2017,Troyes,Bryan Pelé,FRA,"FW,MF",25,1992,17.9,20,9,9,8,3,4,28,14.3,24,11,0,11,15,35,13,0,2018
FRA-Ligue 1,2017,Troyes,Chaouki Ben Saada,TUN,"FW,MF",33,1984,3.8,11,8,5,3,3,2,11,18.2,9,3,0,3,2,13,3,0,2018
FRA-Ligue 1,2017,Troyes,Charles Traore,MLI,DF,25,1992,33.3,60,32,46,9,5,26,56,46.4,30,52,16,36,57,117,171,0,2018
FRA-Ligue 1,2017,Troyes,Christophe Hérelle,MTQ,DF,24,1992,32.9,39,26,27,12,0,16,30,53.3,14,38,27,11,56,95,241,1,2018
FRA-Ligue 1,2017,Troyes,Erwin Zelazny,FRA,GK,25,1991,17.0,1,1,1,0,0,1,2,50.0,1,0,0,0,2,3,10,1,2018
FRA-Ligue 1,2017,Troyes,François Bellugou,FRA,MF,30,1987,24.2,48,33,23,21,4,21,49,42.9,28,20,6,14,28,76,45,0,2018
FRA-Ligue 1,2017,Troyes,Gabriel Dos Santos,BRA,DF,19,1997,0.9,1,1,1,0,0,0,1,0.0,1,2,1,1,0,1,4,1,2018
FRA-Ligue 1,2017,Troyes,Jimmy Giraudon,FRA,DF,25,1992,23.2,26,16,20,6,0,10,16,62.5,6,30,22,8,31,57,128,2,2018
FRA-Ligue 1,2017,Troyes,Johann Obiang,GAB,DF,24,1993,5.2,13,9,9,2,2,6,13,46.2,7,9,1,8,7,20,15,0,2018
FRA-Ligue 1,2017,Troyes,Jonathan Tinhan,BEN,"MF,FW",28,1989,0.8,1,0,0,1,0,0,1,0.0,1,1,0,1,1,2,0,0,2018
FRA-Ligue 1,2017,Troyes,Jérémy Cordoval,GLP,DF,27,1990,10.2,20,16,12,7,1,9,14,64.3,5,12,2,10,9,29,35,0,2018
FRA-Ligue 1,2017,Troyes,Karim Azamoum,FRA,MF,27,1990,25.0,84,57,41,37,6,27,68,39.7,41,30,11,19,26,110,61,3,2018
FRA-Ligue 1,2017,Troyes,Mamadou Samassa,MLI,GK,27,1990,21.0,0,0,0,0,0,0,2,0.0,2,0,0,0,0,0,12,3,2018
FRA-Ligue 1,2017,Troyes,Mathieu Deplagne,FRA,DF,25,1991,26.8,52,38,33,14,5,20,48,41.7,28,26,10,16,60,112,95,2,2018
FRA-Ligue 1,2017,Troyes,Oswaldo Vizcarrondo,VEN,DF,33,1984,19.1,21,15,17,3,1,14,37,37.8,23,18,16,2,20,41,129,2,2018
FRA-Ligue 1,2017,Troyes,Rémi Walter,FRA,MF,22,1995,11.1,23,10,9,13,1,2,23,8.7,21,7,3,4,11,34,14,0,2018
FRA-Ligue 1,2017,Troyes,Samuel Grandsir,FRA,"FW,MF",20,1996,28.9,69,43,39,18,12,21,73,28.8,52,31,3,28,23,92,19,1,2018
FRA-Ligue 1,2017,Troyes,Saîf-Eddine Khaoui,TUN,"MF,FW",22,1995,21.7,57,25,22,27,8,15,50,30.0,35,12,2,10,27,84,9,0,2018
FRA-Ligue 1,2017,Troyes,Stéphane Darbion,FRA,"FW,MF",33,1984,19.0,19,14,13,4,2,5,40,12.5,35,21,2,19,20,39,17,0,2018
FRA-Ligue 1,2017,Troyes,Suk Hyun-jun,KOR,FW,26,1991,13.3,6,5,2,2,2,1,9,11.1,8,10,0,10,1,7,7,0,2018
FRA-Ligue 1,2017,Troyes,Tristan Dingomé,CMR,MF,26,1991,13.2,25,20,12,9,4,5,13,38.5,8,12,0,12,12,37,16,1,2018
FRA-Ligue 1,2018,Amiens,Alexis Blin,FRA,MF,21,1996,22.1,77,45,33,36,8,35,89,39.3,54,39,14,25,33,110,48,1,2019
FRA-Ligue 1,2018,Amiens,Bakaye Dibassy,MLI,DF,28,1989,32.7,38,26,18,16,4,18,27,66.7,9,40,21,19,44,82,102,0,2019
FRA-Ligue 1,2018,Amiens,Bongani Zungu,RSA,MF,25,1992,2.6,3,2,0,1,2,2,8,25.0,6,0,0,0,2,5,5,0,2019
FRA-Ligue 1,2018,Amiens,Cheick Timite,CIV,"FW,MF",20,1997,16.2,18,13,5,7,6,3,16,18.8,13,14,2,12,12,30,13,0,2019
FRA-Ligue 1,2018,Amiens,Eddy Gnahoré,FRA,MF,24,1993,24.9,39,27,17,17,5,9,39,23.1,30,29,4,25,23,62,23,1,2019
FRA-Ligue 1,2018,Amiens,Emil Krafth,SWE,DF,23,1994,33.0,55,35,34,14,7,32,65,49.2,33,27,12,15,23,78,94,4,2019
FRA-Ligue 1,2018,Amiens,Erik Pieters,NED,DF,29,1988,14.0,49,28,28,18,3,25,33,75.8,8,21,13,8,17,66,56,0,2019
FRA-Ligue 1,2018,Amiens,Ganso,BRA,"MF,FW",28,1989,5.8,12,8,2,8,2,2,15,13.3,13,5,1,4,6,18,0,0,2019
FRA-Ligue 1,2018,Amiens,Gaoussou Traoré,MLI,MF,18,1999,1.2,10,5,6,4,0,4,8,50.0,4,1,0,1,0,10,0,0,2019
FRA-Ligue 1,2018,Amiens,Guessouma Fofana,MTN,MF,25,1992,2.1,6,4,3,3,0,1,3,33.3,2,2,1,1,3,9,0,0,2019
FRA-Ligue 1,2018,Amiens,Jordan Lefort,FRA,DF,24,1993,20.0,33,18,23,6,4,16,25,64.0,9,11,8,3,46,79,107,0,2019
FRA-Ligue 1,2018,Amiens,Juan Ferney Otero,COL,"FW,MF",23,1995,24.2,29,13,11,12,6,13,46,28.3,33,23,3,20,22,51,18,0,2019
FRA-Ligue 1,2018,Amiens,Khaled Adénon,BEN,DF,33,1985,22.2,31,22,20,11,0,16,28,57.1,12,26,11,15,31,62,101,0,2019
FRA-Ligue 1,2018,Amiens,Mathieu Bodmer,FRA,"MF,FW",35,1982,11.9,15,11,3,11,1,3,10,30.0,7,3,0,3,2,17,10,0,2019
FRA-Ligue 1,2018,Amiens,Moussa Konaté,SEN,FW,25,1993,20.8,10,8,3,3,4,2,12,16.7,10,14,3,11,5,15,15,0,2019
FRA-Ligue 1,2018,Amiens,Oualid El Hajjam,MAR,"DF,MF",27,1991,6.0,14,9,10,3,1,5,15,33.3,10,8,2,6,12,26,26,0,2019
FRA-Ligue 1,2018,Amiens,Prince-Désir Gouano,FRA,DF,24,1993,29.1,31,18,25,5,1,12,22,54.5,10,36,27,9,46,77,127,6,2019
FRA-Ligue 1,2018,Amiens,Quentin Cornette,FRA,"FW,MF",24,1994,2.3,5,1,2,2,1,3,6,50.0,3,3,0,3,1,6,5,0,2019
FRA-Ligue 1,2018,Amiens,Rafał Kurzawa,POL,FW,25,1993,2.7,8,3,6,2,0,2,6,33.3,4,1,0,1,3,11,3,0,2019
FRA-Ligue 1,2018,Amiens,Régis Gurtner,FRA,GK,31,1986,38.0,1,1,1,0,0,0,1,0.0,1,0,0,0,1,2,7,3,2019
FRA-Ligue 1,2018,Amiens,Saman Ghoddos,IRN,"FW,MF",24,1993,20.3,33,17,14,15,4,13,32,40.6,19,15,2,13,7,40,13,0,2019
FRA-Ligue 1,2018,Amiens,Sanasi Sy,FRA,MF,19,1999,0.0,0,0,0,0,0,0,0,,0,0,0,0,0,0,0,0,2019
FRA-Ligue 1,2018,Amiens,Sehrou Guirassy,GUI,FW,22,1996,12.3,7,5,1,5,1,0,4,0.0,4,7,0,7,4,11,14,0,2019
FRA-Ligue 1,2018,Amiens,Stanley Segarel,FRA,FW,24,1994,0.2,0,0,0,0,0,0,0,,0,0,0,0,0,0,0,0,2019
FRA-Ligue 1,2018,Amiens,Stiven Mendoza,COL,"FW,MF",26,1992,20.9,29,18,10,12,7,14,38,36.8,24,18,0,18,17,46,12,0,2019
FRA-Ligue 1,2018,Amiens,Thomas Monconduit,FRA,MF,27,1991,31.3,76,47,38,33,5,26,63,41.3,37,46,17,29,36,112,77,1,2019
FRA-Ligue 1,2018,Angers,Abdoulaye Bamba,CIV,DF,28,1990,28.6,51,29,31,14,6,24,44,54.5,20,20,4,16,37,88,86,0,2019
FRA-Ligue 1,2018,Angers,Angelo Fulgini,FRA,"MF,FW",21,1996,18.2,38,22,18,13,7,12,31,38.7,19,21,3,18,28,66,15,0,2019
FRA-Ligue 1,2018,Angers,Baptiste Santamaria,FRA,MF,23,1995,36.1,118,60,48,63,7,51,106,48.1,55,41,4,37,57,175,57,2,2019
FRA-Ligue 1,2018,Angers,Cheikh N'Doye,SEN,MF,32,1986,25.9,25,15,14,11,0,10,32,31.3,22,33,8,25,25,50,61,0,2019
FRA-Ligue 1,2018,Angers,Cristian López,ESP,FW,29,1989,4.1,6,3,1,2,3,1,8,12.5,7,4,0,4,1,7,2,0,2019
FRA-Ligue 1,2018,Angers,Elhadji Pape Diaw,SEN,DF,23,1994,0.2,0,0,0,0,0,0,0,,0,0,0,0,1,1,0,0,2019
FRA-Ligue 1,2018,Angers,Farid El Melali,ALG,"MF,FW",21,1997,3.6,8,4,3,4,1,3,12,25.0,9,2,0,2,5,13,1,0,2019
FRA-Ligue 1,2018,Angers,Flavien Tait,FRA,"MF,FW",25,1993,33.2,58,35,33,16,9,23,59,39.0,36,29,2,27,28,86,15,0,2019
FRA-Ligue 1,2018,Angers,Harrison Manzala,COD,"MF,FW",24,1994,0.8,2,2,1,0,1,0,0,,0,0,0,0,0,2,1,0,2019
FRA-Ligue 1,2018,Angers,Ismaël Traoré,CIV,DF,31,1986,29.3,27,11,19,8,0,9,24,37.5,15,27,16,11,42,69,120,2,2019
FRA-Ligue 1,2018,Angers,Jeff Reine-Adélaïde,FRA,"FW,MF",20,1998,28.4,40,22,18,19,3,17,40,42.5,23,20,0,20,19,59,10,0,2019
FRA-Ligue 1,2018,Angers,Ludovic Butelle,FRA,GK,35,1983,36.0,1,0,1,0,0,1,1,100.0,0,0,0,0,1,2,31,1,2019
FRA-Ligue 1,2018,Angers,Mateo Pavlović,BIH,DF,28,1990,27.7,26,18,24,2,0,12,24,50.0,12,37,29,8,20,46,164,2,2019
FRA-Ligue 1,2018,Angers,Pierrick Capelle,FRA,"DF,MF",31,1987,20.5,51,31,23,22,6,19,54,35.2,35,23,2,21,38,89,49,0,2019
FRA-Ligue 1,2018,Angers,Rayan Aït Nouri,ALG,"DF,MF",17,2001,0.6,2,2,1,1,0,0,1,0.0,1,0,0,0,0,2,1,0,2019
FRA-Ligue 1,2018,Angers,Romain Thomas,FRA,DF,30,1988,26.6,35,26,25,10,0,14,19,73.7,5,31,24,7,29,64,133,1,2019
FRA-Ligue 1,2018,Angers,Stéphane Bahoken,CMR,FW,26,1992,27.4,15,7,0,10,5,3,21,14.3,18,35,3,32,8,23,5,0,2019
FRA-Ligue 1,2018,Angers,Thomas Mangani,FRA,MF,31,1987,17.8,42,27,13,26,3,19,62,30.6,43,13,2,11,23,65,24,0,2019
FRA-Ligue 1,2018,Angers,Théo Pellenard,FRA,DF,24,1994,5.5,11,6,7,2,2,5,8,62.5,3,6,2,4,5,16,16,0,2019
FRA-Ligue 1,2018,Angers,Vincent Manceau,FRA,DF,29,1989,31.0,98,65,64,23,11,33,62,53.2,29,41,10,31,44,142,87,0,2019
FRA-Ligue 1,2018,Angers,Vincent Pajot,FRA,MF,27,1990,7.9,18,14,6,8,4,4,14,28.6,10,9,0,9,8,26,6,0,2019
FRA-Ligue 1,2018,Angers,Wilfried Kanga,CIV,FW,20,1998,5.5,0,0,0,0,0,0,1,0.0,1,3,0,3,0,0,4,0,2019
FRA-Ligue 1,2018,Angers,Yoann Andreu,FRA,DF,29,1989,0.0,1,0,1,0,0,0,1,0.0,1,0,0,0,1,2,0,0,2019
FRA-Ligue 1,2018,Angers,Zacharie Boucher,FRA,GK,26,1992,2.0,0,0,0,0,0,0,0,,0,1,0,1,0,0,1,0,2019
FRA-Ligue 1,2018,Bordeaux,Albert Lottin,FRA,"MF,FW",16,2001,0.2,1,1,0,1,0,0,1,0.0,1,1,0,1,0,1,0,0,2019
FRA-Ligue 1,2018,Bordeaux,Alexandre Lauray,FRA,DF,21,1997,2.9,11,6,9,2,0,6,8,75.0,2,2,0,2,4,15,10,0,2019
FRA-Ligue 1,2018,Bordeaux,Andreas Cornelius,DEN,FW,25,1993,8.8,4,1,1,3,0,1,4,25.0,3,4,1,3,1,5,21,0,2019
FRA-Ligue 1,2018,Bordeaux,Aurélien Tchouaméni,FRA,MF,18,2000,7.8,24,12,10,14,0,7,18,38.9,11,11,5,6,21,45,14,0,2019
FRA-Ligue 1,2018,Bordeaux,Benoît Costil,FRA,GK,31,1987,37.0,2,0,2,0,0,2,2,100.0,0,0,0,0,0,2,14,3,2019
FRA-Ligue 1,2018,Bordeaux,Driss Trichard,FRA,DF,23,1995,1.0,2,2,2,0,0,1,1,100.0,0,1,0,1,1,3,4,0,2019
FRA-Ligue 1,2018,Bordeaux,François Kamano,GUI,"FW,MF",22,1996,28.5,29,18,6,17,6,11,30,36.7,19,27,0,27,17,46,6,1,2019
FRA-Ligue 1,2018,Bordeaux,Gaëtan Laborde,FRA,FW,24,1994,1.0,4,3,0,1,3,2,4,50.0,2,0,0,0,0,4,0,0,2019
FRA-Ligue 1,2018,Bordeaux,Gaëtan Poussin,FRA,GK,19,1999,1.0,0,0,0,0,0,0,0,,0,0,0,0,0,0,0,0,2019
FRA-Ligue 1,2018,Bordeaux,Igor Lewczuk,POL,DF,33,1985,5.0,12,7,8,2,2,1,4,25.0,3,2,2,0,4,16,27,0,2019
FRA-Ligue 1,2018,Bordeaux,Jaroslav Plašil,CZE,MF,36,1982,16.0,34,26,11,20,3,18,44,40.9,26,21,5,16,19,53,28,1,2019
FRA-Ligue 1,2018,Bordeaux,Jimmy Briand,FRA,FW,32,1985,27.7,14,8,2,10,2,4,24,16.7,20,14,6,8,4,18,29,0,2019
FRA-Ligue 1,2018,Bordeaux,Josh Maja,NGA,FW,19,1998,2.2,2,1,1,1,0,0,1,0.0,1,1,0,1,0,2,0,0,2019
FRA-Ligue 1,2018,Bordeaux,Jules Koundé,FRA,DF,19,1998,37.0,48,31,37,11,0,27,41,65.9,14,44,23,21,50,98,193,7,2019
FRA-Ligue 1,2018,Bordeaux,Lukas Lerager,DEN,MF,25,1993,14.4,38,21,14,23,1,18,43,41.9,25,22,10,12,32,70,26,1,2019
FRA-Ligue 1,2018,Bordeaux,Maxime Poundjé,FRA,DF,25,1992,28.2,48,35,34,12,2,31,62,50.0,31,24,5,19,29,77,79,0,2019
FRA-Ligue 1,2018,Bordeaux,Milan Gajić,SRB,DF,22,1996,1.0,2,1,1,0,1,1,1,100.0,0,0,0,0,1,3,7,0,2019
FRA-Ligue 1,2018,Bordeaux,Nicolas de Préville,FRA,"FW,MF",27,1991,14.1,28,19,10,15,3,8,29,27.6,21,23,1,22,10,38,21,1,2019
FRA-Ligue 1,2018,Bordeaux,Otávio,BRA,MF,24,1994,31.9,127,74,59,64,4,49,109,45.0,60,45,11,34,43,170,54,1,2019
FRA-Ligue 1,2018,Bordeaux,Pablo,BRA,DF,27,1991,21.5,26,15,22,3,1,13,23,56.5,10,28,22,6,32,58,173,2,2019
FRA-Ligue 1,2018,Bordeaux,Paul Baysse,FRA,DF,30,1988,0.8,1,0,1,0,0,0,1,0.0,1,1,1,0,1,2,6,0,2019
FRA-Ligue 1,2018,Bordeaux,Samuel Kalu,NGA,FW,20,1997,14.2,27,18,15,7,5,4,11,36.4,7,11,3,8,8,35,4,1,2019
FRA-Ligue 1,2018,Bordeaux,Sergi Palencia,ESP,DF,22,1996,22.1,74,50,46,20,8,27,55,49.1,28,22,3,19,17,91,70,1,2019
FRA-Ligue 1,2018,Bordeaux,Till Cissokho,FRA,DF,18,2000,0.9,1,0,1,0,0,0,0,,0,0,0,0,2,3,3,0,2019
FRA-Ligue 1,2018,Bordeaux,Toma Bašić,CRO,MF,21,1996,14.8,32,16,5,21,6,11,31,35.5,20,13,1,12,9,41,22,1,2019
FRA-Ligue 1,2018,Bordeaux,Valentín Vada,ARG,MF,22,1996,0.4,2,1,0,2,0,1,1,100.0,0,0,0,0,0,2,0,0,2019
FRA-Ligue 1,2018,Bordeaux,Vukašin Jovanović,SRB,DF,22,1996,15.3,26,21,21,5,0,13,19,68.4,6,23,12,11,36,62,105,0,2019
FRA-Ligue 1,2018,Bordeaux,Yacine Adli,FRA,MF,18,2000,2.4,7,2,2,3,2,3,9,33.3,6,3,0,3,2,9,0,0,2019
FRA-Ligue 1,2018,Bordeaux,Yann Karamoh,FRA,FW,20,1998,13.6,7,3,1,4,2,1,13,7.7,12,9,0,9,6,13,3,0,2019
FRA-Ligue 1,2018,Bordeaux,Yassine Benrahou,FRA,"MF,FW",19,1999,2.0,9,6,1,7,1,2,5,40.0,3,4,0,4,2,11,1,0,2019
FRA-Ligue 1,2018,Bordeaux,Younousse Sankharé,SEN,MF,28,1989,16.4,25,12,2,19,4,6,19,31.6,13,14,0,14,9,34,4,0,2019
FRA-Ligue 1,2018,Bordeaux,Youssouf Sabaly,SEN,DF,25,1993,21.2,46,32,32,12,2,25,46,54.3,21,19,2,17,26,72,42,0,2019
FRA-Ligue 1,2018,Bordeaux,Zaydou Youssouf,FRA,"MF,FW",19,1999,4.7,7,5,3,4,0,3,7,42.9,4,5,1,4,5,12,0,0,2019
FRA-Ligue 1,2018,Caen,Adama Mbengue,SEN,DF,24,1993,8.2,48,32,34,12,2,19,26,73.1,7,15,4,11,7,55,22,0,2019
FRA-Ligue 1,2018,Caen,Alexander Djiku,GHA,DF,23,1994,30.6,48,37,33,13,2,23,43,53.5,20,56,31,25,83,131,183,3,2019
FRA-Ligue 1,2018,Caen,Aly Ndom,FRA,MF,22,1996,0.5,0,0,0,0,0,0,0,,0,0,0,0,1,1,1,0,2019
FRA-Ligue 1,2018,Caen,Baissama Sankoh,GUI,"MF,FW",26,1992,7.2,4,1,4,0,0,1,4,25.0,3,8,1,7,5,9,16,0,2019
FRA-Ligue 1,2018,Caen,Brice Samba,FRA,GK,24,1994,38.0,1,0,1,0,0,0,1,0.0,1,0,0,0,1,2,12,4,2019
FRA-Ligue 1,2018,Caen,Casimir Ninga,CHA,"FW,MF",25,1993,27.4,53,30,23,21,9,20,49,40.8,29,22,1,21,22,75,12,0,2019
FRA-Ligue 1,2018,Caen,Claudio Beauvue,GLP,"FW,MF",30,1988,16.7,18,11,7,9,2,1,14,7.1,13,11,2,9,10,28,21,0,2019
FRA-Ligue 1,2018,Caen,Emmanuel Imorou,BEN,DF,29,1988,12.4,18,13,10,7,1,11,17,64.7,6,14,4,10,28,46,49,1,2019
FRA-Ligue 1,2018,Caen,Enzo Crivelli,FRA,FW,23,1995,25.1,20,14,10,8,2,8,13,61.5,5,5,0,5,4,24,28,1,2019
FRA-Ligue 1,2018,Caen,Evens Joseph,FRA,"MF,FW",19,1999,3.8,5,2,1,2,2,1,3,33.3,2,3,0,3,2,7,1,0,2019
FRA-Ligue 1,2018,Caen,Fayçal Fajr,MAR,MF,29,1988,36.0,65,32,22,33,10,25,66,37.9,41,27,6,21,29,94,19,2,2019
FRA-Ligue 1,2018,Caen,Frederic Guilbert,FRA,DF,23,1994,32.4,98,67,59,29,10,41,83,49.4,42,49,21,28,78,176,121,2,2019
FRA-Ligue 1,2018,Caen,Herman Moussaki,FRA,"MF,FW",19,1999,2.3,3,3,2,1,0,1,4,25.0,3,2,1,1,0,3,3,0,2019
FRA-Ligue 1,2018,Caen,Ismaël Diomandé,CIV,"MF,DF",25,1992,14.4,28,15,15,12,1,11,20,55.0,9,17,7,10,10,38,37,0,2019
FRA-Ligue 1,2018,Caen,Jessy Deminguet,FRA,MF,20,1998,14.1,37,25,18,17,2,15,40,37.5,25,19,3,16,18,55,28,1,2019
FRA-Ligue 1,2018,Caen,Jonathan Gradit,FRA,DF,25,1992,22.3,52,28,30,21,1,28,52,53.8,24,40,15,25,45,97,82,3,2019
FRA-Ligue 1,2018,Caen,Malik Tchokounté,FRA,"FW,MF",29,1988,16.4,21,13,6,12,3,5,10,50.0,5,11,0,11,6,27,26,0,2019
FRA-Ligue 1,2018,Caen,Paul Baysse,FRA,DF,30,1988,19.9,25,14,20,5,0,13,18,72.2,5,25,20,5,31,56,113,1,2019
FRA-Ligue 1,2018,Caen,Prince Oniangué,CGO,MF,29,1988,26.0,59,33,22,34,3,24,57,42.1,33,30,10,20,29,88,42,0,2019
FRA-Ligue 1,2018,Caen,Romain Genevois,HAI,DF,30,1987,4.0,10,6,9,1,0,6,11,54.5,5,3,0,3,8,18,13,0,2019
FRA-Ligue 1,2018,Caen,Saîf-Eddine Khaoui,TUN,"MF,FW",23,1995,15.0,20,14,5,11,4,8,27,29.6,19,9,1,8,20,40,4,0,2019
FRA-Ligue 1,2018,Caen,Stef Peeters,BEL,MF,26,1992,4.5,15,8,8,4,3,4,11,36.4,7,1,0,1,6,21,1,0,2019
FRA-Ligue 1,2018,Caen,Timo Stavitski,FIN,"MF,FW",19,1999,0.2,0,0,0,0,0,0,1,0.0,1,0,0,0,0,0,0,0,2019
FRA-Ligue 1,2018,Caen,Yacine Bammou,MAR,"FW,MF",26,1991,10.3,14,7,7,4,3,3,8,37.5,5,14,3,11,9,23,17,0,2019
FRA-Ligue 1,2018,Caen,Younn Zahary,COM,DF,19,1998,8.2,16,9,7,6,3,8,14,57.1,6,13,8,5,16,32,35,0,2019
FRA-Ligue 1,2018,Caen,Yoël Armougom,FRA,DF,20,1998,20.6,31,21,20,9,2,15,29,51.7,14,9,3,6,21,52,66,0,2019
FRA-Ligue 1,2018,Dijon,Arnold Bouka Moutou,CGO,"DF,FW",29,1988,0.7,3,1,2,1,0,0,4,0.0,4,1,0,1,3,6,1,0,2019
FRA-Ligue 1,2018,Dijon,Benjamin Jeannot,FRA,"FW,MF",26,1992,16.0,17,12,5,7,5,6,19,31.6,13,15,3,12,12,29,14,0,2019
FRA-Ligue 1,2018,Dijon,Bobby Allain,FRA,GK,26,1991,13.0,0,0,0,0,0,0,1,0.0,1,1,0,1,0,0,16,1,2019
FRA-Ligue 1,2018,Dijon,Cédric Yamberé,CTA,DF,27,1990,31.2,47,31,36,11,0,21,39,53.8,18,45,32,13,52,99,136,4,2019
FRA-Ligue 1,2018,Dijon,Enzo Loiodice,FRA,MF,17,2000,9.4,25,14,8,15,2,10,21,47.6,11,7,0,7,11,36,7,0,2019
FRA-Ligue 1,2018,Dijon,Florent Balmont,FRA,MF,38,1980,12.0,29,16,16,10,3,9,36,25.0,27,13,2,11,6,35,8,0,2019
FRA-Ligue 1,2018,Dijon,Fouad Chafik,MAR,DF,31,1986,20.5,44,31,29,12,3,23,36,63.9,13,17,3,14,25,69,71,0,2019
FRA-Ligue 1,2018,Dijon,Frédéric Sammaritano,FRA,"FW,MF",32,1986,6.0,11,5,5,5,1,5,13,38.5,8,8,1,7,8,19,2,1,2019
FRA-Ligue 1,2018,Dijon,Jordan Marié,FRA,MF,26,1991,20.0,52,28,15,31,6,21,58,36.2,37,28,5,23,40,92,32,0,2019
FRA-Ligue 1,2018,Dijon,Jules Keita,GUI,"FW,MF",20,1998,5.1,10,4,0,3,7,5,12,41.7,7,2,0,2,2,12,1,0,2019
FRA-Ligue 1,2018,Dijon,Júlio Tavares,CPV,FW,29,1988,31.2,15,9,1,7,7,3,9,33.3,6,17,3,14,13,28,51,0,2019
FRA-Ligue 1,2018,Dijon,Kwon Chang-hoon,KOR,"FW,MF",24,1994,10.4,7,4,3,2,2,0,12,0.0,12,16,0,16,8,15,8,0,2019
FRA-Ligue 1,2018,Dijon,Laurent Ciman,BEL,DF,32,1985,8.0,11,6,9,2,0,7,16,43.8,9,13,9,4,7,18,37,0,2019
FRA-Ligue 1,2018,Dijon,Mehdi Abeid,ALG,MF,25,1992,22.5,51,33,27,16,8,15,45,33.3,30,33,7,26,29,80,23,1,2019
FRA-Ligue 1,2018,Dijon,Mickaël Alphonse,GLP,DF,29,1989,6.3,10,5,6,1,3,3,4,75.0,1,3,1,2,9,19,30,0,2019
FRA-Ligue 1,2018,Dijon,Nayef Aguerd,MAR,DF,22,1996,11.7,17,12,8,9,0,8,19,42.1,11,20,11,9,14,31,59,1,2019
FRA-Ligue 1,2018,Dijon,Naïm Sliti,TUN,"MF,FW",26,1992,25.4,56,33,24,19,13,15,46,32.6,31,18,0,18,11,67,9,0,2019
FRA-Ligue 1,2018,Dijon,Oussama Haddadi,TUN,DF,26,1992,29.7,51,25,38,11,2,24,43,55.8,19,33,8,25,45,96,93,2,2019
FRA-Ligue 1,2018,Dijon,Romain Amalfitano,FRA,"MF,FW",28,1989,28.0,52,33,20,28,4,25,67,37.3,42,45,13,32,47,99,35,0,2019
FRA-Ligue 1,2018,Dijon,Rúnar Alex Rúnarsson,ISL,GK,23,1995,25.0,2,0,2,0,0,2,6,33.3,4,0,0,0,1,3,7,2,2019
FRA-Ligue 1,2018,Dijon,Senou Coulibaly,MLI,DF,23,1994,4.6,13,7,10,3,0,3,8,37.5,5,8,2,6,11,24,20,0,2019
FRA-Ligue 1,2018,Dijon,Sory Kaba,GUI,"FW,MF",23,1995,2.6,1,1,1,0,0,1,3,33.3,2,2,0,2,0,1,1,0,2019
FRA-Ligue 1,2018,Dijon,Valentin Rosier,FRA,"DF,MF",21,1996,16.2,44,25,22,19,3,16,31,51.6,15,25,4,21,32,76,45,1,2019
FRA-Ligue 1,2018,Dijon,Wesley Lautoa,NCL,"DF,MF",30,1987,33.6,81,55,46,31,4,34,75,45.3,41,37,14,23,87,168,110,1,2019
FRA-Ligue 1,2018,Dijon,Wesley Saïd,FRA,"FW,MF",23,1995,25.0,25,18,6,11,8,5,20,25.0,15,9,0,9,9,34,9,0,2019
FRA-Ligue 1,2018,Dijon,Yoann Gourcuff,FRA,"MF,FW",32,1986,1.5,0,0,0,0,0,0,2,0.0,2,1,1,0,0,0,1,0,2019
FRA-Ligue 1,2018,Guingamp,Alexandre Mendy,GNB,FW,24,1994,8.5,5,3,0,4,1,3,8,37.5,5,3,0,3,1,6,6,0,2019
FRA-Ligue 1,2018,Guingamp,Cheick Traoré,MLI,DF,23,1995,16.8,37,21,23,11,3,15,25,60.0,10,13,3,10,23,60,46,1,2019
FRA-Ligue 1,2018,Guingamp,Christophe Kerbrat,FRA,DF,31,1986,23.3,40,24,28,12,0,24,38,63.2,14,19,10,9,50,90,140,5,2019
FRA-Ligue 1,2018,Guingamp,Didier Ibrahim Ndong,GAB,MF,24,1994,8.3,16,11,3,13,0,5,13,38.5,8,15,3,12,15,31,6,1,2019
FRA-Ligue 1,2018,Guingamp,Djégui Koita,FRA,DF,18,1999,1.9,8,6,8,0,0,3,4,75.0,1,5,3,2,0,8,9,0,2019
FRA-Ligue 1,2018,Guingamp,Franck Tabanou,FRA,DF,29,1989,2.0,4,3,4,0,0,1,2,50.0,1,0,0,0,6,10,15,0,2019
FRA-Ligue 1,2018,Guingamp,Félix Eboa Eboa,CMR,DF,21,1997,27.0,47,33,26,20,1,16,22,72.7,6,37,24,13,39,86,136,2,2019
FRA-Ligue 1,2018,Guingamp,Guessouma Fofana,MTN,MF,25,1992,5.3,14,9,2,10,2,4,10,40.0,6,3,0,3,6,20,8,0,2019
FRA-Ligue 1,2018,Guingamp,Johan Larsson,SWE,DF,28,1990,1.0,1,1,0,1,0,1,2,50.0,1,0,0,0,1,2,1,1,2019
FRA-Ligue 1,2018,Guingamp,Jordan Ikoko,COD,DF,24,1994,19.0,37,24,22,14,1,16,28,57.1,12,18,5,13,24,61,30,0,2019
FRA-Ligue 1,2018,Guingamp,Jérémy Sorbon,FRA,DF,34,1983,29.4,33,20,23,10,0,14,22,63.6,8,33,23,10,34,67,105,2,2019
FRA-Ligue 1,2018,Guingamp,Karl-Johan Johnsson,SWE,GK,28,1990,17.0,0,0,0,0,0,0,1,0.0,1,0,0,0,0,0,4,1,2019
FRA-Ligue 1,2018,Guingamp,Lebogang Phiri,RSA,MF,23,1994,21.4,60,38,16,41,3,24,43,55.8,19,26,3,23,29,89,19,0,2019
FRA-Ligue 1,2018,Guingamp,Louis Carnot,FRA,MF,17,2001,0.1,0,0,0,0,0,0,0,,0,0,0,0,0,0,0,0,2019
FRA-Ligue 1,2018,Guingamp,Lucas Deaux,FRA,MF,29,1988,13.2,41,28,21,18,2,20,41,48.8,21,10,0,10,11,52,7,0,2019
FRA-Ligue 1,2018,Guingamp,Ludovic Blas,FRA,"MF,FW",20,1997,26.4,62,38,22,32,8,20,43,46.5,23,44,7,37,26,88,14,0,2019
FRA-Ligue 1,2018,Guingamp,Marc-Aurèle Caillard,FRA,GK,24,1994,21.0,0,0,0,0,0,0,2,0.0,2,0,0,0,2,2,8,3,2019
FRA-Ligue 1,2018,Guingamp,Marcus Coco,FRA,"FW,MF",22,1996,20.4,39,23,20,10,9,16,33,48.5,17,24,0,24,23,62,14,0,2019
FRA-Ligue 1,2018,Guingamp,Marcus Thuram,FRA,"FW,MF",20,1997,28.6,45,28,23,15,7,20,43,46.5,23,24,1,23,10,55,14,0,2019
FRA-Ligue 1,2018,Guingamp,Matthias Phaeton,GLP,"FW,MF",18,2000,0.6,1,1,0,1,0,0,0,,0,0,0,0,0,1,0,0,2019
FRA-Ligue 1,2018,Guingamp,Mehdi Merghem,FRA,"FW,MF",21,1997,8.0,25,18,15,7,3,11,21,52.4,10,14,1,13,9,34,6,0,2019
FRA-Ligue 1,2018,Guingamp,Nathaël Julan,FRA,"FW,MF",22,1996,4.8,1,0,0,0,1,0,3,0.0,3,6,1,5,0,1,2,0,2019
FRA-Ligue 1,2018,Guingamp,Nicolas Benezet,FRA,"MF,FW",27,1991,18.5,32,19,14,15,3,5,19,26.3,14,12,0,12,19,51,4,0,2019
FRA-Ligue 1,2018,Guingamp,Nolan Roux,FRA,FW,30,1988,17.1,11,9,0,6,5,4,14,28.6,10,6,2,4,4,15,21,0,2019
FRA-Ligue 1,2018,Guingamp,Papy Djilobodji,SEN,DF,29,1988,1.9,1,1,1,0,0,0,0,,0,4,2,2,0,1,11,0,2019
FRA-Ligue 1,2018,Guingamp,Pedro Rebocho,POR,DF,23,1995,36.0,61,35,31,22,8,29,54,53.7,25,48,13,35,40,101,92,1,2019
FRA-Ligue 1,2018,Guingamp,Ronny Rodelin,FRA,"MF,FW",28,1989,8.8,13,5,2,7,4,3,8,37.5,5,8,1,7,8,21,13,0,2019
FRA-Ligue 1,2018,Guingamp,Yannis Salibur,FRA,MF,27,1991,0.2,0,0,0,0,0,0,0,,0,0,0,0,0,0,0,0,2019
FRA-Ligue 1,2018,Guingamp,Yeni Ngbakoto,COD,"MF,FW",26,1992,6.3,9,4,4,3,2,4,8,50.0,4,7,0,7,4,13,2,0,2019
FRA-Ligue 1,2018,Guingamp,Étienne Didot,FRA,MF,35,1983,23.4,41,29,12,27,2,17,44,38.6,27,37,10,27,37,78,35,0,2019
FRA-Ligue 1,2018,Lille,Adama Soumaoro,FRA,DF,26,1992,19.1,14,11,12,2,0,4,6,66.7,2,21,18,3,21,35,92,1,2019
FRA-Ligue 1,2018,Lille,Arton Zekaj,KVX,FW,18,2000,0.0,0,0,0,0,0,0,0,,0,0,0,0,0,0,0,0,2019
FRA-Ligue 1,2018,Lille,Boubakary Soumaré,FRA,MF,19,1999,6.3,20,15,9,11,0,10,18,55.6,8,9,3,6,7,27,5,0,2019
FRA-Ligue 1,2018,Lille,Edgar Ié,GNB,DF,24,1994,2.7,5,4,3,2,0,3,5,60.0,2,2,1,1,7,12,17,0,2019
FRA-Ligue 1,2018,Lille,Fodé Ballo-Touré,SEN,DF,21,1997,17.7,47,35,26,19,2,21,32,65.6,11,25,7,18,27,74,42,2,2019
FRA-Ligue 1,2018,Lille,Gabriel Dos Santos,BRA,DF,20,1997,11.8,18,11,13,4,1,4,7,57.1,3,14,6,8,19,37,60,2,2019
FRA-Ligue 1,2018,Lille,Jonathan Bamba,CIV,"FW,MF",22,1996,33.4,29,19,7,17,5,13,39,33.3,26,24,1,23,41,70,18,0,2019
FRA-Ligue 1,2018,Lille,Jonathan Ikone,FRA,"MF,FW",20,1998,31.1,25,14,7,12,6,8,30,26.7,22,24,2,22,6,31,4,0,2019
FRA-Ligue 1,2018,Lille,José Fonte,POR,DF,34,1983,34.6,27,15,15,9,3,17,24,70.8,7,33,26,7,37,64,153,1,2019
FRA-Ligue 1,2018,Lille,Jérémy Pied,FRA,DF,29,1989,5.2,12,8,5,6,1,3,9,33.3,6,8,1,7,5,17,13,0,2019
FRA-Ligue 1,2018,Lille,Kouadio-Yves Dabila,CIV,DF,21,1997,8.7,11,6,10,1,0,5,6,83.3,1,13,9,4,6,17,44,0,2019
FRA-Ligue 1,2018,Lille,Lebo Mothiba,RSA,FW,22,1996,2.8,1,1,0,1,0,0,0,,0,0,0,0,0,1,8,0,2019
FRA-Ligue 1,2018,Lille,Loïc Rémy,FRA,FW,31,1987,13.4,2,1,0,2,0,0,3,0.0,3,3,1,2,2,4,17,1,2019
FRA-Ligue 1,2018,Lille,Luiz Araújo,BRA,"FW,MF",22,1996,8.7,23,17,8,9,6,9,24,37.5,15,6,1,5,3,26,4,0,2019
FRA-Ligue 1,2018,Lille,Mike Maignan,FRA,GK,23,1995,38.0,0,0,0,0,0,0,0,,0,1,0,1,0,0,12,1,2019
FRA-Ligue 1,2018,Lille,Nicolas Pépé,CIV,"FW,MF",23,1995,36.9,27,10,6,15,6,8,35,22.9,27,33,0,33,13,40,11,1,2019
FRA-Ligue 1,2018,Lille,Rafael Leão,POR,FW,19,1999,14.3,5,2,0,4,1,2,15,13.3,13,13,4,9,4,9,12,0,2019
FRA-Ligue 1,2018,Lille,Reinildo Mandava,MOZ,DF,24,1994,1.1,3,2,1,2,0,2,3,66.7,1,1,0,1,1,4,0,0,2019
FRA-Ligue 1,2018,Lille,Rui Fonte,POR,"FW,MF",28,1990,7.0,25,12,4,16,5,6,11,54.5,5,4,0,4,2,27,8,0,2019
FRA-Ligue 1,2018,Lille,Thiago Maia,BRA,MF,21,1997,11.3,32,19,17,13,2,13,33,39.4,20,14,5,9,23,55,23,0,2019
FRA-Ligue 1,2018,Lille,Thiago Mendes,BRA,MF,26,1992,34.2,85,47,42,41,2,39,71,54.9,32,44,11,33,68,153,49,0,2019
FRA-Ligue 1,2018,Lille,Xeka,POR,MF,23,1994,25.1,59,31,25,27,7,18,57,31.6,39,20,2,18,21,80,30,4,2019
FRA-Ligue 1,2018,Lille,Yassine Benzia,ALG,MF,23,1994,1.8,1,1,0,1,0,1,1,100.0,0,0,0,0,1,2,1,0,2019
FRA-Ligue 1,2018,Lille,Youssouf Koné,MLI,DF,23,1995,19.0,67,38,45,19,3,41,65,63.1,24,31,3,28,39,106,52,1,2019
FRA-Ligue 1,2018,Lille,Zeki Çelik,TUR,DF,21,1997,33.0,90,59,40,39,11,36,89,40.4,53,34,5,29,34,124,89,1,2019
FRA-Ligue 1,2018,Lyon,Anthony Lopes,POR,GK,27,1990,34.0,1,0,1,0,0,1,3,33.3,2,3,0,3,2,3,16,3,2019
FRA-Ligue 1,2018,Lyon,Bertrand Traoré,BFA,FW,22,1995,23.5,36,22,19,13,4,12,26,46.2,14,23,5,18,15,51,18,0,2019
FRA-Ligue 1,2018,Lyon,Ferland Mendy,FRA,DF,23,1995,28.1,44,28,25,14,5,14,17,82.4,3,22,5,17,34,78,53,2,2019
FRA-Ligue 1,2018,Lyon,Fernando Marçal,BRA,DF,29,1989,9.8,25,16,17,7,1,12,15,80.0,3,9,3,6,30,55,42,0,2019
FRA-Ligue 1,2018,Lyon,Houssem Aouar,ALG,MF,20,1998,34.0,63,38,28,25,10,17,61,27.9,44,33,6,27,32,95,25,3,2019
FRA-Ligue 1,2018,Lyon,Jason Denayer,BEL,DF,23,1995,30.6,33,21,22,11,0,16,24,66.7,8,36,32,4,26,59,122,1,2019
FRA-Ligue 1,2018,Lyon,Jordan Ferri,FRA,MF,26,1992,1.3,5,3,3,1,1,1,4,25.0,3,4,2,2,1,6,3,0,2019
FRA-Ligue 1,2018,Lyon,Jérémy Morel,MAD,DF,34,1984,11.8,16,10,11,5,0,9,13,69.2,4,18,14,4,18,34,45,1,2019
FRA-Ligue 1,2018,Lyon,Kenny Tete,NED,DF,22,1995,11.6,30,23,11,16,3,13,19,68.4,6,13,5,8,18,48,29,0,2019
FRA-Ligue 1,2018,Lyon,Lenny Pintor,FRA,FW,17,2000,0.0,0,0,0,0,0,0,0,,0,0,0,0,0,0,0,0,2019
FRA-Ligue 1,2018,Lyon,Leo Dubois,FRA,DF,23,1994,22.7,51,22,25,21,5,20,35,57.1,15,30,10,20,22,73,61,1,2019
FRA-Ligue 1,2018,Lyon,Lucas Tousart,FRA,MF,21,1997,19.2,74,38,33,34,7,25,59,42.4,34,30,13,17,26,100,27,0,2019
FRA-Ligue 1,2018,Lyon,Marcelo,BRA,DF,31,1987,32.0,48,33,29,17,2,19,24,79.2,5,30,22,8,62,110,152,2,2019
FRA-Ligue 1,2018,Lyon,Mariano,DOM,FW,24,1993,1.6,0,0,0,0,0,0,0,,0,0,0,0,1,1,0,0,2019
FRA-Ligue 1,2018,Lyon,Martin Terrier,FRA,FW,21,1997,16.5,23,13,5,13,5,9,23,39.1,14,17,2,15,6,29,14,0,2019
FRA-Ligue 1,2018,Lyon,Mathieu Gorgelin,FRA,GK,27,1990,4.0,0,0,0,0,0,0,0,,0,0,0,0,0,0,3,0,2019
FRA-Ligue 1,2018,Lyon,Maxwel Cornet,CIV,FW,21,1996,14.2,14,11,4,7,3,1,11,9.1,10,10,0,10,5,19,8,0,2019
FRA-Ligue 1,2018,Lyon,Memphis,NED,"FW,MF",24,1994,30.4,12,9,0,7,5,5,21,23.8,16,16,2,14,9,21,1,0,2019
FRA-Ligue 1,2018,Lyon,Moussa Dembélé,FRA,FW,22,1996,22.4,12,4,0,8,4,4,14,28.6,10,15,2,13,2,14,13,0,2019
FRA-Ligue 1,2018,Lyon,Nabil Fekir,FRA,MF,25,1993,22.1,51,31,16,19,16,13,38,34.2,25,42,0,42,7,58,3,0,2019
FRA-Ligue 1,2018,Lyon,Oumar Solet,FRA,DF,18,2000,0.7,1,0,1,0,0,1,1,100.0,0,1,0,1,0,1,0,0,2019
FRA-Ligue 1,2018,Lyon,Pape Cheikh Diop,SEN,MF,20,1997,5.0,1,0,0,1,0,0,5,0.0,5,6,2,4,2,3,2,1,2019
FRA-Ligue 1,2018,Lyon,Rafael,BRA,DF,28,1990,11.4,31,19,14,12,5,17,24,70.8,7,19,2,17,15,46,30,2,2019
FRA-Ligue 1,2018,Lyon,Tanguy Ndombele,FRA,MF,21,1996,29.9,66,43,21,35,10,22,54,40.7,32,29,9,20,30,96,13,3,2019
FRA-Ligue 1,2018,Lyon,Yassin Fekir,FRA,FW,21,1997,0.1,0,0,0,0,0,0,1,0.0,1,0,0,0,0,0,0,0,2019
FRA-Ligue 1,2018,Marseille,Adil Rami,FRA,DF,32,1985,15.7,14,9,12,2,0,8,12,66.7,4,14,14,0,18,32,52,3,2019
FRA-Ligue 1,2018,Marseille,Boubacar Kamara,FRA,DF,18,1999,26.8,67,39,38,24,5,32,49,65.3,17,24,13,11,45,112,95,2,2019
FRA-Ligue 1,2018,Marseille,Bouna Sarr,SEN,"DF,MF",26,1992,24.9,67,48,27,27,13,26,42,61.9,16,28,3,25,39,106,56,1,2019
FRA-Ligue 1,2018,Marseille,Christopher Rocchia,FRA,DF,20,1998,0.0,0,0,0,0,0,0,0,,0,0,0,0,0,0,1,0,2019
FRA-Ligue 1,2018,Marseille,Clinton N'Jie,CMR,FW,24,1993,4.0,7,4,2,3,2,3,3,100.0,0,2,0,2,2,9,0,0,2019
FRA-Ligue 1,2018,Marseille,Dimitri Payet,FRA,"MF,FW",31,1987,21.2,11,9,2,8,1,5,22,22.7,17,14,0,14,8,19,8,0,2019
FRA-Ligue 1,2018,Marseille,Duje Ćaleta-Car,CRO,DF,21,1996,17.2,22,16,14,8,0,14,18,77.8,4,15,9,6,20,42,86,2,2019
FRA-Ligue 1,2018,Marseille,Florian Thauvin,FRA,"FW,MF",25,1993,29.0,42,23,10,21,11,16,35,45.7,19,19,1,18,8,50,4,0,2019
FRA-Ligue 1,2018,Marseille,Grégory Sertic,FRA,MF,28,1989,1.2,2,0,1,1,0,0,1,0.0,1,2,1,1,1,3,2,0,2019
FRA-Ligue 1,2018,Marseille,Hiroki Sakai,JPN,DF,28,1990,26.4,59,41,30,23,6,29,54,53.7,25,25,10,15,37,96,77,0,2019
FRA-Ligue 1,2018,Marseille,Jordan Amavi,FRA,DF,24,1994,24.2,74,50,34,26,14,35,56,62.5,21,24,8,16,46,120,93,4,2019
FRA-Ligue 1,2018,Marseille,Kevin Strootman,NED,MF,28,1990,21.6,76,40,21,47,8,20,52,38.5,32,24,6,18,24,100,26,0,2019
FRA-Ligue 1,2018,Marseille,Kostas Mitroglou,GRE,FW,30,1988,6.4,0,0,0,0,0,0,3,0.0,3,0,0,0,0,0,5,0,2019
FRA-Ligue 1,2018,Marseille,Lucas Ocampos,ARG,"FW,MF",24,1994,30.1,80,54,37,33,10,34,80,42.5,46,40,5,35,29,109,30,0,2019
FRA-Ligue 1,2018,Marseille,Luiz Gustavo,BRA,"MF,DF",31,1987,27.1,72,43,49,18,5,30,66,45.5,36,26,12,14,34,106,61,0,2019
FRA-Ligue 1,2018,Marseille,Mario Balotelli,ITA,FW,27,1990,10.4,5,3,1,3,1,2,7,28.6,5,8,2,6,3,8,6,0,2019
FRA-Ligue 1,2018,Marseille,Maxime Lopez,FRA,MF,20,1997,24.2,46,24,17,23,6,19,53,35.8,34,10,2,8,20,66,8,0,2019
FRA-Ligue 1,2018,Marseille,Morgan Sanson,FRA,MF,23,1994,26.7,70,47,27,35,8,21,77,27.3,56,40,1,39,42,112,8,1,2019
FRA-Ligue 1,2018,Marseille,Nemanja Radonjić,SRB,"FW,MF",22,1996,7.6,8,5,1,5,2,5,16,31.3,11,3,0,3,5,13,4,0,2019
FRA-Ligue 1,2018,Marseille,Rolando,POR,DF,32,1985,8.9,18,7,15,3,0,8,10,80.0,2,8,6,2,11,29,25,0,2019
FRA-Ligue 1,2018,Marseille,Steve Mandanda,FRA,GK,33,1985,30.4,0,0,0,0,0,0,3,0.0,3,0,0,0,1,1,7,4,2019
FRA-Ligue 1,2018,Marseille,Tomáš Hubočan,SVK,DF,32,1985,0.8,3,2,3,0,0,3,4,75.0,1,0,0,0,2,5,5,0,2019
FRA-Ligue 1,2018,Marseille,Valère Germain,FRA,FW,28,1990,24.1,38,25,8,22,8,8,33,24.2,25,20,5,15,6,44,30,0,2019
FRA-Ligue 1,2018,Marseille,Yohann Pelé,FRA,GK,35,1982,7.6,0,0,0,0,0,0,2,0.0,2,0,0,0,0,0,1,1,2019
FRA-Ligue 1,2018,Monaco,Adama Traoré,MLI,MF,23,1995,2.7,2,1,1,0,1,1,4,25.0,3,4,0,4,3,5,1,0,2019
FRA-Ligue 1,2018,Monaco,Adrien Silva,POR,MF,29,1989,13.2,50,31,19,26,5,30,62,48.4,32,15,2,13,16,66,23,0,2019
FRA-Ligue 1,2018,Monaco,Aleksandr Golovin,RUS,"MF,FW",22,1996,25.4,36,17,3,20,13,10,44,22.7,34,34,3,31,22,58,12,0,2019
FRA-Ligue 1,2018,Monaco,Almamy Touré,MLI,DF,22,1996,3.8,13,6,6,7,0,3,10,30.0,7,3,1,2,11,24,12,0,2019
FRA-Ligue 1,2018,Monaco,Andrea Raggi,ITA,DF,34,1984,5.5,7,5,7,0,0,6,6,100.0,0,1,0,1,7,14,21,0,2019
FRA-Ligue 1,2018,Monaco,Antonio Barreca,ITA,DF,23,1995,6.6,11,8,8,3,0,7,11,63.6,4,3,2,1,7,18,18,0,2019
FRA-Ligue 1,2018,Monaco,Benjamin Henrichs,GER,"DF,MF",21,1997,20.3,58,39,32,22,4,16,38,42.1,22,18,0,18,35,93,45,0,2019
FRA-Ligue 1,2018,Monaco,Benoît Badiashile,FRA,DF,17,2001,19.6,25,18,18,7,0,17,25,68.0,8,12,5,7,21,46,79,2,2019
FRA-Ligue 1,2018,Monaco,Carlos Vinícius,BRA,"FW,MF",23,1995,5.8,4,1,1,2,1,0,1,0.0,1,7,0,7,1,5,2,0,2019
FRA-Ligue 1,2018,Monaco,Cesc Fàbregas,ESP,MF,31,1987,10.7,14,10,5,5,4,8,28,28.6,20,12,3,9,9,23,5,1,2019
FRA-Ligue 1,2018,Monaco,Danijel Subašić,CRO,GK,33,1984,12.6,0,0,0,0,0,0,1,0.0,1,0,0,0,0,0,6,2,2019
FRA-Ligue 1,2018,Monaco,Diego Benaglio,SUI,GK,34,1983,22.9,1,0,1,0,0,1,1,100.0,0,0,0,0,0,1,16,0,2019
FRA-Ligue 1,2018,Monaco,Djibril Sidibé,FRA,"DF,MF",26,1992,23.1,50,34,27,12,11,26,48,54.2,22,25,9,16,30,80,51,0,2019
FRA-Ligue 1,2018,Monaco,Fodé Ballo-Touré,SEN,DF,21,1997,17.7,46,31,26,16,4,20,40,50.0,20,20,2,18,28,74,38,2,2019
FRA-Ligue 1,2018,Monaco,Gelson Martins,POR,"FW,MF",23,1995,15.4,20,12,8,7,5,13,32,40.6,19,9,1,8,8,28,7,0,2019
FRA-Ligue 1,2018,Monaco,Georges-Kévin N'Koudou,CMR,FW,23,1995,0.3,2,1,0,0,2,1,1,100.0,0,2,0,2,0,2,0,0,2019
FRA-Ligue 1,2018,Monaco,Giulian Biancone,FRA,DF,18,2000,1.0,4,3,4,0,0,1,3,33.3,2,0,0,0,3,7,2,0,2019
FRA-Ligue 1,2018,Monaco,Han-Noah Massengo,FRA,MF,17,2001,0.7,2,2,2,0,0,2,5,40.0,3,0,0,0,2,4,1,0,2019
FRA-Ligue 1,2018,Monaco,Jean-Eudes Aholou,CIV,MF,24,1994,11.9,20,11,6,11,3,8,16,50.0,8,7,0,7,17,37,12,0,2019
FRA-Ligue 1,2018,Monaco,Jemerson,BRA,"DF,MF",25,1992,24.7,54,38,34,19,1,29,46,63.0,17,29,17,12,25,79,121,1,2019
FRA-Ligue 1,2018,Monaco,Jordi Mboula,ESP,"FW,MF",19,1999,3.1,3,0,0,1,2,3,6,50.0,3,1,0,1,1,4,5,0,2019
FRA-Ligue 1,2018,Monaco,Julien Serrano,FRA,"MF,DF",20,1998,1.3,5,4,3,2,0,3,6,50.0,3,1,0,1,3,8,3,0,2019
FRA-Ligue 1,2018,Monaco,Kamil Glik,POL,DF,30,1988,33.0,32,23,26,5,1,16,32,50.0,16,25,17,8,61,93,200,1,2019
FRA-Ligue 1,2018,Monaco,Kévin N'Doram,FRA,"DF,MF",22,1996,2.2,5,4,1,4,0,3,5,60.0,2,1,1,0,5,10,8,1,2019
FRA-Ligue 1,2018,Monaco,Moussa Sylla,FRA,"FW,MF",18,1999,8.5,6,4,4,1,1,2,6,33.3,4,5,2,3,2,8,5,0,2019
FRA-Ligue 1,2018,Monaco,Nacer Chadli,BEL,"MF,DF",28,1989,7.7,11,5,4,4,3,3,8,37.5,5,7,1,6,3,14,7,0,2019
FRA-Ligue 1,2018,Monaco,Naldo,BRA,DF,35,1982,3.3,5,3,4,1,0,2,4,50.0,2,5,2,3,5,10,23,0,2019
FRA-Ligue 1,2018,Monaco,Pelé,GNB,MF,26,1991,5.2,8,7,3,5,0,2,6,33.3,4,2,1,1,3,11,10,0,2019
FRA-Ligue 1,2018,Monaco,Pietro Pellegri,ITA,"FW,MF",17,2001,0.9,1,1,0,0,1,0,0,,0,0,0,0,0,1,0,0,2019
FRA-Ligue 1,2018,Monaco,Radamel Falcao,COL,FW,32,1986,28.4,34,15,6,16,12,8,27,29.6,19,11,6,5,3,37,23,2,2019
FRA-Ligue 1,2018,Monaco,Romain Faivre,FRA,MF,20,1998,1.0,1,0,0,1,0,0,1,0.0,1,0,0,0,1,2,1,1,2019
FRA-Ligue 1,2018,Monaco,Ronaël Pierre-Gabriel,FRA,DF,20,1998,3.9,13,8,10,2,1,9,10,90.0,1,3,1,2,3,16,18,0,2019
FRA-Ligue 1,2018,Monaco,Rony Lopes,POR,"FW,MF",22,1995,20.5,33,22,10,17,6,9,22,40.9,13,17,1,16,8,41,10,0,2019
FRA-Ligue 1,2018,Monaco,Samuel Grandsir,FRA,"FW,MF",21,1996,5.2,12,7,4,5,3,2,10,20.0,8,11,0,11,1,13,5,1,2019
FRA-Ligue 1,2018,Monaco,Seydou Sy,SEN,GK,22,1995,2.5,0,0,0,0,0,0,0,,0,0,0,0,0,0,0,1,2019
FRA-Ligue 1,2018,Monaco,Sofiane Diop,FRA,"MF,FW",18,2000,8.2,12,7,3,6,3,1,15,6.7,14,6,0,6,8,20,6,0,2019
FRA-Ligue 1,2018,Monaco,Stevan Jovetić,MNE,"MF,FW",28,1989,4.4,2,1,1,1,0,1,3,33.3,2,1,0,1,1,3,3,0,2019
FRA-Ligue 1,2018,Monaco,Willem Geubbels,FRA,MF,16,2001,0.1,0,0,0,0,0,0,0,,0,0,0,0,0,0,0,0,2019
FRA-Ligue 1,2018,Monaco,William Vainqueur,FRA,MF,29,1988,0.9,6,3,4,2,0,1,1,100.0,0,1,0,1,0,6,0,0,2019
FRA-Ligue 1,2018,Monaco,Wilson Isidor,FRA,FW,17,2000,0.5,0,0,0,0,0,0,0,,0,1,1,0,0,0,1,0,2019
FRA-Ligue 1,2018,Monaco,Youri Tielemans,BEL,MF,21,1997,18.7,45,24,17,23,5,24,47,51.1,23,20,3,17,18,63,22,0,2019
FRA-Ligue 1,2018,Monaco,Youssef Aït Bennasser,MAR,MF,22,1996,11.9,33,16,14,18,1,13,29,44.8,16,15,5,10,15,48,19,0,2019
FRA-Ligue 1,2018,Montpellier,Ambroise Oyongo,CMR,DF,27,1991,23.7,44,21,23,16,5,20,38,52.6,18,26,6,20,38,82,60,0,2019
FRA-Ligue 1,2018,Montpellier,Andy Delort,ALG,FW,26,1991,34.6,34,20,7,20,7,8,34,23.5,26,28,7,21,4,38,7,0,2019
FRA-Ligue 1,2018,Montpellier,Benjamin Lecomte,FRA,GK,27,1991,37.0,1,0,1,0,0,1,3,33.3,2,0,0,0,5,6,24,3,2019
FRA-Ligue 1,2018,Montpellier,Bilal Boutobba,FRA,"FW,MF",19,1998,0.4,0,0,0,0,0,0,2,0.0,2,0,0,0,0,0,0,0,2019
FRA-Ligue 1,2018,Montpellier,Damien Le Tallec,FRA,MF,28,1990,31.2,95,58,42,43,10,33,89,37.1,56,35,8,27,59,154,50,0,2019
FRA-Ligue 1,2018,Montpellier,Daniel Congré,FRA,DF,33,1985,36.6,75,45,46,26,3,38,65,58.5,27,35,15,20,67,142,106,1,2019
FRA-Ligue 1,2018,Montpellier,Dimitry Bertaud,FRA,GK,20,1998,1.0,0,0,0,0,0,0,0,,0,0,0,0,0,0,0,0,2019
FRA-Ligue 1,2018,Montpellier,Ellyes Skhiri,TUN,MF,23,1995,34.3,105,58,31,64,10,43,91,47.3,48,60,7,53,60,165,41,0,2019
FRA-Ligue 1,2018,Montpellier,Facundo Píriz,URU,"MF,FW",28,1990,1.3,9,6,3,4,2,4,9,44.4,5,2,1,1,0,9,2,0,2019
FRA-Ligue 1,2018,Montpellier,Florent Mollet,FRA,MF,26,1991,28.5,36,20,8,20,8,13,51,25.5,38,32,1,31,23,59,7,0,2019
FRA-Ligue 1,2018,Montpellier,Gaëtan Laborde,FRA,"FW,MF",24,1994,32.2,36,15,6,15,15,11,27,40.7,16,18,2,16,6,42,27,0,2019
FRA-Ligue 1,2018,Montpellier,Giovanni Sio,CIV,FW,29,1989,0.7,0,0,0,0,0,0,0,,0,0,0,0,0,0,0,0,2019
FRA-Ligue 1,2018,Montpellier,Junior Sambia,FRA,"MF,FW",21,1996,10.3,15,7,7,7,1,6,15,40.0,9,14,2,12,5,20,3,0,2019
FRA-Ligue 1,2018,Montpellier,Keagan Dolly,RSA,FW,25,1993,1.0,1,1,0,1,0,0,3,0.0,3,0,0,0,0,1,0,0,2019
FRA-Ligue 1,2018,Montpellier,Mathías Suárez,URU,DF,22,1996,6.1,20,11,7,10,3,10,23,43.5,13,11,0,11,9,29,18,0,2019
FRA-Ligue 1,2018,Montpellier,Mihailo Ristić,SRB,"DF,MF",22,1995,3.6,14,9,8,5,1,6,10,60.0,4,11,3,8,9,23,6,0,2019
FRA-Ligue 1,2018,Montpellier,Morgan Poaty,CGO,MF,21,1997,1.0,1,1,1,0,0,0,0,,0,1,0,1,0,1,2,0,2019
FRA-Ligue 1,2018,Montpellier,Nicolas Cozza,FRA,DF,19,1999,10.9,19,15,14,5,0,4,10,40.0,6,13,10,3,23,42,37,1,2019
FRA-Ligue 1,2018,Montpellier,Paul Lasne,FRA,"MF,DF",29,1989,19.9,53,33,32,16,5,24,43,55.8,19,22,2,20,22,75,23,1,2019
FRA-Ligue 1,2018,Montpellier,Pedro Mendes,POR,DF,27,1990,29.6,71,42,56,13,2,31,47,66.0,16,42,22,20,48,119,73,1,2019
FRA-Ligue 1,2018,Montpellier,Petar Škuletić,SRB,FW,28,1990,6.7,9,5,4,2,3,1,15,6.7,14,7,1,6,3,12,14,1,2019
FRA-Ligue 1,2018,Montpellier,Ruben Aguilar,FRA,DF,25,1993,28.1,88,51,40,33,15,39,69,56.5,30,23,3,20,37,125,50,1,2019
FRA-Ligue 1,2018,Montpellier,Souleymane Camara,SEN,"FW,MF",35,1982,1.5,0,0,0,0,0,0,2,0.0,2,0,0,0,0,0,3,0,2019
FRA-Ligue 1,2018,Montpellier,Vitorino Hilton,BRA,DF,40,1977,35.9,33,13,28,5,0,12,30,40.0,18,31,15,16,66,99,198,2,2019
FRA-Ligue 1,2018,Montpellier,Yanis Ammour,FRA,MF,19,1999,0.0,0,0,0,0,0,0,0,,0,0,0,0,0,0,0,0,2019
FRA-Ligue 1,2018,Nantes,Abdoulaye Dabo,FRA,FW,17,2001,1.3,3,1,1,0,2,0,0,,0,0,0,0,0,3,0,0,2019
FRA-Ligue 1,2018,Nantes,Abdoulaye Touré,FRA,MF,24,1994,30.5,48,31,14,28,6,19,56,33.9,37,25,10,15,47,95,29,1,2019
FRA-Ligue 1,2018,Nantes,Abdul Majeed Waris,GHA,"FW,MF",26,1991,25.0,22,13,6,13,3,7,28,25.0,21,9,0,9,7,29,7,0,2019
FRA-Ligue 1,2018,Nantes,Alexandre Olliero,FRA,GK,22,1996,1.0,0,0,0,0,0,0,0,,0,0,0,0,0,0,0,0,2019
FRA-Ligue 1,2018,Nantes,Alexis Alegue,FRA,FW,21,1996,0.1,1,0,0,1,0,0,0,,0,0,0,0,0,1,0,0,2019
FRA-Ligue 1,2018,Nantes,Andrei Girotto,BRA,MF,26,1992,16.4,57,40,18,36,3,20,44,45.5,24,22,6,16,29,86,43,1,2019
FRA-Ligue 1,2018,Nantes,Anthony Limbombe,BEL,FW,24,1994,13.7,12,10,4,6,2,7,16,43.8,9,5,0,5,8,20,10,0,2019
FRA-Ligue 1,2018,Nantes,Anthony Walongwa,COD,DF,24,1993,1.0,0,0,0,0,0,0,0,,0,3,2,1,1,1,2,0,2019
FRA-Ligue 1,2018,Nantes,Antonio Mance,CRO,FW,22,1995,0.6,1,1,0,0,1,1,2,50.0,1,0,0,0,0,1,0,0,2019
FRA-Ligue 1,2018,Nantes,Charles Traore,MLI,"DF,FW",26,1992,12.9,40,20,22,16,2,23,34,67.6,11,16,3,13,19,59,46,0,2019
FRA-Ligue 1,2018,Nantes,Ciprian Tătărușanu,ROU,GK,32,1986,26.6,0,0,0,0,0,0,0,,0,0,0,0,2,2,20,0,2019
FRA-Ligue 1,2018,Nantes,Diego Carlos,BRA,DF,25,1993,35.0,58,34,43,14,1,26,33,78.8,7,44,31,13,50,108,186,1,2019
FRA-Ligue 1,2018,Nantes,Edgar Ié,GNB,DF,24,1994,8.6,20,13,12,6,2,9,16,56.3,7,10,3,7,8,28,23,0,2019
FRA-Ligue 1,2018,Nantes,Elie Youan,FRA,FW,19,1999,0.2,1,0,0,1,0,0,0,,0,0,0,0,0,1,0,0,2019
FRA-Ligue 1,2018,Nantes,Emiliano Sala,ARG,FW,27,1990,15.2,7,5,0,2,5,1,8,12.5,7,8,1,7,2,9,20,0,2019
FRA-Ligue 1,2018,Nantes,Enock Kwateng,FRA,DF,21,1997,22.7,65,41,34,27,4,33,70,47.1,37,28,4,24,78,143,56,0,2019
FRA-Ligue 1,2018,Nantes,Fábio,BRA,"DF,FW",28,1990,14.2,53,34,25,27,1,26,53,49.1,27,18,4,14,18,71,27,0,2019
FRA-Ligue 1,2018,Nantes,Gabriel Boschilia,BRA,"FW,MF",22,1996,14.7,33,23,11,9,13,8,33,24.2,25,14,2,12,8,41,7,0,2019
FRA-Ligue 1,2018,Nantes,Imran Louza,MAR,MF,19,1999,1.0,2,0,1,1,0,1,1,100.0,0,1,0,1,0,2,1,0,2019
FRA-Ligue 1,2018,Nantes,Kalifa Coulibaly,MLI,FW,26,1991,19.5,15,7,1,10,4,4,11,36.4,7,8,1,7,4,19,22,0,2019
FRA-Ligue 1,2018,Nantes,Kara Mbodji,SEN,DF,28,1989,5.6,12,10,10,1,1,6,8,75.0,2,4,1,3,6,18,25,0,2019
FRA-Ligue 1,2018,Nantes,Koffi Djidji,CIV,DF,25,1992,1.0,1,1,1,0,0,0,0,,0,1,1,0,1,2,3,0,2019
FRA-Ligue 1,2018,Nantes,Lucas Evangelista,BRA,"FW,MF",23,1995,8.0,30,17,11,12,7,14,25,56.0,11,10,0,10,9,39,6,0,2019
FRA-Ligue 1,2018,Nantes,Lucas Lima,BRA,"DF,FW",26,1991,27.7,49,28,26,15,8,20,53,37.7,33,39,3,36,29,78,62,1,2019
FRA-Ligue 1,2018,Nantes,Matt Miazga,USA,DF,23,1995,8.0,12,11,11,1,0,7,9,77.8,2,11,7,4,12,24,41,1,2019
FRA-Ligue 1,2018,Nantes,Maxime Dupé,FRA,GK,25,1993,10.4,0,0,0,0,0,0,0,,0,0,0,0,0,0,3,1,2019
FRA-Ligue 1,2018,Nantes,Nicolas Pallois,FRA,DF,30,1987,24.0,77,48,60,17,0,40,69,58.0,29,30,14,16,34,111,114,0,2019
FRA-Ligue 1,2018,Nantes,Randal Kolo Muani,FRA,FW,19,1998,1.4,2,0,1,1,0,0,1,0.0,1,2,0,2,0,2,2,0,2019
FRA-Ligue 1,2018,Nantes,Rene Krhin,SVN,MF,28,1990,11.7,22,14,7,12,3,11,19,57.9,8,7,4,3,21,43,32,0,2019
FRA-Ligue 1,2018,Nantes,Samuel Moutoussamy,COD,"MF,FW",21,1996,18.3,35,20,16,11,8,12,34,35.3,22,17,2,15,9,44,17,0,2019
FRA-Ligue 1,2018,Nantes,Thomas Basila,FRA,DF,19,1999,1.0,2,1,1,1,0,0,0,,0,2,1,1,0,2,8,0,2019
FRA-Ligue 1,2018,Nantes,Valentin Eysseric,FRA,"MF,FW",26,1992,2.3,1,1,0,1,0,0,2,0.0,2,2,0,2,0,1,0,0,2019
FRA-Ligue 1,2018,Nantes,Valentin Rongier,FRA,MF,23,1994,35.8,86,54,24,46,16,26,65,40.0,39,46,6,40,33,119,19,0,2019
FRA-Ligue 1,2018,Nice,Adrien Tameze,CMR,MF,24,1994,32.7,74,44,32,31,11,39,92,42.4,53,53,12,41,56,130,59,1,2019
FRA-Ligue 1,2018,Nice,Allan Saint-Maximin,FRA,FW,21,1997,32.2,12,6,1,7,4,2,14,14.3,12,11,0,11,4,16,3,0,2019
FRA-Ligue 1,2018,Nice,Andy Pelmard,FRA,DF,18,2000,3.1,5,5,3,2,0,1,4,25.0,3,0,0,0,3,8,3,0,2019
FRA-Ligue 1,2018,Nice,Assil Jaziri,TUN,FW,18,1999,0.4,2,2,0,2,0,1,2,50.0,1,1,0,1,1,3,0,0,2019
FRA-Ligue 1,2018,Nice,Bassem Srarfi,TUN,"FW,MF",21,1997,9.1,20,11,8,8,4,6,17,35.3,11,8,0,8,5,25,5,0,2019
FRA-Ligue 1,2018,Nice,Christophe Hérelle,MTQ,DF,25,1992,32.6,72,52,51,19,2,40,50,80.0,10,39,16,23,61,133,158,2,2019
FRA-Ligue 1,2018,Nice,Christophe Jallet,FRA,DF,34,1983,9.8,29,21,12,13,4,16,27,59.3,11,21,5,16,14,43,32,0,2019
FRA-Ligue 1,2018,Nice,Danilo Barbosa,BRA,MF,22,1996,17.2,29,20,13,13,3,6,17,35.3,11,17,2,15,15,44,25,1,2019
FRA-Ligue 1,2018,Nice,Dante,BRA,DF,34,1983,35.8,54,40,36,16,2,24,41,58.5,17,56,30,26,38,92,156,2,2019
FRA-Ligue 1,2018,Nice,Eddy Sylvestre,FRA,"FW,MF",18,1999,3.0,3,2,0,3,0,3,9,33.3,6,1,0,1,0,3,0,0,2019
FRA-Ligue 1,2018,Nice,Ignatius Ganago,CMR,FW,19,1999,11.5,3,1,0,2,1,0,7,0.0,7,2,0,2,1,4,7,0,2019
FRA-Ligue 1,2018,Nice,Ihsan Sacko,FRA,FW,21,1997,4.9,7,2,2,5,0,2,5,40.0,3,5,0,5,2,9,2,0,2019
FRA-Ligue 1,2018,Nice,Jean-Victor Makengo,FRA,"MF,FW",20,1998,11.4,10,8,3,6,1,1,5,20.0,4,5,1,4,9,19,5,0,2019
FRA-Ligue 1,2018,Nice,Malang Sarr,FRA,DF,19,1999,33.3,59,36,38,17,4,31,57,54.4,26,29,12,17,68,127,107,2,2019
FRA-Ligue 1,2018,Nice,Mario Balotelli,ITA,FW,27,1990,8.4,1,0,0,1,0,1,4,25.0,3,9,1,8,1,2,8,0,2019
FRA-Ligue 1,2018,Nice,Maxime Pélican,FRA,"FW,MF",20,1998,1.0,1,1,0,1,0,0,0,,0,1,0,1,0,1,0,0,2019
FRA-Ligue 1,2018,Nice,Mickaël Le Bihan,FRA,FW,28,1990,2.3,1,1,0,1,0,1,2,50.0,1,1,0,1,1,2,1,0,2019
FRA-Ligue 1,2018,Nice,Mohamed Lamine Diaby,FRA,FW,17,2001,1.8,1,1,0,1,0,1,1,100.0,0,2,0,2,2,3,0,0,2019
FRA-Ligue 1,2018,Nice,Myziane Maolida,FRA,FW,19,1999,10.6,12,8,5,5,2,2,4,50.0,2,5,0,5,1,13,5,0,2019
FRA-Ligue 1,2018,Nice,Olivier Boscagli,FRA,DF,20,1997,9.6,20,12,14,4,2,9,20,45.0,11,12,1,11,17,37,37,0,2019
FRA-Ligue 1,2018,Nice,Patrick Burner,MTQ,DF,22,1996,15.0,36,23,22,10,4,16,34,47.1,18,15,5,10,31,67,40,0,2019
FRA-Ligue 1,2018,Nice,Paul Wade,FRA,MF,18,2000,0.1,0,0,0,0,0,0,3,0.0,3,0,0,0,0,0,1,0,2019
FRA-Ligue 1,2018,Nice,Pedro Brazão,POR,"MF,FW",15,2002,0.2,0,0,0,0,0,0,1,0.0,1,0,0,0,0,0,0,0,2019
FRA-Ligue 1,2018,Nice,Pierre Lees-Melou,FRA,MF,25,1993,26.6,74,46,31,36,7,25,62,40.3,37,44,8,36,36,110,37,0,2019
FRA-Ligue 1,2018,Nice,Racine Coly,SEN,"DF,MF",22,1995,5.6,7,2,1,5,1,4,11,36.4,7,6,1,5,9,16,11,1,2019
FRA-Ligue 1,2018,Nice,Rémi Walter,FRA,MF,23,1995,9.3,20,12,7,10,3,5,15,33.3,10,9,1,8,6,26,11,0,2019
FRA-Ligue 1,2018,Nice,Walter Benítez,ARG,GK,25,1993,35.0,1,0,1,0,0,1,2,50.0,1,0,0,0,2,3,6,2,2019
FRA-Ligue 1,2018,Nice,Wylan Cyprien,FRA,MF,23,1995,26.2,40,20,16,21,3,15,43,34.9,28,20,5,15,11,51,15,0,2019
FRA-Ligue 1,2018,Nice,Yoan Cardinale,FRA,GK,24,1994,3.0,1,0,1,0,0,1,1,100.0,0,0,0,0,0,1,1,0,2019
FRA-Ligue 1,2018,Nice,Youcef Atal,ALG,"DF,FW",22,1996,25.1,68,44,34,25,9,34,67,50.7,33,38,8,30,56,124,42,0,2019
FRA-Ligue 1,2018,Nîmes,Anthony Briançon,FRA,DF,23,1994,32.5,46,27,36,10,0,27,50,54.0,23,51,38,13,70,116,184,1,2019
FRA-Ligue 1,2018,Nîmes,Antonin Bobichon,FRA,MF,22,1995,23.9,34,16,17,12,5,16,58,27.6,42,15,3,12,15,49,13,0,2019
FRA-Ligue 1,2018,Nîmes,Baptiste Guillaume,BEL,FW,23,1995,13.1,12,6,1,8,3,2,9,22.2,7,6,0,6,2,14,6,0,2019
FRA-Ligue 1,2018,Nîmes,Clément Depres,FRA,FW,23,1994,4.9,2,2,1,1,0,1,4,25.0,3,3,0,3,0,2,6,0,2019
FRA-Ligue 1,2018,Nîmes,Denis Bouanga,GAB,"MF,FW",23,1994,29.3,52,32,21,22,9,13,61,21.3,48,24,3,21,20,72,16,0,2019
FRA-Ligue 1,2018,Nîmes,Faitout Maouassa,FRA,DF,20,1998,23.7,55,30,35,15,5,23,39,59.0,16,24,5,19,23,78,81,1,2019
FRA-Ligue 1,2018,Nîmes,Florian Miguel,FRA,DF,21,1996,12.4,19,16,13,6,0,7,11,63.6,4,15,7,8,21,40,47,0,2019
FRA-Ligue 1,2018,Nîmes,Féthi Harek,ALG,DF,35,1982,2.0,4,4,2,2,0,3,4,75.0,1,1,0,1,1,5,6,0,2019
FRA-Ligue 1,2018,Nîmes,Gaëtan Paquiez,FRA,DF,24,1994,14.8,43,29,30,10,3,23,48,47.9,25,24,6,18,22,65,50,0,2019
FRA-Ligue 1,2018,Nîmes,Hervé Lybohy,NIG,DF,35,1983,16.4,22,13,13,9,0,11,16,68.8,5,17,11,6,14,36,70,0,2019
FRA-Ligue 1,2018,Nîmes,Jordan Ferri,FRA,MF,26,1992,20.8,52,31,22,23,7,26,62,41.9,36,27,2,25,15,67,9,1,2019
FRA-Ligue 1,2018,Nîmes,Loïck Landre,FRA,DF,26,1992,17.7,31,21,23,8,0,14,22,63.6,8,16,11,5,38,69,83,1,2019
FRA-Ligue 1,2018,Nîmes,Mustapha Diallo,SEN,MF,32,1986,5.1,16,11,6,9,1,5,13,38.5,8,7,1,6,10,26,14,1,2019
FRA-Ligue 1,2018,Nîmes,Paul Bernardoni,FRA,GK,21,1997,38.0,1,1,1,0,0,1,2,50.0,1,0,0,0,1,2,20,1,2019
FRA-Ligue 1,2018,Nîmes,Pierrick Valdivia,FRA,MF,30,1988,0.3,1,1,0,1,0,1,2,50.0,1,1,0,1,1,2,0,0,2019
FRA-Ligue 1,2018,Nîmes,Rachid Alioui,MAR,FW,26,1992,13.9,15,5,3,9,3,4,9,44.4,5,8,1,7,10,25,11,0,2019
FRA-Ligue 1,2018,Nîmes,Renaud Ripart,FRA,"FW,DF",25,1993,33.4,76,49,41,22,13,32,76,42.1,44,43,7,36,27,103,79,0,2019
FRA-Ligue 1,2018,Nîmes,Sada Thioub,SEN,"MF,FW",23,1995,27.5,30,19,13,10,7,20,45,44.4,25,29,1,28,16,46,11,0,2019
FRA-Ligue 1,2018,Nîmes,Sofiane Alakouch,MAR,DF,20,1998,21.1,81,44,44,31,6,36,63,57.1,27,15,4,11,46,127,57,0,2019
FRA-Ligue 1,2018,Nîmes,Theo Valls,FRA,MF,22,1995,19.7,37,21,16,19,2,15,43,34.9,28,17,4,13,22,59,15,0,2019
FRA-Ligue 1,2018,Nîmes,Théo Sainte-Luce,FRA,MF,19,1998,0.0,0,0,0,0,0,0,0,,0,0,0,0,0,0,0,0,2019
FRA-Ligue 1,2018,Nîmes,Téji Savanier,FRA,MF,26,1991,31.8,95,58,35,52,8,43,116,37.1,73,32,15,17,64,159,53,2,2019
FRA-Ligue 1,2018,Nîmes,Umut Bozok,TUR,FW,21,1996,13.7,9,6,0,3,6,2,4,50.0,2,3,0,3,5,14,1,0,2019
FRA-Ligue 1,2018,Paris S-G,Adrien Rabiot,FRA,MF,23,1995,11.8,35,20,13,17,5,9,12,75.0,3,9,2,7,10,45,20,0,2019
FRA-Ligue 1,2018,Paris S-G,Alphonse Areola,FRA,GK,25,1993,21.0,1,1,1,0,0,1,1,100.0,0,0,0,0,0,1,4,1,2019
FRA-Ligue 1,2018,Paris S-G,Antoine Bernede,FRA,MF,19,1999,1.9,13,7,3,8,2,5,9,55.6,4,3,1,2,3,16,1,1,2019
FRA-Ligue 1,2018,Paris S-G,Christopher Nkunku,FRA,"MF,FW",20,1997,12.8,21,16,8,10,3,7,16,43.8,9,12,2,10,9,30,7,1,2019
FRA-Ligue 1,2018,Paris S-G,Colin Dagba,FRA,"DF,MF",19,1998,10.2,24,12,10,12,2,13,19,68.4,6,10,0,10,9,33,10,1,2019
FRA-Ligue 1,2018,Paris S-G,Dani Alves,BRA,"MF,DF",35,1983,18.0,42,22,16,23,3,13,38,34.2,25,18,5,13,8,50,11,0,2019
FRA-Ligue 1,2018,Paris S-G,Edinson Cavani,URU,FW,31,1987,18.6,11,8,1,4,6,3,13,23.1,10,11,2,9,6,17,16,0,2019
FRA-Ligue 1,2018,Paris S-G,Eric Maxim Choupo-Moting,CMR,FW,29,1989,8.9,9,4,3,2,4,2,9,22.2,7,7,0,7,3,12,4,0,2019
FRA-Ligue 1,2018,Paris S-G,Gianluigi Buffon,ITA,GK,40,1978,17.0,0,0,0,0,0,0,1,0.0,1,0,0,0,0,0,5,0,2019
FRA-Ligue 1,2018,Paris S-G,Giovani Lo Celso,ARG,MF,22,1996,0.1,1,1,0,0,1,0,1,0.0,1,0,0,0,0,1,0,0,2019
FRA-Ligue 1,2018,Paris S-G,Juan Bernat,ESP,"DF,MF",25,1993,20.4,47,32,22,19,6,22,46,47.8,24,19,5,14,20,67,41,1,2019
FRA-Ligue 1,2018,Paris S-G,Julian Draxler,GER,"MF,FW",24,1993,22.7,41,22,11,19,11,16,43,37.2,27,20,1,19,15,56,2,1,2019
FRA-Ligue 1,2018,Paris S-G,Kylian Mbappé,FRA,FW,19,1998,26.0,8,4,2,1,5,1,6,16.7,5,2,0,2,5,13,2,0,2019
FRA-Ligue 1,2018,Paris S-G,Kévin Rimane,GUF,MF,27,1991,0.1,0,0,0,0,0,0,0,,0,0,0,0,0,0,0,0,2019
FRA-Ligue 1,2018,Paris S-G,Lassana Diarra,FRA,MF,33,1985,1.8,2,1,0,2,0,0,1,0.0,1,0,0,0,2,4,3,0,2019
FRA-Ligue 1,2018,Paris S-G,Layvin Kurzawa,FRA,"DF,MF",25,1992,11.2,19,11,6,5,8,6,16,37.5,10,10,2,8,10,29,16,0,2019
FRA-Ligue 1,2018,Paris S-G,Leandro Paredes,ARG,MF,24,1994,13.9,34,19,16,15,3,13,30,43.3,17,17,5,12,14,48,20,2,2019
FRA-Ligue 1,2018,Paris S-G,Loïc Mbe Soh,FRA,DF,17,2001,2.0,0,0,0,0,0,0,3,0.0,3,2,2,0,3,3,5,0,2019
FRA-Ligue 1,2018,Paris S-G,Marco Verratti,ITA,MF,25,1992,20.9,72,42,25,39,8,36,81,44.4,45,26,1,25,18,90,8,2,2019
FRA-Ligue 1,2018,Paris S-G,Marquinhos,BRA,"DF,MF",24,1994,29.9,65,41,34,28,3,31,52,59.6,21,30,13,17,44,109,84,1,2019
FRA-Ligue 1,2018,Paris S-G,Metehan Güçlü,TUR,MF,19,1999,0.2,0,0,0,0,0,0,0,,0,0,0,0,0,0,0,0,2019
FRA-Ligue 1,2018,Paris S-G,Moussa Diaby,FRA,"MF,DF",19,1999,12.7,14,8,7,2,5,2,11,18.2,9,7,1,6,12,26,6,0,2019
FRA-Ligue 1,2018,Paris S-G,Neymar,BRA,"MF,FW",26,1992,16.0,14,9,3,10,1,4,21,19.0,17,8,0,8,5,19,1,1,2019
FRA-Ligue 1,2018,Paris S-G,Presnel Kimpembe,FRA,DF,22,1995,22.3,55,34,26,25,4,24,40,60.0,16,17,10,7,30,85,48,5,2019
FRA-Ligue 1,2018,Paris S-G,Stanley N'Soki,FRA,DF,19,1999,7.8,20,14,8,10,2,6,13,46.2,7,10,1,9,18,38,20,1,2019
FRA-Ligue 1,2018,Paris S-G,Thiago Silva,BRA,DF,33,1984,23.1,16,13,7,8,1,6,11,54.5,5,28,20,8,32,48,99,1,2019
FRA-Ligue 1,2018,Paris S-G,Thilo Kehrer,GER,DF,21,1996,21.1,64,43,27,31,6,31,55,56.4,24,32,17,15,31,95,69,1,2019
FRA-Ligue 1,2018,Paris S-G,Thomas Meunier,BEL,DF,26,1991,17.9,44,33,25,15,4,21,35,60.0,14,13,2,11,19,63,29,0,2019
FRA-Ligue 1,2018,Paris S-G,Timothy Weah,USA,FW,18,2000,0.6,0,0,0,0,0,0,0,,0,0,0,0,0,0,0,0,2019
FRA-Ligue 1,2018,Paris S-G,Ángel Di María,ARG,"FW,MF",30,1988,25.8,29,17,12,10,7,10,42,23.8,32,24,1,23,16,45,4,0,2019
FRA-Ligue 1,2018,Reims,Alaixys Romao,TOG,MF,34,1984,35.1,118,71,61,50,7,43,102,42.2,59,44,16,28,58,176,65,1,2019
FRA-Ligue 1,2018,Reims,Aly Ndom,FRA,MF,22,1996,4.0,11,9,5,5,1,3,7,42.9,4,6,2,4,3,14,9,1,2019
FRA-Ligue 1,2018,Reims,Arber Zeneli,KVX,FW,23,1995,9.0,8,6,3,2,3,0,10,0.0,10,3,0,3,2,10,3,1,2019
FRA-Ligue 1,2018,Reims,Axel Disasi,FRA,DF,20,1998,1.8,2,1,1,1,0,1,2,50.0,1,2,1,1,2,4,16,0,2019
FRA-Ligue 1,2018,Reims,Baba Rahman,GHA,DF,24,1994,10.7,26,20,17,8,1,18,21,85.7,3,21,3,18,16,42,37,2,2019
FRA-Ligue 1,2018,Reims,Björn Engels,BEL,DF,23,1994,33.0,11,8,6,5,0,6,16,37.5,10,30,24,6,44,55,181,3,2019
FRA-Ligue 1,2018,Reims,Boulaye Dia,SEN,FW,21,1996,8.3,12,6,3,8,1,5,11,45.5,6,4,2,2,4,16,9,0,2019
FRA-Ligue 1,2018,Reims,Edouard Mendy,SEN,GK,26,1992,38.0,0,0,0,0,0,0,1,0.0,1,1,0,1,2,2,16,3,2019
FRA-Ligue 1,2018,Reims,Ghislain Konan,CIV,DF,22,1995,20.0,45,28,31,10,4,24,40,60.0,16,18,4,14,40,85,55,1,2019
FRA-Ligue 1,2018,Reims,Grejohn Kyei,FRA,FW,22,1995,0.0,0,0,0,0,0,0,1,0.0,1,0,0,0,0,0,0,0,2019
FRA-Ligue 1,2018,Reims,Hassane Kamara,CIV,"DF,FW",24,1994,10.3,29,21,22,5,2,16,19,84.2,3,6,1,5,14,43,41,0,2019
FRA-Ligue 1,2018,Reims,Marvin Martin,FRA,MF,30,1988,6.9,2,1,0,2,0,0,6,0.0,6,2,1,1,2,4,1,0,2019
FRA-Ligue 1,2018,Reims,Mathieu Cafaro,FRA,"FW,MF",21,1997,23.3,59,28,29,24,6,18,63,28.6,45,28,0,28,20,79,14,0,2019
FRA-Ligue 1,2018,Reims,Moreto Cassamã,GNB,MF,20,1998,0.7,3,3,1,2,0,1,7,14.3,6,1,0,1,1,4,2,0,2019
FRA-Ligue 1,2018,Reims,Moussa Doumbia,MLI,"FW,MF",23,1994,17.8,28,13,13,13,2,11,39,28.2,28,7,2,5,7,35,13,0,2019
FRA-Ligue 1,2018,Reims,Nolan Mbemba,CGO,"MF,DF",23,1995,4.0,14,8,10,4,0,6,9,66.7,3,4,1,3,10,24,4,2,2019
FRA-Ligue 1,2018,Reims,Pablo Chavarría,ARG,FW,30,1988,21.9,20,12,8,6,6,3,15,20.0,12,11,0,11,4,24,19,0,2019
FRA-Ligue 1,2018,Reims,Remi Oudin,FRA,"FW,MF",21,1996,29.0,51,32,25,18,8,20,45,44.4,25,29,5,24,42,93,34,0,2019
FRA-Ligue 1,2018,Reims,Romain Métanire,MAD,DF,28,1990,3.5,12,9,10,1,1,5,7,71.4,2,4,3,1,6,18,13,0,2019
FRA-Ligue 1,2018,Reims,Sheyi Ojo,ENG,"FW,MF",21,1997,5.2,8,6,2,4,2,2,8,25.0,6,1,0,1,3,11,2,0,2019
FRA-Ligue 1,2018,Reims,Suk Hyun-jun,KOR,FW,27,1991,8.8,11,8,1,6,4,0,8,0.0,8,2,1,1,2,13,4,1,2019
FRA-Ligue 1,2018,Reims,Thomas Foket,BEL,DF,23,1994,32.0,91,52,55,23,13,42,69,60.9,27,30,4,26,49,140,80,1,2019
FRA-Ligue 1,2018,Reims,Thomas Fontaine,MAD,"DF,MF",27,1991,4.7,6,3,5,0,1,2,5,40.0,3,6,2,4,7,13,28,1,2019
FRA-Ligue 1,2018,Reims,Tristan Dingomé,CMR,MF,27,1991,14.9,27,15,11,10,6,7,24,29.2,17,16,3,13,11,38,5,0,2019
FRA-Ligue 1,2018,Reims,Virgile Pinson,FRA,MF,22,1996,0.1,0,0,0,0,0,0,0,,0,0,0,0,0,0,0,0,2019
FRA-Ligue 1,2018,Reims,Xavier Chavalerin,FRA,MF,27,1991,36.0,106,61,56,39,11,28,72,38.9,44,44,12,32,72,178,39,1,2019
FRA-Ligue 1,2018,Reims,Yunis Abdelhamid,MAR,DF,30,1987,38.0,60,33,48,11,1,30,40,75.0,10,44,24,20,65,125,196,0,2019
FRA-Ligue 1,2018,Rennes,Abdoulaye Diallo,SEN,GK,26,1992,5.5,1,1,1,0,0,1,1,100.0,0,0,0,0,0,1,1,0,2019
FRA-Ligue 1,2018,Rennes,Adrien Hunou,FRA,"FW,MF",24,1994,13.8,11,7,3,5,3,2,9,22.2,7,14,0,14,5,16,8,0,2019
FRA-Ligue 1,2018,Rennes,Armand Lauriente,FRA,MF,19,1998,0.0,0,0,0,0,0,0,0,,0,0,0,0,0,0,0,0,2019
FRA-Ligue 1,2018,Rennes,Benjamin André,FRA,MF,27,1990,27.7,101,60,39,50,12,33,85,38.8,52,40,6,34,54,155,58,0,2019
FRA-Ligue 1,2018,Rennes,Benjamin Bourigeaud,FRA,"MF,FW",24,1994,26.9,55,35,23,21,11,20,67,29.9,47,44,5,39,32,87,34,1,2019
FRA-Ligue 1,2018,Rennes,Clément Grenier,FRA,MF,27,1991,29.6,44,27,7,33,4,21,61,34.4,40,28,4,24,29,73,34,1,2019
FRA-Ligue 1,2018,Rennes,Damien Da Silva,FRA,DF,30,1988,31.9,41,25,31,9,1,18,24,75.0,6,42,36,6,39,80,152,0,2019
FRA-Ligue 1,2018,Rennes,Denis-Will Poha,FRA,MF,21,1997,0.3,0,0,0,0,0,0,1,0.0,1,0,0,0,1,1,1,0,2019
FRA-Ligue 1,2018,Rennes,Diafra Sakho,SEN,FW,28,1989,1.6,2,1,0,0,2,0,0,,0,0,0,0,0,2,0,0,2019
FRA-Ligue 1,2018,Rennes,Eduardo Camavinga,FRA,MF,15,2002,4.0,23,15,8,12,3,8,18,44.4,10,13,2,11,4,27,4,0,2019
FRA-Ligue 1,2018,Rennes,Gerzino Nyamsi,FRA,DF,21,1997,6.0,6,3,5,1,0,4,9,44.4,5,8,4,4,4,10,17,0,2019
FRA-Ligue 1,2018,Rennes,Hamari Traoré,MLI,DF,26,1992,33.0,61,33,32,27,2,36,71,50.7,35,39,11,28,44,105,82,0,2019
FRA-Ligue 1,2018,Rennes,Hatem Ben Arfa,FRA,"FW,MF",31,1987,22.6,15,7,4,8,3,7,16,43.8,9,9,0,9,4,19,0,0,2019
FRA-Ligue 1,2018,Rennes,Ismaila Sarr,SEN,"FW,MF",20,1998,31.0,35,24,16,15,4,17,34,50.0,17,17,2,15,14,49,4,0,2019
FRA-Ligue 1,2018,Rennes,Jakob Johansson,SWE,MF,28,1990,7.9,17,9,5,12,0,10,20,50.0,10,7,3,4,3,20,17,1,2019
FRA-Ligue 1,2018,Rennes,James Lea Siliki,CMR,"MF,FW",22,1996,13.6,26,17,13,10,3,12,35,34.3,23,14,1,13,10,36,7,1,2019
FRA-Ligue 1,2018,Rennes,Jordan Pefok,USA,FW,22,1996,6.8,6,2,0,3,3,2,4,50.0,2,7,2,5,4,10,5,0,2019
FRA-Ligue 1,2018,Rennes,Jérémy Gélin,FRA,"DF,MF",21,1997,14.2,30,16,18,10,2,18,34,52.9,16,14,6,8,19,49,29,0,2019
FRA-Ligue 1,2018,Rennes,Ludovic Baal,GUF,DF,32,1986,1.4,4,3,3,1,0,0,0,,0,1,0,1,2,6,1,0,2019
FRA-Ligue 1,2018,Rennes,M'Baye Niang,SEN,"FW,MF",23,1994,19.9,16,10,3,8,5,2,11,18.2,9,19,3,16,8,24,14,0,2019
FRA-Ligue 1,2018,Rennes,Mehdi Zeffane,ALG,"DF,MF",26,1992,13.5,19,13,12,7,0,10,26,38.5,16,14,5,9,18,37,35,1,2019
FRA-Ligue 1,2018,Rennes,Mexer,MOZ,DF,29,1988,27.4,23,12,18,5,0,12,18,66.7,6,26,18,8,30,53,125,0,2019
FRA-Ligue 1,2018,Rennes,Nicolas Janvier,FRA,MF,19,1998,0.0,0,0,0,0,0,0,0,,0,0,0,0,0,0,0,0,2019
FRA-Ligue 1,2018,Rennes,Ramy Bensebaini,ALG,DF,23,1995,23.9,69,48,42,19,8,40,58,69.0,18,24,10,14,41,110,98,0,2019
FRA-Ligue 1,2018,Rennes,Romain Del Castillo,FRA,"MF,FW",22,1996,14.9,36,20,15,13,8,13,37,35.1,24,19,0,19,20,56,7,1,2019
FRA-Ligue 1,2018,Rennes,Sacha Boey,FRA,DF,17,2000,0.2,0,0,0,0,0,0,0,,0,0,0,0,0,0,0,0,2019
FRA-Ligue 1,2018,Rennes,Souleyman Doumbia,CIV,DF,21,1996,6.7,11,7,9,2,0,6,10,60.0,4,6,1,5,4,15,20,0,2019
FRA-Ligue 1,2018,Rennes,Tomáš Koubek,CZE,GK,25,1992,32.5,0,0,0,0,0,0,1,0.0,1,0,0,0,0,0,26,4,2019
FRA-Ligue 1,2018,Saint-Étienne,Arnaud Nordin,FRA,"FW,MF",20,1998,11.7,14,12,4,4,6,4,11,36.4,7,13,2,11,5,19,9,0,2019
FRA-Ligue 1,2018,Saint-Étienne,Assane Dioussé,SEN,MF,20,1997,2.4,6,4,3,3,0,2,4,50.0,2,2,0,2,1,7,7,1,2019
FRA-Ligue 1,2018,Saint-Étienne,Charles Abi,FRA,"DF,FW",18,2000,0.4,4,4,2,1,1,2,2,100.0,0,1,0,1,0,4,1,0,2019
FRA-Ligue 1,2018,Saint-Étienne,Gabriel Silva,BRA,DF,27,1991,15.9,19,10,13,6,0,6,17,35.3,11,15,3,12,14,33,60,1,2019
FRA-Ligue 1,2018,Saint-Étienne,Jessy Moulin,FRA,GK,32,1986,1.0,1,0,1,0,0,1,1,100.0,0,0,0,0,0,1,2,0,2019
FRA-Ligue 1,2018,Saint-Étienne,Kenny Rocha Santos,CPV,MF,18,2000,0.0,0,0,0,0,0,0,0,,0,0,0,0,0,0,0,0,2019
FRA-Ligue 1,2018,Saint-Étienne,Kévin Monnet-Paquet,FRA,"DF,MF",29,1988,16.5,46,25,23,16,7,20,36,55.6,16,22,4,18,14,60,28,0,2019
FRA-Ligue 1,2018,Saint-Étienne,Lamine Ghezali,FRA,"FW,MF",19,1999,0.5,1,1,0,1,0,1,2,50.0,1,0,0,0,0,1,2,0,2019
FRA-Ligue 1,2018,Saint-Étienne,Lois Diony,FRA,FW,25,1992,17.7,17,12,3,9,5,4,10,40.0,6,14,0,14,1,18,9,0,2019
FRA-Ligue 1,2018,Saint-Étienne,Loïc Perrin,FRA,DF,32,1985,30.0,53,36,34,17,2,20,33,60.6,13,37,24,13,44,97,118,2,2019
FRA-Ligue 1,2018,Saint-Étienne,Mahdi Camara,FRA,FW,20,1998,0.1,0,0,0,0,0,0,0,,0,0,0,0,0,0,2,0,2019
FRA-Ligue 1,2018,Saint-Étienne,Makhtar Gueye,SEN,"FW,MF",20,1997,0.6,2,1,2,0,0,2,2,100.0,0,2,0,2,0,2,0,0,2019
FRA-Ligue 1,2018,Saint-Étienne,Mathieu Debuchy,FRA,DF,33,1985,21.6,43,26,25,13,5,22,37,59.5,15,17,7,10,47,90,64,0,2019
FRA-Ligue 1,2018,Saint-Étienne,Mickaël Panos,FRA,DF,21,1997,0.3,1,0,0,1,0,1,2,50.0,1,2,0,2,1,2,0,0,2019
FRA-Ligue 1,2018,Saint-Étienne,Neven Subotić,SRB,DF,29,1988,23.9,44,23,36,7,1,20,39,51.3,19,14,6,8,38,82,107,3,2019
FRA-Ligue 1,2018,Saint-Étienne,Ole Selnæs,NOR,MF,24,1994,18.5,44,26,12,23,9,13,35,37.1,22,24,7,17,19,63,29,0,2019
FRA-Ligue 1,2018,Saint-Étienne,Pierre-Yves Polomat,FRA,DF,24,1993,10.6,18,13,11,6,1,10,18,55.6,8,4,2,2,21,39,27,0,2019
FRA-Ligue 1,2018,Saint-Étienne,Robert Berić,SVN,FW,27,1991,13.1,12,5,1,9,2,1,11,9.1,10,8,2,6,4,16,3,0,2019
FRA-Ligue 1,2018,Saint-Étienne,Romain Hamouma,FRA,"FW,MF",31,1987,17.6,30,19,6,18,6,12,32,37.5,20,12,1,11,9,39,7,0,2019
FRA-Ligue 1,2018,Saint-Étienne,Rémy Cabella,FRA,"MF,FW",28,1990,33.3,88,51,31,38,19,30,87,34.5,57,39,1,38,19,107,5,3,2019
FRA-Ligue 1,2018,Saint-Étienne,Stéphane Ruffier,FRA,GK,31,1986,37.0,2,2,2,0,0,2,4,50.0,2,0,0,0,0,2,18,3,2019
FRA-Ligue 1,2018,Saint-Étienne,Timothée Kolodziejczak,FRA,DF,26,1991,35.4,34,22,21,10,3,20,45,44.4,25,25,11,14,53,87,118,2,2019
FRA-Ligue 1,2018,Saint-Étienne,Valentín Vada,ARG,MF,22,1996,4.5,7,4,4,3,0,3,12,25.0,9,4,1,3,7,14,4,0,2019
FRA-Ligue 1,2018,Saint-Étienne,Wahbi Khazri,TUN,"FW,MF",27,1991,31.3,41,26,8,14,19,17,49,34.7,32,27,2,25,11,52,5,0,2019
FRA-Ligue 1,2018,Saint-Étienne,Wesley Fofana,FRA,DF,17,2000,1.8,7,6,5,2,0,6,13,46.2,7,1,0,1,4,11,9,0,2019
FRA-Ligue 1,2018,Saint-Étienne,William Saliba,FRA,DF,17,2001,14.2,32,20,28,4,0,16,24,66.7,8,11,10,1,28,60,44,2,2019
FRA-Ligue 1,2018,Saint-Étienne,Yann M'Vila,FRA,MF,28,1990,36.2,72,40,22,48,2,29,72,40.3,43,42,12,30,74,146,86,5,2019
FRA-Ligue 1,2018,Saint-Étienne,Yannis Salibur,FRA,"FW,MF",27,1991,9.8,9,5,1,7,1,1,7,14.3,6,6,0,6,8,17,4,0,2019
FRA-Ligue 1,2018,Saint-Étienne,Youssef Aït Bennasser,MAR,MF,22,1996,10.4,25,13,9,12,4,13,28,46.4,15,15,2,13,19,44,6,2,2019
FRA-Ligue 1,2018,Strasbourg,Abdallah N'dour,SEN,DF,24,1993,3.2,6,4,3,3,0,4,9,44.4,5,4,2,2,5,11,8,0,2019
FRA-Ligue 1,2018,Strasbourg,Adrien Thomasson,FRA,"MF,FW",24,1993,27.5,54,27,18,23,13,21,66,31.8,45,29,5,24,18,72,12,1,2019
FRA-Ligue 1,2018,Strasbourg,Anthony Caci,FRA,DF,21,1997,25.5,56,30,38,14,4,24,46,52.2,22,20,10,10,47,103,63,0,2019
FRA-Ligue 1,2018,Strasbourg,Anthony Gonçalves,FRA,"MF,FW",32,1986,11.8,22,15,12,8,2,7,22,31.8,15,21,2,19,10,32,17,0,2019
FRA-Ligue 1,2018,Strasbourg,Benjamin Corgnet,FRA,"MF,FW",31,1987,7.5,21,12,7,9,5,4,11,36.4,7,1,0,1,6,27,9,0,2019
FRA-Ligue 1,2018,Strasbourg,Dimitri Liénard,FRA,"MF,DF",30,1988,14.3,33,18,20,9,4,21,45,46.7,24,11,2,9,18,51,22,0,2019
FRA-Ligue 1,2018,Strasbourg,Eiji Kawashima,JPN,GK,35,1983,1.0,0,0,0,0,0,0,0,,0,0,0,0,0,0,0,0,2019
FRA-Ligue 1,2018,Strasbourg,Ibrahima Sissoko,FRA,MF,20,1997,29.6,60,41,23,34,3,23,55,41.8,32,37,3,34,34,94,39,1,2019
FRA-Ligue 1,2018,Strasbourg,Idriss Saadi,ALG,"FW,MF",26,1992,0.1,0,0,0,0,0,0,0,,0,0,0,0,0,0,0,0,2019
FRA-Ligue 1,2018,Strasbourg,Ismael Aaneba,FRA,DF,19,1999,2.3,12,6,7,5,0,5,10,50.0,5,5,0,5,8,20,9,0,2019
FRA-Ligue 1,2018,Strasbourg,Jonas Martin,FRA,MF,28,1990,22.9,46,28,23,18,5,17,33,51.5,16,30,12,18,30,76,42,0,2019
FRA-Ligue 1,2018,Strasbourg,Jérémy Grimm,FRA,MF,31,1987,1.9,4,2,2,2,0,3,5,60.0,2,1,0,1,4,8,5,0,2019
FRA-Ligue 1,2018,Strasbourg,Kenny Lala,FRA,"DF,FW",26,1991,34.0,78,45,48,23,7,30,53,56.6,23,26,9,17,28,106,62,2,2019
FRA-Ligue 1,2018,Strasbourg,Kévin Zohi,MLI,"FW,MF",21,1996,7.0,14,10,6,6,2,5,9,55.6,4,8,0,8,7,21,5,0,2019
FRA-Ligue 1,2018,Strasbourg,Lamine Koné,CIV,DF,29,1989,23.9,21,16,9,9,3,6,9,66.7,3,18,13,5,33,54,66,3,2019
FRA-Ligue 1,2018,Strasbourg,Lebo Mothiba,RSA,FW,22,1996,19.7,10,9,2,7,1,0,8,0.0,8,5,1,4,0,10,6,0,2019
FRA-Ligue 1,2018,Strasbourg,Lionel Carole,FRA,"DF,FW",27,1991,19.2,25,12,16,7,2,11,16,68.8,5,19,5,14,32,57,51,0,2019
FRA-Ligue 1,2018,Strasbourg,Ludovic Ajorque,FRA,FW,24,1994,17.0,17,13,1,10,6,4,9,44.4,5,5,0,5,5,22,9,0,2019
FRA-Ligue 1,2018,Strasbourg,Matz Sels,BEL,GK,26,1992,37.0,0,0,0,0,0,0,1,0.0,1,0,0,0,1,1,24,1,2019
FRA-Ligue 1,2018,Strasbourg,Mootaz Zemzemi,TUN,"FW,MF",18,1999,0.0,1,0,0,0,1,0,0,,0,0,0,0,0,1,0,0,2019
FRA-Ligue 1,2018,Strasbourg,Nuno da Costa,CPV,FW,27,1991,22.8,39,27,10,19,10,10,38,26.3,28,24,1,23,14,53,9,0,2019
FRA-Ligue 1,2018,Strasbourg,Pablo Martinez,FRA,DF,29,1989,31.3,51,34,34,17,0,30,49,61.2,19,37,23,14,52,103,132,1,2019
FRA-Ligue 1,2018,Strasbourg,Samuel Grandsir,FRA,"MF,FW",21,1996,2.6,9,6,5,3,1,3,7,42.9,4,2,0,2,1,10,0,0,2019
FRA-Ligue 1,2018,Strasbourg,Sanjin Prcić,BIH,MF,24,1993,11.7,19,14,11,7,1,8,18,44.4,10,22,8,14,18,37,7,1,2019
FRA-Ligue 1,2018,Strasbourg,Stefan Mitrović,SRB,DF,28,1990,33.6,23,16,20,3,0,12,24,50.0,12,41,31,10,46,69,146,2,2019
FRA-Ligue 1,2018,Strasbourg,Youssouf Fofana,FRA,MF,19,1999,10.1,28,20,5,20,3,9,27,33.3,18,7,0,7,11,39,8,0,2019
FRA-Ligue 1,2018,Toulouse,Aaron Leya Iseka,BEL,FW,20,1997,16.0,6,4,1,4,1,1,4,25.0,3,5,3,2,1,7,10,0,2019
FRA-Ligue 1,2018,Toulouse,Bafodé Diakité,FRA,DF,17,2001,7.0,15,7,5,9,1,10,14,71.4,4,15,3,12,11,26,29,0,2019
FRA-Ligue 1,2018,Toulouse,Baptiste Reynet,FRA,GK,27,1990,30.0,0,0,0,0,0,0,3,0.0,3,0,0,0,1,1,14,2,2019
FRA-Ligue 1,2018,Toulouse,Christopher Jullien,FRA,DF,25,1993,33.5,35,24,23,10,2,12,32,37.5,20,39,27,12,41,76,203,4,2019
FRA-Ligue 1,2018,Toulouse,Clément Michelin,FRA,DF,21,1997,1.0,3,2,2,1,0,2,3,66.7,1,0,0,0,3,6,7,0,2019
FRA-Ligue 1,2018,Toulouse,Corentin Jean,FRA,"FW,MF",23,1995,7.0,9,6,3,6,0,2,8,25.0,6,8,0,8,2,11,5,0,2019
FRA-Ligue 1,2018,Toulouse,François Moubandje,SUI,DF,28,1990,21.5,38,22,22,10,6,17,22,77.3,5,18,4,14,27,65,74,0,2019
FRA-Ligue 1,2018,Toulouse,Gen Shoji,JPN,DF,25,1992,18.0,24,13,16,8,0,11,24,45.8,13,22,14,8,21,45,56,0,2019
FRA-Ligue 1,2018,Toulouse,Hakim El Mokeddem,BRA,"FW,MF",19,1999,0.3,1,1,1,0,0,0,1,0.0,1,0,0,0,0,1,1,0,2019
FRA-Ligue 1,2018,Toulouse,Ibrahim Sangaré,CIV,MF,20,1997,27.4,102,66,50,44,8,32,63,50.8,31,52,20,32,29,131,49,2,2019
FRA-Ligue 1,2018,Toulouse,Issiaga Sylla,GUI,"DF,MF",24,1994,22.2,54,36,30,24,0,28,53,52.8,25,36,10,26,39,93,77,0,2019
FRA-Ligue 1,2018,Toulouse,Jean-Clair Todibo,FRA,DF,18,1999,9.3,21,18,19,2,0,11,13,84.6,2,14,5,9,14,35,62,2,2019
FRA-Ligue 1,2018,Toulouse,Jimmy Durmaz,SWE,"MF,FW",29,1989,21.1,34,22,8,13,13,15,38,39.5,23,14,2,12,11,45,16,1,2019
FRA-Ligue 1,2018,Toulouse,John Bostock,TRI,MF,26,1992,10.9,24,14,14,10,0,9,30,30.0,21,12,2,10,17,41,11,0,2019
FRA-Ligue 1,2018,Toulouse,Kalidou Sidibé,FRA,MF,19,1999,14.0,24,12,11,12,1,7,15,46.7,8,16,3,13,17,41,26,1,2019
FRA-Ligue 1,2018,Toulouse,Kelvin Amian,FRA,DF,20,1998,32.0,68,45,54,12,2,20,30,66.7,10,36,13,23,36,104,113,1,2019
FRA-Ligue 1,2018,Toulouse,Kouadio Koné,FRA,MF,17,2001,0.8,4,2,0,4,0,2,4,50.0,2,0,0,0,0,4,0,0,2019
FRA-Ligue 1,2018,Toulouse,Manu García,ESP,MF,20,1998,20.5,37,26,14,17,6,15,49,30.6,34,16,1,15,15,52,5,0,2019
FRA-Ligue 1,2018,Toulouse,Mathieu Dossevi,TOG,"FW,MF",30,1988,27.4,42,28,20,11,11,13,40,32.5,27,29,1,28,33,75,13,0,2019
FRA-Ligue 1,2018,Toulouse,Mauro Goicoechea,URU,GK,30,1988,7.9,0,0,0,0,0,0,0,,0,0,0,0,0,0,7,0,2019
FRA-Ligue 1,2018,Toulouse,Max Gradel,CIV,"FW,MF",30,1987,36.0,58,35,34,19,5,24,70,34.3,46,53,9,44,18,76,41,0,2019
FRA-Ligue 1,2018,Toulouse,Nathan N'Goumou,FRA,FW,18,2000,0.8,1,1,0,1,0,0,1,0.0,1,1,0,1,0,1,3,0,2019
FRA-Ligue 1,2018,Toulouse,Ndombe Mubele,COD,FW,24,1994,5.2,9,4,5,2,2,4,9,44.4,5,4,0,4,2,11,2,0,2019
FRA-Ligue 1,2018,Toulouse,Steven Fortes,CPV,DF,26,1992,1.5,3,1,1,2,0,0,0,,0,1,1,0,2,5,9,2,2019
FRA-Ligue 1,2018,Toulouse,Steven Moreira,FRA,"DF,MF",23,1994,9.6,19,8,13,5,1,10,17,58.8,7,14,0,14,10,29,19,1,2019
FRA-Ligue 1,2018,Toulouse,Stéphane Mbia,CMR,"DF,MF",32,1986,5.0,1,0,1,0,0,1,2,50.0,1,9,4,5,7,8,25,1,2019
FRA-Ligue 1,2018,Toulouse,Yann Bodiger,FRA,MF,23,1995,0.1,0,0,0,0,0,0,1,0.0,1,0,0,0,0,0,0,0,2019
FRA-Ligue 1,2018,Toulouse,Yannick Cahuzac,FRA,"MF,DF",33,1985,15.9,33,19,15,15,3,17,32,53.1,15,16,4,12,24,57,55,0,2019
FRA-Ligue 1,2018,Toulouse,Yaya Sanogo,FRA,FW,25,1993,13.8,4,2,0,2,2,2,4,50.0,2,3,0,3,3,7,15,0,2019
FRA-Ligue 1,2019,Amiens,Alexis Blin,FRA,MF,22,1996,20.5,39,25,18,15,6,20,61,32.8,41,25,6,19,16,55,49,0,2020
FRA-Ligue 1,2019,Amiens,Arturo Calabresi,ITA,DF,23,1996,20.9,53,33,29,20,4,33,75,44.0,42,24,11,13,29,82,60,0,2020
FRA-Ligue 1,2019,Amiens,Aurélien Chedjou,CMR,DF,34,1985,21.9,27,19,18,9,0,10,22,45.5,12,15,11,4,40,67,120,3,2020
FRA-Ligue 1,2019,Amiens,Bakaye Dibassy,MLI,DF,29,1989,20.8,26,14,17,8,1,15,20,75.0,5,29,18,11,37,63,78,2,2020
FRA-Ligue 1,2019,Amiens,Bongani Zungu,RSA,MF,26,1992,11.0,27,11,10,13,4,18,31,58.1,13,8,2,6,16,43,21,0,2020
FRA-Ligue 1,2019,Amiens,Chadrac Akolo,COD,"FW,MF",24,1995,6.0,16,8,8,6,2,5,12,41.7,7,6,1,5,5,21,5,0,2020
FRA-Ligue 1,2019,Amiens,Cheick Timite,CIV,"MF,FW",21,1997,1.3,1,0,0,1,0,0,1,0.0,1,0,0,0,2,3,1,0,2020
FRA-Ligue 1,2019,Amiens,Christophe Jallet,FRA,DF,35,1983,9.5,24,16,14,8,2,14,37,37.8,23,8,2,6,18,42,29,0,2020
FRA-Ligue 1,2019,Amiens,Eddy Gnahoré,FRA,MF,25,1993,12.6,24,12,7,15,2,8,28,28.6,20,25,4,21,9,33,25,0,2020
FRA-Ligue 1,2019,Amiens,Fousseni Diabaté,MLI,"FW,MF",23,1995,13.2,16,10,6,6,4,5,16,31.3,11,11,0,11,8,24,3,1,2020
FRA-Ligue 1,2019,Amiens,Gaël Kakuta,COD,"MF,FW",28,1991,22.2,46,27,13,27,6,17,48,35.4,31,15,1,14,16,62,8,2,2020
FRA-Ligue 1,2019,Amiens,Haitam Aleesami,NOR,DF,28,1991,21.3,36,16,25,9,2,18,43,41.9,25,33,10,23,34,70,59,1,2020
FRA-Ligue 1,2019,Amiens,Isaac Mbenza,BEL,FW,23,1996,0.9,0,0,0,0,0,0,1,0.0,1,0,0,0,0,0,0,0,2020
FRA-Ligue 1,2019,Amiens,Jack Lahne,SWE,FW,17,2001,0.1,1,1,0,0,1,0,0,,0,0,0,0,0,1,0,0,2020
FRA-Ligue 1,2019,Amiens,Jordan Lefort,FRA,DF,25,1993,9.4,3,2,2,1,0,3,5,60.0,2,4,1,3,9,12,29,0,2020
FRA-Ligue 1,2019,Amiens,Juan Ferney Otero,COL,"FW,MF",24,1995,13.4,17,10,6,9,2,8,24,33.3,16,12,1,11,19,36,10,0,2020
FRA-Ligue 1,2019,Amiens,Mahdi Talal,FRA,FW,21,1997,0.2,0,0,0,0,0,0,1,0.0,1,1,0,1,0,0,2,0,2020
FRA-Ligue 1,2019,Amiens,Mathieu Bodmer,FRA,"MF,FW",36,1982,1.0,0,0,0,0,0,0,1,0.0,1,1,1,0,1,1,1,0,2020
FRA-Ligue 1,2019,Amiens,Moussa Konaté,SEN,FW,26,1993,6.8,3,0,0,3,0,0,2,0.0,2,2,0,2,1,4,1,0,2020
FRA-Ligue 1,2019,Amiens,Nicholas Opoku,GHA,DF,21,1997,7.0,7,5,6,1,0,7,14,50.0,7,6,2,4,7,14,32,0,2020
FRA-Ligue 1,2019,Amiens,Prince-Désir Gouano,FRA,DF,25,1993,3.0,3,1,0,3,0,0,0,,0,6,3,3,2,5,15,0,2020
FRA-Ligue 1,2019,Amiens,Quentin Cornette,FRA,"FW,MF",25,1994,3.9,8,3,3,2,3,3,9,33.3,6,7,1,6,6,14,5,0,2020
FRA-Ligue 1,2019,Amiens,Régis Gurtner,FRA,GK,32,1986,28.0,1,1,1,0,0,1,2,50.0,1,0,0,0,0,1,10,4,2020
FRA-Ligue 1,2019,Amiens,Saman Ghoddos,IRN,FW,25,1993,2.6,2,2,0,1,1,1,2,50.0,1,5,0,5,2,4,3,0,2020
FRA-Ligue 1,2019,Amiens,Sehrou Guirassy,GUI,FW,23,1996,21.3,7,3,1,4,2,2,7,28.6,5,13,6,7,4,11,21,0,2020
FRA-Ligue 1,2019,Amiens,Stiven Mendoza,COL,"FW,MF",27,1992,12.2,12,7,4,5,3,4,22,18.2,18,13,2,11,9,21,3,1,2020
FRA-Ligue 1,2019,Amiens,Thomas Monconduit,FRA,MF,28,1991,15.2,26,12,6,18,2,9,26,34.6,17,11,4,7,10,36,25,3,2020
FRA-Ligue 1,2019,Angers,Abdoulaye Bamba,CIV,DF,29,1990,6.2,10,7,7,1,2,8,15,53.3,7,4,1,3,4,14,18,0,2020
FRA-Ligue 1,2019,Angers,Angelo Fulgini,FRA,MF,22,1996,17.5,28,18,8,15,5,12,23,52.2,11,6,1,5,19,47,10,0,2020
FRA-Ligue 1,2019,Angers,Antonin Bobichon,FRA,MF,23,1995,7.2,9,4,4,5,0,2,19,10.5,17,7,0,7,7,16,4,0,2020
FRA-Ligue 1,2019,Angers,Baptiste Santamaria,FRA,MF,24,1995,27.8,91,53,39,43,9,35,79,44.3,44,27,5,22,43,134,36,0,2020
FRA-Ligue 1,2019,Angers,Casimir Ninga,CHA,"MF,FW",26,1993,7.6,5,5,4,0,1,1,5,20.0,4,5,0,5,3,8,2,0,2020
FRA-Ligue 1,2019,Angers,Danijel Petković,MNE,GK,26,1993,2.0,0,0,0,0,0,0,0,,0,0,0,0,0,0,2,0,2020
FRA-Ligue 1,2019,Angers,Farid El Melali,ALG,"MF,FW",22,1997,3.4,7,5,2,2,3,4,14,28.6,10,5,0,5,2,9,4,0,2020
FRA-Ligue 1,2019,Angers,Ibrahim Cissé,SEN,DF,23,1996,0.7,2,1,0,2,0,0,0,,0,0,0,0,0,2,2,0,2020
FRA-Ligue 1,2019,Angers,Ismaël Traoré,CIV,DF,32,1986,22.8,23,12,14,7,2,10,17,58.8,7,23,13,10,27,50,85,1,2020
FRA-Ligue 1,2019,Angers,Jeff Reine-Adélaïde,FRA,MF,21,1998,0.9,3,1,1,2,0,1,1,100.0,0,1,0,1,0,3,1,0,2020
FRA-Ligue 1,2019,Angers,Ludovic Butelle,FRA,GK,36,1983,26.0,1,1,1,0,0,1,2,50.0,1,1,0,1,0,1,10,4,2020
FRA-Ligue 1,2019,Angers,Mateo Pavlović,BIH,DF,29,1990,9.0,8,2,6,2,0,5,7,71.4,2,4,2,2,5,13,38,1,2020
FRA-Ligue 1,2019,Angers,Mathias Pereira Lage,POR,MF,22,1996,17.1,30,18,16,13,1,12,37,32.4,25,19,0,19,17,47,9,0,2020
FRA-Ligue 1,2019,Angers,Pierrick Capelle,FRA,"MF,DF",32,1987,19.4,42,32,18,16,8,16,48,33.3,32,17,3,14,21,63,28,0,2020
FRA-Ligue 1,2019,Angers,Rachid Alioui,MAR,FW,27,1992,17.4,8,5,0,7,1,2,13,15.4,11,3,0,3,2,10,9,0,2020
FRA-Ligue 1,2019,Angers,Rayan Aït Nouri,ALG,DF,18,2001,14.2,29,22,14,8,7,10,21,47.6,11,14,1,13,18,47,33,0,2020
FRA-Ligue 1,2019,Angers,Romain Thomas,FRA,DF,31,1988,26.0,24,17,16,7,1,8,18,44.4,10,35,18,17,39,63,118,1,2020
FRA-Ligue 1,2019,Angers,Sada Thioub,SEN,"MF,FW",24,1995,16.8,20,12,8,9,3,5,18,27.8,13,9,1,8,4,24,5,0,2020
FRA-Ligue 1,2019,Angers,Souleyman Doumbia,CIV,DF,22,1996,5.0,10,4,7,2,1,5,6,83.3,1,5,0,5,6,16,18,0,2020
FRA-Ligue 1,2019,Angers,Stéphane Bahoken,CMR,FW,27,1992,10.1,7,4,1,2,4,1,7,14.3,6,4,1,3,2,9,2,0,2020
FRA-Ligue 1,2019,Angers,Thomas Mangani,FRA,MF,32,1987,20.8,33,23,15,16,2,14,47,29.8,33,17,2,15,12,45,20,1,2020
FRA-Ligue 1,2019,Angers,Théo Pellenard,FRA,DF,25,1994,5.1,11,8,6,3,2,6,13,46.2,7,4,0,4,5,16,8,0,2020
FRA-Ligue 1,2019,Angers,Vincent Manceau,FRA,DF,30,1989,22.0,34,22,18,13,3,16,36,44.4,20,16,3,13,22,56,51,0,2020
FRA-Ligue 1,2019,Angers,Vincent Pajot,FRA,MF,28,1990,1.3,2,2,1,1,0,1,1,100.0,0,3,0,3,5,7,0,0,2020
FRA-Ligue 1,2019,Angers,Wilfried Kanga,CIV,FW,21,1998,0.8,0,0,0,0,0,0,1,0.0,1,0,0,0,0,0,0,0,2020
FRA-Ligue 1,2019,Angers,Zinédine Ould Khaled,FRA,MF,19,2000,0.7,2,1,0,2,0,2,4,50.0,2,0,0,0,4,6,0,0,2020
FRA-Ligue 1,2019,Bordeaux,Albert Lottin,FRA,MF,17,2001,0.5,2,0,2,0,0,1,4,25.0,3,0,0,0,2,4,2,0,2020
FRA-Ligue 1,2019,Bordeaux,Aurélien Tchouaméni,FRA,MF,19,2000,12.3,30,14,15,13,2,11,27,40.7,16,11,3,8,13,43,19,1,2020
FRA-Ligue 1,2019,Bordeaux,Benoît Costil,FRA,GK,32,1987,28.0,0,0,0,0,0,0,3,0.0,3,0,0,0,2,2,9,0,2020
FRA-Ligue 1,2019,Bordeaux,Enock Kwateng,FRA,DF,22,1997,10.9,36,22,17,17,2,22,47,46.8,25,16,6,10,22,58,41,0,2020
FRA-Ligue 1,2019,Bordeaux,François Kamano,GUI,"DF,MF",23,1996,7.2,12,6,5,4,3,8,15,53.3,7,5,0,5,3,15,2,0,2020
FRA-Ligue 1,2019,Bordeaux,Hwang Ui-jo,KOR,"FW,MF",26,1992,18.1,9,7,2,5,2,4,20,20.0,16,7,0,7,5,14,5,0,2020
FRA-Ligue 1,2019,Bordeaux,Jimmy Briand,FRA,FW,33,1985,16.9,12,8,5,4,3,3,13,23.1,10,8,4,4,6,18,12,0,2020
FRA-Ligue 1,2019,Bordeaux,Jonathan Cafu,BRA,DF,28,1991,2.2,7,3,4,3,0,4,7,57.1,3,1,0,1,1,8,3,0,2020
FRA-Ligue 1,2019,Bordeaux,Josh Maja,NGA,FW,20,1998,8.2,5,2,0,2,3,1,10,10.0,9,8,4,4,1,6,3,0,2020
FRA-Ligue 1,2019,Bordeaux,Laurent Koscielny,FRA,DF,33,1985,24.3,28,13,24,4,0,10,20,50.0,10,23,19,4,26,54,104,0,2020
FRA-Ligue 1,2019,Bordeaux,Loris Benito,SUI,DF,27,1992,21.1,40,25,23,11,6,16,43,37.2,27,14,5,9,29,69,58,1,2020
FRA-Ligue 1,2019,Bordeaux,Maxime Poundjé,FRA,DF,26,1992,0.0,0,0,0,0,0,0,0,,0,0,0,0,0,0,0,0,2020
FRA-Ligue 1,2019,Bordeaux,Mexer,MOZ,DF,30,1988,16.5,16,11,14,1,1,10,30,33.3,20,14,13,1,15,31,47,0,2020
FRA-Ligue 1,2019,Bordeaux,Nicolas de Préville,FRA,"MF,FW",28,1991,22.2,35,21,9,22,4,18,56,32.1,38,15,3,12,6,41,19,0,2020
FRA-Ligue 1,2019,Bordeaux,Otávio,BRA,MF,25,1994,24.6,80,45,23,52,5,35,82,42.7,47,26,9,17,41,121,40,6,2020
FRA-Ligue 1,2019,Bordeaux,Pablo,BRA,DF,28,1991,24.1,27,15,22,5,0,16,31,51.6,15,25,14,11,40,67,130,2,2020
FRA-Ligue 1,2019,Bordeaux,Raoul Bellanova,ITA,DF,19,2000,0.7,1,1,1,0,0,0,1,0.0,1,0,0,0,0,1,0,0,2020
FRA-Ligue 1,2019,Bordeaux,Remi Oudin,FRA,"FW,MF",22,1996,6.2,9,6,4,4,1,4,14,28.6,10,7,1,6,9,18,5,0,2020
FRA-Ligue 1,2019,Bordeaux,Rubén Pardo,ESP,MF,26,1992,2.1,3,2,2,1,0,2,3,66.7,1,0,0,0,1,4,2,1,2020
FRA-Ligue 1,2019,Bordeaux,Samuel Kalu,NGA,"DF,FW",21,1997,15.1,33,17,19,12,2,16,36,44.4,20,13,1,12,24,57,10,0,2020
FRA-Ligue 1,2019,Bordeaux,Toma Bašić,CRO,MF,22,1996,11.0,26,22,9,16,1,12,27,44.4,15,14,2,12,9,35,12,1,2020
FRA-Ligue 1,2019,Bordeaux,Vukašin Jovanović,SRB,DF,23,1996,6.4,18,11,12,6,0,14,21,66.7,7,5,3,2,15,33,15,0,2020
FRA-Ligue 1,2019,Bordeaux,Yacine Adli,FRA,MF,19,2000,11.3,22,14,4,15,3,11,34,32.4,23,10,0,10,8,30,3,0,2020
FRA-Ligue 1,2019,Bordeaux,Yassine Benrahou,FRA,"FW,MF",20,1999,1.9,3,0,1,1,1,2,5,40.0,3,1,0,1,2,5,1,0,2020
FRA-Ligue 1,2019,Bordeaux,Youssef Aït Bennasser,MAR,MF,23,1996,6.0,11,8,6,4,1,4,24,16.7,20,6,1,5,4,15,10,1,2020
FRA-Ligue 1,2019,Bordeaux,Youssouf Sabaly,SEN,DF,26,1993,10.1,18,11,9,4,5,6,22,27.3,16,8,1,7,18,36,23,0,2020
FRA-Ligue 1,2019,Brest,Alexandre Mendy,GNB,FW,25,1994,10.0,5,1,1,0,4,1,4,25.0,3,4,1,3,0,5,10,0,2020
FRA-Ligue 1,2019,Brest,Brendan Chardonnet,FRA,DF,24,1994,9.1,12,6,10,2,0,7,12,58.3,5,8,5,3,15,27,50,0,2020
FRA-Ligue 1,2019,Brest,Cristian Battocchio,ITA,MF,27,1992,15.5,31,24,13,13,5,14,36,38.9,22,13,4,9,19,50,21,0,2020
FRA-Ligue 1,2019,Brest,Donovan Léon,GUF,GK,26,1992,1.4,0,0,0,0,0,0,0,,0,1,0,1,0,0,0,0,2020
FRA-Ligue 1,2019,Brest,Dénys Bain,FRA,DF,26,1993,14.1,21,14,15,6,0,9,9,100.0,0,13,10,3,28,49,66,0,2020
FRA-Ligue 1,2019,Brest,Ferris N'Goma,FRA,"MF,FW",26,1993,0.3,0,0,0,0,0,0,0,,0,1,0,1,0,0,0,0,2020
FRA-Ligue 1,2019,Brest,Gautier Larsonneur,FRA,GK,22,1997,26.6,2,1,2,0,0,2,4,50.0,2,1,0,1,4,6,14,3,2020
FRA-Ligue 1,2019,Brest,Gaëtan Belaud,FRA,DF,32,1986,6.4,13,7,10,2,1,4,8,50.0,4,8,3,5,15,28,15,0,2020
FRA-Ligue 1,2019,Brest,Gaëtan Charbonnier,FRA,"FW,MF",30,1988,22.9,36,16,11,11,14,10,35,28.6,25,19,6,13,7,43,33,1,2020
FRA-Ligue 1,2019,Brest,Haris Belkebla,ALG,MF,25,1994,20.2,44,24,17,17,10,10,28,35.7,18,25,5,20,53,97,21,2,2020
FRA-Ligue 1,2019,Brest,Hianga Mananga Mbock,FRA,MF,19,1999,1.6,1,1,1,0,0,0,0,,0,0,0,0,4,5,0,0,2020
FRA-Ligue 1,2019,Brest,Hugo Magnetti,FRA,MF,21,1998,2.6,16,10,7,7,2,5,9,55.6,4,4,0,4,7,23,4,0,2020
FRA-Ligue 1,2019,Brest,Ibrahima Diallo,FRA,MF,20,1999,17.3,38,24,15,22,1,12,29,41.4,17,9,2,7,23,61,16,3,2020
FRA-Ligue 1,2019,Brest,Irvin Cardona,FRA,"FW,MF",21,1997,16.1,13,8,5,6,2,9,32,28.1,23,8,0,8,1,14,7,0,2020
FRA-Ligue 1,2019,Brest,Jean-Charles Castelletto,CMR,DF,24,1995,20.4,18,9,13,5,0,9,18,50.0,9,20,16,4,33,51,87,1,2020
FRA-Ligue 1,2019,Brest,Jean-Kevin Duverne,FRA,DF,22,1997,13.1,12,8,5,6,1,2,6,33.3,4,23,8,15,20,32,50,0,2020
FRA-Ligue 1,2019,Brest,Julien Faussurier,FRA,DF,32,1987,22.0,36,22,23,13,0,21,53,39.6,32,22,7,15,33,69,46,1,2020
FRA-Ligue 1,2019,Brest,Kévin Mayi,GAB,"FW,MF",26,1993,0.0,0,0,0,0,0,0,0,,0,0,0,0,0,0,0,0,2020
FRA-Ligue 1,2019,Brest,Ludovic Baal,GUF,DF,33,1986,9.2,27,15,13,12,2,10,22,45.5,12,9,3,6,17,44,20,0,2020
FRA-Ligue 1,2019,Brest,Mathias Autret,FRA,"MF,FW",28,1991,13.6,23,17,5,11,7,8,25,32.0,17,14,1,13,10,33,3,0,2020
FRA-Ligue 1,2019,Brest,Paul Lasne,FRA,"MF,FW",30,1989,13.6,25,13,13,11,1,6,20,30.0,14,7,2,5,7,32,5,0,2020
FRA-Ligue 1,2019,Brest,Romain Perraud,FRA,DF,21,1997,18.6,29,14,18,9,2,14,28,50.0,14,24,9,15,27,56,50,0,2020
FRA-Ligue 1,2019,Brest,Samuel Grandsir,FRA,"FW,MF",22,1996,16.6,34,22,13,16,5,11,30,36.7,19,9,0,9,14,48,5,0,2020
FRA-Ligue 1,2019,Brest,Yoann Court,FRA,"FW,MF",29,1990,16.3,48,26,28,17,3,20,64,31.3,44,21,0,21,15,63,14,0,2020
FRA-Ligue 1,2019,Dijon,Ahmad Ngouyamsa,CMR,DF,18,2000,0.6,1,0,1,0,0,0,3,0.0,3,1,1,0,1,2,5,0,2020
FRA-Ligue 1,2019,Dijon,Alfred Gomis,SEN,GK,25,1993,18.0,1,0,1,0,0,1,2,50.0,1,2,0,2,0,1,14,2,2020
FRA-Ligue 1,2019,Dijon,Benjamin Jeannot,FRA,"MF,FW",27,1992,1.9,2,1,0,1,1,0,4,0.0,4,2,0,2,2,4,4,0,2020
FRA-Ligue 1,2019,Dijon,Bruno Ecuele Manga,GAB,DF,31,1988,28.0,22,15,17,5,0,9,20,45.0,11,34,23,11,37,59,112,2,2020
FRA-Ligue 1,2019,Dijon,Bryan Soumaré,FRA,"MF,FW",20,1999,4.3,12,1,6,5,1,6,9,66.7,3,1,0,1,2,14,1,0,2020
FRA-Ligue 1,2019,Dijon,Didier Ibrahim Ndong,GAB,MF,25,1994,26.5,62,35,30,31,1,30,59,50.8,29,27,6,21,49,111,31,0,2020
FRA-Ligue 1,2019,Dijon,Enzo Loiodice,FRA,MF,18,2000,2.1,6,4,1,4,1,1,3,33.3,2,2,0,2,2,8,1,0,2020
FRA-Ligue 1,2019,Dijon,Florent Balmont,FRA,MF,39,1980,4.5,12,6,5,7,0,7,12,58.3,5,6,0,6,1,13,3,0,2020
FRA-Ligue 1,2019,Dijon,Fouad Chafik,MAR,DF,32,1986,17.0,32,21,22,7,3,17,36,47.2,19,12,5,7,26,58,36,0,2020
FRA-Ligue 1,2019,Dijon,Frédéric Sammaritano,FRA,"MF,FW",33,1986,5.8,9,7,4,4,1,4,11,36.4,7,6,1,5,2,11,3,1,2020
FRA-Ligue 1,2019,Dijon,Hamza Mendyl,MAR,DF,21,1997,16.0,49,32,31,14,4,29,46,63.0,17,16,4,12,23,72,47,0,2020
FRA-Ligue 1,2019,Dijon,Jhonder Cádiz,VEN,"FW,MF",24,1995,8.9,16,8,6,7,3,3,7,42.9,4,4,2,2,1,17,9,0,2020
FRA-Ligue 1,2019,Dijon,Jordan Marié,FRA,"MF,FW",27,1991,2.2,7,5,4,3,0,4,9,44.4,5,3,1,2,4,11,2,0,2020
FRA-Ligue 1,2019,Dijon,Jules Keita,GUI,"MF,FW",21,1998,1.8,4,3,2,1,1,1,6,16.7,5,1,0,1,3,7,0,0,2020
FRA-Ligue 1,2019,Dijon,Júlio Tavares,CPV,FW,30,1988,22.2,12,8,1,6,5,4,17,23.5,13,9,2,7,8,20,29,0,2020
FRA-Ligue 1,2019,Dijon,Mama Samba Baldé,GNB,"FW,MF",23,1995,18.6,24,13,9,8,7,7,30,23.3,23,17,0,17,7,31,24,0,2020
FRA-Ligue 1,2019,Dijon,Matheus Pereira da Silva,BRA,"MF,FW",21,1998,5.2,10,6,1,6,3,4,10,40.0,6,11,0,11,6,16,5,0,2020
FRA-Ligue 1,2019,Dijon,Mickaël Alphonse,GLP,DF,30,1989,15.3,39,25,26,12,1,23,37,62.2,14,19,3,16,17,56,64,0,2020
FRA-Ligue 1,2019,Dijon,Mounir Chouiar,FRA,"MF,FW",20,1999,16.7,36,23,13,18,5,12,42,28.6,30,8,0,8,13,49,13,0,2020
FRA-Ligue 1,2019,Dijon,Muzinga Ngonda,COD,DF,24,1994,6.0,15,6,10,3,2,7,10,70.0,3,5,4,1,11,26,23,0,2020
FRA-Ligue 1,2019,Dijon,Nayef Aguerd,MAR,DF,23,1996,10.6,13,9,7,5,1,8,12,66.7,4,11,11,0,18,31,54,0,2020
FRA-Ligue 1,2019,Dijon,Rayan Philippe,FRA,FW,18,2000,0.3,0,0,0,0,0,0,1,0.0,1,0,0,0,1,1,1,1,2020
FRA-Ligue 1,2019,Dijon,Romain Amalfitano,FRA,MF,29,1989,18.8,43,27,18,21,4,21,61,34.4,40,23,9,14,36,79,14,2,2020
FRA-Ligue 1,2019,Dijon,Rúnar Alex Rúnarsson,ISL,GK,24,1995,10.0,0,0,0,0,0,0,2,0.0,2,0,0,0,0,0,3,3,2020
FRA-Ligue 1,2019,Dijon,Senou Coulibaly,MLI,DF,24,1994,7.4,14,7,11,3,0,2,4,50.0,2,11,10,1,10,24,44,1,2020
FRA-Ligue 1,2019,Dijon,Stephy Mavididi,ENG,"FW,MF",21,1998,15.5,18,11,7,8,3,10,26,38.5,16,11,0,11,7,25,5,0,2020
FRA-Ligue 1,2019,Dijon,Wesley Lautoa,NCL,"MF,DF",31,1987,20.8,54,29,24,28,2,28,63,44.4,35,31,16,15,42,96,48,2,2020
FRA-Ligue 1,2019,Dijon,Yassine Benzia,ALG,MF,24,1994,1.9,3,2,2,1,0,1,6,16.7,5,4,2,2,3,6,1,0,2020
FRA-Ligue 1,2019,Lille,Abou Ouattara,BFA,FW,19,1999,0.1,0,0,0,0,0,0,0,,0,0,0,0,0,0,1,0,2020
FRA-Ligue 1,2019,Lille,Adama Soumaoro,FRA,DF,27,1992,4.6,1,1,0,1,0,0,0,,0,6,5,1,4,5,17,0,2020
FRA-Ligue 1,2019,Lille,Benjamin André,FRA,MF,28,1990,22.8,72,44,31,35,6,29,74,39.2,45,32,9,23,59,131,40,1,2020
FRA-Ligue 1,2019,Lille,Boubakary Soumaré,FRA,MF,20,1999,13.5,19,12,6,13,0,9,19,47.4,10,6,0,6,16,35,9,0,2020
FRA-Ligue 1,2019,Lille,Cheikh Niasse,SEN,MF,19,2000,0.2,0,0,0,0,0,0,0,,0,0,0,0,0,0,0,0,2020
FRA-Ligue 1,2019,Lille,Domagoj Bradarić,CRO,DF,19,1999,15.8,28,11,9,17,2,12,27,44.4,15,16,3,13,22,50,28,0,2020
FRA-Ligue 1,2019,Lille,Gabriel Dos Santos,BRA,DF,21,1997,23.2,41,29,27,11,3,15,22,68.2,7,27,18,9,22,63,86,2,2020
FRA-Ligue 1,2019,Lille,Jean Onana,CMR,MF,19,2000,0.9,0,0,0,0,0,0,2,0.0,2,1,0,1,1,1,0,0,2020
FRA-Ligue 1,2019,Lille,Jonathan Bamba,CIV,"FW,MF",23,1996,21.5,12,6,5,5,2,7,29,24.1,22,19,3,16,16,28,8,2,2020
FRA-Ligue 1,2019,Lille,Jonathan Ikone,FRA,"MF,FW",21,1998,22.9,15,7,3,7,5,6,24,25.0,18,26,2,24,5,20,3,0,2020
FRA-Ligue 1,2019,Lille,José Fonte,POR,DF,35,1983,24.5,19,11,11,7,1,11,22,50.0,11,19,11,8,28,47,90,1,2020
FRA-Ligue 1,2019,Lille,Jérémy Pied,FRA,DF,30,1989,5.0,18,10,6,11,1,11,16,68.8,5,8,0,8,7,25,10,0,2020
FRA-Ligue 1,2019,Lille,Loïc Rémy,FRA,FW,32,1987,10.7,4,1,0,3,1,0,4,0.0,4,1,1,0,0,4,7,0,2020
FRA-Ligue 1,2019,Lille,Luiz Araújo,BRA,"FW,MF",23,1996,9.2,20,11,3,8,9,5,31,16.1,26,14,0,14,4,24,6,0,2020
FRA-Ligue 1,2019,Lille,Mike Maignan,FRA,GK,24,1995,28.0,0,0,0,0,0,0,0,,0,0,0,0,2,2,5,0,2020
FRA-Ligue 1,2019,Lille,Nicolás Gaitán,ARG,"MF,FW",31,1988,0.6,1,0,0,1,0,1,1,100.0,0,1,0,1,0,1,1,0,2020
FRA-Ligue 1,2019,Lille,Reinildo Mandava,MOZ,"DF,MF",25,1994,12.3,37,21,23,11,3,25,41,61.0,16,16,1,15,19,56,20,0,2020
FRA-Ligue 1,2019,Lille,Renato Sanches,POR,"MF,FW",21,1997,16.5,28,15,9,15,4,8,33,24.2,25,19,1,18,15,43,10,1,2020
FRA-Ligue 1,2019,Lille,Thiago Maia,BRA,MF,22,1997,0.5,4,4,1,3,0,0,1,0.0,1,0,0,0,1,5,1,0,2020
FRA-Ligue 1,2019,Lille,Tiago Djaló,POR,DF,19,2000,7.3,9,4,5,3,1,2,7,28.6,5,3,2,1,11,20,28,0,2020
FRA-Ligue 1,2019,Lille,Timothy Weah,USA,"MF,FW",19,2000,0.9,0,0,0,0,0,0,1,0.0,1,0,0,0,0,0,1,0,2020
FRA-Ligue 1,2019,Lille,Victor Osimhen,NGA,FW,20,1998,25.4,8,4,1,0,7,1,11,9.1,10,8,0,8,11,19,32,0,2020
FRA-Ligue 1,2019,Lille,Xeka,POR,MF,24,1994,7.9,18,10,3,13,2,9,29,31.0,20,11,1,10,4,22,7,1,2020
FRA-Ligue 1,2019,Lille,Yusuf Yazıcı,TUR,"MF,FW",22,1997,9.4,17,8,2,11,4,5,13,38.5,8,6,1,5,5,22,1,1,2020
FRA-Ligue 1,2019,Lille,Zeki Çelik,TUR,DF,22,1997,23.0,53,28,18,28,7,27,60,45.0,33,24,4,20,26,79,39,0,2020
FRA-Ligue 1,2019,Lyon,Amine Gouiri,FRA,FW,19,2000,0.0,0,0,0,0,0,0,0,,0,0,0,0,0,0,0,0,2020
FRA-Ligue 1,2019,Lyon,Anthony Lopes,POR,GK,28,1990,26.0,0,0,0,0,0,0,0,,0,0,0,0,1,1,11,0,2020
FRA-Ligue 1,2019,Lyon,Bertrand Traoré,BFA,"FW,MF",23,1995,13.9,27,14,8,12,7,8,19,42.1,11,17,2,15,21,48,16,0,2020
FRA-Ligue 1,2019,Lyon,Bruno Guimarães,BRA,MF,21,1997,3.0,12,7,5,6,1,5,10,50.0,5,1,0,1,4,16,1,0,2020
FRA-Ligue 1,2019,Lyon,Ciprian Tătărușanu,ROU,GK,33,1986,2.0,0,0,0,0,0,0,0,,0,0,0,0,0,0,0,1,2020
FRA-Ligue 1,2019,Lyon,Fernando Marçal,BRA,DF,30,1989,9.2,28,18,18,7,3,13,26,50.0,13,7,3,4,26,54,32,0,2020
FRA-Ligue 1,2019,Lyon,Houssem Aouar,ALG,"MF,FW",21,1998,21.7,28,12,6,18,4,10,35,28.6,25,15,1,14,13,41,11,0,2020
FRA-Ligue 1,2019,Lyon,Jason Denayer,BEL,DF,24,1995,23.7,17,13,12,5,0,10,14,71.4,4,32,29,3,20,37,83,0,2020
FRA-Ligue 1,2019,Lyon,Jean Lucas,BRA,MF,21,1998,2.2,16,7,8,5,3,2,9,22.2,7,2,2,0,2,18,0,0,2020
FRA-Ligue 1,2019,Lyon,Jeff Reine-Adélaïde,FRA,"MF,FW",21,1998,8.7,10,8,3,3,4,5,13,38.5,8,3,1,2,7,17,4,0,2020
FRA-Ligue 1,2019,Lyon,Joachim Andersen,DEN,DF,23,1996,17.0,17,9,15,2,0,7,19,36.8,12,16,12,4,10,27,74,2,2020
FRA-Ligue 1,2019,Lyon,Karl Toko Ekambi,CMR,"FW,MF",26,1992,6.0,5,2,0,1,4,3,5,60.0,2,2,0,2,5,10,1,0,2020
FRA-Ligue 1,2019,Lyon,Kenny Tete,NED,DF,23,1995,11.9,33,21,12,16,5,15,23,65.2,8,12,3,9,19,52,34,0,2020
FRA-Ligue 1,2019,Lyon,Leo Dubois,FRA,DF,24,1994,15.0,32,23,20,9,3,13,22,59.1,9,12,4,8,18,50,34,1,2020
FRA-Ligue 1,2019,Lyon,Lucas Tousart,FRA,MF,22,1997,19.6,58,32,19,34,5,17,56,30.4,39,19,7,12,31,89,27,1,2020
FRA-Ligue 1,2019,Lyon,Marcelo,BRA,DF,32,1987,16.7,27,18,18,8,1,16,23,69.6,7,12,11,1,22,49,77,0,2020
FRA-Ligue 1,2019,Lyon,Martin Terrier,FRA,"FW,MF",22,1997,13.3,20,15,7,10,3,3,14,21.4,11,14,1,13,10,30,11,0,2020
FRA-Ligue 1,2019,Lyon,Maxence Caqueret,FRA,MF,19,2000,6.3,24,15,10,13,1,11,25,44.0,14,14,2,12,9,33,6,1,2020
FRA-Ligue 1,2019,Lyon,Maxwel Cornet,CIV,"FW,DF",22,1996,14.8,30,19,18,8,4,13,23,56.5,10,16,1,15,21,51,19,1,2020
FRA-Ligue 1,2019,Lyon,Melvin Bard,FRA,DF,18,2000,0.5,0,0,0,0,0,0,0,,0,0,0,0,1,1,0,0,2020
FRA-Ligue 1,2019,Lyon,Memphis,NED,"FW,MF",25,1994,11.3,4,3,2,0,2,0,5,0.0,5,0,0,0,2,6,2,0,2020
FRA-Ligue 1,2019,Lyon,Moussa Dembélé,FRA,FW,23,1996,24.3,12,7,2,5,5,4,14,28.6,10,14,3,11,5,17,31,0,2020
FRA-Ligue 1,2019,Lyon,Oumar Solet,FRA,DF,19,2000,0.1,0,0,0,0,0,0,0,,0,1,1,0,0,0,1,0,2020
FRA-Ligue 1,2019,Lyon,Rafael,BRA,DF,29,1990,7.8,24,16,12,8,4,10,18,55.6,8,6,3,3,10,34,14,0,2020
FRA-Ligue 1,2019,Lyon,Rayan Cherki,FRA,"MF,FW",15,2003,1.6,3,2,0,1,2,3,4,75.0,1,3,0,3,0,3,0,0,2020
FRA-Ligue 1,2019,Lyon,Thiago Mendes,BRA,MF,27,1992,20.1,43,29,20,19,4,21,45,46.7,24,21,7,14,46,89,36,0,2020
FRA-Ligue 1,2019,Lyon,Youssouf Koné,MLI,DF,24,1995,9.1,22,14,17,3,2,12,20,60.0,8,2,1,1,8,30,15,0,2020
FRA-Ligue 1,2019,Marseille,Boubacar Kamara,FRA,"DF,MF",19,1999,23.8,67,34,37,27,3,27,57,47.4,30,27,14,13,34,101,53,1,2020
FRA-Ligue 1,2019,Marseille,Bouna Sarr,SEN,"DF,FW",27,1992,24.0,60,37,30,19,11,30,53,56.6,23,17,1,16,32,92,38,0,2020
FRA-Ligue 1,2019,Marseille,Darío Benedetto,ARG,FW,29,1990,23.3,12,9,0,9,3,3,18,16.7,15,15,2,13,3,15,23,1,2020
FRA-Ligue 1,2019,Marseille,Dimitri Payet,FRA,"FW,MF",32,1987,21.4,22,12,8,8,6,10,26,38.5,16,8,1,7,8,30,12,0,2020
FRA-Ligue 1,2019,Marseille,Duje Ćaleta-Car,CRO,DF,22,1996,21.0,29,15,17,11,1,18,26,69.2,8,17,6,11,26,55,98,0,2020
FRA-Ligue 1,2019,Marseille,Florian Chabrolle,FRA,MF,21,1998,0.2,0,0,0,0,0,0,0,,0,0,0,0,0,0,0,0,2020
FRA-Ligue 1,2019,Marseille,Florian Thauvin,FRA,FW,26,1993,0.2,1,0,0,1,0,0,1,0.0,1,0,0,0,0,1,0,0,2020
FRA-Ligue 1,2019,Marseille,Hiroki Sakai,JPN,DF,29,1990,18.0,57,36,26,24,7,25,40,62.5,15,20,5,15,23,80,34,1,2020
FRA-Ligue 1,2019,Marseille,Isaac Lihadji,FRA,MF,17,2002,0.3,0,0,0,0,0,0,0,,0,0,0,0,0,0,0,0,2020
FRA-Ligue 1,2019,Marseille,Jordan Amavi,FRA,DF,25,1994,24.0,55,29,31,19,5,31,64,48.4,33,27,6,21,56,111,97,0,2020
FRA-Ligue 1,2019,Marseille,Kevin Strootman,NED,MF,29,1990,15.7,39,27,13,23,3,20,49,40.8,29,16,1,15,17,56,24,0,2020
FRA-Ligue 1,2019,Marseille,Lucas Perrin,FRA,DF,20,1998,4.0,5,2,3,2,0,2,7,28.6,5,3,2,1,10,15,17,0,2020
FRA-Ligue 1,2019,Marseille,Luiz Gustavo,BRA,MF,32,1987,2.1,6,3,3,3,0,3,5,60.0,2,5,2,3,5,11,6,0,2020
FRA-Ligue 1,2019,Marseille,Marley Aké,FRA,"FW,MF",18,2001,1.1,2,2,1,1,0,1,3,33.3,2,0,0,0,1,3,1,0,2020
FRA-Ligue 1,2019,Marseille,Maxime Lopez,FRA,"MF,FW",21,1997,12.3,16,10,5,8,3,4,26,15.4,22,8,2,6,8,24,1,0,2020
FRA-Ligue 1,2019,Marseille,Morgan Sanson,FRA,MF,24,1994,24.1,60,28,20,29,11,13,52,25.0,39,39,5,34,23,83,9,0,2020
FRA-Ligue 1,2019,Marseille,Nemanja Radonjić,SRB,"FW,MF",23,1996,9.8,10,3,4,3,3,6,17,35.3,11,7,0,7,2,12,7,0,2020
FRA-Ligue 1,2019,Marseille,Saîf-Eddine Khaoui,TUN,"MF,FW",24,1995,1.2,3,1,0,3,0,2,5,40.0,3,2,0,2,1,4,4,0,2020
FRA-Ligue 1,2019,Marseille,Steve Mandanda,FRA,GK,34,1985,26.3,3,1,3,0,0,3,4,75.0,1,0,0,0,1,4,2,4,2020
FRA-Ligue 1,2019,Marseille,Valentin Rongier,FRA,MF,24,1994,19.9,76,51,25,41,10,22,63,34.9,41,30,4,26,36,112,16,2,2020
FRA-Ligue 1,2019,Marseille,Valère Germain,FRA,FW,29,1990,15.0,22,12,6,11,5,6,31,19.4,25,16,3,13,8,30,26,0,2020
FRA-Ligue 1,2019,Marseille,Yohann Pelé,FRA,GK,36,1982,1.7,0,0,0,0,0,0,0,,0,0,0,0,0,0,0,0,2020
FRA-Ligue 1,2019,Marseille,Álvaro González,ESP,DF,29,1990,18.1,19,13,14,4,1,9,13,69.2,4,7,4,3,18,37,65,0,2020
FRA-Ligue 1,2019,Metz,Adama Traoré,MLI,"FW,MF",24,1995,11.2,3,1,1,2,0,3,12,25.0,9,7,2,5,3,6,5,0,2020
FRA-Ligue 1,2019,Metz,Alexandre Oukidja,ALG,GK,31,1988,26.5,0,0,0,0,0,0,1,0.0,1,1,0,1,0,0,15,1,2020
FRA-Ligue 1,2019,Metz,Dylan Bronn,TUN,DF,24,1995,9.0,7,5,6,1,0,4,7,57.1,3,11,9,2,6,13,42,0,2020
FRA-Ligue 1,2019,Metz,Fabien Centonze,FRA,DF,23,1996,28.0,76,49,53,22,1,34,57,59.6,23,30,11,19,59,135,98,0,2020
FRA-Ligue 1,2019,Metz,Farid Boulaya,ALG,FW,26,1993,9.1,14,10,7,4,3,7,19,36.8,12,5,0,5,6,20,3,0,2020
FRA-Ligue 1,2019,Metz,Georges Mikautadze,GEO,FW,18,2000,0.1,1,0,0,0,1,0,0,,0,0,0,0,0,1,0,0,2020
FRA-Ligue 1,2019,Metz,Habib Diallo,SEN,FW,24,1995,24.4,2,1,0,2,0,0,6,0.0,6,6,5,1,4,6,43,0,2020
FRA-Ligue 1,2019,Metz,Habib Maïga,CIV,MF,23,1996,25.2,84,50,36,38,10,24,64,37.5,40,39,4,35,34,118,39,2,2020
FRA-Ligue 1,2019,Metz,Ibrahima Niane,SEN,FW,20,1999,10.6,8,7,2,5,1,5,16,31.3,11,5,1,4,10,18,11,1,2020
FRA-Ligue 1,2019,Metz,John Boye,GHA,DF,32,1987,23.5,30,19,25,5,0,19,32,59.4,13,31,18,13,31,61,116,0,2020
FRA-Ligue 1,2019,Metz,Kévin N'Doram,FRA,MF,23,1996,18.3,43,28,19,21,3,17,40,42.5,23,20,8,12,26,69,23,0,2020
FRA-Ligue 1,2019,Metz,Mamadou Fofana,MLI,"DF,MF",21,1998,17.6,57,35,38,15,4,21,41,51.2,20,22,10,12,22,79,61,1,2020
FRA-Ligue 1,2019,Metz,Manuel Cabit,MTQ,DF,26,1993,3.0,3,1,1,2,0,2,10,20.0,8,5,0,5,4,7,5,0,2020
FRA-Ligue 1,2019,Metz,Marvin Gakpa,FRA,"MF,FW",25,1993,5.2,10,6,3,4,3,4,8,50.0,4,3,0,3,5,15,1,0,2020
FRA-Ligue 1,2019,Metz,Matthieu Udol,FRA,DF,23,1996,12.2,29,19,19,8,2,13,24,54.2,11,21,4,17,23,52,43,0,2020
FRA-Ligue 1,2019,Metz,Opa Nguette,SEN,FW,25,1994,20.3,44,28,23,15,6,11,39,28.2,28,17,3,14,12,56,12,0,2020
FRA-Ligue 1,2019,Metz,Papa Ndiaga Yade,SEN,FW,19,2000,0.0,0,0,0,0,0,0,0,,0,0,0,0,0,0,0,0,2020
FRA-Ligue 1,2019,Metz,Paul Delecroix,GNB,GK,30,1988,1.5,0,0,0,0,0,0,0,,0,0,0,0,0,0,0,0,2020
FRA-Ligue 1,2019,Metz,Renaud Cohade,FRA,MF,34,1984,8.5,28,20,11,12,5,12,28,42.9,16,14,3,11,8,36,6,0,2020
FRA-Ligue 1,2019,Metz,Stoppila Sunzu,ZAM,DF,30,1989,15.0,16,8,12,4,0,10,15,66.7,5,22,15,7,24,40,63,0,2020
FRA-Ligue 1,2019,Metz,Thierry Ambrose,GLP,FW,22,1997,6.1,7,5,2,2,3,2,7,28.6,5,3,0,3,3,10,3,0,2020
FRA-Ligue 1,2019,Metz,Thomas Delaine,FRA,DF,27,1992,13.9,25,16,18,6,1,12,21,57.1,9,17,1,16,15,40,28,0,2020
FRA-Ligue 1,2019,Metz,Victorien Angban,CIV,MF,22,1996,11.4,23,18,11,11,1,11,24,45.8,13,9,2,7,8,31,5,0,2020
FRA-Ligue 1,2019,Metz,Vincent Pajot,FRA,MF,28,1990,5.8,16,11,8,7,1,2,4,50.0,2,5,1,4,9,25,13,0,2020
FRA-Ligue 1,2019,Monaco,Adama Traoré,MLI,MF,24,1995,0.3,0,0,0,0,0,0,0,,0,0,0,0,1,1,0,0,2020
FRA-Ligue 1,2019,Monaco,Adrien Silva,POR,MF,30,1989,13.6,37,22,14,19,4,10,37,27.0,27,19,6,13,12,49,14,2,2020
FRA-Ligue 1,2019,Monaco,Aleksandr Golovin,RUS,MF,23,1996,22.9,49,27,17,26,6,14,69,20.3,55,28,0,28,31,80,22,0,2020
FRA-Ligue 1,2019,Monaco,Aurélien Tchouaméni,FRA,MF,19,2000,0.7,0,0,0,0,0,0,2,0.0,2,0,0,0,0,0,2,1,2020
FRA-Ligue 1,2019,Monaco,Benjamin Henrichs,GER,"DF,MF",22,1997,9.9,26,20,16,9,1,14,33,42.4,19,19,4,15,14,40,18,0,2020
FRA-Ligue 1,2019,Monaco,Benjamin Lecomte,FRA,GK,28,1991,28.0,0,0,0,0,0,0,1,0.0,1,1,0,1,0,0,10,5,2020
FRA-Ligue 1,2019,Monaco,Benoît Badiashile,FRA,DF,18,2001,15.7,18,12,12,5,1,6,12,50.0,6,20,11,9,27,45,57,1,2020
FRA-Ligue 1,2019,Monaco,Cesc Fàbregas,ESP,MF,32,1987,10.3,11,4,6,3,2,6,29,20.7,23,8,1,7,7,18,3,0,2020
FRA-Ligue 1,2019,Monaco,Fodé Ballo-Touré,SEN,DF,22,1997,18.7,36,25,21,11,4,17,32,53.1,15,10,1,9,24,60,45,0,2020
FRA-Ligue 1,2019,Monaco,Gabriel Boschilia,BRA,"MF,FW",23,1996,1.4,3,1,0,3,0,1,5,20.0,4,1,1,0,2,5,2,0,2020
FRA-Ligue 1,2019,Monaco,Gelson Martins,POR,"DF,FW",24,1995,18.6,30,22,11,15,4,17,42,40.5,25,9,2,7,19,49,10,1,2020
FRA-Ligue 1,2019,Monaco,Gil Bastião Dias,POR,"DF,MF",22,1996,11.7,53,33,30,21,2,29,58,50.0,29,15,1,14,13,66,22,1,2020
FRA-Ligue 1,2019,Monaco,Guillermo Maripán,CHI,DF,25,1994,19.5,42,26,28,13,1,24,41,58.5,17,30,13,17,25,67,69,2,2020
FRA-Ligue 1,2019,Monaco,Henry Onyekuru,NGA,"MF,FW",22,1997,1.8,1,1,1,0,0,0,0,,0,1,0,1,1,2,0,0,2020
FRA-Ligue 1,2019,Monaco,Islam Slimani,ALG,FW,31,1988,14.3,8,4,0,2,6,4,15,26.7,11,5,0,5,1,9,11,1,2020
FRA-Ligue 1,2019,Monaco,Jean-Kévin Augustin,FRA,FW,22,1997,3.0,3,0,1,2,0,1,6,16.7,5,2,0,2,3,6,0,0,2020
FRA-Ligue 1,2019,Monaco,Jemerson,BRA,"DF,MF",26,1992,11.7,28,17,13,14,1,10,21,47.6,11,8,3,5,16,44,24,0,2020
FRA-Ligue 1,2019,Monaco,Jonathan Panzo,ENG,DF,18,2000,1.2,2,2,2,0,0,1,1,100.0,0,3,1,2,3,5,7,0,2020
FRA-Ligue 1,2019,Monaco,Kamil Glik,POL,DF,31,1988,23.0,26,14,15,11,0,13,21,61.9,8,23,17,6,27,53,118,0,2020
FRA-Ligue 1,2019,Monaco,Keita Baldé,SEN,"FW,MF",24,1995,9.5,6,5,1,1,4,3,9,33.3,6,4,1,3,2,8,7,1,2020
FRA-Ligue 1,2019,Monaco,Lyle Foster,RSA,FW,18,2000,0.7,0,0,0,0,0,0,1,0.0,1,0,0,0,0,0,1,0,2020
FRA-Ligue 1,2019,Monaco,Moussa Sylla,FRA,FW,19,1999,0.1,0,0,0,0,0,0,0,,0,0,0,0,0,0,0,0,2020
FRA-Ligue 1,2019,Monaco,Rony Lopes,POR,FW,23,1995,0.9,1,0,0,1,0,0,0,,0,0,0,0,0,1,0,0,2020
FRA-Ligue 1,2019,Monaco,Ruben Aguilar,FRA,DF,26,1993,11.9,36,22,19,15,2,19,28,67.9,9,6,2,4,11,47,21,0,2020
FRA-Ligue 1,2019,Monaco,Stevan Jovetić,MNE,"FW,MF",29,1989,5.3,2,1,0,1,1,1,5,20.0,4,1,0,1,1,3,5,0,2020
FRA-Ligue 1,2019,Monaco,Tiemoué Bakayoko,FRA,MF,24,1994,19.1,48,24,16,27,5,29,54,53.7,25,12,4,8,29,77,17,0,2020
FRA-Ligue 1,2019,Monaco,Wissam Ben Yedder,FRA,FW,28,1990,24.0,22,16,2,12,8,8,19,42.1,11,12,0,12,4,26,1,0,2020
FRA-Ligue 1,2019,Monaco,Youssouf Fofana,FRA,MF,20,1999,6.8,16,9,6,10,0,8,15,53.3,7,12,2,10,8,24,9,0,2020
FRA-Ligue 1,2019,Montpellier,Ambroise Oyongo,CMR,"DF,FW",28,1991,20.2,25,10,16,6,3,16,28,57.1,12,8,0,8,17,42,35,0,2020
FRA-Ligue 1,2019,Montpellier,Andy Delort,ALG,FW,27,1991,25.3,28,18,11,9,8,7,27,25.9,20,21,6,15,3,31,10,0,2020
FRA-Ligue 1,2019,Montpellier,Arnaud Souquet,FRA,"DF,FW",27,1992,22.4,62,40,45,13,4,30,67,44.8,37,20,6,14,17,79,44,0,2020
FRA-Ligue 1,2019,Montpellier,Bastian Badu,FRA,FW,19,2000,0.1,0,0,0,0,0,0,0,,0,0,0,0,0,0,0,0,2020
FRA-Ligue 1,2019,Montpellier,Bilal Boutobba,FRA,MF,20,1998,0.1,0,0,0,0,0,0,1,0.0,1,0,0,0,0,0,0,0,2020
FRA-Ligue 1,2019,Montpellier,Clément Vidal,FRA,DF,19,2000,1.0,0,0,0,0,0,0,2,0.0,2,1,1,0,0,0,6,0,2020
FRA-Ligue 1,2019,Montpellier,Damien Le Tallec,FRA,"MF,DF",29,1990,27.3,52,27,20,28,4,24,69,34.8,45,38,18,20,38,90,59,0,2020
FRA-Ligue 1,2019,Montpellier,Daniel Congré,FRA,DF,34,1985,21.6,37,27,20,16,1,18,38,47.4,20,8,7,1,47,84,66,1,2020
FRA-Ligue 1,2019,Montpellier,Dimitry Bertaud,FRA,GK,21,1998,2.2,0,0,0,0,0,0,0,,0,0,0,0,0,0,0,0,2020
FRA-Ligue 1,2019,Montpellier,Florent Mollet,FRA,"MF,FW",27,1991,18.7,13,11,3,8,2,7,28,25.0,21,9,1,8,9,22,2,0,2020
FRA-Ligue 1,2019,Montpellier,Gaëtan Laborde,FRA,FW,25,1994,24.9,21,12,4,10,7,9,38,23.7,29,21,0,21,7,28,32,1,2020
FRA-Ligue 1,2019,Montpellier,Gerónimo Rulli,ARG,GK,27,1992,25.0,3,1,3,0,0,3,4,75.0,1,1,0,1,2,5,9,1,2020
FRA-Ligue 1,2019,Montpellier,Jordan Ferri,FRA,MF,27,1992,12.8,22,13,7,12,3,13,44,29.5,31,9,0,9,10,32,10,0,2020
FRA-Ligue 1,2019,Montpellier,Joris Chotard,FRA,MF,17,2001,13.9,30,18,13,17,0,15,35,42.9,20,12,5,7,20,50,12,1,2020
FRA-Ligue 1,2019,Montpellier,Junior Sambia,FRA,"DF,MF",22,1996,6.5,8,6,4,2,2,3,13,23.1,10,4,0,4,8,16,6,0,2020
FRA-Ligue 1,2019,Montpellier,Keagan Dolly,RSA,MF,26,1993,1.6,6,3,1,3,2,2,5,40.0,3,1,0,1,1,7,0,0,2020
FRA-Ligue 1,2019,Montpellier,Mathías Suárez,URU,DF,23,1996,0.7,2,2,2,0,0,2,3,66.7,1,0,0,0,1,3,3,0,2020
FRA-Ligue 1,2019,Montpellier,Matis Carvalho,POR,GK,20,1999,0.8,0,0,0,0,0,0,1,0.0,1,0,0,0,0,0,1,0,2020
FRA-Ligue 1,2019,Montpellier,Mihailo Ristić,SRB,"DF,MF",23,1995,9.0,18,14,7,11,0,9,20,45.0,11,7,2,5,7,25,18,0,2020
FRA-Ligue 1,2019,Montpellier,Nicolas Cozza,FRA,DF,20,1999,6.2,5,5,3,2,0,2,3,66.7,1,8,6,2,9,14,18,0,2020
FRA-Ligue 1,2019,Montpellier,Pedro Mendes,POR,DF,28,1990,15.3,28,17,15,13,0,15,24,62.5,9,19,12,7,28,56,42,1,2020
FRA-Ligue 1,2019,Montpellier,Petar Škuletić,SRB,"FW,MF",29,1990,1.2,6,4,2,2,2,2,4,50.0,2,0,0,0,0,6,1,0,2020
FRA-Ligue 1,2019,Montpellier,Souleymane Camara,SEN,FW,36,1982,1.8,0,0,0,0,0,0,2,0.0,2,0,0,0,0,0,1,0,2020
FRA-Ligue 1,2019,Montpellier,Thibaut Vargas,FRA,"DF,MF",19,2000,1.7,3,1,3,0,0,2,5,40.0,3,1,1,0,0,3,3,0,2020
FRA-Ligue 1,2019,Montpellier,Téji Savanier,FRA,MF,27,1991,16.9,52,39,16,30,6,25,77,32.5,52,10,0,10,35,87,21,1,2020
FRA-Ligue 1,2019,Montpellier,Vitorino Hilton,BRA,DF,41,1977,27.9,27,17,20,7,0,13,28,46.4,15,22,18,4,49,76,121,1,2020
FRA-Ligue 1,2019,Montpellier,Yun Il-lok,KOR,"MF,FW",27,1992,1.3,1,1,0,1,0,0,4,0.0,4,0,0,0,0,1,0,0,2020
FRA-Ligue 1,2019,Nantes,Abdoul Kader Bamba,FRA,"FW,MF",25,1994,16.3,19,15,5,9,5,9,30,30.0,21,8,2,6,16,35,8,0,2020
FRA-Ligue 1,2019,Nantes,Abdoulaye Touré,FRA,MF,25,1994,24.7,32,21,10,21,1,10,30,33.3,20,31,11,20,29,61,18,1,2020
FRA-Ligue 1,2019,Nantes,Alban Lafont,FRA,GK,20,1999,27.0,1,1,1,0,0,1,1,100.0,0,0,0,0,0,1,12,0,2020
FRA-Ligue 1,2019,Nantes,Andrei Girotto,BRA,DF,27,1992,24.2,76,53,45,29,2,39,71,54.9,32,32,17,15,34,110,111,1,2020
FRA-Ligue 1,2019,Nantes,Anthony Limbombe,BEL,"FW,MF",25,1994,1.7,3,2,1,2,0,1,1,100.0,0,1,0,1,0,3,3,0,2020
FRA-Ligue 1,2019,Nantes,Charles Traore,MLI,DF,27,1992,19.3,48,35,27,19,2,36,61,59.0,25,21,4,17,39,87,64,0,2020
FRA-Ligue 1,2019,Nantes,Cristian Benavente,PER,"MF,FW",25,1994,3.9,8,5,2,5,1,2,8,25.0,6,1,0,1,3,11,0,0,2020
FRA-Ligue 1,2019,Nantes,Denis Petrić,SRB,GK,31,1988,1.0,1,1,1,0,0,1,1,100.0,0,0,0,0,0,1,0,0,2020
FRA-Ligue 1,2019,Nantes,Dennis Appiah,FRA,DF,27,1992,17.8,58,35,32,20,6,28,52,53.8,24,9,3,6,23,81,34,0,2020
FRA-Ligue 1,2019,Nantes,Elie Youan,FRA,"FW,MF",20,1999,1.8,0,0,0,0,0,0,7,0.0,7,2,0,2,0,0,3,0,2020
FRA-Ligue 1,2019,Nantes,Fábio,BRA,DF,29,1990,9.3,38,22,18,20,0,25,35,71.4,10,10,5,5,18,56,19,0,2020
FRA-Ligue 1,2019,Nantes,Imran Louza,MAR,"MF,FW",20,1999,22.3,53,27,18,27,8,19,46,41.3,27,18,2,16,17,70,7,0,2020
FRA-Ligue 1,2019,Nantes,Josué Homawoo,FRA,DF,21,1997,0.5,6,2,3,3,0,2,2,100.0,0,3,2,1,2,8,2,0,2020
FRA-Ligue 1,2019,Nantes,Kalifa Coulibaly,MLI,FW,27,1991,18.0,11,7,0,5,6,3,5,60.0,2,3,1,2,6,17,32,0,2020
FRA-Ligue 1,2019,Nantes,Lucas Lima,BRA,"FW,DF",27,1991,3.0,7,2,4,3,0,2,5,40.0,3,2,0,2,1,8,3,0,2020
FRA-Ligue 1,2019,Nantes,Ludovic Blas,FRA,"FW,MF",21,1997,20.5,26,18,7,15,4,5,26,19.2,21,17,1,16,14,40,11,0,2020
FRA-Ligue 1,2019,Nantes,Marcus Coco,FRA,FW,23,1996,0.2,1,0,1,0,0,1,1,100.0,0,0,0,0,0,1,0,0,2020
FRA-Ligue 1,2019,Nantes,Mehdi Abeid,ALG,MF,26,1992,20.2,55,29,18,32,5,20,53,37.7,33,16,3,13,23,78,8,1,2020
FRA-Ligue 1,2019,Nantes,Molla Wagué,MLI,DF,28,1991,7.6,15,12,11,4,0,7,7,100.0,0,10,8,2,15,30,42,0,2020
FRA-Ligue 1,2019,Nantes,Moses Simon,NGA,"FW,MF",24,1995,24.2,15,7,5,4,6,6,21,28.6,15,6,0,6,8,23,6,0,2020
FRA-Ligue 1,2019,Nantes,Nicolas Pallois,FRA,DF,31,1987,21.0,47,36,28,17,2,31,55,56.4,24,18,13,5,40,87,77,1,2020
FRA-Ligue 1,2019,Nantes,Percy Prado,PER,DF,23,1996,2.1,6,5,3,2,1,5,9,55.6,4,1,0,1,1,7,5,0,2020
FRA-Ligue 1,2019,Nantes,Renaud Emond,BEL,FW,27,1991,3.2,3,1,0,2,1,1,5,20.0,4,0,0,0,0,3,7,0,2020
FRA-Ligue 1,2019,Nantes,Rene Krhin,SVN,"DF,MF",29,1990,3.6,4,3,1,3,0,2,2,100.0,0,1,0,1,6,10,17,0,2020
FRA-Ligue 1,2019,Nantes,Roli Pereira de Sa,FRA,MF,22,1996,0.1,0,0,0,0,0,0,0,,0,0,0,0,0,0,0,0,2020
FRA-Ligue 1,2019,Nantes,Samuel Moutoussamy,COD,"DF,MF",22,1996,5.8,4,1,2,1,1,2,7,28.6,5,2,0,2,4,8,7,0,2020
FRA-Ligue 1,2019,Nantes,Thomas Basila,FRA,DF,20,1999,4.6,6,3,2,4,0,4,4,100.0,0,0,0,0,4,10,14,0,2020
FRA-Ligue 1,2019,Nantes,Valentin Rongier,FRA,MF,24,1994,3.0,5,4,0,2,3,3,5,60.0,2,4,0,4,2,7,0,0,2020
FRA-Ligue 1,2019,Nantes,Wesley Moustache,FRA,DF,20,1999,0.5,0,0,0,0,0,0,0,,0,1,0,1,0,0,2,0,2020
FRA-Ligue 1,2019,Nice,Adam Ounas,ALG,"FW,MF",22,1996,12.5,10,5,2,6,2,5,13,38.5,8,9,1,8,11,21,8,1,2020
FRA-Ligue 1,2019,Nice,Adrien Tameze,CMR,MF,25,1994,5.8,6,2,2,3,1,4,16,25.0,12,7,2,5,7,13,1,1,2020
FRA-Ligue 1,2019,Nice,Alexis Claude-Maurice,FRA,"FW,MF",21,1998,18.1,26,16,8,11,7,13,35,37.1,22,20,4,16,11,37,4,0,2020
FRA-Ligue 1,2019,Nice,Andy Pelmard,FRA,DF,19,2000,8.5,22,14,13,9,0,9,11,81.8,2,12,4,8,15,37,28,1,2020
FRA-Ligue 1,2019,Nice,Arnaud Lusamba,COD,"MF,FW",22,1997,10.9,20,11,8,10,2,7,23,30.4,16,9,0,9,5,25,6,1,2020
FRA-Ligue 1,2019,Nice,Bassem Srarfi,TUN,"FW,MF",22,1997,1.5,0,0,0,0,0,0,2,0.0,2,0,0,0,2,2,0,0,2020
FRA-Ligue 1,2019,Nice,Christophe Hérelle,MTQ,DF,26,1992,12.3,14,11,10,4,0,3,7,42.9,4,14,8,6,17,31,26,1,2020
FRA-Ligue 1,2019,Nice,Danilo Barbosa,BRA,"DF,MF",23,1996,12.5,28,21,17,9,2,13,29,44.8,16,21,6,15,20,48,38,0,2020
FRA-Ligue 1,2019,Nice,Dante,BRA,DF,35,1983,21.0,34,21,24,10,0,17,25,68.0,8,27,16,11,26,60,79,0,2020
FRA-Ligue 1,2019,Nice,Eddy Sylvestre,FRA,MF,19,1999,0.4,0,0,0,0,0,0,1,0.0,1,0,0,0,0,0,0,0,2020
FRA-Ligue 1,2019,Nice,Gautier Lloris,FRA,DF,24,1995,3.0,5,3,5,0,0,4,5,80.0,1,3,3,0,2,7,11,0,2020
FRA-Ligue 1,2019,Nice,Hicham Boudaoui,ALG,"MF,FW",19,1999,5.4,20,10,6,11,3,9,23,39.1,14,10,3,7,13,33,7,0,2020
FRA-Ligue 1,2019,Nice,Ibrahim Cissé,CIV,DF,20,1999,0.6,1,1,1,0,0,0,0,,0,0,0,0,0,1,6,0,2020
FRA-Ligue 1,2019,Nice,Ignatius Ganago,CMR,"FW,MF",20,1999,13.8,10,6,4,3,3,3,18,16.7,15,8,1,7,4,14,13,0,2020
FRA-Ligue 1,2019,Nice,Ihsan Sacko,FRA,FW,22,1997,1.6,1,1,1,0,0,0,1,0.0,1,0,0,0,0,1,0,0,2020
FRA-Ligue 1,2019,Nice,Kasper Dolberg,DEN,FW,21,1997,21.0,10,6,0,3,7,4,17,23.5,13,18,2,16,10,20,24,0,2020
FRA-Ligue 1,2019,Nice,Khéphren Thuram,FRA,MF,18,2001,6.6,22,7,14,8,0,6,17,35.3,11,12,2,10,7,29,13,0,2020
FRA-Ligue 1,2019,Nice,Malang Sarr,FRA,DF,20,1999,16.2,19,11,13,6,0,9,22,40.9,13,10,4,6,38,57,31,4,2020
FRA-Ligue 1,2019,Nice,Mickaël Le Bihan,FRA,"FW,DF",29,1990,1.1,0,0,0,0,0,0,2,0.0,2,0,0,0,0,0,2,0,2020
FRA-Ligue 1,2019,Nice,Moussa Wagué,SEN,"DF,MF",20,1998,2.2,6,4,3,3,0,2,3,66.7,1,2,1,1,2,8,2,0,2020
FRA-Ligue 1,2019,Nice,Myziane Maolida,FRA,"FW,MF",20,1999,7.5,14,10,5,6,3,5,12,41.7,7,8,0,8,3,17,3,0,2020
FRA-Ligue 1,2019,Nice,Patrick Burner,MTQ,DF,23,1996,15.9,35,25,15,17,3,14,25,56.0,11,11,2,9,30,65,37,0,2020
FRA-Ligue 1,2019,Nice,Pierre Lees-Melou,FRA,MF,26,1993,25.0,63,27,34,21,8,31,88,35.2,57,38,12,26,32,95,43,0,2020
FRA-Ligue 1,2019,Nice,Racine Coly,SEN,"DF,FW",23,1995,7.2,21,13,15,5,1,9,17,52.9,8,5,0,5,12,33,23,0,2020
FRA-Ligue 1,2019,Nice,Riza Durmisi,DEN,"DF,MF",25,1994,1.8,1,1,1,0,0,0,0,,0,2,1,1,1,2,3,0,2020
FRA-Ligue 1,2019,Nice,Rémi Walter,FRA,MF,24,1995,0.6,1,1,0,1,0,1,1,100.0,0,0,0,0,0,1,0,0,2020
FRA-Ligue 1,2019,Nice,Stanley N'Soki,FRA,DF,20,1999,14.1,40,29,24,16,0,23,42,54.8,19,14,6,8,32,72,37,0,2020
FRA-Ligue 1,2019,Nice,Walter Benítez,ARG,GK,26,1993,26.0,1,1,1,0,0,1,3,33.3,2,0,0,0,0,1,8,0,2020
FRA-Ligue 1,2019,Nice,Wylan Cyprien,FRA,MF,24,1995,19.7,17,11,5,12,0,7,27,25.9,20,8,2,6,19,36,16,3,2020
FRA-Ligue 1,2019,Nice,Yannis Clementia,MTQ,GK,22,1997,2.0,0,0,0,0,0,0,0,,0,0,0,0,0,0,0,0,2020
FRA-Ligue 1,2019,Nice,Youcef Atal,ALG,"FW,DF",23,1996,11.1,24,11,15,6,3,13,31,41.9,18,12,1,11,24,48,11,1,2020
FRA-Ligue 1,2019,Nîmes,Anthony Briançon,FRA,DF,24,1994,19.3,29,19,20,9,0,17,34,50.0,17,22,16,6,39,68,80,0,2020
FRA-Ligue 1,2019,Nîmes,Antoine Valerio,FRA,MF,19,1999,1.0,1,1,0,1,0,0,2,0.0,2,2,0,2,3,4,1,0,2020
FRA-Ligue 1,2019,Nîmes,Antonin Bobichon,FRA,MF,23,1995,2.0,4,3,1,3,0,3,3,100.0,0,1,0,1,1,5,0,0,2020
FRA-Ligue 1,2019,Nîmes,Florian Miguel,FRA,DF,22,1996,22.8,51,25,27,20,4,31,52,59.6,21,19,4,15,33,84,32,0,2020
FRA-Ligue 1,2019,Nîmes,Gaëtan Paquiez,FRA,DF,25,1994,17.0,36,25,14,13,9,17,47,36.2,30,18,5,13,33,69,43,0,2020
FRA-Ligue 1,2019,Nîmes,Haris Duljević,BIH,"FW,MF",25,1993,5.8,11,6,3,7,1,4,12,33.3,8,5,0,5,2,13,1,0,2020
FRA-Ligue 1,2019,Nîmes,Kevin Denkey,TOG,FW,18,2000,6.7,10,5,1,8,1,6,10,60.0,4,7,0,7,2,12,1,1,2020
FRA-Ligue 1,2019,Nîmes,Lamine Fomba,FRA,MF,21,1998,15.3,65,31,20,37,8,21,43,48.8,22,29,4,25,25,90,11,1,2020
FRA-Ligue 1,2019,Nîmes,Loïck Landre,FRA,DF,27,1992,10.3,16,9,12,3,1,7,11,63.6,4,12,9,3,17,33,34,0,2020
FRA-Ligue 1,2019,Nîmes,Luca Valls,FRA,MF,20,1998,0.1,1,0,1,0,0,1,1,100.0,0,1,0,1,0,1,0,0,2020
FRA-Ligue 1,2019,Nîmes,Lucas Buadés,FRA,"MF,FW",21,1997,1.3,4,4,3,1,0,1,5,20.0,4,0,0,0,1,5,3,0,2020
FRA-Ligue 1,2019,Nîmes,Lucas Deaux,FRA,MF,30,1988,14.8,49,26,16,29,4,16,45,35.6,29,20,4,16,15,64,19,0,2020
FRA-Ligue 1,2019,Nîmes,Lucas Dias,FRA,GK,20,1999,3.5,1,1,1,0,0,1,1,100.0,0,0,0,0,0,1,2,0,2020
FRA-Ligue 1,2019,Nîmes,Moussa Koné,SEN,"FW,MF",22,1996,1.6,2,0,1,1,0,1,3,33.3,2,1,0,1,1,3,0,0,2020
FRA-Ligue 1,2019,Nîmes,Nolan Roux,FRA,FW,31,1988,6.5,5,2,1,3,1,1,3,33.3,2,2,0,2,4,9,5,0,2020
FRA-Ligue 1,2019,Nîmes,Pablo Martinez,FRA,DF,30,1989,26.0,42,21,26,15,1,21,40,52.5,19,34,22,12,58,100,97,0,2020
FRA-Ligue 1,2019,Nîmes,Paul Bernardoni,FRA,GK,22,1997,24.5,0,0,0,0,0,0,1,0.0,1,0,0,0,0,0,11,1,2020
FRA-Ligue 1,2019,Nîmes,Pierrick Valdivia,FRA,MF,31,1988,0.8,1,1,0,0,1,0,1,0.0,1,0,0,0,0,1,0,0,2020
FRA-Ligue 1,2019,Nîmes,Renaud Ripart,FRA,"FW,DF",26,1993,22.5,39,23,17,20,2,18,46,39.1,28,17,2,15,12,51,37,0,2020
FRA-Ligue 1,2019,Nîmes,Romain Philippoteaux,FRA,"FW,MF",31,1988,22.2,23,12,11,11,1,9,43,20.9,34,22,1,21,13,36,10,0,2020
FRA-Ligue 1,2019,Nîmes,Sami Ben Amar,MAR,FW,21,1998,0.2,1,1,0,0,1,1,1,100.0,0,1,0,1,1,2,0,0,2020
FRA-Ligue 1,2019,Nîmes,Sidy Sarr,SEN,MF,23,1996,12.9,35,18,15,16,4,11,34,32.4,23,13,3,10,15,50,18,0,2020
FRA-Ligue 1,2019,Nîmes,Sofiane Alakouch,MAR,DF,21,1998,15.6,45,26,25,13,7,25,48,52.1,23,13,2,11,23,68,39,3,2020
FRA-Ligue 1,2019,Nîmes,Theo Valls,FRA,MF,23,1995,18.1,39,16,12,26,1,16,50,32.0,34,17,0,17,13,52,6,0,2020
FRA-Ligue 1,2019,Nîmes,Théo Sainte-Luce,FRA,"MF,DF",20,1998,0.2,0,0,0,0,0,0,0,,0,0,0,0,0,0,0,0,2020
FRA-Ligue 1,2019,Nîmes,Vlatko Stojanovski,MKD,FW,22,1997,1.4,3,3,0,3,0,1,1,100.0,0,0,0,0,0,3,1,0,2020
FRA-Ligue 1,2019,Nîmes,Yassine Benrahou,FRA,"MF,FW",20,1999,8.5,13,8,3,3,7,5,16,31.3,11,1,0,1,2,15,0,0,2020
FRA-Ligue 1,2019,Nîmes,Zinedine Ferhat,ALG,"FW,MF",26,1993,25.0,26,16,5,16,5,15,46,32.6,31,15,3,12,16,42,18,0,2020
FRA-Ligue 1,2019,Paris S-G,Abdou Diallo,SEN,DF,23,1996,13.3,20,11,9,10,1,8,14,57.1,6,9,5,4,10,30,32,0,2020
FRA-Ligue 1,2019,Paris S-G,Adil Aouchiche,FRA,MF,17,2002,0.7,3,2,1,2,0,2,4,50.0,2,3,0,3,0,3,0,0,2020
FRA-Ligue 1,2019,Paris S-G,Alphonse Areola,FRA,GK,26,1993,3.0,0,0,0,0,0,0,0,,0,0,0,0,0,0,1,1,2020
FRA-Ligue 1,2019,Paris S-G,Ander Herrera,ESP,"MF,DF",29,1989,6.1,19,11,9,9,1,5,14,35.7,9,10,2,8,6,25,4,0,2020
FRA-Ligue 1,2019,Paris S-G,Arthur Zagre,FRA,MF,17,2001,0.3,1,0,1,0,0,0,0,,0,1,0,1,1,2,0,0,2020
FRA-Ligue 1,2019,Paris S-G,Colin Dagba,FRA,DF,20,1998,7.4,10,4,2,4,4,5,9,55.6,4,6,1,5,6,16,9,0,2020
FRA-Ligue 1,2019,Paris S-G,Edinson Cavani,URU,FW,32,1987,6.7,5,1,0,2,3,0,3,0.0,3,7,0,7,1,6,2,0,2020
FRA-Ligue 1,2019,Paris S-G,Eric Maxim Choupo-Moting,CMR,"FW,MF",30,1989,5.0,12,9,3,4,5,4,8,50.0,4,3,0,3,1,13,3,0,2020
FRA-Ligue 1,2019,Paris S-G,Idrissa Gana Gueye,SEN,MF,29,1989,18.4,65,34,30,25,10,18,43,41.9,25,29,4,25,33,98,15,0,2020
FRA-Ligue 1,2019,Paris S-G,Jesé,ESP,FW,26,1993,0.0,0,0,0,0,0,0,0,,0,0,0,0,0,0,0,0,2020
FRA-Ligue 1,2019,Paris S-G,Juan Bernat,ESP,"DF,MF",26,1993,15.4,42,27,19,16,7,20,51,39.2,31,13,1,12,10,52,26,0,2020
FRA-Ligue 1,2019,Paris S-G,Julian Draxler,GER,MF,25,1993,7.6,13,10,2,9,2,7,15,46.7,8,7,1,6,10,23,1,0,2020
FRA-Ligue 1,2019,Paris S-G,Keylor Navas,CRC,GK,32,1986,21.0,0,0,0,0,0,0,0,,0,1,0,1,0,0,4,2,2020
FRA-Ligue 1,2019,Paris S-G,Kylian Mbappé,FRA,FW,20,1998,16.8,7,2,1,5,1,3,10,30.0,7,4,0,4,3,10,0,0,2020
FRA-Ligue 1,2019,Paris S-G,Layvin Kurzawa,FRA,DF,26,1992,9.5,23,16,5,14,4,11,23,47.8,12,12,1,11,18,41,24,1,2020
FRA-Ligue 1,2019,Paris S-G,Leandro Paredes,ARG,MF,25,1994,9.0,22,14,7,14,1,13,29,44.8,16,7,1,6,15,37,7,0,2020
FRA-Ligue 1,2019,Paris S-G,Loïc Mbe Soh,FRA,DF,18,2001,0.6,2,2,2,0,0,2,2,100.0,0,0,0,0,1,3,0,0,2020
FRA-Ligue 1,2019,Paris S-G,Marcin Bułka,POL,GK,19,1999,1.0,0,0,0,0,0,0,0,,0,0,0,0,0,0,0,0,2020
FRA-Ligue 1,2019,Paris S-G,Marco Verratti,ITA,MF,26,1992,16.5,54,32,22,22,10,20,56,35.7,36,23,3,20,19,73,9,0,2020
FRA-Ligue 1,2019,Paris S-G,Marquinhos,BRA,"MF,DF",25,1994,16.4,39,20,17,18,4,11,26,42.3,15,25,8,17,25,64,31,1,2020
FRA-Ligue 1,2019,Paris S-G,Mauro Icardi,ARG,FW,26,1993,14.1,4,2,1,3,0,1,10,10.0,9,7,1,6,2,6,11,0,2020
FRA-Ligue 1,2019,Paris S-G,Mitchel Bakker,NED,DF,19,2000,1.0,2,2,1,1,0,1,1,100.0,0,0,0,0,0,2,2,0,2020
FRA-Ligue 1,2019,Paris S-G,Neymar,BRA,"MF,FW",27,1992,14.6,12,7,1,9,2,3,21,14.3,18,10,0,10,4,16,1,0,2020
FRA-Ligue 1,2019,Paris S-G,Pablo Sarabia,ESP,"FW,MF",27,1992,12.9,12,7,3,6,3,4,25,16.0,21,19,1,18,10,22,5,0,2020
FRA-Ligue 1,2019,Paris S-G,Presnel Kimpembe,FRA,DF,23,1995,13.6,33,25,25,8,0,14,20,70.0,6,7,3,4,21,54,33,1,2020
FRA-Ligue 1,2019,Paris S-G,Sergio Rico,ESP,GK,25,1993,2.0,0,0,0,0,0,0,0,,0,0,0,0,0,0,1,2,2020
FRA-Ligue 1,2019,Paris S-G,Tanguy Nianzou,FRA,"DF,MF",17,2002,5.0,2,1,0,1,1,1,3,33.3,2,4,2,2,3,5,6,0,2020
FRA-Ligue 1,2019,Paris S-G,Thiago Silva,BRA,DF,34,1984,17.5,28,16,15,13,0,13,16,81.3,3,18,15,3,26,54,54,0,2020
FRA-Ligue 1,2019,Paris S-G,Thilo Kehrer,GER,DF,22,1996,5.3,10,7,4,5,1,5,10,50.0,5,2,0,2,1,11,2,1,2020
FRA-Ligue 1,2019,Paris S-G,Thomas Meunier,BEL,DF,27,1991,13.8,27,21,9,12,6,16,26,61.5,10,17,5,12,18,45,19,1,2020
FRA-Ligue 1,2019,Paris S-G,Ángel Di María,ARG,"FW,MF",31,1988,22.2,17,12,2,8,7,4,34,11.8,30,14,3,11,11,28,1,3,2020
FRA-Ligue 1,2019,Reims,Alaixys Romao,TOG,MF,35,1984,19.8,46,29,31,14,1,17,57,29.8,40,12,3,9,26,72,38,3,2020
FRA-Ligue 1,2019,Reims,Anastasios Donis,GRE,FW,22,1996,6.8,3,2,2,1,0,1,9,11.1,8,2,0,2,1,4,3,0,2020
FRA-Ligue 1,2019,Reims,Arber Zeneli,KVX,MF,24,1995,0.1,0,0,0,0,0,0,0,,0,0,0,0,0,0,0,0,2020
FRA-Ligue 1,2019,Reims,Axel Disasi,FRA,DF,21,1998,27.0,32,21,18,13,1,17,27,63.0,10,29,24,5,26,58,97,0,2020
FRA-Ligue 1,2019,Reims,Boulaye Dia,SEN,FW,22,1996,20.1,15,9,7,6,2,3,10,30.0,7,9,2,7,7,22,16,0,2020
FRA-Ligue 1,2019,Reims,Dario Maresic,AUT,DF,19,1999,1.0,0,0,0,0,0,0,0,,0,1,1,0,1,1,6,0,2020
FRA-Ligue 1,2019,Reims,Dereck Kutesa,SUI,"FW,MF",21,1997,5.9,6,5,3,2,1,3,9,33.3,6,5,0,5,1,7,1,0,2020
FRA-Ligue 1,2019,Reims,El Bilal Touré,MLI,FW,17,2001,5.0,3,3,1,0,2,0,0,,0,6,0,6,1,4,1,0,2020
FRA-Ligue 1,2019,Reims,Ghislain Konan,CIV,DF,23,1995,14.8,43,26,28,14,1,19,28,67.9,9,13,3,10,24,67,34,0,2020
FRA-Ligue 1,2019,Reims,Hassane Kamara,CIV,"DF,FW",25,1994,19.0,58,47,40,14,4,24,35,68.6,11,17,2,15,58,116,58,0,2020
FRA-Ligue 1,2019,Reims,Kaj Sierhuis,NED,FW,21,1998,0.1,0,0,0,0,0,0,0,,0,0,0,0,0,0,0,0,2020
FRA-Ligue 1,2019,Reims,Marshall Munetsi,ZIM,MF,23,1996,9.3,27,19,12,12,3,6,12,50.0,6,13,7,6,12,39,20,1,2020
FRA-Ligue 1,2019,Reims,Mathieu Cafaro,FRA,"FW,MF",22,1997,10.3,12,6,5,5,2,6,17,35.3,11,13,0,13,2,14,0,0,2020
FRA-Ligue 1,2019,Reims,Moreto Cassamã,GNB,MF,21,1998,6.6,17,11,2,13,2,5,7,71.4,2,7,2,5,5,22,6,0,2020
FRA-Ligue 1,2019,Reims,Moussa Doumbia,MLI,"FW,MF",24,1994,19.1,16,8,5,6,5,7,24,29.2,17,14,1,13,9,25,5,0,2020
FRA-Ligue 1,2019,Reims,Nathanael Mbuku,FRA,"FW,MF",17,2002,4.4,4,2,2,2,0,0,3,0.0,3,0,0,0,2,6,1,0,2020
FRA-Ligue 1,2019,Reims,Nicolas Lemaître,FRA,GK,22,1997,1.0,0,0,0,0,0,0,1,0.0,1,0,0,0,1,1,1,1,2020
FRA-Ligue 1,2019,Reims,Predrag Rajković,SRB,GK,23,1995,27.0,1,1,1,0,0,1,1,100.0,0,0,0,0,1,2,9,0,2020
FRA-Ligue 1,2019,Reims,Remi Oudin,FRA,"FW,MF",22,1996,15.5,15,7,8,5,2,6,19,31.6,13,16,1,15,18,33,18,1,2020
FRA-Ligue 1,2019,Reims,Sambou Sissoko,FRA,"MF,FW",20,1999,0.4,0,0,0,0,0,0,0,,0,0,0,0,1,1,2,0,2020
FRA-Ligue 1,2019,Reims,Suk Hyun-jun,KOR,"FW,MF",28,1991,2.9,3,3,1,1,1,1,2,50.0,1,1,0,1,1,4,2,0,2020
FRA-Ligue 1,2019,Reims,Thomas Foket,BEL,DF,24,1994,27.0,61,36,31,23,7,30,48,62.5,18,15,4,11,39,100,59,1,2020
FRA-Ligue 1,2019,Reims,Timothée Nkada,FRA,FW,20,1999,1.6,1,0,1,0,0,0,1,0.0,1,0,0,0,0,1,1,0,2020
FRA-Ligue 1,2019,Reims,Tristan Dingomé,CMR,MF,28,1991,9.9,10,4,3,6,1,2,12,16.7,10,6,0,6,6,16,1,0,2020
FRA-Ligue 1,2019,Reims,Xavier Chavalerin,FRA,MF,28,1991,23.9,71,52,29,33,9,19,49,38.8,30,23,8,15,36,107,36,0,2020
FRA-Ligue 1,2019,Reims,Yunis Abdelhamid,MAR,DF,31,1987,28.0,46,33,29,15,2,17,30,56.7,13,26,14,12,47,93,99,1,2020
FRA-Ligue 1,2019,Rennes,Adrien Hunou,FRA,"FW,MF",25,1994,13.4,21,18,5,11,5,4,21,19.0,17,16,1,15,5,26,5,0,2020
FRA-Ligue 1,2019,Rennes,Benjamin Bourigeaud,FRA,MF,25,1994,21.1,40,12,18,20,2,17,68,25.0,51,38,7,31,20,60,25,0,2020
FRA-Ligue 1,2019,Rennes,Clément Grenier,FRA,MF,28,1991,9.3,21,12,6,15,0,11,40,27.5,29,7,2,5,7,28,16,0,2020
FRA-Ligue 1,2019,Rennes,Damien Da Silva,FRA,DF,31,1988,24.9,27,14,20,5,2,10,19,52.6,9,21,13,8,26,53,143,1,2020
FRA-Ligue 1,2019,Rennes,Edouard Mendy,SEN,GK,27,1992,24.0,0,0,0,0,0,0,0,,0,0,0,0,0,0,5,1,2020
FRA-Ligue 1,2019,Rennes,Eduardo Camavinga,FRA,MF,16,2002,23.4,105,64,45,56,4,48,96,50.0,48,26,8,18,34,139,35,0,2020
FRA-Ligue 1,2019,Rennes,Faitout Maouassa,FRA,DF,21,1998,20.0,51,33,27,20,4,14,26,53.8,12,13,5,8,23,74,59,0,2020
FRA-Ligue 1,2019,Rennes,Flavien Tait,FRA,"MF,FW",26,1993,9.8,20,13,12,6,2,9,28,32.1,19,7,0,7,9,29,5,1,2020
FRA-Ligue 1,2019,Rennes,Gerzino Nyamsi,FRA,DF,22,1997,1.3,1,0,1,0,0,0,0,,0,1,0,1,1,2,5,0,2020
FRA-Ligue 1,2019,Rennes,Hamari Traoré,MLI,DF,27,1992,26.8,55,26,34,18,3,32,64,50.0,32,22,5,17,48,103,59,1,2020
FRA-Ligue 1,2019,Rennes,James Lea Siliki,CMR,MF,23,1996,12.0,28,16,19,9,0,16,29,55.2,13,15,4,11,12,40,12,0,2020
FRA-Ligue 1,2019,Rennes,Jonas Martin,FRA,MF,29,1990,1.3,6,2,4,0,2,1,1,100.0,0,2,2,0,0,6,0,0,2020
FRA-Ligue 1,2019,Rennes,Jordan Pefok,USA,FW,23,1996,4.9,7,6,1,4,2,0,2,0.0,2,3,0,3,1,8,2,0,2020
FRA-Ligue 1,2019,Rennes,Joris Gnagnon,FRA,DF,22,1997,14.2,16,13,14,2,0,10,11,90.9,1,21,17,4,18,34,61,0,2020
FRA-Ligue 1,2019,Rennes,Jérémy Gélin,FRA,"DF,MF",22,1997,10.3,14,5,10,2,2,8,13,61.5,5,14,7,7,15,29,33,1,2020
FRA-Ligue 1,2019,Rennes,Jérémy Morel,MAD,DF,35,1984,20.1,15,9,13,1,1,9,20,45.0,11,21,17,4,17,32,59,1,2020
FRA-Ligue 1,2019,Rennes,Lucas Da Cunha,FRA,MF,18,2001,0.8,1,0,1,0,0,1,1,100.0,0,0,0,0,0,1,0,0,2020
FRA-Ligue 1,2019,Rennes,M'Baye Niang,SEN,FW,24,1994,23.6,17,10,3,11,3,6,21,28.6,15,10,1,9,5,22,20,0,2020
FRA-Ligue 1,2019,Rennes,Rafik Guitane,FRA,MF,20,1999,0.2,0,0,0,0,0,0,0,,0,0,0,0,0,0,0,0,2020
FRA-Ligue 1,2019,Rennes,Raphinha,BRA,"MF,FW",22,1996,18.8,22,18,5,12,5,10,32,31.3,22,23,1,22,17,39,14,1,2020
FRA-Ligue 1,2019,Rennes,Romain Del Castillo,FRA,"FW,MF",23,1996,13.8,20,14,5,11,4,6,27,22.2,21,12,2,10,7,27,7,0,2020
FRA-Ligue 1,2019,Rennes,Romain Salin,FRA,GK,35,1984,4.0,0,0,0,0,0,0,1,0.0,1,0,0,0,0,0,3,0,2020
FRA-Ligue 1,2019,Rennes,Sacha Boey,FRA,DF,18,2000,1.9,6,4,3,1,2,4,8,50.0,4,0,0,0,2,8,5,0,2020
FRA-Ligue 1,2019,Rennes,Souleyman Doumbia,CIV,DF,22,1996,1.0,1,1,1,0,0,1,1,100.0,0,2,2,0,0,1,3,0,2020
FRA-Ligue 1,2019,Rennes,Steven Nzonzi,FRA,MF,30,1988,4.3,5,4,3,1,1,1,2,50.0,1,2,2,0,4,9,18,0,2020
FRA-Ligue 1,2019,Rennes,Yann Gboho,FRA,FW,18,2001,2.5,2,2,1,0,1,0,2,0.0,2,1,0,1,1,3,0,0,2020
FRA-Ligue 1,2019,Saint-Étienne,Arnaud Nordin,FRA,"FW,MF",21,1998,10.1,7,3,3,3,1,4,13,30.8,9,11,1,10,4,11,6,0,2020
FRA-Ligue 1,2019,Saint-Étienne,Assane Dioussé,SEN,MF,21,1997,1.3,1,1,0,1,0,0,3,0.0,3,0,0,0,0,1,2,0,2020
FRA-Ligue 1,2019,Saint-Étienne,Bilal Benkhedim,FRA,"MF,FW",18,2001,1.5,3,3,1,1,1,1,4,25.0,3,1,0,1,1,4,0,0,2020
FRA-Ligue 1,2019,Saint-Étienne,Charles Abi,FRA,FW,19,2000,6.9,9,9,2,5,2,2,7,28.6,5,2,0,2,4,13,4,0,2020
FRA-Ligue 1,2019,Saint-Étienne,Denis Bouanga,GAB,"FW,MF",24,1994,22.7,45,34,10,25,10,20,55,36.4,35,30,0,30,10,55,15,0,2020
FRA-Ligue 1,2019,Saint-Étienne,Edmilson Correia,GNB,"FW,DF",19,2000,0.5,0,0,0,0,0,0,1,0.0,1,1,0,1,1,1,0,0,2020
FRA-Ligue 1,2019,Saint-Étienne,Franck Honorat,FRA,"FW,DF",22,1996,9.4,16,11,7,8,1,8,23,34.8,15,12,1,11,5,21,13,1,2020
FRA-Ligue 1,2019,Saint-Étienne,Gabriel Silva,BRA,DF,28,1991,2.6,4,1,1,2,1,2,3,66.7,1,2,0,2,4,8,8,0,2020
FRA-Ligue 1,2019,Saint-Étienne,Harold Moukoudi,CMR,DF,21,1997,11.0,28,19,20,7,1,11,14,78.6,3,16,10,6,16,44,42,2,2020
FRA-Ligue 1,2019,Saint-Étienne,Jean-Eudes Aholou,CIV,MF,25,1994,7.0,16,12,2,11,3,3,9,33.3,6,6,1,5,15,31,10,0,2020
FRA-Ligue 1,2019,Saint-Étienne,Jessy Moulin,FRA,GK,33,1986,5.0,0,0,0,0,0,0,0,,0,0,0,0,1,1,2,0,2020
FRA-Ligue 1,2019,Saint-Étienne,Lois Diony,FRA,FW,26,1992,7.4,15,5,0,11,4,5,9,55.6,4,3,0,3,1,16,0,0,2020
FRA-Ligue 1,2019,Saint-Étienne,Loïc Perrin,FRA,DF,33,1985,19.0,27,20,16,11,0,11,14,78.6,3,23,17,6,39,66,59,0,2020
FRA-Ligue 1,2019,Saint-Étienne,Mahdi Camara,FRA,MF,21,1998,10.0,33,20,12,16,5,18,32,56.3,14,20,2,18,18,51,5,0,2020
FRA-Ligue 1,2019,Saint-Étienne,Mathieu Debuchy,FRA,DF,34,1985,19.7,44,26,22,15,7,24,47,51.1,23,21,11,10,43,87,59,0,2020
FRA-Ligue 1,2019,Saint-Étienne,Maxence Rivera,FRA,"MF,FW",17,2002,0.3,0,0,0,0,0,0,1,0.0,1,1,0,1,0,0,0,0,2020
FRA-Ligue 1,2019,Saint-Étienne,Miguel Trauco,PER,DF,26,1992,16.4,32,20,16,12,4,19,44,43.2,25,8,1,7,23,55,25,0,2020
FRA-Ligue 1,2019,Saint-Étienne,Robert Berić,SVN,FW,28,1991,4.6,3,2,0,2,1,0,5,0.0,5,2,0,2,4,7,2,0,2020
FRA-Ligue 1,2019,Saint-Étienne,Romain Hamouma,FRA,"FW,MF",32,1987,9.6,12,9,1,5,6,2,12,16.7,10,12,0,12,0,12,4,0,2020
FRA-Ligue 1,2019,Saint-Étienne,Ryad Boudebouz,ALG,"MF,FW",29,1990,17.7,25,16,9,14,2,8,25,32.0,17,14,1,13,7,32,5,0,2020
FRA-Ligue 1,2019,Saint-Étienne,Sergi Palencia,ESP,DF,23,1996,5.2,16,10,6,10,0,5,7,71.4,2,6,1,5,8,24,4,0,2020
FRA-Ligue 1,2019,Saint-Étienne,Stefan Bajic,FRA,GK,17,2001,1.0,0,0,0,0,0,0,0,,0,1,0,1,0,0,2,0,2020
FRA-Ligue 1,2019,Saint-Étienne,Stéphane Ruffier,FRA,GK,32,1986,22.0,0,0,0,0,0,0,0,,0,0,0,0,0,0,5,3,2020
FRA-Ligue 1,2019,Saint-Étienne,Timothée Kolodziejczak,FRA,DF,27,1991,14.5,17,10,13,4,0,9,21,42.9,12,8,3,5,30,47,44,2,2020
FRA-Ligue 1,2019,Saint-Étienne,Wahbi Khazri,TUN,"FW,MF",28,1991,12.8,17,9,5,7,5,9,27,33.3,18,11,0,11,4,21,0,0,2020
FRA-Ligue 1,2019,Saint-Étienne,Wesley Fofana,FRA,DF,18,2000,13.5,25,15,16,9,0,12,18,66.7,6,10,5,5,36,61,55,4,2020
FRA-Ligue 1,2019,Saint-Étienne,William Saliba,FRA,DF,18,2001,11.0,19,9,15,3,1,5,10,50.0,5,13,4,9,21,40,36,1,2020
FRA-Ligue 1,2019,Saint-Étienne,Yann M'Vila,FRA,"MF,DF",29,1990,21.6,29,14,12,16,1,12,43,27.9,31,14,4,10,40,69,47,1,2020
FRA-Ligue 1,2019,Saint-Étienne,Yohan Cabaye,FRA,MF,33,1986,9.5,29,18,11,14,4,14,25,56.0,11,10,0,10,22,51,7,1,2020
FRA-Ligue 1,2019,Saint-Étienne,Yvann Macon,FRA,DF,20,1998,1.1,0,0,0,0,0,0,1,0.0,1,2,0,2,3,3,4,0,2020
FRA-Ligue 1,2019,Saint-Étienne,Zaydou Youssouf,FRA,MF,20,1999,12.0,40,22,12,26,2,15,35,42.9,20,7,1,6,16,56,13,0,2020
FRA-Ligue 1,2019,Strasbourg,Abdallah N'dour,SEN,DF,25,1993,4.1,5,4,2,3,0,5,10,50.0,5,4,1,3,4,9,5,1,2020
FRA-Ligue 1,2019,Strasbourg,Abdul Majeed Waris,GHA,FW,27,1991,4.1,6,4,4,2,0,3,8,37.5,5,2,0,2,4,10,0,0,2020
FRA-Ligue 1,2019,Strasbourg,Adrien Lebeau,FRA,"MF,FW",20,1999,0.1,1,1,1,0,0,0,1,0.0,1,1,0,1,0,1,0,0,2020
FRA-Ligue 1,2019,Strasbourg,Adrien Thomasson,FRA,"MF,FW",25,1993,23.0,36,21,11,16,9,15,47,31.9,32,21,1,20,9,45,9,0,2020
FRA-Ligue 1,2019,Strasbourg,Alexander Djiku,GHA,"DF,MF",24,1994,22.9,46,32,27,19,0,21,29,72.4,8,14,8,6,55,101,82,4,2020
FRA-Ligue 1,2019,Strasbourg,Anthony Caci,FRA,DF,22,1997,7.7,29,17,19,9,1,8,17,47.1,9,15,5,10,19,48,15,1,2020
FRA-Ligue 1,2019,Strasbourg,Benjamin Corgnet,FRA,"MF,FW",32,1987,2.9,1,1,1,0,0,1,3,33.3,2,2,0,2,2,3,3,0,2020
FRA-Ligue 1,2019,Strasbourg,Dimitri Liénard,FRA,MF,31,1988,16.5,37,24,10,22,5,18,39,46.2,21,18,4,14,17,54,25,0,2020
FRA-Ligue 1,2019,Strasbourg,Ibrahima Sissoko,FRA,MF,21,1997,17.8,46,27,21,21,4,16,48,33.3,32,14,5,9,20,66,25,0,2020
FRA-Ligue 1,2019,Strasbourg,Jean-Ricner Bellegarde,FRA,MF,21,1998,16.6,40,27,18,19,3,13,21,61.9,8,16,3,13,22,62,6,0,2020
FRA-Ligue 1,2019,Strasbourg,Jonas Martin,FRA,MF,29,1990,2.7,5,3,4,0,1,1,3,33.3,2,3,0,3,1,6,3,0,2020
FRA-Ligue 1,2019,Strasbourg,Jérémy Grimm,FRA,MF,32,1987,0.0,0,0,0,0,0,0,0,,0,0,0,0,0,0,0,0,2020
FRA-Ligue 1,2019,Strasbourg,Kenny Lala,FRA,"DF,MF",27,1991,22.7,29,16,17,11,1,11,27,40.7,16,14,5,9,20,49,40,1,2020
FRA-Ligue 1,2019,Strasbourg,Kévin Zohi,MLI,"FW,MF",22,1996,5.9,8,6,3,3,2,3,6,50.0,3,1,0,1,4,12,2,0,2020
FRA-Ligue 1,2019,Strasbourg,Lamine Koné,CIV,DF,30,1989,16.4,31,21,20,10,1,12,17,70.6,5,8,5,3,25,56,47,1,2020
FRA-Ligue 1,2019,Strasbourg,Lebo Mothiba,RSA,FW,23,1996,11.6,4,3,1,1,2,1,6,16.7,5,5,0,5,3,7,1,0,2020
FRA-Ligue 1,2019,Strasbourg,Lionel Carole,FRA,DF,28,1991,14.1,23,8,15,6,2,13,17,76.5,4,2,1,1,19,42,22,0,2020
FRA-Ligue 1,2019,Strasbourg,Ludovic Ajorque,FRA,FW,25,1994,22.9,15,10,2,10,3,2,13,15.4,11,11,0,11,2,17,20,0,2020
FRA-Ligue 1,2019,Strasbourg,Matz Sels,BEL,GK,27,1992,27.0,0,0,0,0,0,0,1,0.0,1,0,0,0,1,1,6,0,2020
FRA-Ligue 1,2019,Strasbourg,Mohamed Simakan,FRA,DF,19,2000,16.7,54,32,35,16,3,22,34,64.7,12,14,3,11,31,85,25,0,2020
FRA-Ligue 1,2019,Strasbourg,Mootaz Zemzemi,TUN,MF,19,1999,0.3,0,0,0,0,0,0,0,,0,0,0,0,1,1,0,0,2020
FRA-Ligue 1,2019,Strasbourg,Nuno da Costa,CPV,FW,28,1991,5.9,15,10,3,8,4,4,10,40.0,6,7,0,7,4,19,3,0,2020
FRA-Ligue 1,2019,Strasbourg,Sanjin Prcić,BIH,"MF,FW",25,1993,0.9,1,0,0,0,1,1,2,50.0,1,1,1,0,1,2,0,0,2020
FRA-Ligue 1,2019,Strasbourg,Stefan Mitrović,SRB,DF,29,1990,22.8,15,9,10,5,0,6,14,42.9,8,14,9,5,23,38,90,3,2020
FRA-Ligue 1,2019,Strasbourg,Youssouf Fofana,FRA,MF,20,1999,11.2,25,17,10,12,3,13,30,43.3,17,11,0,11,14,39,7,0,2020
FRA-Ligue 1,2019,Toulouse,Aaron Leya Iseka,BEL,FW,21,1997,8.6,2,0,0,2,0,0,3,0.0,3,5,0,5,1,3,7,0,2020
FRA-Ligue 1,2019,Toulouse,Adil Taoui,FRA,MF,17,2001,0.3,2,2,0,2,0,0,2,0.0,2,0,0,0,2,4,0,0,2020
FRA-Ligue 1,2019,Toulouse,Agustín Rogel,URU,DF,21,1997,9.5,15,8,12,3,0,7,13,53.8,6,13,10,3,11,26,35,2,2020
FRA-Ligue 1,2019,Toulouse,Amine Adli,FRA,"MF,FW",19,2000,0.5,0,0,0,0,0,0,1,0.0,1,0,0,0,1,1,0,0,2020
FRA-Ligue 1,2019,Toulouse,Bafodé Diakité,FRA,DF,18,2001,15.2,23,19,15,8,0,7,13,53.8,6,18,9,9,20,43,75,0,2020
FRA-Ligue 1,2019,Toulouse,Baptiste Reynet,FRA,GK,28,1990,22.6,1,1,1,0,0,1,3,33.3,2,0,0,0,0,1,12,0,2020
FRA-Ligue 1,2019,Toulouse,Corentin Jean,FRA,DF,24,1995,0.1,0,0,0,0,0,0,0,,0,0,0,0,0,0,1,0,2020
FRA-Ligue 1,2019,Toulouse,Efthimis Koulouris,GRE,FW,23,1996,17.1,13,8,5,5,3,3,13,23.1,10,8,4,4,3,16,16,0,2020
FRA-Ligue 1,2019,Toulouse,Gen Shoji,JPN,DF,26,1992,0.5,2,2,2,0,0,1,1,100.0,0,0,0,0,0,2,2,0,2020
FRA-Ligue 1,2019,Toulouse,Ibrahim Sangaré,CIV,MF,21,1997,24.2,84,54,37,42,5,33,74,44.6,41,28,10,18,39,123,49,4,2020
FRA-Ligue 1,2019,Toulouse,Issiaga Sylla,GUI,DF,25,1994,28.0,73,49,44,21,8,40,69,58.0,29,31,7,24,67,140,90,2,2020
FRA-Ligue 1,2019,Toulouse,Janis Antiste,FRA,MF,16,2002,0.1,0,0,0,0,0,0,0,,0,0,0,0,0,0,0,0,2020
FRA-Ligue 1,2019,Toulouse,Jean-Victor Makengo,FRA,MF,21,1998,11.0,14,11,3,10,1,4,13,30.8,9,7,1,6,3,17,5,1,2020
FRA-Ligue 1,2019,Toulouse,Kalidou Sidibé,FRA,MF,20,1999,1.0,3,3,0,3,0,2,5,40.0,3,0,0,0,1,4,0,0,2020
FRA-Ligue 1,2019,Toulouse,Kelvin Amian,FRA,DF,21,1998,18.1,27,21,21,5,1,14,25,56.0,11,14,7,7,18,45,56,0,2020
FRA-Ligue 1,2019,Toulouse,Kouadio Koné,FRA,MF,18,2001,9.7,35,20,17,14,4,13,30,43.3,17,15,1,14,19,54,10,1,2020
FRA-Ligue 1,2019,Toulouse,Lovre Kalinić,CRO,GK,29,1990,3.4,0,0,0,0,0,0,1,0.0,1,0,0,0,0,0,0,0,2020
FRA-Ligue 1,2019,Toulouse,Mathieu Dossevi,TOG,"MF,FW",31,1988,19.5,32,20,7,17,8,15,30,50.0,15,17,0,17,14,46,7,0,2020
FRA-Ligue 1,2019,Toulouse,Mathieu Goncalves,FRA,DF,18,2001,3.5,5,3,5,0,0,2,8,25.0,6,4,3,1,4,9,10,0,2020
FRA-Ligue 1,2019,Toulouse,Mauro Goicoechea,URU,GK,31,1988,2.0,0,0,0,0,0,0,0,,0,0,0,0,0,0,1,2,2020
FRA-Ligue 1,2019,Toulouse,Max Gradel,CIV,"MF,FW",31,1987,18.2,36,20,17,14,5,12,47,25.5,35,11,1,10,11,47,23,0,2020
FRA-Ligue 1,2019,Toulouse,Moussa Diarra,MLI,DF,18,2000,1.0,3,3,2,1,0,1,1,100.0,0,0,0,0,3,6,2,0,2020
FRA-Ligue 1,2019,Toulouse,Nathan N'Goumou,FRA,FW,19,2000,0.1,0,0,0,0,0,0,0,,0,0,0,0,0,0,1,0,2020
FRA-Ligue 1,2019,Toulouse,Nicolas Isimat-Mirin,FRA,DF,27,1991,14.0,14,8,8,6,0,5,11,45.5,6,18,12,6,22,36,71,0,2020
FRA-Ligue 1,2019,Toulouse,Quentin Boisgard,FRA,"MF,FW",22,1997,12.7,31,19,10,14,7,14,35,40.0,21,11,0,11,12,43,4,1,2020
FRA-Ligue 1,2019,Toulouse,Ruben Gabrielsen,NOR,DF,27,1992,7.3,3,2,3,0,0,2,4,50.0,2,5,3,2,8,11,41,0,2020
FRA-Ligue 1,2019,Toulouse,Steven Moreira,FRA,DF,24,1994,15.4,37,25,21,15,1,19,31,61.3,12,16,3,13,16,53,29,0,2020
FRA-Ligue 1,2019,Toulouse,Wesley Saïd,FRA,"MF,FW",24,1995,12.9,20,9,8,10,2,2,13,15.4,11,6,0,6,9,29,8,0,2020
FRA-Ligue 1,2019,Toulouse,William Vainqueur,FRA,MF,30,1988,19.1,68,36,30,32,6,22,60,36.7,38,21,5,16,29,97,23,0,2020
FRA-Ligue 1,2019,Toulouse,Yaya Sanogo,FRA,FW,26,1993,10.1,6,3,2,3,1,1,2,50.0,1,4,1,3,7,13,14,0,2020
FRA-Ligue 1,2020,Angers,Abdoulaye Bamba,CIV,DF,30,1990,15.0,27,17,19,7,1,19,28,67.9,9,7,1,6,19,46,34,0,2021
FRA-Ligue 1,2020,Angers,Angelo Fulgini,FRA,MF,23,1996,30.3,22,13,4,12,6,12,34,35.3,22,17,0,17,15,37,9,0,2021
FRA-Ligue 1,2020,Angers,Antonin Bobichon,FRA,"MF,FW",24,1995,10.1,23,14,10,8,5,9,15,60.0,6,4,1,3,2,25,1,0,2021
FRA-Ligue 1,2020,Angers,Baptiste Santamaria,FRA,MF,25,1995,3.0,9,6,3,5,1,2,7,28.6,5,4,0,4,7,16,8,0,2021
FRA-Ligue 1,2020,Angers,Casimir Ninga,CHA,FW,27,1993,0.3,0,0,0,0,0,0,0,,0,0,0,0,0,0,1,0,2021
FRA-Ligue 1,2020,Angers,Enzo Ebosse,CMR,DF,21,1999,2.9,5,3,5,0,0,3,4,75.0,1,1,1,0,2,7,13,0,2021
FRA-Ligue 1,2020,Angers,Farid El Melali,ALG,"FW,MF",23,1997,4.6,9,5,5,4,0,2,13,15.4,11,12,0,12,6,15,2,0,2021
FRA-Ligue 1,2020,Angers,Ibrahim Amadou,FRA,MF,27,1993,16.7,39,26,18,19,2,15,38,39.5,23,14,4,10,23,62,25,0,2021
FRA-Ligue 1,2020,Angers,Ismaël Traoré,CIV,DF,33,1986,33.3,32,14,23,9,0,20,37,54.1,17,27,13,14,40,72,107,0,2021
FRA-Ligue 1,2020,Angers,Jimmy Cabot,FRA,"FW,MF",26,1994,10.5,26,13,8,14,4,11,36,30.6,25,8,0,8,12,38,6,0,2021
FRA-Ligue 1,2020,Angers,Lassana Coulibaly,MLI,MF,24,1996,18.7,78,41,33,34,11,39,75,52.0,36,29,4,25,33,111,17,0,2021
FRA-Ligue 1,2020,Angers,Lois Diony,FRA,FW,27,1992,19.4,15,10,3,9,3,4,18,22.2,14,6,3,3,5,20,16,0,2021
FRA-Ligue 1,2020,Angers,Mateo Pavlović,BIH,DF,30,1990,12.3,11,6,8,3,0,8,23,34.8,15,13,11,2,21,32,40,0,2021
FRA-Ligue 1,2020,Angers,Mathias Pereira Lage,POR,"FW,MF",23,1996,16.3,29,17,12,15,2,10,40,25.0,30,21,4,17,15,44,16,0,2021
FRA-Ligue 1,2020,Angers,Mohamed Ali Cho,FRA,"FW,MF",16,2004,3.9,9,7,2,6,1,4,9,44.4,5,4,0,4,3,12,0,0,2021
FRA-Ligue 1,2020,Angers,Noah Fatar,FRA,"FW,MF",18,2002,0.2,1,0,0,0,1,0,0,,0,0,0,0,0,1,0,0,2021
FRA-Ligue 1,2020,Angers,Paul Bernardoni,FRA,GK,23,1997,38.0,1,1,1,0,0,1,2,50.0,1,0,0,0,2,3,23,1,2021
FRA-Ligue 1,2020,Angers,Pierrick Capelle,FRA,"MF,DF",33,1987,22.8,53,28,24,17,12,31,79,39.2,48,25,1,24,47,100,32,0,2021
FRA-Ligue 1,2020,Angers,Rachid Alioui,MAR,FW,28,1992,0.2,0,0,0,0,0,0,1,0.0,1,0,0,0,0,0,0,0,2021
FRA-Ligue 1,2020,Angers,Rayan Aït Nouri,ALG,DF,19,2001,2.1,3,2,1,2,0,3,5,60.0,2,2,1,1,4,7,1,0,2021
FRA-Ligue 1,2020,Angers,Romain Thomas,FRA,DF,32,1988,33.6,47,25,34,11,2,20,35,57.1,15,35,20,15,50,97,138,0,2021
FRA-Ligue 1,2020,Angers,Sada Thioub,SEN,"FW,MF",25,1995,14.0,17,14,7,6,4,7,23,30.4,16,10,0,10,9,26,3,0,2021
FRA-Ligue 1,2020,Angers,Sofiane Boufal,MAR,"FW,MF",26,1993,8.1,17,11,8,6,3,8,28,28.6,20,8,0,8,3,20,1,0,2021
FRA-Ligue 1,2020,Angers,Souleyman Doumbia,CIV,DF,23,1996,24.7,48,33,25,19,4,22,36,61.1,14,18,4,14,42,90,50,0,2021
FRA-Ligue 1,2020,Angers,Stéphane Bahoken,CMR,FW,28,1992,18.0,9,6,1,7,1,4,12,33.3,8,9,0,9,9,18,9,0,2021
FRA-Ligue 1,2020,Angers,Thomas Mangani,FRA,MF,33,1987,29.9,54,37,25,26,3,30,90,33.3,60,31,8,23,38,92,39,0,2021
FRA-Ligue 1,2020,Angers,Vincent Manceau,FRA,DF,31,1989,25.7,42,27,23,17,2,30,63,47.6,33,23,2,21,35,77,61,0,2021
FRA-Ligue 1,2020,Angers,Waniss Taibi,FRA,MF,18,2002,0.4,0,0,0,0,0,0,2,0.0,2,1,0,1,0,0,0,0,2021
FRA-Ligue 1,2020,Angers,Wilfried Kanga,CIV,FW,22,1998,1.5,0,0,0,0,0,0,1,0.0,1,1,0,1,0,0,2,0,2021
FRA-Ligue 1,2020,Angers,Yassin Fortune,FRA,FW,21,1999,0.2,0,0,0,0,0,0,0,,0,0,0,0,0,0,0,0,2021
FRA-Ligue 1,2020,Angers,Zinédine Ould Khaled,FRA,MF,20,2000,0.4,0,0,0,0,0,0,0,,0,0,0,0,1,1,0,0,2021
FRA-Ligue 1,2020,Bordeaux,Amadou Traore,FRA,"FW,MF",18,2002,3.4,6,1,2,2,2,2,9,22.2,7,9,0,9,1,7,2,0,2021
FRA-Ligue 1,2020,Bordeaux,Benoît Costil,FRA,GK,33,1987,38.0,1,1,1,0,0,1,3,33.3,2,1,0,1,1,2,17,0,2021
FRA-Ligue 1,2020,Bordeaux,Dilane Bakwa,FRA,"FW,MF",17,2002,0.6,2,2,1,1,0,0,1,0.0,1,2,0,2,1,3,0,0,2021
FRA-Ligue 1,2020,Bordeaux,Enock Kwateng,FRA,DF,23,1997,11.5,21,12,15,4,2,14,27,51.9,13,15,3,12,26,47,27,0,2021
FRA-Ligue 1,2020,Bordeaux,Hatem Ben Arfa,FRA,"MF,FW",33,1987,18.9,11,7,1,7,3,2,9,22.2,7,3,0,3,2,13,0,0,2021
FRA-Ligue 1,2020,Bordeaux,Hwang Ui-jo,KOR,"FW,MF",27,1992,27.8,14,6,5,8,1,6,25,24.0,19,17,2,15,8,22,14,0,2021
FRA-Ligue 1,2020,Bordeaux,Issouf Sissokho,MLI,"MF,DF",18,2002,0.9,6,4,4,2,0,3,6,50.0,3,2,0,2,1,7,0,0,2021
FRA-Ligue 1,2020,Bordeaux,Jean Seri,CIV,MF,29,1991,7.9,17,9,3,12,2,4,15,26.7,11,8,2,6,12,29,7,0,2021
FRA-Ligue 1,2020,Bordeaux,Jimmy Briand,FRA,FW,34,1985,6.3,7,3,3,2,2,1,1,100.0,0,2,0,2,1,8,3,0,2021
FRA-Ligue 1,2020,Bordeaux,Josh Maja,NGA,FW,21,1998,8.9,8,2,3,3,2,3,14,21.4,11,3,0,3,6,14,9,0,2021
FRA-Ligue 1,2020,Bordeaux,Laurent Koscielny,FRA,DF,34,1985,24.6,29,17,18,11,0,16,24,66.7,8,44,34,10,54,83,115,1,2021
FRA-Ligue 1,2020,Bordeaux,Loris Benito,SUI,DF,28,1992,29.5,42,26,27,12,3,22,48,45.8,26,33,10,23,42,84,70,0,2021
FRA-Ligue 1,2020,Bordeaux,Loïc Bessile,TOG,DF,21,1999,1.0,0,0,0,0,0,0,0,,0,2,1,1,1,1,3,0,2021
FRA-Ligue 1,2020,Bordeaux,Maxime Poundjé,FRA,DF,27,1992,5.5,10,7,9,1,0,2,6,33.3,4,7,3,4,11,21,5,0,2021
FRA-Ligue 1,2020,Bordeaux,Mehdi Zerkane,ALG,"MF,FW",21,1999,13.2,23,15,7,10,6,5,18,27.8,13,15,2,13,9,32,5,0,2021
FRA-Ligue 1,2020,Bordeaux,Mexer,MOZ,DF,31,1988,7.9,9,6,8,0,1,5,10,50.0,5,8,5,3,17,26,22,0,2021
FRA-Ligue 1,2020,Bordeaux,Nicolas de Préville,FRA,"FW,MF",29,1991,17.9,19,14,7,6,6,9,42,21.4,33,15,0,15,13,32,7,0,2021
FRA-Ligue 1,2020,Bordeaux,Otávio,BRA,MF,26,1994,17.3,54,31,33,19,2,26,55,47.3,29,20,5,15,26,80,36,0,2021
FRA-Ligue 1,2020,Bordeaux,Pablo,BRA,DF,29,1991,12.0,17,11,13,4,0,8,14,57.1,6,17,12,5,25,42,46,1,2021
FRA-Ligue 1,2020,Bordeaux,Paul Baysse,FRA,DF,32,1988,29.0,35,18,21,13,1,16,21,76.2,5,33,24,9,52,87,123,1,2021
FRA-Ligue 1,2020,Bordeaux,Remi Oudin,FRA,"FW,MF",23,1996,26.9,34,16,22,7,5,15,36,41.7,21,22,2,20,51,85,40,1,2021
FRA-Ligue 1,2020,Bordeaux,Rubén Pardo,ESP,MF,27,1992,0.3,0,0,0,0,0,0,0,,0,0,0,0,1,1,0,0,2021
FRA-Ligue 1,2020,Bordeaux,Samuel Kalu,NGA,"FW,MF",22,1997,10.7,21,12,11,8,2,4,13,30.8,9,14,0,14,9,30,2,0,2021
FRA-Ligue 1,2020,Bordeaux,Sekou Mara,FRA,"FW,MF",18,2002,2.5,5,3,1,3,1,2,10,20.0,8,0,0,0,1,6,1,0,2021
FRA-Ligue 1,2020,Bordeaux,Tom Lacoux,FRA,MF,18,2002,5.8,22,14,10,11,1,9,21,42.9,12,12,3,9,12,34,7,0,2021
FRA-Ligue 1,2020,Bordeaux,Toma Bašić,CRO,MF,23,1996,28.9,33,22,15,16,2,16,58,27.6,42,21,5,16,32,65,42,1,2021
FRA-Ligue 1,2020,Bordeaux,Yacine Adli,FRA,MF,20,2000,26.9,74,37,30,33,11,35,92,38.0,57,27,2,25,39,113,17,2,2021
FRA-Ligue 1,2020,Bordeaux,Youssouf Sabaly,SEN,DF,27,1993,32.3,47,33,24,17,6,27,45,60.0,18,31,8,23,49,96,57,2,2021
FRA-Ligue 1,2020,Brest,Bandiougou Fadiga,FRA,"MF,FW",19,2001,0.5,0,0,0,0,0,0,2,0.0,2,0,0,0,0,0,0,0,2021
FRA-Ligue 1,2020,Brest,Brendan Chardonnet,FRA,DF,25,1994,30.2,51,29,31,19,1,27,41,65.9,14,54,41,13,64,115,151,0,2021
FRA-Ligue 1,2020,Brest,Christophe Hérelle,MTQ,DF,27,1992,15.3,19,13,12,6,1,10,12,83.3,2,13,9,4,31,50,41,2,2021
FRA-Ligue 1,2020,Brest,Cristian Battocchio,ITA,MF,28,1992,3.9,5,2,1,4,0,2,9,22.2,7,0,0,0,4,9,5,0,2021
FRA-Ligue 1,2020,Brest,Franck Honorat,FRA,"MF,FW",23,1996,27.3,28,13,12,10,6,14,37,37.8,23,15,3,12,11,39,24,0,2021
FRA-Ligue 1,2020,Brest,Gautier Larsonneur,FRA,GK,23,1997,35.0,1,1,1,0,0,1,1,100.0,0,2,0,2,0,1,16,3,2021
FRA-Ligue 1,2020,Brest,Gaëtan Charbonnier,FRA,"MF,FW",31,1988,17.4,24,15,6,11,7,12,32,37.5,20,15,1,14,9,33,19,0,2021
FRA-Ligue 1,2020,Brest,Haris Belkebla,ALG,MF,26,1994,30.3,69,39,32,28,9,31,66,47.0,35,26,5,21,57,126,34,0,2021
FRA-Ligue 1,2020,Brest,Heriberto Tavares,POR,"FW,MF",23,1997,0.5,2,0,0,0,2,1,3,33.3,2,0,0,0,1,3,1,0,2021
FRA-Ligue 1,2020,Brest,Hianga Mananga Mbock,FRA,"MF,FW",20,1999,5.1,4,3,2,2,0,2,9,22.2,7,2,0,2,3,7,6,0,2021
FRA-Ligue 1,2020,Brest,Hugo Magnetti,FRA,MF,22,1998,6.7,24,12,10,13,1,20,40,50.0,20,6,1,5,14,38,8,0,2021
FRA-Ligue 1,2020,Brest,Ibrahima Diallo,FRA,MF,21,1999,4.9,14,9,2,9,3,4,8,50.0,4,4,0,4,3,17,3,0,2021
FRA-Ligue 1,2020,Brest,Irvin Cardona,FRA,FW,22,1997,22.5,10,5,3,6,1,4,22,18.2,18,17,3,14,9,19,23,2,2021
FRA-Ligue 1,2020,Brest,Jean Lucas,BRA,"MF,FW",22,1998,11.2,19,13,10,9,0,8,29,27.6,21,7,0,7,8,27,10,1,2021
FRA-Ligue 1,2020,Brest,Jean-Kevin Duverne,FRA,DF,23,1997,22.5,38,21,24,14,0,15,32,46.9,17,24,16,8,30,68,70,0,2021
FRA-Ligue 1,2020,Brest,Julien Faussurier,FRA,DF,33,1987,10.6,16,11,6,8,2,11,25,44.0,14,12,4,8,9,25,10,0,2021
FRA-Ligue 1,2020,Brest,Jérémy Le Douaron,FRA,"FW,MF",22,1998,9.1,15,10,9,4,2,7,21,33.3,14,14,1,13,8,23,11,0,2021
FRA-Ligue 1,2020,Brest,Lilian Brassier,FRA,DF,20,1999,10.7,19,10,12,4,3,7,11,63.6,4,13,6,7,23,42,38,1,2021
FRA-Ligue 1,2020,Brest,Ludovic Baal,GUF,"DF,MF",34,1986,3.3,6,5,4,1,1,2,5,40.0,3,4,1,3,5,11,5,0,2021
FRA-Ligue 1,2020,Brest,Paul Lasne,FRA,MF,31,1989,18.7,46,26,25,19,2,17,40,42.5,23,25,5,20,47,93,17,2,2021
FRA-Ligue 1,2020,Brest,Romain Faivre,FRA,"MF,FW",22,1998,32.1,54,27,26,23,5,21,54,38.9,33,30,0,30,30,84,18,0,2021
FRA-Ligue 1,2020,Brest,Romain Perraud,FRA,DF,22,1997,34.9,60,34,42,16,2,24,45,53.3,21,36,3,33,45,105,76,0,2021
FRA-Ligue 1,2020,Brest,Romain Philippoteaux,FRA,"MF,FW",32,1988,6.5,11,6,6,3,2,6,9,66.7,3,4,0,4,10,21,2,0,2021
FRA-Ligue 1,2020,Brest,Ronaël Pierre-Gabriel,FRA,DF,22,1998,25.6,60,40,42,16,2,35,52,67.3,17,17,7,10,30,90,57,0,2021
FRA-Ligue 1,2020,Brest,Steve Mounié,BEN,FW,25,1994,29.8,15,11,3,11,1,3,28,10.7,25,18,3,15,12,27,40,0,2021
FRA-Ligue 1,2020,Brest,Sébastien Cibois,FRA,GK,22,1998,3.0,0,0,0,0,0,0,0,,0,0,0,0,0,0,0,1,2021
FRA-Ligue 1,2020,Dijon,Aboubakar Kamara,MTN,"FW,MF",25,1995,6.2,3,1,0,2,1,1,7,14.3,6,1,0,1,0,3,2,0,2021
FRA-Ligue 1,2020,Dijon,Ahmad Ngouyamsa,CMR,DF,19,2000,1.7,6,4,5,1,0,4,8,50.0,4,2,1,1,2,8,8,0,2021
FRA-Ligue 1,2020,Dijon,Alfred Gomis,SEN,GK,26,1993,5.0,1,0,1,0,0,1,2,50.0,1,0,0,0,1,2,7,0,2021
FRA-Ligue 1,2020,Dijon,Anthony Racioppi,SUI,GK,21,1998,21.0,0,0,0,0,0,0,2,0.0,2,0,0,0,2,2,12,4,2021
FRA-Ligue 1,2020,Dijon,Aníbal Chalá,ECU,DF,24,1996,8.3,10,7,6,3,1,6,12,50.0,6,5,3,2,14,24,15,1,2021
FRA-Ligue 1,2020,Dijon,Arthur Zagre,FRA,"DF,MF",18,2001,1.4,3,1,2,1,0,2,2,100.0,0,1,1,0,3,6,1,0,2021
FRA-Ligue 1,2020,Dijon,Aurélien Scheidler,FRA,FW,22,1998,3.8,2,0,0,2,0,0,2,0.0,2,0,0,0,1,3,5,0,2021
FRA-Ligue 1,2020,Dijon,Bersant Celina,KVX,"MF,FW",23,1996,25.5,20,12,8,8,4,7,38,18.4,31,20,2,18,8,28,10,0,2021
FRA-Ligue 1,2020,Dijon,Bruno Ecuele Manga,GAB,DF,32,1988,38.0,52,38,46,6,0,29,40,72.5,11,50,33,17,57,109,165,3,2021
FRA-Ligue 1,2020,Dijon,Charles Costes,FRA,MF,17,2002,0.0,0,0,0,0,0,0,0,,0,0,0,0,0,0,0,0,2021
FRA-Ligue 1,2020,Dijon,Didier Ibrahim Ndong,GAB,MF,26,1994,29.0,53,32,22,30,1,25,70,35.7,45,35,7,28,37,90,40,0,2021
FRA-Ligue 1,2020,Dijon,Erwan Belhadji,FRA,MF,19,2001,0.3,3,0,3,0,0,3,5,60.0,2,1,0,1,0,3,0,0,2021
FRA-Ligue 1,2020,Dijon,Fouad Chafik,MAR,DF,33,1986,18.0,39,24,29,8,2,16,35,45.7,19,19,10,9,21,60,41,0,2021
FRA-Ligue 1,2020,Dijon,Frédéric Sammaritano,FRA,"FW,MF",34,1986,12.6,15,10,9,5,1,9,26,34.6,17,6,0,6,9,24,3,0,2021
FRA-Ligue 1,2020,Dijon,Jacques Siwe,FRA,FW,19,2001,1.9,4,1,1,1,2,0,1,0.0,1,1,0,1,1,5,1,0,2021
FRA-Ligue 1,2020,Dijon,Jonathan Panzo,ENG,DF,19,2000,20.0,17,12,13,4,0,8,11,72.7,3,27,13,14,59,76,91,2,2021
FRA-Ligue 1,2020,Dijon,Jordan Marié,FRA,MF,28,1991,15.9,34,17,9,23,2,23,56,41.1,33,14,5,9,23,57,12,2,2021
FRA-Ligue 1,2020,Dijon,Junior Dina Ebimbe,FRA,"FW,MF",19,2000,23.8,38,25,14,19,5,15,45,33.3,30,17,1,16,14,52,9,0,2021
FRA-Ligue 1,2020,Dijon,Mama Samba Baldé,GNB,FW,24,1995,24.0,23,9,4,13,6,9,22,40.9,13,16,1,15,4,27,26,0,2021
FRA-Ligue 1,2020,Dijon,Mihai Dobre,ROU,FW,21,1998,5.9,12,5,6,2,4,7,14,50.0,7,5,0,5,10,22,3,0,2021
FRA-Ligue 1,2020,Dijon,Mounir Chouiar,FRA,"FW,MF",21,1999,14.3,22,12,10,9,3,6,18,33.3,12,10,0,10,11,33,8,0,2021
FRA-Ligue 1,2020,Dijon,Moussa Konaté,SEN,FW,27,1993,13.3,5,3,1,2,2,2,11,18.2,9,4,1,3,5,10,8,0,2021
FRA-Ligue 1,2020,Dijon,Muzinga Ngonda,COD,DF,25,1994,25.6,59,40,37,21,1,30,50,60.0,20,28,3,25,72,131,58,0,2021
FRA-Ligue 1,2020,Dijon,Pape Cheikh Diop,SEN,MF,22,1997,12.1,24,14,15,6,3,13,33,39.4,20,14,2,12,6,30,6,0,2021
FRA-Ligue 1,2020,Dijon,Rayan Philippe,FRA,FW,19,2000,1.0,3,1,1,1,1,2,2,100.0,0,0,0,0,0,3,0,0,2021
FRA-Ligue 1,2020,Dijon,Roger Assalé,CIV,"FW,MF",26,1993,9.2,10,8,3,5,2,4,12,33.3,8,7,3,4,2,12,2,0,2021
FRA-Ligue 1,2020,Dijon,Romain Amalfitano,FRA,"FW,DF",30,1989,1.3,4,2,3,1,0,1,3,33.3,2,2,1,1,1,5,1,0,2021
FRA-Ligue 1,2020,Dijon,Sacha Boey,FRA,DF,19,2000,20.7,54,40,30,23,1,27,55,49.1,28,25,5,20,41,95,62,0,2021
FRA-Ligue 1,2020,Dijon,Saturnin Allagbé,BEN,GK,26,1993,12.0,0,0,0,0,0,0,1,0.0,1,0,0,0,0,0,9,3,2021
FRA-Ligue 1,2020,Dijon,Senou Coulibaly,MLI,DF,25,1994,21.5,33,21,23,10,0,12,24,50.0,12,18,12,6,30,63,89,0,2021
FRA-Ligue 1,2020,Dijon,Wesley Lautoa,NCL,"MF,DF",32,1987,17.9,36,20,20,13,3,11,37,29.7,26,17,8,9,29,65,33,1,2021
FRA-Ligue 1,2020,Dijon,Wilitty Younoussa,CMR,MF,18,2001,0.9,6,3,3,3,0,3,7,42.9,4,3,0,3,2,8,0,0,2021
FRA-Ligue 1,2020,Dijon,Yassine Benzia,ALG,"MF,FW",25,1994,4.5,10,5,5,3,2,2,10,20.0,8,3,0,3,6,16,2,0,2021
FRA-Ligue 1,2020,Lens,Adrien Louveau,FRA,MF,20,2000,0.1,0,0,0,0,0,0,0,,0,0,0,0,0,0,1,0,2021
FRA-Ligue 1,2020,Lens,Aleksandar Radovanović,SRB,DF,26,1993,1.0,1,1,0,1,0,0,0,,0,2,1,1,0,1,2,0,2021
FRA-Ligue 1,2020,Lens,Ansou Sow,FRA,MF,20,2000,0.1,0,0,0,0,0,0,0,,0,1,0,1,0,0,0,0,2021
FRA-Ligue 1,2020,Lens,Arnaud Kalimuendo,FRA,"FW,MF",18,2002,13.5,8,2,2,2,4,1,7,14.3,6,11,0,11,2,10,2,0,2021
FRA-Ligue 1,2020,Lens,Cheick Doucouré,MLI,MF,20,2000,29.2,87,47,40,42,5,32,65,49.2,33,20,4,16,52,139,26,1,2021
FRA-Ligue 1,2020,Lens,Cheick Traoré,MLI,DF,25,1995,0.4,2,2,1,1,0,2,4,50.0,2,1,0,1,2,4,1,0,2021
FRA-Ligue 1,2020,Lens,Clément Michelin,FRA,DF,23,1997,12.8,25,19,13,9,3,9,16,56.3,7,13,4,9,25,50,32,0,2021
FRA-Ligue 1,2020,Lens,Corentin Jean,FRA,"FW,MF",25,1995,6.4,4,3,1,1,2,0,5,0.0,5,4,0,4,2,6,2,0,2021
FRA-Ligue 1,2020,Lens,David Pereira da Costa,POR,"MF,FW",19,2001,1.8,4,4,1,2,1,2,3,66.7,1,2,0,2,0,4,4,0,2021
FRA-Ligue 1,2020,Lens,Facundo Medina,ARG,DF,21,1999,22.3,39,22,22,15,2,24,38,63.2,14,25,9,16,39,78,51,3,2021
FRA-Ligue 1,2020,Lens,Florian Sotoca,FRA,FW,29,1990,26.8,31,20,3,20,8,6,22,27.3,16,27,0,27,9,40,24,0,2021
FRA-Ligue 1,2020,Lens,Gaël Kakuta,COD,"MF,FW",29,1991,26.6,38,23,10,18,10,8,44,18.2,36,24,3,21,17,55,4,0,2021
FRA-Ligue 1,2020,Lens,Ignatius Ganago,CMR,FW,21,1999,14.5,4,3,0,2,2,3,12,25.0,9,7,1,6,6,10,3,0,2021
FRA-Ligue 1,2020,Lens,Ismaëlben Boura,FRA,DF,19,2000,9.1,11,7,8,2,1,3,9,33.3,6,7,2,5,21,32,12,0,2021
FRA-Ligue 1,2020,Lens,Issiaga Sylla,GUI,"DF,MF",26,1994,12.4,28,20,11,17,0,11,21,52.4,10,13,3,10,16,44,21,0,2021
FRA-Ligue 1,2020,Lens,Jean-Louis Leca,FRA,GK,34,1985,36.8,3,2,3,0,0,3,5,60.0,2,0,0,0,1,4,14,4,2021
FRA-Ligue 1,2020,Lens,Jonathan Clauss,FRA,DF,27,1992,28.0,43,20,12,20,11,17,38,44.7,21,24,1,23,45,88,46,0,2021
FRA-Ligue 1,2020,Lens,Jonathan Gradit,FRA,DF,27,1992,31.4,60,39,26,28,6,22,38,57.9,16,37,19,18,56,116,81,1,2021
FRA-Ligue 1,2020,Lens,Loïc Bade,FRA,DF,20,2000,29.0,57,34,47,10,0,30,55,54.5,25,43,17,26,74,131,135,2,2021
FRA-Ligue 1,2020,Lens,Manuel Perez,FRA,"MF,FW",29,1991,1.4,1,0,1,0,0,0,8,0.0,8,2,0,2,2,3,2,0,2021
FRA-Ligue 1,2020,Lens,Massadio Haïdara,MLI,DF,27,1992,23.7,48,32,21,21,6,23,37,62.2,14,29,6,23,35,83,60,0,2021
FRA-Ligue 1,2020,Lens,Seko Fofana,CIV,MF,25,1995,25.7,16,8,3,10,3,4,26,15.4,22,16,5,11,34,50,23,1,2021
FRA-Ligue 1,2020,Lens,Simon Banza,FRA,FW,23,1996,15.2,13,6,0,4,9,1,14,7.1,13,16,1,15,7,20,15,0,2021
FRA-Ligue 1,2020,Lens,Steven Fortes,CPV,DF,28,1992,15.9,33,20,20,10,3,16,22,72.7,6,25,10,15,27,60,52,0,2021
FRA-Ligue 1,2020,Lens,Tony Mauricio,FRA,MF,26,1994,5.6,19,12,7,8,4,11,17,64.7,6,8,1,7,3,22,4,0,2021
FRA-Ligue 1,2020,Lens,Wuilker Faríñez,VEN,GK,22,1998,1.2,0,0,0,0,0,0,0,,0,0,0,0,0,0,1,0,2021
FRA-Ligue 1,2020,Lens,Yannick Cahuzac,FRA,MF,35,1985,25.0,26,12,12,10,4,9,27,33.3,18,18,5,13,33,59,72,0,2021
FRA-Ligue 1,2020,Lille,Adama Soumaoro,FRA,DF,28,1992,1.6,1,0,0,0,1,0,0,,0,1,1,0,2,3,2,0,2021
FRA-Ligue 1,2020,Lille,Benjamin André,FRA,MF,29,1990,32.1,114,68,47,61,6,53,122,43.4,69,39,10,29,76,190,49,0,2021
FRA-Ligue 1,2020,Lille,Boubakary Soumaré,FRA,MF,21,1999,21.3,44,29,16,25,3,14,29,48.3,15,14,6,8,39,83,21,0,2021
FRA-Ligue 1,2020,Lille,Burak Yılmaz,TUR,FW,35,1985,22.8,13,6,3,7,3,4,30,13.3,26,7,0,7,5,18,22,0,2021
FRA-Ligue 1,2020,Lille,Domagoj Bradarić,CRO,DF,20,1999,14.0,28,18,11,13,4,12,27,44.4,15,14,4,10,26,54,21,0,2021
FRA-Ligue 1,2020,Lille,Isaac Lihadji,FRA,"MF,FW",18,2002,2.2,11,4,2,6,3,4,5,80.0,1,5,1,4,1,12,0,1,2021
FRA-Ligue 1,2020,Lille,Jonathan Bamba,CIV,MF,24,1996,33.2,45,23,15,19,11,24,84,28.6,60,24,2,22,24,69,15,0,2021
FRA-Ligue 1,2020,Lille,Jonathan David,CAN,FW,20,2000,26.2,17,10,5,5,7,9,24,37.5,15,19,1,18,3,20,9,0,2021
FRA-Ligue 1,2020,Lille,Jonathan Ikone,FRA,"MF,FW",22,1998,24.2,18,12,3,8,7,9,22,40.9,13,16,1,15,7,25,9,0,2021
FRA-Ligue 1,2020,Lille,José Fonte,POR,DF,36,1983,35.4,40,29,28,10,2,27,33,81.8,6,36,23,13,36,76,137,1,2021
FRA-Ligue 1,2020,Lille,Jérémy Pied,FRA,DF,31,1989,3.5,7,0,3,3,1,4,9,44.4,5,3,1,2,6,13,8,0,2021
FRA-Ligue 1,2020,Lille,Luiz Araújo,BRA,MF,24,1996,16.6,38,25,12,18,8,8,28,28.6,20,23,1,22,11,49,3,0,2021
FRA-Ligue 1,2020,Lille,Mike Maignan,FRA,GK,25,1995,38.0,0,0,0,0,0,0,0,,0,0,0,0,0,0,7,2,2021
FRA-Ligue 1,2020,Lille,Reinildo Mandava,MOZ,DF,26,1994,24.2,79,43,39,32,8,35,58,60.3,23,26,3,23,45,124,53,0,2021
FRA-Ligue 1,2020,Lille,Renato Sanches,POR,MF,22,1997,14.1,13,7,4,8,1,5,25,20.0,20,13,2,11,13,26,8,0,2021
FRA-Ligue 1,2020,Lille,Sven Botman,NED,DF,20,2000,36.8,31,21,18,12,1,14,26,53.8,12,31,21,10,57,88,126,2,2021
FRA-Ligue 1,2020,Lille,Tiago Djaló,POR,DF,20,2000,9.7,22,13,14,5,3,15,23,65.2,8,10,4,6,9,31,23,0,2021
FRA-Ligue 1,2020,Lille,Timothy Weah,USA,"FW,MF",20,2000,9.8,15,7,3,9,3,7,14,50.0,7,7,0,7,4,19,5,0,2021
FRA-Ligue 1,2020,Lille,Xeka,POR,MF,25,1994,13.3,33,17,14,15,4,16,43,37.2,27,14,2,12,20,53,18,0,2021
FRA-Ligue 1,2020,Lille,Yusuf Yazıcı,TUR,"FW,MF",23,1997,12.1,12,5,6,2,4,1,24,4.2,23,5,1,4,2,14,2,0,2021
FRA-Ligue 1,2020,Lille,Zeki Çelik,TUR,DF,23,1997,26.5,72,33,30,30,12,44,81,54.3,37,32,6,26,38,110,52,0,2021
FRA-Ligue 1,2020,Lorient,Adrian Grbić,AUT,FW,23,1996,10.7,6,4,2,2,2,1,7,14.3,6,6,0,6,5,11,7,0,2021
FRA-Ligue 1,2020,Lorient,Andrew Gravillon,GLP,DF,22,1998,25.2,26,17,17,9,0,13,28,46.4,15,44,31,13,59,85,118,4,2021
FRA-Ligue 1,2020,Lorient,Armand Lauriente,FRA,"MF,FW",21,1998,18.0,30,10,10,19,1,7,26,26.9,19,21,0,21,15,45,4,0,2021
FRA-Ligue 1,2020,Lorient,Enzo Le Fée,FRA,MF,20,2000,20.2,51,28,23,23,5,27,73,37.0,46,30,6,24,25,76,10,0,2021
FRA-Ligue 1,2020,Lorient,Fabien Lemoine,FRA,MF,33,1987,21.5,74,45,39,33,2,36,89,40.4,53,25,1,24,27,101,35,0,2021
FRA-Ligue 1,2020,Lorient,Franklin Wadja,CMR,"MF,FW",25,1995,0.4,4,2,0,2,2,2,2,100.0,0,0,0,0,2,6,1,0,2021
FRA-Ligue 1,2020,Lorient,Houboulang Mendes,FRA,DF,22,1998,14.4,28,19,19,5,4,16,28,57.1,12,14,2,12,14,42,35,0,2021
FRA-Ligue 1,2020,Lorient,Jonathan Delaplace,FRA,DF,34,1986,10.1,8,5,5,1,2,7,13,53.8,6,12,5,7,17,25,19,1,2021
FRA-Ligue 1,2020,Lorient,Julien Laporte,FRA,DF,26,1993,29.5,65,39,48,16,1,42,74,56.8,32,34,23,11,65,130,125,0,2021
FRA-Ligue 1,2020,Lorient,Jérémy Morel,MAD,DF,36,1984,27.7,31,19,21,10,0,20,39,51.3,19,26,11,15,44,75,81,1,2021
FRA-Ligue 1,2020,Lorient,Jérôme Hergault,FRA,"DF,MF",34,1986,18.1,38,23,22,10,6,17,31,54.8,14,16,2,14,22,60,34,0,2021
FRA-Ligue 1,2020,Lorient,Laurent Abergel,FRA,MF,27,1993,32.9,145,84,64,69,12,54,162,33.3,108,64,6,58,46,191,12,0,2021
FRA-Ligue 1,2020,Lorient,Loris Mouyokolo,CGO,DF,19,2001,0.2,1,1,1,0,0,1,1,100.0,0,1,1,0,0,1,1,0,2021
FRA-Ligue 1,2020,Lorient,Matthieu Dreyer,FRA,GK,31,1989,15.0,0,0,0,0,0,0,0,,0,0,0,0,0,0,4,2,2021
FRA-Ligue 1,2020,Lorient,Paul Nardi,FRA,GK,26,1994,23.0,0,0,0,0,0,0,1,0.0,1,1,0,1,0,0,15,2,2021
FRA-Ligue 1,2020,Lorient,Pierre-Yves Hamel,FRA,FW,26,1994,9.4,15,8,3,9,3,1,6,16.7,5,12,1,11,10,25,6,0,2021
FRA-Ligue 1,2020,Lorient,Quentin Boisgard,FRA,"MF,FW",23,1997,14.6,24,17,3,15,6,11,24,45.8,13,17,2,15,15,39,1,0,2021
FRA-Ligue 1,2020,Lorient,Stéphane Diarra,FRA,"MF,FW",21,1998,2.2,0,0,0,0,0,0,7,0.0,7,6,1,5,4,4,1,0,2021
FRA-Ligue 1,2020,Lorient,Sylvain Marveaux,FRA,"MF,FW",34,1986,2.2,6,3,1,4,1,3,3,100.0,0,2,0,2,1,7,2,0,2021
FRA-Ligue 1,2020,Lorient,Terem Moffi,NGA,FW,21,1999,23.0,13,8,0,8,5,4,19,21.1,15,5,2,3,4,17,8,0,2021
FRA-Ligue 1,2020,Lorient,Thomas Fontaine,MAD,DF,29,1991,3.6,5,2,5,0,0,2,2,100.0,0,3,2,1,5,10,14,0,2021
FRA-Ligue 1,2020,Lorient,Thomas Monconduit,FRA,MF,29,1991,12.8,28,15,9,16,3,15,41,36.6,26,10,3,7,13,41,21,1,2021
FRA-Ligue 1,2020,Lorient,Trevoh Chalobah,ENG,"DF,MF",21,1999,24.9,45,26,32,13,0,24,50,48.0,26,20,7,13,69,114,56,0,2021
FRA-Ligue 1,2020,Lorient,Umut Bozok,TUR,"MF,FW",23,1996,0.7,0,0,0,0,0,0,2,0.0,2,0,0,0,0,0,0,0,2021
FRA-Ligue 1,2020,Lorient,Vincent Le Goff,FRA,DF,30,1989,25.6,42,29,16,24,2,18,49,36.7,31,27,5,22,44,86,44,0,2021
FRA-Ligue 1,2020,Lorient,Yoane Wissa,COD,"MF,FW",23,1996,29.7,35,20,12,14,9,11,34,32.4,23,25,3,22,20,55,14,0,2021
FRA-Ligue 1,2020,Lorient,Yoann Etienne,FRA,DF,23,1997,1.0,2,0,1,1,0,1,1,100.0,0,1,0,1,1,3,2,0,2021
FRA-Ligue 1,2020,Lyon,Anthony Lopes,POR,GK,29,1990,38.0,1,1,1,0,0,1,2,50.0,1,1,0,1,1,2,20,1,2021
FRA-Ligue 1,2020,Lyon,Bruno Guimarães,BRA,MF,22,1997,19.5,76,34,26,41,9,30,64,46.9,34,24,4,20,14,90,13,0,2021
FRA-Ligue 1,2020,Lyon,Djamel Benlamri,ALG,DF,30,1989,1.7,5,3,5,0,0,3,6,50.0,3,3,2,1,6,11,11,0,2021
FRA-Ligue 1,2020,Lyon,Fernando Marçal,BRA,DF,31,1989,0.9,1,0,0,1,0,0,0,,0,0,0,0,2,3,0,0,2021
FRA-Ligue 1,2020,Lyon,Florent da Silva,FRA,FW,17,2003,0.0,0,0,0,0,0,0,0,,0,0,0,0,0,0,0,0,2021
FRA-Ligue 1,2020,Lyon,Habib Keita,MLI,MF,18,2002,0.1,0,0,0,0,0,0,0,,0,0,0,0,0,0,0,0,2021
FRA-Ligue 1,2020,Lyon,Houssem Aouar,ALG,"MF,FW",22,1998,19.8,17,12,0,13,4,8,25,32.0,17,17,1,16,17,34,4,0,2021
FRA-Ligue 1,2020,Lyon,Islam Slimani,ALG,FW,32,1988,6.4,7,5,3,1,3,3,12,25.0,9,4,1,3,1,8,6,0,2021
FRA-Ligue 1,2020,Lyon,Jason Denayer,BEL,DF,25,1995,29.0,25,16,16,9,0,6,13,46.2,7,36,25,11,27,52,91,1,2021
FRA-Ligue 1,2020,Lyon,Jean Lucas,BRA,MF,22,1998,1.9,3,2,2,1,0,1,4,25.0,3,3,1,2,2,5,1,0,2021
FRA-Ligue 1,2020,Lyon,Jeff Reine-Adélaïde,FRA,FW,22,1998,0.3,0,0,0,0,0,0,0,,0,0,0,0,0,0,0,0,2021
FRA-Ligue 1,2020,Lyon,Joachim Andersen,DEN,DF,24,1996,2.1,2,1,1,1,0,2,2,100.0,0,1,1,0,2,4,6,0,2021
FRA-Ligue 1,2020,Lyon,Karl Toko Ekambi,CMR,FW,27,1992,31.2,16,10,5,3,8,8,32,25.0,24,20,1,19,26,42,8,0,2021
FRA-Ligue 1,2020,Lyon,Kenny Tete,NED,DF,24,1995,0.2,2,0,1,1,0,0,0,,0,0,0,0,2,4,0,0,2021
FRA-Ligue 1,2020,Lyon,Leo Dubois,FRA,DF,25,1994,32.3,38,26,19,16,3,18,36,50.0,18,27,9,18,31,69,69,2,2021
FRA-Ligue 1,2020,Lyon,Lucas Paquetá,BRA,MF,22,1997,25.3,70,36,30,28,12,23,66,34.8,43,28,3,25,20,90,16,1,2021
FRA-Ligue 1,2020,Lyon,Malo Gusto,FRA,"DF,MF",17,2003,0.0,0,0,0,0,0,0,0,,0,0,0,0,0,0,0,0,2021
FRA-Ligue 1,2020,Lyon,Marcelo,BRA,DF,33,1987,32.3,44,29,30,12,2,26,37,70.3,11,35,25,10,49,93,122,2,2021
FRA-Ligue 1,2020,Lyon,Mattia De Sciglio,ITA,DF,27,1992,16.3,29,17,15,11,3,18,27,66.7,9,13,4,9,27,56,44,0,2021
FRA-Ligue 1,2020,Lyon,Maxence Caqueret,FRA,MF,20,2000,19.6,72,45,17,39,16,35,106,33.0,71,35,3,32,23,95,5,2,2021
FRA-Ligue 1,2020,Lyon,Maxwel Cornet,CIV,"DF,FW",23,1996,27.2,70,41,39,24,7,33,58,56.9,25,23,5,18,43,113,47,2,2021
FRA-Ligue 1,2020,Lyon,Melvin Bard,FRA,DF,19,2000,4.8,12,8,7,4,1,6,11,54.5,5,10,2,8,6,18,14,0,2021
FRA-Ligue 1,2020,Lyon,Memphis,NED,FW,26,1994,32.5,4,3,0,3,1,1,20,5.0,19,11,1,10,5,9,3,0,2021
FRA-Ligue 1,2020,Lyon,Moussa Dembélé,FRA,FW,24,1996,7.5,2,2,0,1,1,0,4,0.0,4,4,2,2,5,7,9,0,2021
FRA-Ligue 1,2020,Lyon,Rayan Cherki,FRA,"FW,MF",16,2003,7.8,5,3,0,3,2,1,11,9.1,10,3,0,3,4,9,0,0,2021
FRA-Ligue 1,2020,Lyon,Sinaly Diomande,CIV,DF,19,2001,12.6,10,7,8,1,1,5,14,35.7,9,19,15,4,33,43,53,1,2021
FRA-Ligue 1,2020,Lyon,Thiago Mendes,BRA,MF,28,1992,24.9,37,22,13,20,4,18,38,47.4,20,33,7,26,39,76,21,2,2021
FRA-Ligue 1,2020,Lyon,Tino Kadewere,ZIM,FW,24,1996,22.3,35,22,12,16,7,17,49,34.7,32,16,3,13,21,56,31,0,2021
FRA-Ligue 1,2020,Lyon,Yaya Soumaré,FRA,MF,20,2000,0.0,,1,,,,,,,,,,,2,,,,2021
FRA-Ligue 1,2020,Marseille,Arkadiusz Milik,POL,FW,26,1994,13.6,14,9,0,7,7,2,12,16.7,10,5,1,4,2,16,9,0,2021
FRA-Ligue 1,2020,Marseille,Bamba Dieng,SEN,"FW,DF",20,2000,1.4,5,3,3,2,0,2,4,50.0,2,2,0,2,0,5,0,0,2021
FRA-Ligue 1,2020,Marseille,Boubacar Kamara,FRA,MF,20,1999,32.2,88,51,31,49,8,40,74,54.1,34,36,13,23,34,122,51,0,2021
FRA-Ligue 1,2020,Marseille,Bouna Sarr,SEN,DF,28,1992,0.8,1,1,0,0,1,1,1,100.0,0,1,1,0,1,2,1,0,2021
FRA-Ligue 1,2020,Marseille,Cheick Souaré,FRA,MF,17,2002,0.1,0,0,0,0,0,0,0,,0,1,1,0,1,1,0,0,2021
FRA-Ligue 1,2020,Marseille,Christopher Rocchia,FRA,"DF,FW",22,1998,0.2,1,0,1,0,0,0,2,0.0,2,0,0,0,0,1,1,0,2021
FRA-Ligue 1,2020,Marseille,Darío Benedetto,ARG,FW,30,1990,17.5,6,4,1,4,1,5,13,38.5,8,9,2,7,3,9,17,0,2021
FRA-Ligue 1,2020,Marseille,Dimitri Payet,FRA,"FW,MF",33,1987,26.9,27,17,4,16,7,17,40,42.5,23,19,2,17,8,35,10,0,2021
FRA-Ligue 1,2020,Marseille,Duje Ćaleta-Car,CRO,DF,23,1996,31.3,29,17,19,9,1,17,30,56.7,13,29,22,7,44,73,130,0,2021
FRA-Ligue 1,2020,Marseille,Florian Thauvin,FRA,"FW,MF",27,1993,30.4,40,22,14,21,5,20,54,37.0,34,26,2,24,14,54,11,0,2021
FRA-Ligue 1,2020,Marseille,Hiroki Sakai,JPN,DF,30,1990,26.5,81,48,34,35,12,39,51,76.5,12,21,5,16,54,135,65,0,2021
FRA-Ligue 1,2020,Marseille,Jordan Amavi,FRA,DF,26,1994,9.0,11,9,9,1,1,9,12,75.0,3,12,2,10,27,38,33,1,2021
FRA-Ligue 1,2020,Marseille,Kevin Strootman,NED,"MF,FW",30,1990,2.6,9,6,5,4,0,4,8,50.0,4,5,2,3,5,14,7,0,2021
FRA-Ligue 1,2020,Marseille,Leonardo Balerdi,ARG,DF,21,1999,18.2,29,18,19,7,3,14,31,45.2,17,17,9,8,28,57,65,3,2021
FRA-Ligue 1,2020,Marseille,Lucas Perrin,FRA,DF,21,1998,3.4,7,4,4,3,0,5,12,41.7,7,5,4,1,8,15,16,0,2021
FRA-Ligue 1,2020,Marseille,Luis Henrique,BRA,"FW,DF",18,2001,7.5,5,4,3,1,1,4,9,44.4,5,5,1,4,7,12,4,0,2021
FRA-Ligue 1,2020,Marseille,Marley Aké,FRA,FW,19,2001,1.6,3,3,1,0,2,0,1,0.0,1,2,0,2,0,3,1,0,2021
FRA-Ligue 1,2020,Marseille,Maxime Lopez,FRA,"FW,MF",22,1997,1.5,1,1,1,0,0,0,2,0.0,2,0,0,0,2,3,2,0,2021
FRA-Ligue 1,2020,Marseille,Mickaël Cuisance,FRA,MF,20,1999,11.4,24,11,2,15,7,10,33,30.3,23,13,1,12,3,27,4,0,2021
FRA-Ligue 1,2020,Marseille,Morgan Sanson,FRA,MF,25,1994,9.2,21,12,6,12,3,9,28,32.1,19,12,0,12,9,30,5,0,2021
FRA-Ligue 1,2020,Marseille,Nemanja Radonjić,SRB,FW,24,1996,4.4,6,5,1,2,3,2,12,16.7,10,8,0,8,3,9,1,0,2021
FRA-Ligue 1,2020,Marseille,Olivier Ntcham,CMR,MF,24,1996,1.3,1,0,0,1,0,1,3,33.3,2,3,1,2,2,3,3,0,2021
FRA-Ligue 1,2020,Marseille,Pape Gueye,SEN,MF,21,1999,22.9,49,21,25,19,5,15,45,33.3,30,25,6,19,47,96,34,0,2021
FRA-Ligue 1,2020,Marseille,Pol Lirola,ESP,"DF,FW",22,1997,17.3,28,16,11,15,2,16,28,57.1,12,18,5,13,25,53,26,0,2021
FRA-Ligue 1,2020,Marseille,Saîf-Eddine Khaoui,TUN,"FW,DF",25,1995,6.7,19,11,7,6,6,7,16,43.8,9,8,0,8,12,31,1,0,2021
FRA-Ligue 1,2020,Marseille,Steve Mandanda,FRA,GK,35,1985,37.0,0,0,0,0,0,0,1,0.0,1,0,0,0,2,2,8,6,2021
FRA-Ligue 1,2020,Marseille,Valentin Rongier,FRA,MF,25,1994,21.0,93,59,31,55,7,43,85,50.6,42,32,2,30,28,121,21,1,2021
FRA-Ligue 1,2020,Marseille,Valère Germain,FRA,"FW,MF",30,1990,9.5,8,6,2,4,2,3,11,27.3,8,7,2,5,11,19,22,0,2021
FRA-Ligue 1,2020,Marseille,Yohann Pelé,FRA,GK,37,1982,1.0,0,0,0,0,0,0,0,,0,0,0,0,0,0,0,0,2021
FRA-Ligue 1,2020,Marseille,Yuto Nagatomo,JPN,DF,33,1986,17.7,23,16,12,8,3,9,18,50.0,9,14,3,11,29,52,43,0,2021
FRA-Ligue 1,2020,Marseille,Álvaro González,ESP,DF,30,1990,31.5,26,17,20,6,0,19,31,61.3,12,30,18,12,33,59,119,1,2021
FRA-Ligue 1,2020,Metz,Aaron Leya Iseka,BEL,FW,22,1997,11.2,6,4,2,3,1,0,4,0.0,4,4,2,2,0,6,6,0,2021
FRA-Ligue 1,2020,Metz,Alexandre Oukidja,ALG,GK,32,1988,34.0,0,0,0,0,0,0,1,0.0,1,1,0,1,0,0,17,3,2021
FRA-Ligue 1,2020,Metz,Boubacar Traoré,MLI,MF,18,2001,0.6,3,2,1,2,0,1,1,100.0,0,1,0,1,0,3,0,0,2021
FRA-Ligue 1,2020,Metz,Boubakar Kouyaté,MLI,DF,23,1997,21.8,60,35,45,15,0,32,58,55.2,26,44,27,17,60,120,132,1,2021
FRA-Ligue 1,2020,Metz,Cheikh Tidiane Sabaly,SEN,FW,21,1999,0.1,0,0,0,0,0,0,0,,0,0,0,0,0,0,0,0,2021
FRA-Ligue 1,2020,Metz,Dylan Bronn,TUN,DF,25,1995,37.9,57,37,38,19,0,24,44,54.5,20,31,14,17,44,101,112,0,2021
FRA-Ligue 1,2020,Metz,Fabien Centonze,FRA,DF,24,1996,35.8,104,68,64,30,10,43,73,58.9,30,62,17,45,112,216,119,1,2021
FRA-Ligue 1,2020,Metz,Farid Boulaya,ALG,"MF,FW",27,1993,31.3,24,16,4,17,3,13,51,25.5,38,19,3,16,12,36,7,0,2021
FRA-Ligue 1,2020,Metz,Habib Diallo,SEN,"FW,MF",25,1995,1.6,1,1,0,1,0,1,1,100.0,0,0,0,0,0,1,5,0,2021
FRA-Ligue 1,2020,Metz,Habib Maïga,CIV,MF,24,1996,29.9,81,52,36,40,5,42,85,49.4,43,37,6,31,49,130,36,0,2021
FRA-Ligue 1,2020,Metz,Ibrahima Niane,SEN,FW,21,1999,7.4,1,1,0,0,1,1,2,50.0,1,3,0,3,0,1,8,0,2021
FRA-Ligue 1,2020,Metz,John Boye,GHA,DF,33,1987,33.8,58,34,43,13,2,31,54,57.4,23,36,20,16,80,138,146,1,2021
FRA-Ligue 1,2020,Metz,Kévin N'Doram,FRA,MF,24,1996,3.4,3,2,0,3,0,1,3,33.3,2,0,0,0,6,9,2,0,2021
FRA-Ligue 1,2020,Metz,Lamine Gueye,SEN,"FW,MF",22,1998,16.2,18,9,4,11,3,7,24,29.2,17,7,2,5,21,39,5,0,2021
FRA-Ligue 1,2020,Metz,Mamadou Fofana,MLI,"MF,DF",22,1998,11.9,25,11,17,8,0,7,31,22.6,24,14,2,12,18,43,36,0,2021
FRA-Ligue 1,2020,Metz,Marc-Aurèle Caillard,FRA,GK,26,1994,4.0,0,0,0,0,0,0,0,,0,0,0,0,0,0,2,0,2021
FRA-Ligue 1,2020,Metz,Matthieu Udol,FRA,DF,24,1996,19.2,34,21,18,12,4,17,39,43.6,22,25,5,20,39,73,30,0,2021
FRA-Ligue 1,2020,Metz,Opa Nguette,SEN,"FW,MF",26,1994,12.6,15,8,2,8,5,3,10,30.0,7,14,2,12,1,16,1,0,2021
FRA-Ligue 1,2020,Metz,Papa Ndiaga Yade,SEN,"FW,MF",20,2000,11.1,15,8,9,2,4,7,20,35.0,13,9,0,9,4,19,6,0,2021
FRA-Ligue 1,2020,Metz,Pape Matar Sarr,SEN,MF,17,2002,17.7,45,29,19,21,5,20,38,52.6,18,24,4,20,27,72,16,0,2021
FRA-Ligue 1,2020,Metz,Thierry Ambrose,GLP,FW,23,1997,8.4,7,4,1,1,5,2,12,16.7,10,2,0,2,2,9,4,0,2021
FRA-Ligue 1,2020,Metz,Thomas Delaine,FRA,"DF,FW",28,1992,19.8,32,18,19,11,2,20,35,57.1,15,22,5,17,24,56,30,1,2021
FRA-Ligue 1,2020,Metz,Vagner Gonçalves,CPV,"FW,MF",24,1996,10.7,16,9,5,5,6,2,15,13.3,13,6,0,6,4,20,1,1,2021
FRA-Ligue 1,2020,Metz,Victorien Angban,CIV,MF,23,1996,18.6,36,24,17,15,4,17,42,40.5,25,17,4,13,19,55,9,1,2021
FRA-Ligue 1,2020,Metz,Vincent Pajot,FRA,MF,29,1990,10.2,35,20,19,11,5,10,18,55.6,8,9,2,7,42,77,11,0,2021
FRA-Ligue 1,2020,Metz,Warren Tchimbembé,CGO,"MF,FW",22,1998,5.5,7,4,4,3,0,3,9,33.3,6,6,1,5,2,9,3,0,2021
FRA-Ligue 1,2020,Metz,Youssef Maziz,FRA,"MF,FW",22,1998,2.9,2,0,1,1,0,1,5,20.0,4,1,0,1,6,8,1,0,2021
FRA-Ligue 1,2020,Monaco,Aleksandr Golovin,RUS,"MF,FW",24,1996,11.9,28,16,6,18,4,8,39,20.5,31,21,0,21,11,39,3,0,2021
FRA-Ligue 1,2020,Monaco,Aurélien Tchouaméni,FRA,MF,20,2000,34.0,127,68,47,62,18,48,92,52.2,44,39,11,28,60,187,47,0,2021
FRA-Ligue 1,2020,Monaco,Axel Disasi,FRA,DF,22,1998,22.3,29,20,17,12,0,20,35,57.1,15,18,11,7,26,55,66,1,2021
FRA-Ligue 1,2020,Monaco,Benjamin Lecomte,FRA,GK,29,1991,28.0,0,0,0,0,0,0,2,0.0,2,1,0,1,2,2,20,1,2021
FRA-Ligue 1,2020,Monaco,Benoît Badiashile,FRA,DF,19,2001,31.9,24,17,15,9,0,13,28,46.4,15,21,12,9,58,82,102,4,2021
FRA-Ligue 1,2020,Monaco,Caio Henrique Oliveira Silva,BRA,DF,23,1997,26.3,50,34,25,20,5,31,51,60.8,20,20,3,17,16,66,37,0,2021
FRA-Ligue 1,2020,Monaco,Cesc Fàbregas,ESP,"MF,FW",33,1987,9.7,20,12,6,9,5,9,22,40.9,13,11,1,10,13,33,3,0,2021
FRA-Ligue 1,2020,Monaco,Chrislain Matsima,FRA,"DF,FW",18,2002,3.9,5,4,3,2,0,4,7,57.1,3,3,0,3,4,9,12,0,2021
FRA-Ligue 1,2020,Monaco,Djibril Sidibé,FRA,DF,28,1992,22.0,58,34,26,29,3,37,52,71.2,15,20,5,15,50,108,37,2,2021
FRA-Ligue 1,2020,Monaco,Eliot Matazo,BEL,MF,18,2002,3.5,11,5,6,5,0,3,7,42.9,4,1,0,1,1,12,2,0,2021
FRA-Ligue 1,2020,Monaco,Enzo Millot,FRA,MF,18,2002,0.5,2,0,0,1,1,1,1,100.0,0,0,0,0,2,4,0,0,2021
FRA-Ligue 1,2020,Monaco,Florentino Luís,POR,MF,20,1999,2.7,7,2,4,2,1,6,10,60.0,4,1,0,1,6,13,2,1,2021
FRA-Ligue 1,2020,Monaco,Fodé Ballo-Touré,SEN,DF,23,1997,7.4,21,17,9,11,1,6,13,46.2,7,7,0,7,6,27,11,1,2021
FRA-Ligue 1,2020,Monaco,Gelson Martins,POR,"MF,FW",25,1995,17.2,41,26,12,16,13,15,37,40.5,22,20,0,20,13,54,8,0,2021
FRA-Ligue 1,2020,Monaco,Giulian Biancone,FRA,"DF,MF",20,2000,1.0,3,3,1,1,1,2,3,66.7,1,1,0,1,1,4,4,0,2021
FRA-Ligue 1,2020,Monaco,Guillermo Maripán,CHI,DF,26,1994,23.2,26,11,17,9,0,15,27,55.6,12,18,11,7,27,53,66,1,2021
FRA-Ligue 1,2020,Monaco,Henry Onyekuru,NGA,FW,23,1997,1.6,1,0,1,0,0,1,4,25.0,3,1,0,1,0,1,0,0,2021
FRA-Ligue 1,2020,Monaco,Jean-Eudes Aholou,CIV,MF,26,1994,0.4,1,0,0,1,0,1,3,33.3,2,0,0,0,1,2,1,0,2021
FRA-Ligue 1,2020,Monaco,Kevin Volland,GER,"FW,MF",28,1992,30.8,33,16,11,19,3,8,34,23.5,26,23,0,23,4,37,4,0,2021
FRA-Ligue 1,2020,Monaco,Krépin Diatta,SEN,"MF,DF",21,1999,4.3,4,3,1,1,2,1,3,33.3,2,5,1,4,4,8,1,0,2021
FRA-Ligue 1,2020,Monaco,Pietro Pellegri,ITA,"FW,MF",19,2001,2.6,2,1,0,2,0,0,0,,0,1,0,1,0,2,0,0,2021
FRA-Ligue 1,2020,Monaco,Radosław Majecki,POL,GK,20,1999,1.0,0,0,0,0,0,0,0,,0,0,0,0,0,0,1,0,2021
FRA-Ligue 1,2020,Monaco,Ruben Aguilar,FRA,"DF,MF",27,1993,24.7,63,37,32,21,10,32,52,61.5,20,30,3,27,47,110,43,1,2021
FRA-Ligue 1,2020,Monaco,Sofiane Diop,FRA,"MF,FW",20,2000,22.5,49,34,17,25,7,18,53,34.0,35,25,1,24,31,80,15,0,2021
FRA-Ligue 1,2020,Monaco,Stevan Jovetić,MNE,"FW,MF",30,1989,8.9,8,4,2,3,3,3,13,23.1,10,1,0,1,3,11,3,0,2021
FRA-Ligue 1,2020,Monaco,Strahinja Pavlović,SRB,DF,19,2001,0.0,0,0,0,0,0,0,0,,0,0,0,0,0,0,0,0,2021
FRA-Ligue 1,2020,Monaco,Vito Mannone,ITA,GK,32,1988,9.0,0,0,0,0,0,0,0,,0,0,0,0,0,0,3,1,2021
FRA-Ligue 1,2020,Monaco,Willem Geubbels,FRA,"MF,FW",18,2001,3.3,12,8,5,7,0,5,13,38.5,8,9,0,9,3,15,5,0,2021
FRA-Ligue 1,2020,Monaco,Wissam Ben Yedder,FRA,FW,29,1990,29.0,18,9,2,10,6,3,13,23.1,10,16,0,16,13,31,3,0,2021
FRA-Ligue 1,2020,Monaco,Youssouf Fofana,FRA,MF,21,1999,31.9,90,51,31,51,8,42,82,51.2,40,43,7,36,34,124,14,2,2021
FRA-Ligue 1,2020,Montpellier,Ambroise Oyongo,CMR,DF,29,1991,6.2,13,6,10,3,0,9,15,60.0,6,3,2,1,8,21,26,1,2021
FRA-Ligue 1,2020,Montpellier,Andy Delort,ALG,FW,28,1991,27.6,12,7,1,9,2,8,18,44.4,10,11,1,10,4,16,34,0,2021
FRA-Ligue 1,2020,Montpellier,Arnaud Souquet,FRA,DF,28,1992,13.6,50,33,35,13,2,27,48,56.3,21,15,6,9,17,67,34,0,2021
FRA-Ligue 1,2020,Montpellier,Clément Vidal,FRA,DF,20,2000,1.0,2,1,1,1,0,2,4,50.0,2,4,4,0,1,3,6,1,2021
FRA-Ligue 1,2020,Montpellier,Damien Le Tallec,FRA,"MF,DF",30,1990,13.6,16,10,10,4,2,10,30,33.3,20,15,8,7,25,41,21,2,2021
FRA-Ligue 1,2020,Montpellier,Daniel Congré,FRA,DF,35,1985,36.6,59,35,45,12,2,36,70,51.4,34,50,33,17,69,128,144,3,2021
FRA-Ligue 1,2020,Montpellier,Dimitry Bertaud,FRA,GK,22,1998,8.3,0,0,0,0,0,0,0,,0,0,0,0,1,1,2,0,2021
FRA-Ligue 1,2020,Montpellier,Elye Wahi,FRA,FW,17,2003,6.2,4,3,2,1,1,1,6,16.7,5,4,0,4,2,6,5,0,2021
FRA-Ligue 1,2020,Montpellier,Florent Mollet,FRA,MF,28,1991,26.2,20,15,7,11,2,12,47,25.5,35,18,4,14,32,52,9,1,2021
FRA-Ligue 1,2020,Montpellier,Gaëtan Laborde,FRA,"FW,MF",26,1994,36.2,43,22,21,17,5,16,60,26.7,44,29,3,26,16,59,25,1,2021
FRA-Ligue 1,2020,Montpellier,Jonas Omlin,SUI,GK,26,1994,29.7,1,1,1,0,0,1,4,25.0,3,0,0,0,0,1,9,1,2021
FRA-Ligue 1,2020,Montpellier,Jordan Ferri,FRA,MF,28,1992,28.6,58,40,34,22,2,31,103,30.1,72,30,5,25,8,66,18,1,2021
FRA-Ligue 1,2020,Montpellier,Joris Chotard,FRA,MF,18,2001,12.9,12,8,5,6,1,6,31,19.4,25,12,3,9,11,23,15,0,2021
FRA-Ligue 1,2020,Montpellier,Junior Sambia,FRA,"DF,MF",23,1996,27.2,41,29,20,14,7,26,38,68.4,12,27,14,13,39,80,46,0,2021
FRA-Ligue 1,2020,Montpellier,Keagan Dolly,RSA,MF,27,1993,5.0,7,2,6,0,1,4,8,50.0,4,3,0,3,5,12,2,0,2021
FRA-Ligue 1,2020,Montpellier,Mihailo Ristić,SRB,DF,24,1995,24.8,45,22,25,13,7,28,44,63.6,16,30,9,21,26,71,57,0,2021
FRA-Ligue 1,2020,Montpellier,Nicolas Cozza,FRA,DF,21,1999,15.2,39,30,27,11,1,20,40,50.0,20,20,11,9,26,65,62,0,2021
FRA-Ligue 1,2020,Montpellier,Pedro Mendes,POR,DF,29,1990,18.1,21,19,16,5,0,14,21,66.7,7,23,13,10,34,55,58,0,2021
FRA-Ligue 1,2020,Montpellier,Petar Škuletić,SRB,"FW,MF",30,1990,2.6,3,2,1,2,0,0,5,0.0,5,4,2,2,0,3,4,0,2021
FRA-Ligue 1,2020,Montpellier,Sacha Delaye,FRA,MF,18,2002,0.1,0,0,0,0,0,0,1,0.0,1,0,0,0,1,1,1,0,2021
FRA-Ligue 1,2020,Montpellier,Samy Benchamma,FRA,"DF,MF",20,2000,0.5,1,1,1,0,0,0,0,,0,0,0,0,0,1,1,0,2021
FRA-Ligue 1,2020,Montpellier,Stephy Mavididi,ENG,"FW,MF",22,1998,22.6,18,5,7,10,1,8,23,34.8,15,12,0,12,14,32,6,0,2021
FRA-Ligue 1,2020,Montpellier,Téji Savanier,FRA,MF,28,1991,24.1,49,33,16,25,8,22,73,30.1,51,28,6,22,38,87,15,0,2021
FRA-Ligue 1,2020,Montpellier,Vitorino Hilton,BRA,DF,42,1977,23.5,15,10,10,4,1,3,14,21.4,11,34,26,8,38,53,104,3,2021
FRA-Ligue 1,2020,Montpellier,Yun Il-lok,KOR,"MF,FW",28,1992,3.5,0,0,0,0,0,0,4,0.0,4,0,0,0,5,5,1,0,2021
FRA-Ligue 1,2020,Nantes,Abdoul Kader Bamba,FRA,"FW,MF",26,1994,10.2,18,3,7,8,3,11,18,61.1,7,10,0,10,7,25,4,1,2021
FRA-Ligue 1,2020,Nantes,Abdoulaye Sylla,GUI,DF,20,2000,0.1,2,1,2,0,0,1,1,100.0,0,1,0,1,0,2,1,0,2021
FRA-Ligue 1,2020,Nantes,Abdoulaye Touré,FRA,MF,26,1994,18.7,28,12,10,16,2,14,31,45.2,17,17,2,15,22,50,19,0,2021
FRA-Ligue 1,2020,Nantes,Alban Lafont,FRA,GK,21,1999,38.0,1,0,1,0,0,1,1,100.0,0,1,0,1,0,1,14,0,2021
FRA-Ligue 1,2020,Nantes,Andrei Girotto,BRA,"DF,MF",28,1992,29.6,65,41,50,15,0,39,70,55.7,31,34,15,19,59,124,103,0,2021
FRA-Ligue 1,2020,Nantes,Batista Mendy,FRA,MF,20,2000,0.8,1,1,0,1,0,0,1,0.0,1,3,1,2,1,2,1,0,2021
FRA-Ligue 1,2020,Nantes,Bridge Ndilu,FRA,"FW,MF",20,2000,0.5,0,0,0,0,0,0,2,0.0,2,2,0,2,0,0,0,0,2021
FRA-Ligue 1,2020,Nantes,Charles Traore,MLI,DF,28,1992,18.9,53,34,30,17,6,27,54,50.0,27,26,5,21,36,89,65,0,2021
FRA-Ligue 1,2020,Nantes,Dennis Appiah,FRA,DF,28,1992,17.3,55,34,33,15,7,32,59,54.2,27,23,6,17,25,80,43,0,2021
FRA-Ligue 1,2020,Nantes,Fábio,BRA,DF,30,1990,16.7,62,37,37,23,2,35,61,57.4,26,29,8,21,37,99,49,0,2021
FRA-Ligue 1,2020,Nantes,Imran Louza,MAR,MF,21,1999,26.4,55,28,25,26,4,21,69,30.4,48,20,4,16,33,88,15,2,2021
FRA-Ligue 1,2020,Nantes,Jean-Charles Castelletto,CMR,DF,25,1995,21.6,32,18,20,11,1,18,31,58.1,13,25,19,6,42,74,79,0,2021
FRA-Ligue 1,2020,Nantes,Jean-Kévin Augustin,FRA,FW,23,1997,0.4,2,0,0,2,0,2,2,100.0,0,0,0,0,0,2,0,0,2021
FRA-Ligue 1,2020,Nantes,Kalifa Coulibaly,MLI,FW,28,1991,10.9,3,1,0,1,2,2,8,25.0,6,3,1,2,2,5,12,0,2021
FRA-Ligue 1,2020,Nantes,Ludovic Blas,FRA,"MF,FW",22,1997,31.0,58,30,18,37,3,23,54,42.6,31,33,4,29,21,79,19,0,2021
FRA-Ligue 1,2020,Nantes,Marcus Coco,FRA,"MF,FW",24,1996,16.4,36,21,17,15,4,16,36,44.4,20,16,3,13,20,56,17,0,2021
FRA-Ligue 1,2020,Nantes,Mehdi Abeid,ALG,MF,27,1992,14.7,34,19,16,14,4,15,30,50.0,15,9,2,7,20,54,10,0,2021
FRA-Ligue 1,2020,Nantes,Moses Simon,NGA,"FW,MF",25,1995,25.8,27,14,11,9,7,17,36,47.2,19,24,1,23,15,42,15,1,2021
FRA-Ligue 1,2020,Nantes,Nicolas Pallois,FRA,DF,32,1987,30.8,58,36,42,14,2,38,72,52.8,34,44,20,24,37,95,155,1,2021
FRA-Ligue 1,2020,Nantes,Pedro Chirivella,ESP,MF,23,1997,25.3,26,8,7,13,6,14,49,28.6,35,23,4,19,41,67,19,0,2021
FRA-Ligue 1,2020,Nantes,Randal Kolo Muani,FRA,FW,21,1998,33.7,22,14,1,13,8,7,27,25.9,20,15,2,13,8,30,26,0,2021
FRA-Ligue 1,2020,Nantes,Renaud Emond,BEL,"FW,MF",28,1991,3.9,0,0,0,0,0,0,1,0.0,1,2,0,2,0,0,1,0,2021
FRA-Ligue 1,2020,Nantes,Roli Pereira de Sa,FRA,"FW,MF",23,1996,0.6,4,3,1,3,0,3,4,75.0,1,2,0,2,0,4,0,0,2021
FRA-Ligue 1,2020,Nantes,Samuel Moutoussamy,COD,FW,23,1996,0.9,0,0,0,0,0,0,1,0.0,1,1,0,1,0,0,0,0,2021
FRA-Ligue 1,2020,Nantes,Sébastien Corchia,FRA,DF,29,1990,23.0,55,30,29,17,9,33,60,55.0,27,28,10,18,38,93,40,1,2021
FRA-Ligue 1,2020,Nice,Alexis Claude-Maurice,FRA,"MF,FW",22,1998,21.2,40,19,17,14,9,14,48,29.2,34,16,2,14,14,54,3,0,2021
FRA-Ligue 1,2020,Nice,Alexis Trouillet,FRA,"MF,FW",19,2000,1.2,5,4,1,4,0,4,5,80.0,1,0,0,0,3,8,0,0,2021
FRA-Ligue 1,2020,Nice,Amine Gouiri,FRA,"FW,MF",20,2000,30.5,31,18,7,16,8,10,41,24.4,31,22,6,16,17,48,23,0,2021
FRA-Ligue 1,2020,Nice,Andy Pelmard,FRA,DF,20,2000,13.4,18,12,12,5,1,9,12,75.0,3,11,3,8,20,38,35,0,2021
FRA-Ligue 1,2020,Nice,Dan Ndoye,SUI,"FW,MF",19,2000,6.1,7,6,3,4,0,1,8,12.5,7,4,0,4,7,14,4,0,2021
FRA-Ligue 1,2020,Nice,Danilo Barbosa,BRA,DF,24,1996,2.8,6,3,5,1,0,4,6,66.7,2,2,1,1,2,8,11,2,2021
FRA-Ligue 1,2020,Nice,Dante,BRA,DF,36,1983,8.6,10,5,6,4,0,3,7,42.9,4,6,4,2,10,20,20,0,2021
FRA-Ligue 1,2020,Nice,Eddy Sylvestre,FRA,"FW,MF",20,1999,1.1,1,1,1,0,0,0,1,0.0,1,1,0,1,1,2,0,0,2021
FRA-Ligue 1,2020,Nice,Evann Guessand,FRA,FW,19,2001,0.3,0,0,0,0,0,0,1,0.0,1,1,1,0,1,1,1,0,2021
FRA-Ligue 1,2020,Nice,Flavius Daniliuc,AUT,DF,19,2001,16.4,23,15,15,5,3,10,21,47.6,11,17,6,11,14,37,32,0,2021
FRA-Ligue 1,2020,Nice,Hassane Kamara,CIV,"DF,FW",26,1994,32.9,65,39,40,16,9,27,49,55.1,22,39,12,27,55,120,61,1,2021
FRA-Ligue 1,2020,Nice,Hicham Boudaoui,ALG,MF,20,1999,19.3,52,35,20,24,8,26,68,38.2,42,14,4,10,23,75,26,1,2021
FRA-Ligue 1,2020,Nice,Hicham Mahou,FRA,FW,21,1999,0.4,1,1,1,0,0,1,2,50.0,1,2,0,2,1,2,0,0,2021
FRA-Ligue 1,2020,Nice,Jean-Clair Todibo,FRA,DF,20,1999,14.8,25,15,16,9,0,16,31,51.6,15,13,7,6,19,44,48,1,2021
FRA-Ligue 1,2020,Nice,Jeff Reine-Adélaïde,FRA,"MF,FW",22,1998,11.8,7,4,1,4,2,2,9,22.2,7,10,1,9,4,11,6,0,2021
FRA-Ligue 1,2020,Nice,Jordan Lotomba,SUI,"DF,MF",21,1998,23.6,35,25,19,11,5,20,34,58.8,14,19,7,12,33,68,52,1,2021
FRA-Ligue 1,2020,Nice,Kasper Dolberg,DEN,FW,22,1997,21.4,6,2,1,3,2,2,11,18.2,9,11,2,9,6,12,19,1,2021
FRA-Ligue 1,2020,Nice,Khéphren Thuram,FRA,MF,19,2001,16.6,32,16,5,21,6,9,27,33.3,18,21,9,12,18,50,22,1,2021
FRA-Ligue 1,2020,Nice,Malik Sellouki,FRA,"FW,MF",20,2000,0.7,0,0,0,0,0,0,1,0.0,1,2,0,2,2,2,0,0,2021
FRA-Ligue 1,2020,Nice,Morgan Schneiderlin,FRA,MF,30,1989,24.4,51,31,21,24,6,20,54,37.0,34,21,11,10,53,104,46,0,2021
FRA-Ligue 1,2020,Nice,Myziane Maolida,FRA,"FW,MF",21,1999,12.0,13,8,4,4,5,4,11,36.4,7,6,1,5,6,19,4,0,2021
FRA-Ligue 1,2020,Nice,Patrick Burner,MTQ,DF,24,1996,0.0,0,0,0,0,0,0,0,,0,0,0,0,0,0,0,0,2021
FRA-Ligue 1,2020,Nice,Pierre Lees-Melou,FRA,MF,27,1993,22.9,67,39,33,31,3,25,83,30.1,58,50,14,36,29,96,31,1,2021
FRA-Ligue 1,2020,Nice,Racine Coly,SEN,MF,24,1995,0.2,0,0,0,0,0,0,0,,0,0,0,0,0,0,0,0,2021
FRA-Ligue 1,2020,Nice,Robson Bambu,BRA,DF,22,1997,11.6,16,11,14,2,0,11,14,78.6,3,8,7,1,10,26,57,0,2021
FRA-Ligue 1,2020,Nice,Rony Lopes,POR,"FW,MF",24,1995,19.8,20,14,4,13,3,6,27,22.2,21,14,3,11,8,28,6,0,2021
FRA-Ligue 1,2020,Nice,Salim Ben Seghir,FRA,DF,17,2003,0.1,0,0,0,0,0,0,0,,0,0,0,0,0,0,0,0,2021
FRA-Ligue 1,2020,Nice,Stanley N'Soki,FRA,DF,21,1999,13.8,27,19,15,9,3,13,22,59.1,9,17,4,13,26,53,38,2,2021
FRA-Ligue 1,2020,Nice,Walter Benítez,ARG,GK,27,1993,38.0,1,1,1,0,0,1,3,33.3,2,1,0,1,1,2,7,2,2021
FRA-Ligue 1,2020,Nice,William Saliba,FRA,DF,19,2001,20.0,15,9,8,5,2,5,6,83.3,1,17,16,1,26,41,80,2,2021
FRA-Ligue 1,2020,Nice,Youcef Atal,ALG,"DF,FW",24,1996,10.6,25,12,11,14,0,13,26,50.0,13,10,2,8,26,51,12,0,2021
FRA-Ligue 1,2020,Nîmes,Andrés Cubas,PAR,MF,24,1996,24.9,80,47,30,44,6,33,74,44.6,41,37,10,27,50,130,29,3,2021
FRA-Ligue 1,2020,Nîmes,Anthony Briançon,FRA,DF,25,1994,13.6,12,7,9,3,0,9,19,47.4,10,19,12,7,33,45,57,2,2021
FRA-Ligue 1,2020,Nîmes,Antoine Valerio,FRA,MF,20,1999,0.8,0,0,0,0,0,0,1,0.0,1,1,0,1,2,2,0,0,2021
FRA-Ligue 1,2020,Nîmes,Baptiste Reynet,FRA,GK,29,1990,38.0,2,1,2,0,0,2,4,50.0,2,1,0,1,1,3,9,2,2021
FRA-Ligue 1,2020,Nîmes,Birger Meling,NOR,DF,25,1994,25.9,49,31,27,15,7,33,50,66.0,17,43,9,34,36,85,70,0,2021
FRA-Ligue 1,2020,Nîmes,Clément Depres,FRA,FW,25,1994,0.2,0,0,0,0,0,0,0,,0,0,0,0,0,0,0,0,2021
FRA-Ligue 1,2020,Nîmes,Florian Miguel,FRA,DF,23,1996,17.1,14,13,12,2,0,9,17,52.9,8,21,13,8,45,59,66,1,2021
FRA-Ligue 1,2020,Nîmes,Gaëtan Paquiez,FRA,DF,26,1994,11.6,21,12,12,7,2,12,29,41.4,17,10,3,7,16,37,28,0,2021
FRA-Ligue 1,2020,Nîmes,Haris Duljević,BIH,"MF,FW",26,1993,8.6,15,9,4,7,4,6,22,27.3,16,3,0,3,8,23,1,0,2021
FRA-Ligue 1,2020,Nîmes,Karim Aribi,ALG,FW,26,1994,3.3,2,2,0,1,1,0,5,0.0,5,1,0,1,0,2,3,0,2021
FRA-Ligue 1,2020,Nîmes,Kelyan Guessoum,FRA,DF,21,1999,12.5,13,7,11,1,1,11,16,68.8,5,8,6,2,24,37,51,0,2021
FRA-Ligue 1,2020,Nîmes,Kevin Denkey,TOG,FW,19,2000,5.8,4,2,0,3,1,0,3,0.0,3,2,0,2,1,5,2,0,2021
FRA-Ligue 1,2020,Nîmes,Lamine Fomba,FRA,MF,22,1998,24.2,66,36,30,25,11,30,65,46.2,35,48,19,29,59,125,39,2,2021
FRA-Ligue 1,2020,Nîmes,Loïck Landre,FRA,DF,28,1992,18.1,14,7,9,5,0,13,28,46.4,15,22,19,3,31,45,52,0,2021
FRA-Ligue 1,2020,Nîmes,Lucas Buadés,FRA,MF,22,1997,0.2,1,0,0,1,0,0,0,,0,0,0,0,0,1,0,0,2021
FRA-Ligue 1,2020,Nîmes,Lucas Deaux,FRA,"MF,DF",31,1988,19.5,47,32,20,22,5,16,49,32.7,33,20,3,17,20,67,30,4,2021
FRA-Ligue 1,2020,Nîmes,Mahamadou Doucouré,MLI,"FW,MF",20,2000,0.5,1,1,1,0,0,1,1,100.0,0,0,0,0,0,1,0,0,2021
FRA-Ligue 1,2020,Nîmes,Marco Majouga,CTA,"FW,MF",19,2001,1.4,1,1,1,0,0,1,3,33.3,2,0,0,0,0,1,0,0,2021
FRA-Ligue 1,2020,Nîmes,Matteo Ahlinvi,BEN,MF,21,1999,10.0,26,20,10,14,2,11,39,28.2,28,6,0,6,2,28,8,0,2021
FRA-Ligue 1,2020,Nîmes,Moussa Koné,SEN,FW,23,1996,19.5,13,6,1,8,4,2,9,22.2,7,7,1,6,2,15,7,0,2021
FRA-Ligue 1,2020,Nîmes,Naomichi Ueda,JPN,DF,25,1994,7.9,4,2,3,1,0,4,6,66.7,2,5,4,1,6,10,30,1,2021
FRA-Ligue 1,2020,Nîmes,Nassim Chadli,FRA,"FW,MF",19,2001,0.3,2,1,2,0,0,0,1,0.0,1,1,0,1,0,2,0,0,2021
FRA-Ligue 1,2020,Nîmes,Niclas Eliasson,SWE,"MF,FW",24,1995,20.0,28,14,9,12,7,11,24,45.8,13,20,1,19,23,51,16,0,2021
FRA-Ligue 1,2020,Nîmes,Nolan Roux,FRA,FW,32,1988,7.2,7,3,1,4,2,3,8,37.5,5,6,0,6,5,12,4,0,2021
FRA-Ligue 1,2020,Nîmes,Pablo Martinez,FRA,DF,31,1989,6.0,10,7,7,3,0,7,7,100.0,0,6,4,2,11,21,28,0,2021
FRA-Ligue 1,2020,Nîmes,Patrick Burner,MTQ,DF,24,1996,14.6,25,11,14,10,1,13,26,50.0,13,10,3,7,24,49,41,1,2021
FRA-Ligue 1,2020,Nîmes,Renaud Ripart,FRA,"MF,FW",27,1993,33.9,52,30,25,19,8,26,84,31.0,58,58,12,46,36,88,53,0,2021
FRA-Ligue 1,2020,Nîmes,Romain Philippoteaux,FRA,"FW,MF",32,1988,2.4,1,1,1,0,0,1,5,20.0,4,2,0,2,2,3,1,0,2021
FRA-Ligue 1,2020,Nîmes,Sami Ben Amar,MAR,MF,22,1998,0.1,0,0,0,0,0,0,0,,0,1,0,1,0,0,0,0,2021
FRA-Ligue 1,2020,Nîmes,Sidy Sarr,SEN,MF,24,1996,5.1,10,6,4,6,0,2,5,40.0,3,1,1,0,7,17,4,0,2021
FRA-Ligue 1,2020,Nîmes,Sofiane Alakouch,MAR,DF,22,1998,16.7,53,33,30,16,7,29,45,64.4,16,17,2,15,21,74,38,0,2021
FRA-Ligue 1,2020,Nîmes,Yassine Benrahou,FRA,MF,21,1999,13.8,16,9,8,6,2,7,25,28.0,18,9,0,9,4,20,5,1,2021
FRA-Ligue 1,2020,Nîmes,Zinedine Ferhat,ALG,"FW,MF",27,1993,32.9,36,21,18,9,9,18,39,46.2,21,22,0,22,32,68,38,0,2021
FRA-Ligue 1,2020,Paris S-G,Abdou Diallo,SEN,DF,24,1996,16.6,16,11,9,5,2,8,13,61.5,5,15,8,7,25,41,36,0,2021
FRA-Ligue 1,2020,Paris S-G,Alessandro Florenzi,ITA,DF,29,1991,17.1,24,16,9,9,6,12,29,41.4,17,7,1,6,17,41,25,0,2021
FRA-Ligue 1,2020,Paris S-G,Ander Herrera,ESP,MF,30,1989,20.6,53,35,17,26,10,30,77,39.0,47,31,5,26,31,84,22,1,2021
FRA-Ligue 1,2020,Paris S-G,Arnaud Kalimuendo,FRA,FW,18,2002,0.8,0,0,0,0,0,0,0,,0,0,0,0,0,0,0,0,2021
FRA-Ligue 1,2020,Paris S-G,Bandiougou Fadiga,FRA,"FW,MF",19,2001,0.7,1,0,1,0,0,0,0,,0,0,0,0,0,1,0,0,2021
FRA-Ligue 1,2020,Paris S-G,Colin Dagba,FRA,DF,21,1998,15.1,23,11,4,17,2,14,19,73.7,5,18,5,13,16,39,18,1,2021
FRA-Ligue 1,2020,Paris S-G,Danilo Pereira,POR,"MF,DF",28,1991,15.9,21,11,6,11,4,6,14,42.9,8,14,6,8,29,50,33,4,2021
FRA-Ligue 1,2020,Paris S-G,Edouard Michut,FRA,MF,17,2003,0.0,0,0,0,0,0,0,0,,0,0,0,0,0,0,0,0,2021
FRA-Ligue 1,2020,Paris S-G,Idrissa Gana Gueye,SEN,MF,30,1989,17.6,63,35,20,34,9,26,50,52.0,24,26,7,19,20,83,9,3,2021
FRA-Ligue 1,2020,Paris S-G,Jesé,ESP,FW,27,1993,0.3,0,0,0,0,0,0,1,0.0,1,0,0,0,0,0,0,0,2021
FRA-Ligue 1,2020,Paris S-G,Juan Bernat,ESP,DF,27,1993,2.2,5,3,0,4,1,3,5,60.0,2,4,0,4,1,6,6,0,2021
FRA-Ligue 1,2020,Paris S-G,Julian Draxler,GER,"MF,FW",26,1993,11.8,13,6,5,6,2,5,20,25.0,15,4,0,4,14,27,0,0,2021
FRA-Ligue 1,2020,Paris S-G,Kays Ruiz,MAR,"FW,MF",17,2002,2.1,1,1,0,1,0,0,4,0.0,4,1,0,1,3,4,2,0,2021
FRA-Ligue 1,2020,Paris S-G,Kenny Nagera,FRA,FW,18,2002,0.0,0,0,0,0,0,0,0,,0,0,0,0,0,0,0,0,2021
FRA-Ligue 1,2020,Paris S-G,Keylor Navas,CRC,GK,33,1986,28.0,0,0,0,0,0,0,0,,0,0,0,0,0,0,10,0,2021
FRA-Ligue 1,2020,Paris S-G,Kylian Mbappé,FRA,FW,21,1998,26.4,4,2,0,1,3,2,9,22.2,7,7,1,6,3,7,4,1,2021
FRA-Ligue 1,2020,Paris S-G,Layvin Kurzawa,FRA,DF,27,1992,14.2,26,19,10,10,6,9,28,32.1,19,20,5,15,28,54,26,1,2021
FRA-Ligue 1,2020,Paris S-G,Leandro Paredes,ARG,MF,26,1994,14.5,30,18,12,15,3,19,39,48.7,20,17,5,12,17,47,13,1,2021
FRA-Ligue 1,2020,Paris S-G,Marcin Bułka,POL,GK,20,1999,1.0,0,0,0,0,0,0,0,,0,0,0,0,0,0,0,1,2021
FRA-Ligue 1,2020,Paris S-G,Marco Verratti,ITA,MF,27,1992,16.6,53,30,17,25,11,24,72,33.3,48,22,5,17,26,79,4,1,2021
FRA-Ligue 1,2020,Paris S-G,Marquinhos,BRA,DF,26,1994,23.6,27,21,14,10,3,15,26,57.7,11,21,9,12,27,54,75,2,2021
FRA-Ligue 1,2020,Paris S-G,Mauro Icardi,ARG,FW,27,1993,12.0,6,2,1,2,3,4,13,30.8,9,3,1,2,3,9,7,0,2021
FRA-Ligue 1,2020,Paris S-G,Mitchel Bakker,NED,DF,20,2000,18.8,38,30,15,14,9,17,26,65.4,9,22,2,20,22,60,20,0,2021
FRA-Ligue 1,2020,Paris S-G,Moise Kean,ITA,FW,20,2000,18.9,11,8,2,6,3,3,12,25.0,9,7,1,6,8,19,10,0,2021
FRA-Ligue 1,2020,Paris S-G,Neymar,BRA,"MF,FW",28,1992,15.7,14,11,1,6,7,8,37,21.6,29,8,0,8,9,23,0,0,2021
FRA-Ligue 1,2020,Paris S-G,Pablo Sarabia,ESP,"FW,MF",28,1992,14.7,15,11,6,6,3,10,38,26.3,28,9,1,8,5,20,8,0,2021
FRA-Ligue 1,2020,Paris S-G,Presnel Kimpembe,FRA,DF,24,1995,25.6,46,28,23,19,4,24,34,70.6,10,19,11,8,30,76,61,4,2021
FRA-Ligue 1,2020,Paris S-G,Rafinha,BRA,"MF,FW",27,1993,15.1,54,26,18,28,8,28,49,57.1,21,18,3,15,13,67,6,0,2021
FRA-Ligue 1,2020,Paris S-G,Sergio Rico,ESP,GK,26,1993,9.0,0,0,0,0,0,0,0,,0,0,0,0,0,0,1,0,2021
FRA-Ligue 1,2020,Paris S-G,Thilo Kehrer,GER,DF,23,1996,18.0,31,26,17,11,3,10,26,38.5,16,16,4,12,15,46,37,1,2021
FRA-Ligue 1,2020,Paris S-G,Timothee Pembele,FRA,DF,17,2002,4.3,8,7,4,4,0,5,14,35.7,9,4,0,4,5,13,8,1,2021
FRA-Ligue 1,2020,Paris S-G,Xavi Simons,NED,MF,17,2003,0.0,0,0,0,0,0,0,0,,0,0,0,0,0,0,0,0,2021
FRA-Ligue 1,2020,Paris S-G,Ángel Di María,ARG,"FW,MF",32,1988,20.6,26,17,6,8,12,11,45,24.4,34,14,1,13,6,32,7,0,2021
FRA-Ligue 1,2020,Reims,Alexis Flips,FRA,"MF,FW",20,2000,0.5,0,0,0,0,0,0,2,0.0,2,0,0,0,0,0,1,0,2021
FRA-Ligue 1,2020,Reims,Anastasios Donis,GRE,MF,23,1996,1.1,4,1,2,0,2,1,1,100.0,0,0,0,0,0,4,0,0,2021
FRA-Ligue 1,2020,Reims,Arber Zeneli,KVX,"MF,FW",25,1995,14.3,20,10,11,1,8,8,22,36.4,14,12,1,11,3,23,8,0,2021
FRA-Ligue 1,2020,Reims,Boulaye Dia,SEN,"FW,MF",23,1996,32.6,23,12,3,11,9,4,22,18.2,18,19,5,14,12,35,37,1,2021
FRA-Ligue 1,2020,Reims,Dario Maresic,AUT,DF,20,1999,5.7,12,7,8,4,0,8,14,57.1,6,7,2,5,10,22,17,1,2021
FRA-Ligue 1,2020,Reims,Dereck Kutesa,SUI,"MF,FW",22,1997,7.6,15,7,7,3,5,5,14,35.7,9,7,1,6,7,22,3,0,2021
FRA-Ligue 1,2020,Reims,Dion Lopy,SEN,MF,18,2002,2.8,1,1,0,1,0,0,0,,0,0,0,0,2,3,1,0,2021
FRA-Ligue 1,2020,Reims,El Bilal Touré,MLI,FW,18,2001,13.8,22,12,3,16,3,8,18,44.4,10,8,3,5,6,28,10,1,2021
FRA-Ligue 1,2020,Reims,Fodé Doucouré,MLI,DF,19,2001,3.7,11,8,7,4,0,4,9,44.4,5,2,0,2,4,15,11,0,2021
FRA-Ligue 1,2020,Reims,Fraser Hornby,SCO,"FW,MF",20,1999,0.4,0,0,0,0,0,0,0,,0,0,0,0,1,1,0,0,2021
FRA-Ligue 1,2020,Reims,Ghislain Konan,CIV,DF,24,1995,29.0,57,32,35,17,5,32,56,57.1,24,25,11,14,30,87,67,0,2021
FRA-Ligue 1,2020,Reims,Hugo Ekitike,FRA,"FW,MF",18,2002,1.0,1,1,0,0,1,0,1,0.0,1,0,0,0,0,1,0,0,2021
FRA-Ligue 1,2020,Reims,Kaj Sierhuis,NED,"FW,MF",22,1998,7.2,7,2,1,2,4,2,9,22.2,7,2,1,1,2,9,5,0,2021
FRA-Ligue 1,2020,Reims,Marshall Munetsi,ZIM,"MF,DF",24,1996,21.4,35,19,19,14,2,21,41,51.2,20,33,25,8,57,92,85,3,2021
FRA-Ligue 1,2020,Reims,Mathieu Cafaro,FRA,"MF,FW",23,1997,23.0,40,17,15,19,6,13,43,30.2,30,11,0,11,17,57,12,0,2021
FRA-Ligue 1,2020,Reims,Moreto Cassamã,GNB,MF,22,1998,22.6,49,36,24,23,2,27,49,55.1,22,19,6,13,36,85,33,4,2021
FRA-Ligue 1,2020,Reims,Mouhamadou Drammeh,FRA,MF,21,1999,1.9,0,0,0,0,0,0,2,0.0,2,0,0,0,2,2,7,0,2021
FRA-Ligue 1,2020,Reims,Moussa Doumbia,MLI,"MF,FW",25,1994,10.0,10,6,4,4,2,4,22,18.2,18,5,1,4,10,20,4,0,2021
FRA-Ligue 1,2020,Reims,Moïse Sakava,CMR,MF,19,2000,0.1,0,0,0,0,0,0,0,,0,0,0,0,0,0,0,0,2021
FRA-Ligue 1,2020,Reims,Nathanael Mbuku,FRA,"MF,FW",18,2002,24.6,33,19,9,13,11,8,28,28.6,20,17,0,17,14,47,10,0,2021
FRA-Ligue 1,2020,Reims,Predrag Rajković,SRB,GK,24,1995,36.5,2,1,2,0,0,2,5,40.0,3,1,0,1,2,4,17,3,2021
FRA-Ligue 1,2020,Reims,Thibault De Smet,BEL,DF,22,1998,5.5,11,6,8,3,0,6,15,40.0,9,8,1,7,6,17,16,0,2021
FRA-Ligue 1,2020,Reims,Thomas Foket,BEL,DF,25,1994,36.9,77,43,50,20,7,40,69,58.0,29,28,7,21,69,146,92,2,2021
FRA-Ligue 1,2020,Reims,Tristan Dingomé,CMR,MF,29,1991,0.2,0,0,0,0,0,0,1,0.0,1,0,0,0,0,0,0,0,2021
FRA-Ligue 1,2020,Reims,Valon Berisha,KVX,MF,27,1993,18.3,40,23,19,17,4,11,47,23.4,36,14,2,12,25,65,21,1,2021
FRA-Ligue 1,2020,Reims,Wout Faes,BEL,DF,22,1998,32.2,35,22,26,9,0,20,39,51.3,19,40,31,9,68,103,144,1,2021
FRA-Ligue 1,2020,Reims,Xavier Chavalerin,FRA,MF,29,1991,28.3,92,50,47,38,7,26,74,35.1,48,43,9,34,43,135,29,1,2021
FRA-Ligue 1,2020,Reims,Yehvann Diouf,FRA,GK,20,1999,1.5,0,0,0,0,0,0,0,,0,0,0,0,0,0,0,0,2021
FRA-Ligue 1,2020,Reims,Yunis Abdelhamid,MAR,DF,32,1987,32.1,59,37,36,23,0,26,42,61.9,16,34,15,19,61,120,132,0,2021
FRA-Ligue 1,2020,Rennes,Adrien Hunou,FRA,"FW,MF",26,1994,6.5,6,3,2,2,2,2,8,25.0,6,7,0,7,1,7,2,0,2021
FRA-Ligue 1,2020,Rennes,Adrien Truffert,FRA,"DF,MF",18,2001,21.7,38,18,18,12,8,13,24,54.2,11,26,5,21,18,56,38,1,2021
FRA-Ligue 1,2020,Rennes,Alfred Gomis,SEN,GK,26,1993,22.0,1,1,1,0,0,1,1,100.0,0,0,0,0,3,4,10,1,2021
FRA-Ligue 1,2020,Rennes,Andy Diouf,FRA,FW,17,2003,0.1,0,0,0,0,0,0,0,,0,0,0,0,0,0,0,0,2021
FRA-Ligue 1,2020,Rennes,Benjamin Bourigeaud,FRA,"MF,FW",26,1994,28.4,40,23,17,16,7,21,71,29.6,50,37,1,36,19,59,25,0,2021
FRA-Ligue 1,2020,Rennes,Brandon Soppy,FRA,DF,18,2002,6.2,21,15,16,5,0,10,16,62.5,6,3,0,3,6,27,12,0,2021
FRA-Ligue 1,2020,Rennes,Chimuanya Ugochukwu,FRA,MF,16,2004,0.7,3,1,0,3,0,2,3,66.7,1,1,0,1,0,3,0,0,2021
FRA-Ligue 1,2020,Rennes,Clément Grenier,FRA,"MF,FW",29,1991,12.0,20,8,9,8,3,7,31,22.6,24,7,0,7,5,25,3,0,2021
FRA-Ligue 1,2020,Rennes,Dalbert Henrique,BRA,DF,26,1993,4.1,7,6,4,2,1,6,8,75.0,2,8,2,6,5,12,8,0,2021
FRA-Ligue 1,2020,Rennes,Damien Da Silva,FRA,DF,32,1988,29.6,22,13,13,8,1,12,18,66.7,6,17,13,4,44,66,99,1,2021
FRA-Ligue 1,2020,Rennes,Daniele Rugani,ITA,DF,26,1994,1.0,0,0,0,0,0,0,1,0.0,1,1,1,0,1,1,1,0,2021
FRA-Ligue 1,2020,Rennes,Edouard Mendy,SEN,GK,28,1992,1.0,0,0,0,0,0,0,0,,0,0,0,0,0,0,0,0,2021
FRA-Ligue 1,2020,Rennes,Eduardo Camavinga,FRA,MF,17,2002,26.7,98,58,39,48,11,38,77,49.4,39,36,2,34,23,121,15,1,2021
FRA-Ligue 1,2020,Rennes,Faitout Maouassa,FRA,DF,22,1998,13.0,20,11,10,8,2,11,19,57.9,8,9,1,8,17,37,36,0,2021
FRA-Ligue 1,2020,Rennes,Flavien Tait,FRA,"MF,FW",27,1993,15.2,26,11,11,12,3,10,32,31.3,22,17,3,14,13,39,2,0,2021
FRA-Ligue 1,2020,Rennes,Georginio Rutter,FRA,"FW,MF",18,2002,0.5,2,2,0,1,1,1,3,33.3,2,2,0,2,0,2,0,0,2021
FRA-Ligue 1,2020,Rennes,Gerzino Nyamsi,FRA,DF,23,1997,9.7,12,10,2,8,2,4,6,66.7,2,8,5,3,10,22,32,1,2021
FRA-Ligue 1,2020,Rennes,Hamari Traoré,MLI,DF,28,1992,33.3,56,38,23,27,6,22,59,37.3,37,31,5,26,76,132,50,0,2021
FRA-Ligue 1,2020,Rennes,James Lea Siliki,CMR,MF,24,1996,2.8,5,2,1,3,1,2,2,100.0,0,3,0,3,1,6,1,1,2021
FRA-Ligue 1,2020,Rennes,Jeremy Doku,BEL,"MF,FW",18,2002,25.7,44,25,9,24,11,11,26,42.3,15,18,1,17,11,55,1,0,2021
FRA-Ligue 1,2020,Rennes,Jonas Martin,FRA,MF,30,1990,5.4,11,9,5,4,2,5,14,35.7,9,11,2,9,13,24,2,1,2021
FRA-Ligue 1,2020,Rennes,M'Baye Niang,SEN,FW,25,1994,4.7,3,2,2,1,0,0,0,,0,2,0,2,1,4,2,0,2021
FRA-Ligue 1,2020,Rennes,Martin Terrier,FRA,"FW,MF",23,1997,27.1,33,15,5,15,13,10,36,27.8,26,23,0,23,16,49,7,0,2021
FRA-Ligue 1,2020,Rennes,Matthis Abline,FRA,FW,17,2003,0.0,0,0,0,0,0,0,0,,0,0,0,0,0,0,0,0,2021
FRA-Ligue 1,2020,Rennes,Nayef Aguerd,MAR,DF,24,1996,35.0,37,30,28,9,0,21,33,63.6,12,34,22,12,47,84,102,0,2021
FRA-Ligue 1,2020,Rennes,Raphinha,BRA,"FW,MF",23,1996,4.5,5,2,1,3,1,1,4,25.0,3,5,0,5,3,8,4,0,2021
FRA-Ligue 1,2020,Rennes,Romain Del Castillo,FRA,"MF,FW",24,1996,7.2,30,11,5,14,11,5,25,20.0,20,6,0,6,3,33,4,1,2021
FRA-Ligue 1,2020,Rennes,Romain Salin,FRA,GK,36,1984,15.0,0,0,0,0,0,0,1,0.0,1,0,0,0,1,1,6,3,2021
FRA-Ligue 1,2020,Rennes,Sacha Boey,FRA,DF,19,2000,1.4,3,3,2,1,0,3,4,75.0,1,0,0,0,2,5,2,0,2021
FRA-Ligue 1,2020,Rennes,Sehrou Guirassy,GUI,FW,24,1996,19.6,4,1,1,3,0,1,3,33.3,2,10,1,9,5,9,17,0,2021
FRA-Ligue 1,2020,Rennes,Steven Nzonzi,FRA,MF,31,1988,32.3,34,16,15,16,3,12,31,38.7,19,24,10,14,16,50,26,0,2021
FRA-Ligue 1,2020,Rennes,Yann Gboho,FRA,"MF,FW",19,2001,3.4,6,3,3,1,2,3,8,37.5,5,1,0,1,1,7,3,1,2021
FRA-Ligue 1,2020,Saint-Étienne,Abdoulaye Sidibé,FRA,MF,18,2002,0.1,1,1,1,0,0,1,2,50.0,1,0,0,0,0,1,0,0,2021
FRA-Ligue 1,2020,Saint-Étienne,Adil Aouchiche,FRA,"MF,FW",18,2002,19.2,38,20,12,17,9,13,49,26.5,36,15,1,14,10,48,6,0,2021
FRA-Ligue 1,2020,Saint-Étienne,Aimen Moueffek,FRA,"DF,MF",19,2001,8.3,25,15,16,6,3,13,32,40.6,19,17,2,15,9,34,18,0,2021
FRA-Ligue 1,2020,Saint-Étienne,Anthony Modeste,FRA,"FW,MF",32,1988,3.3,2,1,0,2,0,1,4,25.0,3,3,1,2,0,2,3,0,2021
FRA-Ligue 1,2020,Saint-Étienne,Arnaud Nordin,FRA,"MF,FW",22,1998,19.7,14,8,5,5,4,6,21,28.6,15,13,2,11,9,23,10,0,2021
FRA-Ligue 1,2020,Saint-Étienne,Assane Dioussé,SEN,DF,22,1997,0.0,0,0,0,0,0,0,0,,0,0,0,0,0,0,0,0,2021
FRA-Ligue 1,2020,Saint-Étienne,Baptiste Gabard,FRA,MF,20,2000,1.5,4,3,1,3,0,1,5,20.0,4,4,0,4,1,5,0,0,2021
FRA-Ligue 1,2020,Saint-Étienne,Bilal Benkhedim,FRA,FW,19,2001,0.8,0,0,0,0,0,0,1,0.0,1,1,0,1,0,0,0,0,2021
FRA-Ligue 1,2020,Saint-Étienne,Charles Abi,FRA,"FW,MF",20,2000,10.1,8,2,5,0,3,3,12,25.0,9,6,2,4,4,12,5,0,2021
FRA-Ligue 1,2020,Saint-Étienne,Denis Bouanga,GAB,"MF,FW",25,1994,30.2,52,28,22,24,6,16,58,27.6,42,32,3,29,20,72,36,0,2021
FRA-Ligue 1,2020,Saint-Étienne,Etienne Green,ENG,GK,20,2000,8.0,0,0,0,0,0,0,0,,0,0,0,0,0,0,3,0,2021
FRA-Ligue 1,2020,Saint-Étienne,Gabriel Silva,BRA,DF,29,1991,3.9,7,6,7,0,0,1,2,50.0,1,4,1,3,6,13,8,0,2021
FRA-Ligue 1,2020,Saint-Étienne,Harold Moukoudi,CMR,DF,22,1997,25.3,46,27,37,8,1,28,38,73.7,10,24,10,14,42,88,78,1,2021
FRA-Ligue 1,2020,Saint-Étienne,Jean-Philippe Krasso,CIV,FW,23,1997,2.5,5,3,1,4,0,2,4,50.0,2,5,0,5,1,6,3,0,2021
FRA-Ligue 1,2020,Saint-Étienne,Jessy Moulin,FRA,GK,34,1986,29.0,2,1,2,0,0,2,3,66.7,1,0,0,0,2,4,9,2,2021
FRA-Ligue 1,2020,Saint-Étienne,Kévin Monnet-Paquet,FRA,"MF,FW",31,1988,6.3,11,7,7,2,2,5,10,50.0,5,5,0,5,6,17,7,0,2021
FRA-Ligue 1,2020,Saint-Étienne,Lucas Gourna-Douath,FRA,MF,16,2003,14.7,32,22,18,11,3,15,28,53.6,13,10,0,10,24,56,18,0,2021
FRA-Ligue 1,2020,Saint-Étienne,Mahdi Camara,FRA,"MF,DF",22,1998,36.6,99,67,43,46,10,33,60,55.0,27,50,12,38,78,177,51,0,2021
FRA-Ligue 1,2020,Saint-Étienne,Marvin Tshibuabua,FRA,DF,18,2002,0.5,1,0,1,0,0,0,0,,0,0,0,0,1,2,1,0,2021
FRA-Ligue 1,2020,Saint-Étienne,Mathieu Debuchy,FRA,DF,35,1985,23.4,58,33,37,17,4,40,62,64.5,22,27,9,18,45,103,61,0,2021
FRA-Ligue 1,2020,Saint-Étienne,Mathys Saban,FRA,FW,18,2002,0.1,0,0,0,0,0,0,0,,0,0,0,0,0,0,0,0,2021
FRA-Ligue 1,2020,Saint-Étienne,Maxence Rivera,FRA,"MF,FW",18,2002,2.7,12,10,6,4,2,4,10,40.0,6,5,0,5,1,13,0,0,2021
FRA-Ligue 1,2020,Saint-Étienne,Miguel Trauco,PER,DF,27,1992,22.6,47,29,25,14,8,23,43,53.5,20,19,4,15,30,77,34,1,2021
FRA-Ligue 1,2020,Saint-Étienne,Nelson Sissoko,FRA,DF,23,1997,5.3,12,6,6,3,3,7,12,58.3,5,2,1,1,12,24,16,1,2021
FRA-Ligue 1,2020,Saint-Étienne,Panagiotis Retsos,GRE,DF,21,1998,3.0,5,3,5,0,0,3,7,42.9,4,1,1,0,3,8,12,0,2021
FRA-Ligue 1,2020,Saint-Étienne,Pape Abou Cissé,SEN,DF,24,1995,14.0,15,13,10,5,0,6,10,60.0,4,7,4,3,27,42,87,0,2021
FRA-Ligue 1,2020,Saint-Étienne,Rayan Souici,FRA,DF,22,1998,0.1,0,0,0,0,0,0,0,,0,0,0,0,0,0,0,0,2021
FRA-Ligue 1,2020,Saint-Étienne,Romain Hamouma,FRA,"FW,MF",33,1987,19.7,12,7,5,6,1,4,24,16.7,20,17,1,16,7,19,11,0,2021
FRA-Ligue 1,2020,Saint-Étienne,Ryad Boudebouz,ALG,"MF,FW",30,1990,7.2,9,4,1,7,1,4,8,50.0,4,3,0,3,5,14,5,0,2021
FRA-Ligue 1,2020,Saint-Étienne,Saidou Sow,GUI,DF,18,2002,11.1,23,12,17,6,0,13,19,68.4,6,12,8,4,14,37,39,1,2021
FRA-Ligue 1,2020,Saint-Étienne,Stefan Bajic,FRA,GK,18,2001,1.0,0,0,0,0,0,0,0,,0,0,0,0,0,0,1,0,2021
FRA-Ligue 1,2020,Saint-Étienne,Timothée Kolodziejczak,FRA,DF,28,1991,22.6,28,15,23,5,0,19,27,70.4,8,24,15,9,36,64,80,1,2021
FRA-Ligue 1,2020,Saint-Étienne,Tyron Tormin,FRA,"FW,MF",19,2001,0.2,0,0,0,0,0,0,0,,0,0,0,0,0,0,0,0,2021
FRA-Ligue 1,2020,Saint-Étienne,Wahbi Khazri,TUN,FW,29,1991,13.1,24,15,12,7,5,12,24,50.0,12,10,1,9,4,28,11,0,2021
FRA-Ligue 1,2020,Saint-Étienne,Wesley Fofana,FRA,DF,19,2000,3.5,6,4,6,0,0,3,4,75.0,1,3,3,0,8,14,14,1,2021
FRA-Ligue 1,2020,Saint-Étienne,Yanis Lhery,FRA,MF,17,2003,0.3,0,0,0,0,0,0,0,,0,0,0,0,0,0,0,0,2021
FRA-Ligue 1,2020,Saint-Étienne,Yann M'Vila,FRA,MF,30,1990,0.2,0,0,0,0,0,0,2,0.0,2,0,0,0,1,1,0,0,2021
FRA-Ligue 1,2020,Saint-Étienne,Yvan Neyou,CMR,MF,23,1997,27.1,58,31,24,33,1,25,60,41.7,35,34,5,29,31,89,13,1,2021
FRA-Ligue 1,2020,Saint-Étienne,Yvann Macon,FRA,DF,21,1998,6.0,30,20,20,8,2,7,19,36.8,12,6,2,4,9,39,13,0,2021
FRA-Ligue 1,2020,Saint-Étienne,Zaydou Youssouf,FRA,MF,21,1999,13.7,30,15,19,10,1,16,40,40.0,24,15,0,15,25,55,12,1,2021
FRA-Ligue 1,2020,Strasbourg,Abdul Majeed Waris,GHA,"FW,MF",28,1991,6.1,1,1,1,0,0,1,6,16.7,5,0,0,0,2,3,2,0,2021
FRA-Ligue 1,2020,Strasbourg,Adrien Thomasson,FRA,"MF,FW",26,1993,29.2,36,17,8,16,12,12,58,20.7,46,44,5,39,22,58,2,0,2021
FRA-Ligue 1,2020,Strasbourg,Alexander Djiku,GHA,"DF,MF",25,1994,28.4,60,41,45,13,2,32,52,61.5,20,28,10,18,91,151,104,0,2021
FRA-Ligue 1,2020,Strasbourg,Anthony Caci,FRA,DF,23,1997,31.1,80,46,47,27,6,35,69,50.7,34,30,4,26,55,135,65,1,2021
FRA-Ligue 1,2020,Strasbourg,Bingourou Kamara,SEN,GK,23,1996,8.0,1,1,1,0,0,1,3,33.3,2,0,0,0,1,2,2,1,2021
FRA-Ligue 1,2020,Strasbourg,Dimitri Liénard,FRA,MF,32,1988,20.3,39,27,17,19,3,24,55,43.6,31,23,1,22,18,57,10,0,2021
FRA-Ligue 1,2020,Strasbourg,Dion Moise Sahi,CIV,"FW,MF",18,2001,1.0,1,0,0,1,0,1,1,100.0,0,1,0,1,0,1,0,0,2021
FRA-Ligue 1,2020,Strasbourg,Eiji Kawashima,JPN,GK,37,1983,24.0,1,0,1,0,0,1,1,100.0,0,0,0,0,0,1,4,2,2021
FRA-Ligue 1,2020,Strasbourg,Frederic Guilbert,FRA,DF,25,1994,12.4,37,19,23,11,3,21,34,61.8,13,14,1,13,33,70,32,0,2021
FRA-Ligue 1,2020,Strasbourg,Habib Diallo,SEN,FW,25,1995,25.8,11,6,3,6,2,7,18,38.9,11,12,2,10,13,24,12,0,2021
FRA-Ligue 1,2020,Strasbourg,Ibrahima Sissoko,FRA,MF,22,1997,28.7,68,48,25,35,8,28,68,41.2,40,22,5,17,48,116,44,0,2021
FRA-Ligue 1,2020,Strasbourg,Idriss Saadi,ALG,"MF,FW",28,1992,1.4,0,0,0,0,0,0,2,0.0,2,0,0,0,0,0,0,0,2021
FRA-Ligue 1,2020,Strasbourg,Ismael Aaneba,FRA,DF,21,1999,0.1,0,0,0,0,0,0,0,,0,0,0,0,1,1,1,0,2021
FRA-Ligue 1,2020,Strasbourg,Jean-Eudes Aholou,CIV,MF,26,1994,23.8,46,25,18,25,3,19,48,39.6,29,17,5,12,53,99,32,0,2021
FRA-Ligue 1,2020,Strasbourg,Jean-Ricner Bellegarde,FRA,"MF,FW",22,1998,23.2,56,39,22,25,9,14,23,60.9,9,20,2,18,19,75,16,0,2021
FRA-Ligue 1,2020,Strasbourg,Kenny Lala,FRA,DF,28,1991,20.4,22,13,13,8,1,11,22,50.0,11,12,6,6,23,45,33,1,2021
FRA-Ligue 1,2020,Strasbourg,Kévin Zohi,MLI,"FW,MF",23,1996,4.8,9,5,3,4,2,2,6,33.3,4,6,0,6,6,15,3,0,2021
FRA-Ligue 1,2020,Strasbourg,Lamine Koné,CIV,DF,31,1989,11.6,9,6,5,4,0,5,8,62.5,3,4,3,1,15,24,36,0,2021
FRA-Ligue 1,2020,Strasbourg,Lionel Carole,FRA,DF,29,1991,14.9,37,25,18,14,5,16,29,55.2,13,3,1,2,38,75,28,0,2021
FRA-Ligue 1,2020,Strasbourg,Ludovic Ajorque,FRA,FW,26,1994,33.0,30,18,6,18,6,7,31,22.6,24,14,5,9,11,41,54,0,2021
FRA-Ligue 1,2020,Strasbourg,Mahame Siby,MLI,MF,24,1996,0.2,0,0,0,0,0,0,1,0.0,1,0,0,0,0,0,1,0,2021
FRA-Ligue 1,2020,Strasbourg,Matz Sels,BEL,GK,28,1992,6.0,0,0,0,0,0,0,0,,0,0,0,0,0,0,4,0,2021
FRA-Ligue 1,2020,Strasbourg,Mehdi Chahiri,MAR,"FW,MF",24,1996,8.9,18,8,7,5,6,8,20,40.0,12,9,0,9,6,24,5,0,2021
FRA-Ligue 1,2020,Strasbourg,Mohamed Simakan,FRA,DF,20,2000,17.9,32,22,21,6,5,9,18,50.0,9,17,11,6,31,63,41,0,2021
FRA-Ligue 1,2020,Strasbourg,Sanjin Prcić,BIH,MF,26,1993,3.9,3,2,0,3,0,2,5,40.0,3,4,3,1,4,7,2,1,2021
FRA-Ligue 1,2020,Strasbourg,Stefan Mitrović,SRB,DF,30,1990,30.9,36,27,29,7,0,24,37,64.9,13,23,13,10,31,67,108,5,2021
FRA-Ligue 1,2021,Angers,Abdoulaye Bamba,CIV,"DF,FW",31,1990,5.1,6,5,6,0,0,4,11,36.4,7,5,1,4,9,15,13,0,2022
FRA-Ligue 1,2021,Angers,Angelo Fulgini,FRA,"MF,FW",24,1996,32.5,35,25,8,18,9,14,44,31.8,30,21,5,16,22,57,5,1,2022
FRA-Ligue 1,2021,Angers,Anthony Mandrea,ALG,GK,24,1996,10.0,0,0,0,0,0,0,0,,0,0,0,0,0,0,9,0,2022
FRA-Ligue 1,2021,Angers,Antonin Bobichon,FRA,"MF,FW",25,1995,0.4,1,0,0,1,0,0,0,,0,0,0,0,1,2,0,0,2022
FRA-Ligue 1,2021,Angers,Azzedine Ounahi,MAR,MF,21,2000,18.1,39,22,16,22,1,11,40,27.5,29,19,1,18,26,65,13,0,2022
FRA-Ligue 1,2021,Angers,Batista Mendy,FRA,"MF,DF",21,2000,26.8,49,28,21,22,6,23,45,51.1,22,37,6,31,34,83,40,0,2022
FRA-Ligue 1,2021,Angers,Bilal Brahimi,ALG,FW,21,2000,3.8,1,1,0,1,0,0,3,0.0,3,0,0,0,1,2,1,0,2022
FRA-Ligue 1,2021,Angers,Casimir Ninga,CHA,FW,28,1993,4.5,5,1,1,4,0,2,5,40.0,3,2,0,2,1,6,0,0,2022
FRA-Ligue 1,2021,Angers,Danijel Petković,MNE,GK,28,1993,15.0,0,0,0,0,0,0,1,0.0,1,0,0,0,1,1,9,5,2022
FRA-Ligue 1,2021,Angers,Enzo Ebosse,CMR,DF,22,1999,21.0,25,14,19,6,0,11,19,57.9,8,19,9,10,15,40,42,0,2022
FRA-Ligue 1,2021,Angers,Farid El Melali,ALG,FW,24,1997,0.2,0,0,0,0,0,0,1,0.0,1,1,0,1,0,0,1,0,2022
FRA-Ligue 1,2021,Angers,Ismaël Traoré,CIV,DF,34,1986,35.7,28,17,16,11,1,13,28,46.4,15,25,17,8,44,72,122,1,2022
FRA-Ligue 1,2021,Angers,Jason Mbock,FRA,FW,21,1999,0.2,0,0,0,0,0,0,0,,0,0,0,0,0,0,0,0,2022
FRA-Ligue 1,2021,Angers,Jimmy Cabot,FRA,DF,27,1994,22.3,81,44,59,15,7,47,83,56.6,36,29,0,29,32,113,30,0,2022
FRA-Ligue 1,2021,Angers,Marin Jakoliš,CRO,FW,24,1996,2.5,2,1,0,1,1,0,6,0.0,6,0,0,0,1,3,0,0,2022
FRA-Ligue 1,2021,Angers,Mathias Pereira Lage,POR,DF,24,1996,11.6,21,7,10,7,4,8,30,26.7,22,18,7,11,21,42,22,0,2022
FRA-Ligue 1,2021,Angers,Mohamed Ali Cho,FRA,FW,17,2004,20.4,10,5,1,4,5,5,17,29.4,12,17,1,16,8,18,0,1,2022
FRA-Ligue 1,2021,Angers,Nabil Bentaleb,ALG,MF,26,1994,16.8,42,24,15,20,7,16,29,55.2,13,24,9,15,28,70,13,0,2022
FRA-Ligue 1,2021,Angers,Noah Fatar,FRA,"DF,MF",19,2002,0.1,1,0,0,0,1,0,1,0.0,1,0,0,0,1,2,0,0,2022
FRA-Ligue 1,2021,Angers,Noah Guede-Nadje,FRA,MF,17,2003,0.0,0,0,0,0,0,0,0,,0,0,0,0,0,0,0,0,2022
FRA-Ligue 1,2021,Angers,Paul Bernardoni,FRA,GK,24,1997,13.0,3,2,3,0,0,3,4,75.0,1,0,0,0,0,3,8,1,2022
FRA-Ligue 1,2021,Angers,Pierrick Capelle,FRA,"MF,DF",34,1987,13.3,36,24,16,17,3,18,52,34.6,34,12,1,11,16,52,20,0,2022
FRA-Ligue 1,2021,Angers,Romain Thomas,FRA,DF,33,1988,28.5,49,37,28,21,0,30,57,52.6,27,35,19,16,44,93,126,0,2022
FRA-Ligue 1,2021,Angers,Sada Thioub,SEN,FW,26,1995,0.0,0,0,0,0,0,0,0,,0,0,0,0,0,0,0,0,2022
FRA-Ligue 1,2021,Angers,Sofiane Boufal,MAR,"FW,MF",27,1993,25.9,44,29,19,16,9,18,38,47.4,20,19,2,17,7,51,1,0,2022
FRA-Ligue 1,2021,Angers,Souleyman Doumbia,CIV,"DF,FW",24,1996,24.7,30,20,16,9,5,13,27,48.1,14,25,4,21,39,69,51,0,2022
FRA-Ligue 1,2021,Angers,Stéphane Bahoken,CMR,FW,29,1992,12.2,13,8,2,7,4,1,9,11.1,8,15,0,15,3,16,3,0,2022
FRA-Ligue 1,2021,Angers,Thomas Mangani,FRA,MF,34,1987,24.4,58,30,23,34,1,31,68,45.6,37,38,11,27,36,94,29,0,2022
FRA-Ligue 1,2021,Angers,Vincent Manceau,FRA,DF,32,1989,26.2,32,19,18,13,1,14,37,37.8,23,23,6,17,32,64,72,0,2022
FRA-Ligue 1,2021,Angers,Waniss Taibi,FRA,"MF,FW",19,2002,1.5,8,7,4,4,0,2,4,50.0,2,0,0,0,1,9,1,0,2022
FRA-Ligue 1,2021,Bordeaux,Abdel Jalil Medioub,ALG,DF,23,1997,6.9,9,5,5,3,1,3,4,75.0,1,8,4,4,12,21,34,0,2022
FRA-Ligue 1,2021,Bordeaux,Alberth Elis,HON,"FW,MF",25,1996,15.7,19,10,5,5,9,11,25,44.0,14,9,0,9,7,26,10,0,2022
FRA-Ligue 1,2021,Bordeaux,Amadou Traore,FRA,FW,19,2002,0.2,0,0,0,0,0,0,0,,0,0,0,0,0,0,0,0,2022
FRA-Ligue 1,2021,Bordeaux,Anel Ahmedhodzic,BIH,DF,22,1999,15.0,38,26,27,9,2,20,31,64.5,11,16,8,8,22,60,44,0,2022
FRA-Ligue 1,2021,Bordeaux,Benoît Costil,FRA,GK,34,1987,25.0,1,0,1,0,0,1,2,50.0,1,0,0,0,0,1,6,3,2022
FRA-Ligue 1,2021,Bordeaux,Danylo Ihnatenko,UKR,MF,24,1997,7.7,17,9,8,7,2,10,24,41.7,14,9,2,7,6,23,17,1,2022
FRA-Ligue 1,2021,Bordeaux,Dilane Bakwa,FRA,"FW,MF",18,2002,0.5,1,1,0,1,0,1,2,50.0,1,0,0,0,0,1,1,0,2022
FRA-Ligue 1,2021,Bordeaux,Enock Kwateng,FRA,DF,24,1997,22.2,54,35,31,19,4,33,72,45.8,39,17,4,13,43,97,48,1,2022
FRA-Ligue 1,2021,Bordeaux,Fransérgio,BRA,MF,30,1990,14.0,24,10,8,12,4,12,43,27.9,31,18,6,12,23,47,23,0,2022
FRA-Ligue 1,2021,Bordeaux,Gaëtan Poussin,FRA,GK,22,1999,13.0,1,1,1,0,0,1,1,100.0,0,0,0,0,0,1,15,1,2022
FRA-Ligue 1,2021,Bordeaux,Gideon Mensah,GHA,DF,23,1998,13.4,37,24,19,12,6,18,38,47.4,20,11,2,9,16,53,21,0,2022
FRA-Ligue 1,2021,Bordeaux,Hwang Ui-jo,KOR,FW,28,1992,27.9,10,4,4,4,2,4,13,30.8,9,9,1,8,5,15,18,0,2022
FRA-Ligue 1,2021,Bordeaux,Issouf Sissokho,MLI,MF,19,2002,4.8,17,8,2,13,2,8,17,47.1,9,8,1,7,7,24,0,0,2022
FRA-Ligue 1,2021,Bordeaux,Javairô Dilrosun,NED,"MF,FW",23,1998,19.2,13,4,2,8,3,7,24,29.2,17,14,1,13,11,24,5,0,2022
FRA-Ligue 1,2021,Bordeaux,Jean Onana,CMR,MF,21,2000,20.4,70,49,33,33,4,35,86,40.7,51,37,5,32,36,106,23,1,2022
FRA-Ligue 1,2021,Bordeaux,Jimmy Briand,FRA,"FW,MF",35,1985,2.5,2,0,2,0,0,0,2,0.0,2,0,0,0,1,3,2,0,2022
FRA-Ligue 1,2021,Bordeaux,Johaneko Louisjean,FRA,DF,17,2004,0.1,0,0,0,0,0,0,0,,0,0,0,0,0,0,0,0,2022
FRA-Ligue 1,2021,Bordeaux,Josh Maja,NGA,FW,22,1998,0.1,0,0,0,0,0,0,0,,0,1,0,1,0,0,0,0,2022
FRA-Ligue 1,2021,Bordeaux,Josuha Guilavogui,FRA,"MF,DF",30,1990,14.8,39,16,18,17,4,14,29,48.3,15,16,8,8,36,75,23,0,2022
FRA-Ligue 1,2021,Bordeaux,Junior Mwanga,FRA,DF,18,2003,1.0,5,2,4,1,0,3,3,100.0,0,1,0,1,0,5,1,0,2022
FRA-Ligue 1,2021,Bordeaux,Laurent Koscielny,FRA,DF,35,1985,10.4,14,9,10,3,1,8,13,61.5,5,17,12,5,12,26,39,0,2022
FRA-Ligue 1,2021,Bordeaux,Loris Benito,SUI,DF,29,1992,0.7,0,0,0,0,0,0,0,,0,0,0,0,1,1,3,1,2022
FRA-Ligue 1,2021,Bordeaux,M'Baye Niang,SEN,FW,26,1994,8.6,4,0,0,2,2,0,4,0.0,4,9,1,8,1,5,4,0,2022
FRA-Ligue 1,2021,Bordeaux,Marcelo,BRA,DF,34,1987,10.0,9,5,7,2,0,4,6,66.7,2,4,3,1,13,22,46,1,2022
FRA-Ligue 1,2021,Bordeaux,Mehdi Zerkane,ALG,"MF,DF",22,1999,0.9,0,0,0,0,0,0,1,0.0,1,1,1,0,2,2,0,0,2022
FRA-Ligue 1,2021,Bordeaux,Mexer,MOZ,DF,32,1988,13.6,14,10,11,3,0,11,17,64.7,6,12,7,5,21,35,60,2,2022
FRA-Ligue 1,2021,Bordeaux,Otávio,BRA,MF,27,1994,12.7,36,23,13,21,2,16,39,41.0,23,9,3,6,18,54,11,0,2022
FRA-Ligue 1,2021,Bordeaux,Paul Baysse,FRA,"MF,DF",33,1988,0.1,1,1,0,1,0,0,0,,0,0,0,0,0,1,1,0,2022
FRA-Ligue 1,2021,Bordeaux,Remi Oudin,FRA,"MF,FW",24,1996,19.3,34,18,19,13,2,18,32,56.3,14,14,3,11,27,61,21,0,2022
FRA-Ligue 1,2021,Bordeaux,Ricardo Mangas,POR,DF,23,1998,26.1,35,22,22,8,5,26,41,63.4,15,18,4,14,25,60,47,3,2022
FRA-Ligue 1,2021,Bordeaux,Rubén Pardo,ESP,MF,28,1992,0.1,0,0,0,0,0,0,0,,0,0,0,0,0,0,0,0,2022
FRA-Ligue 1,2021,Bordeaux,Samuel Kalu,NGA,"FW,MF",23,1997,3.6,8,5,3,4,1,2,5,40.0,3,2,0,2,3,11,1,0,2022
FRA-Ligue 1,2021,Bordeaux,Sekou Mara,FRA,"FW,MF",19,2002,10.1,8,4,1,1,6,1,8,12.5,7,7,0,7,2,10,6,0,2022
FRA-Ligue 1,2021,Bordeaux,Stian Rode Gregersen,NOR,DF,26,1995,21.7,39,26,23,12,4,18,33,54.5,15,26,16,10,38,77,103,2,2022
FRA-Ligue 1,2021,Bordeaux,Thibault Klidje,TOG,"MF,FW",20,2001,1.0,0,0,0,0,0,0,1,0.0,1,1,1,0,2,2,0,0,2022
FRA-Ligue 1,2021,Bordeaux,Timothee Pembele,FRA,DF,18,2002,15.7,20,8,8,10,2,10,29,34.5,19,12,3,9,16,36,24,0,2022
FRA-Ligue 1,2021,Bordeaux,Tom Lacoux,FRA,"DF,MF",19,2002,10.1,18,13,11,5,2,9,24,37.5,15,14,4,10,9,27,20,1,2022
FRA-Ligue 1,2021,Bordeaux,Toma Bašić,CRO,MF,24,1996,2.3,2,2,1,0,1,0,4,0.0,4,4,1,3,2,4,0,0,2022
FRA-Ligue 1,2021,Bordeaux,Yacine Adli,FRA,"MF,FW",21,2000,25.1,43,27,22,14,7,19,68,27.9,49,33,3,30,37,80,11,2,2022
FRA-Ligue 1,2021,Brest,Brendan Chardonnet,FRA,DF,26,1994,29.8,44,25,32,11,1,29,40,72.5,11,42,29,13,55,99,141,0,2022
FRA-Ligue 1,2021,Brest,Christophe Hérelle,MTQ,DF,28,1992,21.5,48,28,30,16,2,17,26,65.4,9,20,15,5,44,92,84,1,2022
FRA-Ligue 1,2021,Brest,Dénys Bain,FRA,DF,28,1993,2.0,3,3,1,2,0,1,1,100.0,0,3,1,2,3,6,5,0,2022
FRA-Ligue 1,2021,Brest,Franck Honorat,FRA,"FW,MF",24,1996,32.2,54,38,25,13,16,27,47,57.4,20,24,2,22,15,69,25,0,2022
FRA-Ligue 1,2021,Brest,Haris Belkebla,ALG,MF,27,1994,25.7,46,23,21,21,4,18,39,46.2,21,26,6,20,48,94,30,1,2022
FRA-Ligue 1,2021,Brest,Hianga Mananga Mbock,FRA,MF,21,1999,8.9,18,12,8,7,3,9,21,42.9,12,5,2,3,5,23,6,0,2022
FRA-Ligue 1,2021,Brest,Hugo Magnetti,FRA,MF,23,1998,16.3,50,34,27,20,3,22,50,44.0,28,14,3,11,25,75,13,0,2022
FRA-Ligue 1,2021,Brest,Irvin Cardona,FRA,"FW,MF",23,1997,14.8,13,7,5,4,4,3,16,18.8,13,10,0,10,5,18,17,0,2022
FRA-Ligue 1,2021,Brest,Jean-Kevin Duverne,FRA,DF,24,1997,33.4,71,44,43,21,7,42,90,46.7,48,40,5,35,53,124,92,0,2022
FRA-Ligue 1,2021,Brest,Jere Uronen,FIN,DF,27,1994,9.8,28,15,15,10,3,14,24,58.3,10,12,3,9,16,44,21,0,2022
FRA-Ligue 1,2021,Brest,Julien Faussurier,FRA,"MF,DF",34,1987,5.4,10,6,3,3,4,6,13,46.2,7,12,1,11,5,15,6,0,2022
FRA-Ligue 1,2021,Brest,Jérémy Le Douaron,FRA,"FW,MF",23,1998,16.1,11,5,4,4,3,1,17,5.9,16,15,0,15,4,15,14,0,2022
FRA-Ligue 1,2021,Brest,Lilian Brassier,FRA,DF,21,1999,25.1,40,24,23,13,4,10,21,47.6,11,31,21,10,32,72,86,0,2022
FRA-Ligue 1,2021,Brest,Lucien Agoume,FRA,MF,19,2002,20.8,51,31,24,20,7,23,45,51.1,22,30,9,21,52,103,27,1,2022
FRA-Ligue 1,2021,Brest,Marco Bizot,NED,GK,30,1991,38.0,3,1,3,0,0,3,5,60.0,2,1,0,1,0,3,24,1,2022
FRA-Ligue 1,2021,Brest,Martin Satriano,URU,FW,20,2001,10.4,5,2,1,1,3,2,7,28.6,5,8,0,8,2,7,3,0,2022
FRA-Ligue 1,2021,Brest,Paul Lasne,FRA,MF,32,1989,9.4,26,12,6,16,4,8,18,44.4,10,11,2,9,24,50,10,0,2022
FRA-Ligue 1,2021,Brest,Rafiki Said Ahamada,COM,"MF,FW",21,2000,1.4,4,3,1,2,1,3,4,75.0,1,2,0,2,0,4,0,0,2022
FRA-Ligue 1,2021,Brest,Romain Del Castillo,FRA,"MF,FW",25,1996,10.8,27,16,3,17,7,12,31,38.7,19,12,0,12,7,34,3,0,2022
FRA-Ligue 1,2021,Brest,Romain Faivre,FRA,MF,23,1998,19.9,30,18,12,13,5,12,30,40.0,18,11,0,11,13,43,10,0,2022
FRA-Ligue 1,2021,Brest,Romain Philippoteaux,FRA,MF,33,1988,0.3,1,1,0,1,0,0,0,,0,0,0,0,0,1,0,0,2022
FRA-Ligue 1,2021,Brest,Ronaël Pierre-Gabriel,FRA,DF,23,1998,28.3,79,45,52,21,6,42,73,57.5,31,22,7,15,48,127,74,0,2022
FRA-Ligue 1,2021,Brest,Steve Mounié,BEN,FW,26,1994,25.7,17,6,3,12,2,4,27,14.8,23,13,1,12,6,23,12,0,2022
FRA-Ligue 1,2021,Brest,Youcef Belaïli,ALG,"MF,FW",29,1992,9.2,2,1,0,0,2,2,9,22.2,7,5,1,4,7,9,4,0,2022
FRA-Ligue 1,2021,Brest,Youssouph Badji,SEN,"FW,MF",19,2001,1.5,1,0,0,1,0,0,1,0.0,1,0,0,0,0,1,0,0,2022
FRA-Ligue 1,2021,Clermont Foot,Aboubakar Sidibé,FRA,DF,25,1996,0.1,0,0,0,0,0,0,0,,0,0,0,0,0,0,0,0,2022
FRA-Ligue 1,2021,Clermont Foot,Akim Zedadka,ALG,DF,26,1995,37.1,72,44,34,29,9,37,71,52.1,34,32,8,24,58,130,48,0,2022
FRA-Ligue 1,2021,Clermont Foot,Alidu Seidu,GHA,DF,21,2000,15.7,34,20,20,13,1,16,27,59.3,11,25,11,14,34,68,49,1,2022
FRA-Ligue 1,2021,Clermont Foot,Arial Mendy,SEN,"DF,FW",26,1994,8.8,6,4,4,2,0,2,11,18.2,9,6,1,5,7,13,17,0,2022
FRA-Ligue 1,2021,Clermont Foot,Arthur Desmas,FRA,GK,27,1994,14.5,0,0,0,0,0,0,3,0.0,3,0,0,0,0,0,1,3,2022
FRA-Ligue 1,2021,Clermont Foot,Cédric Hountondji,BEN,DF,27,1994,22.6,33,17,20,12,1,16,24,66.7,8,23,12,11,34,67,76,0,2022
FRA-Ligue 1,2021,Clermont Foot,Elba Rashani,KVX,"FW,MF",28,1993,19.5,40,21,15,21,4,17,55,30.9,38,34,3,31,11,51,20,0,2022
FRA-Ligue 1,2021,Clermont Foot,Florent Ogier,FRA,DF,32,1989,27.0,31,17,18,12,1,17,31,54.8,14,41,27,14,37,68,89,0,2022
FRA-Ligue 1,2021,Clermont Foot,Grejohn Kyei,FRA,FW,25,1995,4.4,3,2,1,1,1,0,6,0.0,6,6,0,6,0,3,1,0,2022
FRA-Ligue 1,2021,Clermont Foot,Jason Berthomier,FRA,MF,31,1990,19.2,29,14,5,17,7,12,34,35.3,22,14,2,12,8,37,4,1,2022
FRA-Ligue 1,2021,Clermont Foot,Jean-Claude Billong,CMR,DF,27,1993,10.9,17,8,14,1,2,8,11,72.7,3,9,1,8,10,27,35,0,2022
FRA-Ligue 1,2021,Clermont Foot,Jim Allevinah,GAB,FW,26,1995,16.5,18,13,8,8,2,5,18,27.8,13,11,0,11,6,24,4,0,2022
FRA-Ligue 1,2021,Clermont Foot,Jodel Dossou,BEN,FW,29,1992,22.3,36,17,15,14,7,15,43,34.9,28,14,0,14,5,41,7,0,2022
FRA-Ligue 1,2021,Clermont Foot,Johan Gastien,FRA,MF,33,1988,30.5,56,34,26,25,5,27,74,36.5,47,45,11,34,53,109,49,1,2022
FRA-Ligue 1,2021,Clermont Foot,Jonathan Iglesias,URU,MF,32,1988,6.4,18,11,6,10,2,10,18,55.6,8,8,2,6,5,23,2,1,2022
FRA-Ligue 1,2021,Clermont Foot,Jordan Tell,GLP,FW,24,1997,3.2,5,5,0,3,2,1,4,25.0,3,3,0,3,0,5,1,0,2022
FRA-Ligue 1,2021,Clermont Foot,Josué Albert,GUF,DF,29,1992,0.2,0,0,0,0,0,0,0,,0,0,0,0,1,1,2,0,2022
FRA-Ligue 1,2021,Clermont Foot,Jérôme Phojo,FRA,DF,28,1993,0.1,0,0,0,0,0,0,0,,0,0,0,0,0,0,1,0,2022
FRA-Ligue 1,2021,Clermont Foot,Lucas Da Cunha,FRA,"FW,MF",20,2001,9.3,17,11,5,8,4,9,18,50.0,9,13,0,13,1,18,3,0,2022
FRA-Ligue 1,2021,Clermont Foot,Mohamed Lamine Bayo,GUI,FW,23,1998,26.8,12,5,4,3,5,3,24,12.5,21,7,1,6,7,19,14,0,2022
FRA-Ligue 1,2021,Clermont Foot,Oriol Busquets,ESP,MF,22,1999,2.2,3,3,0,3,0,2,6,33.3,4,7,4,3,1,4,2,0,2022
FRA-Ligue 1,2021,Clermont Foot,Ouparine Djoco,SEN,GK,23,1998,23.5,0,0,0,0,0,0,0,,0,0,0,0,1,1,14,2,2022
FRA-Ligue 1,2021,Clermont Foot,Pierre-Yves Hamel,FRA,FW,27,1994,5.8,11,6,0,5,6,5,6,83.3,1,2,1,1,0,11,0,0,2022
FRA-Ligue 1,2021,Clermont Foot,Salis Abdul Samed,GHA,MF,21,2000,27.4,43,23,25,16,2,20,57,35.1,37,18,1,17,42,85,15,0,2022
FRA-Ligue 1,2021,Clermont Foot,Saîf-Eddine Khaoui,TUN,"MF,FW",26,1995,10.3,19,10,5,10,4,9,18,50.0,9,9,0,9,14,33,5,0,2022
FRA-Ligue 1,2021,Clermont Foot,Vital N'Simba,COD,DF,28,1993,31.0,66,45,38,23,5,36,63,57.1,27,28,7,21,29,95,30,0,2022
FRA-Ligue 1,2021,Clermont Foot,Yadaly Diaby,GUI,"FW,MF",20,2000,0.7,0,0,0,0,0,0,1,0.0,1,0,0,0,2,2,2,0,2022
FRA-Ligue 1,2021,Clermont Foot,Yohann Magnin,FRA,"MF,DF",24,1997,19.1,53,31,22,26,5,24,42,57.1,18,17,7,10,20,73,36,0,2022
FRA-Ligue 1,2021,Lens,Arnaud Kalimuendo,FRA,FW,19,2002,23.9,9,8,1,3,5,2,7,28.6,5,6,1,5,8,17,0,0,2022
FRA-Ligue 1,2021,Lens,Brayann Pereira,FRA,"DF,MF",18,2003,0.2,1,1,1,0,0,1,1,100.0,0,0,0,0,0,1,1,0,2022
FRA-Ligue 1,2021,Lens,Charles Boli,FRA,"MF,DF",22,1998,0.4,2,1,0,2,0,0,0,,0,0,0,0,0,2,0,0,2022
FRA-Ligue 1,2021,Lens,Cheick Doucouré,MLI,MF,21,2000,32.7,75,43,34,34,7,35,79,44.3,44,30,7,23,68,143,24,0,2022
FRA-Ligue 1,2021,Lens,Christopher Wooh,CMR,DF,19,2001,11.7,29,11,20,8,1,11,18,61.1,7,21,14,7,21,50,40,1,2022
FRA-Ligue 1,2021,Lens,Corentin Jean,FRA,"FW,MF",26,1995,2.8,9,6,4,4,1,3,6,50.0,3,5,0,5,1,10,0,0,2022
FRA-Ligue 1,2021,Lens,David Pereira da Costa,POR,"MF,FW",20,2001,16.3,22,12,9,6,7,11,26,42.3,15,12,0,12,13,35,5,0,2022
FRA-Ligue 1,2021,Lens,Deiver Machado,COL,"DF,MF",27,1993,5.8,16,14,11,1,4,12,14,85.7,2,9,1,8,3,19,12,1,2022
FRA-Ligue 1,2021,Lens,Facundo Medina,ARG,DF,22,1999,28.8,61,42,34,23,4,38,62,61.3,24,24,8,16,37,98,78,3,2022
FRA-Ligue 1,2021,Lens,Florian Sotoca,FRA,"FW,MF",30,1990,27.6,31,19,7,20,4,12,51,23.5,39,31,4,27,25,56,41,0,2022
FRA-Ligue 1,2021,Lens,Gaël Kakuta,COD,"MF,FW",30,1991,18.6,22,14,2,13,7,4,20,20.0,16,10,0,10,4,26,3,0,2022
FRA-Ligue 1,2021,Lens,Ibrahima Baldé,FRA,"FW,MF",18,2003,0.6,0,0,0,0,0,0,0,,0,0,0,0,0,0,0,0,2022
FRA-Ligue 1,2021,Lens,Ignatius Ganago,CMR,FW,22,1999,11.4,3,2,1,2,0,2,6,33.3,4,4,0,4,2,5,3,0,2022
FRA-Ligue 1,2021,Lens,Ismaëlben Boura,FRA,DF,20,2000,1.1,2,2,1,1,0,0,0,,0,1,1,0,2,4,5,0,2022
FRA-Ligue 1,2021,Lens,Jean-Louis Leca,FRA,GK,35,1985,25.7,0,0,0,0,0,0,0,,0,1,0,1,1,1,11,1,2022
FRA-Ligue 1,2021,Lens,Jonathan Clauss,FRA,DF,28,1992,33.8,63,34,33,20,10,22,55,40.0,33,43,1,42,73,136,51,0,2022
FRA-Ligue 1,2021,Lens,Jonathan Gradit,FRA,DF,28,1992,34.1,60,28,24,28,8,25,45,55.6,20,39,27,12,65,125,106,0,2022
FRA-Ligue 1,2021,Lens,Jonathan Varane,FRA,MF,19,2001,0.0,0,0,0,0,0,0,0,,0,0,0,0,0,0,0,0,2022
FRA-Ligue 1,2021,Lens,Kevin Danso,AUT,DF,22,1998,31.0,41,29,29,12,0,23,34,67.6,11,38,25,13,40,81,111,0,2022
FRA-Ligue 1,2021,Lens,Massadio Haïdara,MLI,DF,28,1992,12.0,28,21,18,7,3,15,24,62.5,9,18,4,14,22,50,31,0,2022
FRA-Ligue 1,2021,Lens,Patrick Berg,NOR,MF,23,1997,3.4,14,6,6,8,0,0,4,0.0,4,2,1,1,4,18,3,0,2022
FRA-Ligue 1,2021,Lens,Przemysław Frankowski,POL,DF,26,1995,27.2,57,39,22,27,8,36,74,48.6,38,27,0,27,28,85,52,0,2022
FRA-Ligue 1,2021,Lens,Seko Fofana,CIV,MF,26,1995,37.3,27,19,11,13,3,12,58,20.7,46,24,2,22,26,53,17,1,2022
FRA-Ligue 1,2021,Lens,Simon Banza,FRA,FW,24,1996,1.4,2,1,0,0,2,0,2,0.0,2,1,0,1,1,3,2,0,2022
FRA-Ligue 1,2021,Lens,Steven Fortes,CPV,DF,29,1992,1.0,2,0,2,0,0,1,2,50.0,1,2,1,1,0,2,4,0,2022
FRA-Ligue 1,2021,Lens,Wesley Saïd,FRA,"FW,MF",26,1995,7.3,10,5,1,8,1,1,9,11.1,8,4,0,4,2,12,0,0,2022
FRA-Ligue 1,2021,Lens,Wuilker Faríñez,VEN,GK,23,1998,12.3,0,0,0,0,0,0,0,,0,0,0,0,0,0,4,0,2022
FRA-Ligue 1,2021,Lens,Yannick Cahuzac,FRA,MF,36,1985,6.9,5,2,2,3,0,0,5,0.0,5,8,2,6,9,14,12,0,2022
FRA-Ligue 1,2021,Lille,Amadou Onana,BEL,MF,19,2001,15.1,48,31,17,27,4,18,25,72.0,7,10,3,7,30,78,19,0,2022
FRA-Ligue 1,2021,Lille,Angel Gomes,ENG,"MF,FW",20,2000,10.6,23,13,6,12,5,10,15,66.7,5,4,0,4,3,26,4,0,2022
FRA-Ligue 1,2021,Lille,Benjamin André,FRA,MF,30,1990,30.6,123,69,49,65,9,51,113,45.1,62,49,11,38,50,173,56,0,2022
FRA-Ligue 1,2021,Lille,Burak Yılmaz,TUR,FW,36,1985,24.6,7,2,0,2,5,2,17,11.8,15,8,1,7,2,9,11,0,2022
FRA-Ligue 1,2021,Lille,Cheikh Niasse,SEN,"FW,MF",21,2000,0.5,2,2,0,2,0,2,3,66.7,1,1,1,0,1,3,2,0,2022
FRA-Ligue 1,2021,Lille,Domagoj Bradarić,CRO,DF,21,1999,4.6,11,9,8,2,1,7,12,58.3,5,5,2,3,10,21,7,1,2022
FRA-Ligue 1,2021,Lille,Edon Zhegrova,KVX,"MF,FW",22,1999,5.3,14,5,2,8,4,5,6,83.3,1,4,1,3,2,16,2,0,2022
FRA-Ligue 1,2021,Lille,Gabriel Gudmundsson,SWE,"DF,MF",22,1999,14.9,43,31,24,16,3,17,35,48.6,18,15,3,12,20,63,13,0,2022
FRA-Ligue 1,2021,Lille,Hatem Ben Arfa,FRA,"FW,MF",34,1987,3.5,4,2,2,1,1,2,4,50.0,2,3,0,3,0,4,1,0,2022
FRA-Ligue 1,2021,Lille,Isaac Lihadji,FRA,"MF,FW",19,2002,2.6,3,3,1,1,1,1,5,20.0,4,1,0,1,2,5,0,0,2022
FRA-Ligue 1,2021,Lille,Ivo Grbić,CRO,GK,25,1996,21.0,0,0,0,0,0,0,0,,0,0,0,0,0,0,14,1,2022
FRA-Ligue 1,2021,Lille,Jonathan Bamba,CIV,"MF,FW",25,1996,27.0,30,12,13,9,8,13,36,36.1,23,24,1,23,21,51,10,0,2022
FRA-Ligue 1,2021,Lille,Jonathan David,CAN,FW,21,2000,31.2,24,9,7,11,6,9,30,30.0,21,14,4,10,5,29,15,0,2022
FRA-Ligue 1,2021,Lille,Jonathan Ikone,FRA,"MF,FW",23,1998,11.8,11,3,6,4,1,4,11,36.4,7,13,1,12,5,16,4,0,2022
FRA-Ligue 1,2021,Lille,José Fonte,POR,DF,37,1983,38.0,23,12,14,7,2,11,25,44.0,14,39,32,7,44,67,159,1,2022
FRA-Ligue 1,2021,Lille,Jérémy Pied,FRA,"DF,FW",32,1989,0.1,0,0,0,0,0,0,0,,0,0,0,0,1,1,0,0,2022
FRA-Ligue 1,2021,Lille,Leny Yoro,FRA,MF,15,2005,0.1,1,0,0,1,0,0,0,,0,1,0,1,0,1,0,0,2022
FRA-Ligue 1,2021,Lille,Leonardo César Jardim,BRA,GK,26,1995,17.0,,0,,,,,,,,,,,1,,,,2022
FRA-Ligue 1,2021,Lille,Reinildo Mandava,MOZ,DF,27,1994,16.9,43,23,29,11,3,32,51,62.7,19,13,4,9,37,80,55,0,2022
FRA-Ligue 1,2021,Lille,Renato Sanches,POR,"MF,FW",23,1997,18.3,19,7,8,10,1,9,26,34.6,17,14,3,11,14,33,7,0,2022
FRA-Ligue 1,2021,Lille,Sven Botman,NED,DF,21,2000,25.0,24,11,13,11,0,12,18,66.7,6,32,21,11,26,50,116,0,2022
FRA-Ligue 1,2021,Lille,Tiago Djaló,POR,DF,21,2000,25.9,60,39,39,19,2,26,39,66.7,13,26,10,16,24,84,71,0,2022
FRA-Ligue 1,2021,Lille,Timothy Weah,USA,"MF,FW",21,2000,18.0,19,7,8,8,3,10,20,50.0,10,16,1,15,10,29,7,0,2022
FRA-Ligue 1,2021,Lille,Xeka,POR,MF,26,1994,18.0,47,27,18,24,5,27,56,48.2,29,23,3,20,24,71,26,1,2022
FRA-Ligue 1,2021,Lille,Yusuf Yazıcı,TUR,"MF,FW",24,1997,5.7,10,5,3,6,1,1,9,11.1,8,4,0,4,2,12,1,0,2022
FRA-Ligue 1,2021,Lille,Zeki Çelik,TUR,DF,24,1997,30.0,64,37,43,17,4,36,63,57.1,27,32,9,23,43,107,62,2,2022
FRA-Ligue 1,2021,Lorient,Adrian Grbić,AUT,"FW,MF",24,1996,5.8,2,1,0,2,0,2,6,33.3,4,3,1,2,0,2,7,0,2022
FRA-Ligue 1,2021,Lorient,Armand Lauriente,FRA,"FW,MF",22,1998,27.5,33,18,9,16,8,11,30,36.7,19,27,2,25,15,48,3,0,2022
FRA-Ligue 1,2021,Lorient,Baptiste Mouazan,FRA,MF,19,2001,1.1,4,3,2,2,0,1,3,33.3,2,3,0,3,1,5,1,0,2022
FRA-Ligue 1,2021,Lorient,Bonke Innocent,NGA,MF,25,1996,9.7,27,16,10,16,1,11,26,42.3,15,11,3,8,16,43,14,0,2022
FRA-Ligue 1,2021,Lorient,Dango Ouattara,BFA,"MF,FW",19,2002,9.0,21,15,9,11,1,11,23,47.8,12,10,1,9,14,35,15,1,2022
FRA-Ligue 1,2021,Lorient,Enzo Le Fée,FRA,"MF,FW",21,2000,24.4,70,44,25,36,9,41,90,45.6,49,25,1,24,29,99,18,0,2022
FRA-Ligue 1,2021,Lorient,Fabien Lemoine,FRA,MF,34,1987,12.4,35,22,20,14,1,17,41,41.5,24,21,4,17,14,49,24,1,2022
FRA-Ligue 1,2021,Lorient,Houboulang Mendes,FRA,DF,23,1998,35.8,58,28,37,18,3,40,57,70.2,17,41,21,20,41,99,128,4,2022
FRA-Ligue 1,2021,Lorient,Ibrahima Koné,MLI,FW,22,1999,8.1,7,4,0,3,4,2,3,66.7,1,8,3,5,1,8,3,0,2022
FRA-Ligue 1,2021,Lorient,Igor Carioca,BRA,DF,24,1996,17.5,27,16,16,8,3,15,43,34.9,28,17,2,15,25,52,28,0,2022
FRA-Ligue 1,2021,Lorient,Julien Laporte,FRA,DF,27,1993,32.1,63,45,35,26,2,32,64,50.0,32,37,22,15,54,117,174,0,2022
FRA-Ligue 1,2021,Lorient,Jérémy Morel,MAD,DF,37,1984,6.7,13,9,8,4,1,6,6,100.0,0,9,7,2,7,20,31,0,2022
FRA-Ligue 1,2021,Lorient,Jérôme Hergault,FRA,DF,35,1986,3.9,3,1,1,2,0,2,5,40.0,3,4,1,3,4,7,7,0,2022
FRA-Ligue 1,2021,Lorient,Laurent Abergel,FRA,MF,28,1993,32.8,110,60,44,53,13,71,166,42.8,95,58,1,57,55,165,13,0,2022
FRA-Ligue 1,2021,Lorient,Léo Pétrot,FRA,DF,24,1997,20.2,31,17,23,8,0,21,29,72.4,8,33,17,16,22,53,86,0,2022
FRA-Ligue 1,2021,Lorient,Matthieu Dreyer,FRA,GK,32,1989,16.0,1,1,1,0,0,1,1,100.0,0,0,0,0,0,1,9,0,2022
FRA-Ligue 1,2021,Lorient,Moritz Jenz,GER,DF,22,1999,15.3,26,12,18,6,2,11,24,45.8,13,19,11,8,28,54,55,0,2022
FRA-Ligue 1,2021,Lorient,Paul Nardi,FRA,GK,27,1994,22.0,1,0,1,0,0,1,2,50.0,1,0,0,0,0,1,10,2,2022
FRA-Ligue 1,2021,Lorient,Pierre-Yves Hamel,FRA,"FW,MF",27,1994,0.3,0,0,0,0,0,0,1,0.0,1,0,0,0,2,2,0,0,2022
FRA-Ligue 1,2021,Lorient,Quentin Boisgard,FRA,"MF,FW",24,1997,10.6,19,11,6,10,3,8,17,47.1,9,15,0,15,6,25,5,0,2022
FRA-Ligue 1,2021,Lorient,Redwan Bourles,FRA,"MF,FW",18,2003,0.2,0,0,0,0,0,0,0,,0,0,0,0,0,0,0,0,2022
FRA-Ligue 1,2021,Lorient,Sambou Soumano,SEN,"FW,MF",20,2001,5.0,4,1,1,2,1,2,2,100.0,0,3,0,3,1,5,7,0,2022
FRA-Ligue 1,2021,Lorient,Samuel Loric,FRA,DF,21,2000,3.0,7,5,2,3,2,5,8,62.5,3,2,0,2,5,12,9,0,2022
FRA-Ligue 1,2021,Lorient,Stéphane Diarra,FRA,"MF,FW",22,1998,5.8,11,9,7,3,1,5,10,50.0,5,4,0,4,7,18,1,0,2022
FRA-Ligue 1,2021,Lorient,Terem Moffi,NGA,FW,22,1999,30.1,17,10,3,12,2,9,32,28.1,23,11,2,9,4,21,22,0,2022
FRA-Ligue 1,2021,Lorient,Thomas Fontaine,MAD,DF,30,1991,1.9,2,0,1,0,1,0,1,0.0,1,3,3,0,2,4,4,0,2022
FRA-Ligue 1,2021,Lorient,Thomas Monconduit,FRA,MF,30,1991,25.0,41,25,19,17,5,20,57,35.1,37,21,10,11,22,63,51,1,2022
FRA-Ligue 1,2021,Lorient,Théo Le Bris,FRA,MF,18,2002,0.7,2,1,1,1,0,1,2,50.0,1,2,0,2,0,2,1,0,2022
FRA-Ligue 1,2021,Lorient,Vincent Le Goff,FRA,DF,31,1989,34.0,61,38,38,19,4,37,62,59.7,25,18,3,15,37,98,50,0,2022
FRA-Ligue 1,2021,Lyon,Anthony Lopes,POR,GK,30,1990,33.1,0,0,0,0,0,0,0,,0,0,0,0,3,3,12,3,2022
FRA-Ligue 1,2021,Lyon,Bradley Barcola,FRA,"FW,MF",18,2002,2.9,7,4,2,3,2,1,8,12.5,7,7,1,6,2,9,1,0,2022
FRA-Ligue 1,2021,Lyon,Bruno Guimarães,BRA,MF,23,1997,18.2,50,31,20,25,5,23,59,39.0,36,21,4,17,21,71,11,1,2022
FRA-Ligue 1,2021,Lyon,Castello Lukeba,FRA,DF,18,2002,23.3,34,19,27,7,0,15,23,65.2,8,18,9,9,38,72,64,2,2022
FRA-Ligue 1,2021,Lyon,Damien Da Silva,FRA,DF,33,1988,12.5,13,9,7,5,1,5,9,55.6,4,15,10,5,22,35,53,1,2022
FRA-Ligue 1,2021,Lyon,Emerson Palmieri,ITA,DF,26,1994,25.2,46,25,16,22,8,22,34,64.7,12,23,8,15,27,73,66,0,2022
FRA-Ligue 1,2021,Lyon,Habib Keita,MLI,"MF,FW",19,2002,0.1,0,0,0,0,0,0,0,,0,0,0,0,0,0,0,0,2022
FRA-Ligue 1,2021,Lyon,Henrique,BRA,DF,27,1994,12.3,13,7,10,1,2,5,16,31.3,11,13,1,12,22,35,14,0,2022
FRA-Ligue 1,2021,Lyon,Houssem Aouar,ALG,"MF,FW",23,1998,27.8,46,30,9,25,12,27,54,50.0,27,26,1,25,20,66,5,0,2022
FRA-Ligue 1,2021,Lyon,Islam Slimani,ALG,FW,33,1988,6.4,3,2,0,1,2,1,6,16.7,5,4,0,4,2,5,5,0,2022
FRA-Ligue 1,2021,Lyon,Jason Denayer,BEL,DF,26,1995,11.1,11,4,8,3,0,6,7,85.7,1,8,7,1,16,27,52,0,2022
FRA-Ligue 1,2021,Lyon,Jeff Reine-Adélaïde,FRA,"MF,DF",23,1998,2.2,5,3,4,1,0,4,5,80.0,1,2,0,2,0,5,0,1,2022
FRA-Ligue 1,2021,Lyon,Julian Pollersbeck,GER,GK,26,1994,4.8,0,0,0,0,0,0,0,,0,0,0,0,1,1,1,0,2022
FRA-Ligue 1,2021,Lyon,Jérôme Boateng,GER,DF,32,1988,18.0,20,15,11,9,0,9,17,52.9,8,20,10,10,20,40,73,0,2022
FRA-Ligue 1,2021,Lyon,Karl Toko Ekambi,CMR,FW,28,1992,25.5,13,7,4,6,3,4,21,19.0,17,26,0,26,20,33,5,0,2022
FRA-Ligue 1,2021,Lyon,Leo Dubois,FRA,DF,26,1994,19.4,43,27,22,14,7,27,46,58.7,19,27,3,24,22,65,35,1,2022
FRA-Ligue 1,2021,Lyon,Lucas Paquetá,BRA,"MF,FW",23,1997,30.0,68,38,24,26,18,17,51,33.3,34,43,5,38,9,77,22,0,2022
FRA-Ligue 1,2021,Lyon,Malo Gusto,FRA,DF,18,2003,20.9,55,35,29,21,5,24,40,60.0,16,21,6,15,33,88,41,1,2022
FRA-Ligue 1,2021,Lyon,Marcelo,BRA,DF,34,1987,2.0,4,3,0,4,0,4,6,66.7,2,3,2,1,4,8,10,0,2022
FRA-Ligue 1,2021,Lyon,Maxence Caqueret,FRA,MF,21,2000,25.9,73,40,29,36,8,30,80,37.5,50,38,10,28,43,116,26,2,2022
FRA-Ligue 1,2021,Lyon,Maxwel Cornet,CIV,DF,24,1996,0.7,3,1,1,0,2,3,4,75.0,1,0,0,0,1,4,1,0,2022
FRA-Ligue 1,2021,Lyon,Moussa Dembélé,FRA,FW,25,1996,24.5,18,9,5,5,8,6,15,40.0,9,13,0,13,8,26,30,1,2022
FRA-Ligue 1,2021,Lyon,Rayan Cherki,FRA,"FW,MF",17,2003,4.9,6,2,1,3,2,4,9,44.4,5,2,0,2,1,7,0,0,2022
FRA-Ligue 1,2021,Lyon,Romain Faivre,FRA,"FW,MF",23,1998,9.9,10,4,2,6,2,4,13,30.8,9,4,0,4,3,13,2,0,2022
FRA-Ligue 1,2021,Lyon,Sinaly Diomande,CIV,DF,20,2001,6.4,6,3,4,2,0,5,6,83.3,1,6,6,0,12,18,26,0,2022
FRA-Ligue 1,2021,Lyon,Tanguy Ndombele,FRA,MF,24,1996,7.8,25,14,5,17,3,12,19,63.2,7,8,3,5,3,28,6,2,2022
FRA-Ligue 1,2021,Lyon,Tetê,BRA,"FW,MF",21,2000,6.5,10,5,4,5,1,3,13,23.1,10,4,0,4,3,13,1,0,2022
FRA-Ligue 1,2021,Lyon,Thiago Mendes,BRA,"MF,DF",29,1992,20.7,36,22,18,16,2,12,30,40.0,18,24,5,19,34,70,56,1,2022
FRA-Ligue 1,2021,Lyon,Tino Kadewere,ZIM,FW,25,1996,5.6,7,5,2,2,3,4,13,30.8,9,7,0,7,4,11,1,1,2022
FRA-Ligue 1,2021,Lyon,Xherdan Shaqiri,SUI,"FW,MF",29,1991,7.5,7,3,0,5,2,2,10,20.0,8,2,0,2,2,9,2,0,2022
FRA-Ligue 1,2021,Marseille,Amine Harit,MAR,"FW,MF",24,1997,12.9,18,11,9,9,0,9,17,52.9,8,10,0,10,4,22,2,0,2022
FRA-Ligue 1,2021,Marseille,Arkadiusz Milik,POL,FW,27,1994,15.7,9,2,0,5,4,4,18,22.2,14,9,1,8,3,12,10,1,2022
FRA-Ligue 1,2021,Marseille,Bamba Dieng,SEN,FW,21,2000,10.8,17,11,5,5,7,4,14,28.6,10,7,0,7,5,22,8,0,2022
FRA-Ligue 1,2021,Marseille,Boubacar Kamara,FRA,"MF,DF",21,1999,30.9,68,38,27,36,5,26,47,55.3,21,29,10,19,46,114,44,1,2022
FRA-Ligue 1,2021,Marseille,Cengiz Ünder,TUR,"FW,MF",24,1997,24.4,18,13,5,6,7,5,18,27.8,13,13,2,11,14,32,9,0,2022
FRA-Ligue 1,2021,Marseille,Cédric Bakambu,COD,FW,30,1991,4.0,2,0,1,0,1,0,3,0.0,3,2,0,2,0,2,1,0,2022
FRA-Ligue 1,2021,Marseille,Darío Benedetto,ARG,"FW,MF",31,1990,0.6,0,0,0,0,0,0,0,,0,2,0,2,0,0,0,0,2022
FRA-Ligue 1,2021,Marseille,Dimitri Payet,FRA,"FW,MF",34,1987,28.8,16,8,4,10,2,7,31,22.6,24,9,0,9,9,25,3,0,2022
FRA-Ligue 1,2021,Marseille,Duje Ćaleta-Car,CRO,DF,24,1996,22.9,21,8,15,6,0,11,14,78.6,3,11,7,4,24,45,55,2,2022
FRA-Ligue 1,2021,Marseille,Gerson,BRA,"MF,FW",24,1997,28.3,42,17,16,20,6,8,35,22.9,27,26,4,22,16,58,16,2,2022
FRA-Ligue 1,2021,Marseille,Jordan Amavi,FRA,"DF,FW",27,1994,1.4,6,5,3,1,2,5,10,50.0,5,1,0,1,1,7,3,0,2022
FRA-Ligue 1,2021,Marseille,Konrad De La Fuente,USA,"FW,MF",20,2001,8.7,11,7,8,2,1,7,11,63.6,4,5,0,5,2,13,4,0,2022
FRA-Ligue 1,2021,Marseille,Leonardo Balerdi,ARG,DF,22,1999,10.6,9,6,9,0,0,5,14,35.7,9,11,4,7,19,28,30,0,2022
FRA-Ligue 1,2021,Marseille,Luan Peres Petroni,BRA,DF,27,1994,29.8,65,35,33,25,7,36,52,69.2,16,26,12,14,43,108,64,1,2022
FRA-Ligue 1,2021,Marseille,Luis Henrique,BRA,"FW,MF",19,2001,7.8,4,3,2,1,1,2,5,40.0,3,2,0,2,5,9,1,0,2022
FRA-Ligue 1,2021,Marseille,Mattéo Guendouzi,FRA,MF,22,1999,35.0,45,30,10,26,9,13,47,27.7,34,15,1,14,16,61,18,0,2022
FRA-Ligue 1,2021,Marseille,Nemanja Radonjić,SRB,FW,25,1996,0.2,0,0,0,0,0,0,0,,0,0,0,0,0,0,0,0,2022
FRA-Ligue 1,2021,Marseille,Oussama Targhalline,MAR,FW,19,2002,0.1,0,0,0,0,0,0,0,,0,0,0,0,0,0,0,0,2022
FRA-Ligue 1,2021,Marseille,Pape Gueye,SEN,MF,22,1999,17.0,38,19,15,22,1,16,31,51.6,15,15,3,12,24,62,16,0,2022
FRA-Ligue 1,2021,Marseille,Pau López,ESP,GK,26,1994,29.0,0,0,0,0,0,0,1,0.0,1,0,0,0,0,0,12,1,2022
FRA-Ligue 1,2021,Marseille,Pol Lirola,ESP,"DF,FW",23,1997,19.7,28,16,15,9,4,13,28,46.4,15,15,0,15,13,41,22,0,2022
FRA-Ligue 1,2021,Marseille,Salim Ben Seghir,FRA,MF,18,2003,0.0,0,0,0,0,0,0,0,,0,0,0,0,0,0,0,0,2022
FRA-Ligue 1,2021,Marseille,Sead Kolašinac,BIH,DF,28,1993,4.9,7,6,2,3,2,5,8,62.5,3,4,0,4,0,7,7,1,2022
FRA-Ligue 1,2021,Marseille,Steve Mandanda,FRA,GK,36,1985,9.0,0,0,0,0,0,0,1,0.0,1,1,0,1,1,1,4,1,2022
FRA-Ligue 1,2021,Marseille,Valentin Rongier,FRA,"MF,DF",26,1994,24.4,77,51,36,36,5,28,60,46.7,32,26,5,21,33,110,14,0,2022
FRA-Ligue 1,2021,Marseille,William Saliba,FRA,DF,20,2001,36.0,54,32,36,16,2,27,35,77.1,8,24,16,8,48,102,85,0,2022
FRA-Ligue 1,2021,Marseille,Álvaro González,ESP,DF,31,1990,5.0,1,1,1,0,0,1,1,100.0,0,0,0,0,1,2,9,0,2022
FRA-Ligue 1,2021,Metz,Alexandre Oukidja,ALG,GK,33,1988,20.8,0,0,0,0,0,0,1,0.0,1,1,0,1,1,1,17,2,2022
FRA-Ligue 1,2021,Metz,Amadou Mbengue,SEN,"DF,MF",19,2002,6.8,19,10,10,9,0,11,22,50.0,11,7,2,5,10,29,19,0,2022
FRA-Ligue 1,2021,Metz,Amine Bassi,FRA,"MF,FW",23,1997,2.0,6,3,2,3,1,1,3,33.3,2,5,0,5,0,6,0,0,2022
FRA-Ligue 1,2021,Metz,Boubacar Traoré,MLI,MF,19,2001,19.2,43,26,18,23,2,10,39,25.6,29,29,5,24,25,68,11,1,2022
FRA-Ligue 1,2021,Metz,Boubakar Kouyaté,MLI,DF,24,1997,29.6,84,50,56,28,0,48,77,62.3,29,63,33,30,79,163,217,3,2022
FRA-Ligue 1,2021,Metz,Cheikh Tidiane Sabaly,SEN,"FW,MF",22,1999,1.7,6,3,1,4,1,2,2,100.0,0,1,0,1,0,6,1,0,2022
FRA-Ligue 1,2021,Metz,Didier Lamkel Zé,CMR,FW,24,1996,6.7,3,1,1,0,2,1,3,33.3,2,3,1,2,1,4,7,0,2022
FRA-Ligue 1,2021,Metz,Dylan Bronn,TUN,DF,26,1995,28.3,47,29,33,13,1,20,31,64.5,11,32,19,13,40,87,78,1,2022
FRA-Ligue 1,2021,Metz,Fabien Centonze,FRA,DF,25,1996,17.6,33,21,22,9,2,13,32,40.6,19,37,8,29,32,65,51,0,2022
FRA-Ligue 1,2021,Metz,Fali Candé,GNB,DF,23,1998,10.8,30,18,13,15,2,13,31,41.9,18,11,2,9,6,36,21,0,2022
FRA-Ligue 1,2021,Metz,Farid Boulaya,ALG,"MF,FW",28,1993,17.0,18,10,7,9,2,14,38,36.8,24,8,2,6,12,30,5,0,2022
FRA-Ligue 1,2021,Metz,Georges Mikautadze,GEO,FW,20,2000,0.0,0,0,0,0,0,0,0,,0,0,0,0,0,0,0,0,2022
FRA-Ligue 1,2021,Metz,Habib Maïga,CIV,MF,25,1996,14.1,47,28,29,13,5,24,48,50.0,24,20,7,13,14,61,18,0,2022
FRA-Ligue 1,2021,Metz,Ibrahim Amadou,FRA,"DF,MF",28,1993,9.0,16,8,10,6,0,8,15,53.3,7,4,2,2,14,30,26,0,2022
FRA-Ligue 1,2021,Metz,Ibrahima Niane,SEN,FW,22,1999,17.6,1,1,0,1,0,0,5,0.0,5,6,1,5,3,4,16,0,2022
FRA-Ligue 1,2021,Metz,Jean-Armel Kana-Biyik,CMR,DF,32,1989,7.4,10,6,8,2,0,4,9,44.4,5,11,4,7,16,26,22,1,2022
FRA-Ligue 1,2021,Metz,Jemerson,BRA,DF,28,1992,13.4,37,25,30,7,0,18,26,69.2,8,23,8,15,25,62,33,1,2022
FRA-Ligue 1,2021,Metz,Kévin N'Doram,FRA,MF,25,1996,13.7,10,8,3,5,2,3,20,15.0,17,24,5,19,19,29,21,0,2022
FRA-Ligue 1,2021,Metz,Lamine Gueye,SEN,"FW,MF",23,1998,6.2,5,5,1,1,3,3,7,42.9,4,4,0,4,6,11,1,0,2022
FRA-Ligue 1,2021,Metz,Lenny Joseph,FRA,"FW,MF",20,2000,1.7,2,1,1,1,0,0,0,,0,3,0,3,0,2,0,0,2022
FRA-Ligue 1,2021,Metz,Lenny Lacroix,FRA,DF,18,2003,2.2,9,7,8,1,0,5,8,62.5,3,5,1,4,10,19,5,0,2022
FRA-Ligue 1,2021,Metz,Louis Mafouta,CTA,FW,27,1994,5.8,0,0,0,0,0,0,5,0.0,5,1,0,1,0,0,4,0,2022
FRA-Ligue 1,2021,Metz,Mamadou Fofana,MLI,DF,23,1998,0.4,1,1,0,1,0,1,2,50.0,1,2,1,1,1,2,2,0,2022
FRA-Ligue 1,2021,Metz,Marc-Aurèle Caillard,FRA,GK,27,1994,17.1,0,0,0,0,0,0,2,0.0,2,0,0,0,2,2,9,1,2022
FRA-Ligue 1,2021,Metz,Matthieu Udol,FRA,DF,25,1996,11.2,23,14,11,10,2,12,18,66.7,6,20,7,13,31,54,29,1,2022
FRA-Ligue 1,2021,Metz,Nicolas de Préville,FRA,"FW,MF",30,1991,21.9,17,8,7,8,2,3,19,15.8,16,12,4,8,5,22,11,0,2022
FRA-Ligue 1,2021,Metz,Opa Nguette,SEN,"FW,MF",27,1994,11.6,21,14,9,6,6,5,14,35.7,9,13,3,10,2,23,9,0,2022
FRA-Ligue 1,2021,Metz,Papa Ndiaga Yade,SEN,"DF,FW",21,2000,7.7,15,10,8,7,0,8,18,44.4,10,4,1,3,10,25,9,0,2022
FRA-Ligue 1,2021,Metz,Pape Matar Sarr,SEN,MF,18,2002,23.7,45,26,21,23,1,18,39,46.2,21,33,3,30,29,74,22,0,2022
FRA-Ligue 1,2021,Metz,Sikou Niakaté,FRA,DF,22,1999,7.3,8,7,8,0,0,4,11,36.4,7,5,3,2,27,35,34,0,2022
FRA-Ligue 1,2021,Metz,Sofiane Alakouch,MAR,"DF,MF",23,1998,1.8,7,4,3,4,0,2,5,40.0,3,4,0,4,1,8,4,0,2022
FRA-Ligue 1,2021,Metz,Thomas Delaine,FRA,DF,29,1992,25.7,48,35,34,12,2,22,42,52.4,20,20,7,13,27,75,31,0,2022
FRA-Ligue 1,2021,Metz,Vagner Gonçalves,CPV,FW,25,1996,1.0,2,1,0,2,0,1,1,100.0,0,0,0,0,1,3,0,0,2022
FRA-Ligue 1,2021,Metz,Vincent Pajot,FRA,MF,30,1990,25.7,86,56,35,47,4,20,46,43.5,26,33,6,27,51,137,38,0,2022
FRA-Ligue 1,2021,Metz,Warren Tchimbembé,CGO,MF,23,1998,2.3,1,1,0,1,0,0,1,0.0,1,2,1,1,2,3,2,0,2022
FRA-Ligue 1,2021,Metz,William Mikelbrencis,FRA,DF,17,2004,6.8,11,5,6,4,1,6,9,66.7,3,6,3,3,5,16,9,0,2022
FRA-Ligue 1,2021,Monaco,Aleksandr Golovin,RUS,"FW,MF",25,1996,16.7,40,22,10,18,12,18,41,43.9,23,26,1,25,12,52,8,0,2022
FRA-Ligue 1,2021,Monaco,Alexander Nübel,GER,GK,24,1996,38.0,0,0,0,0,0,0,1,0.0,1,0,0,0,0,0,11,1,2022
FRA-Ligue 1,2021,Monaco,Aurélien Tchouaméni,FRA,MF,21,2000,32.5,86,45,33,49,4,29,55,52.7,26,39,7,32,101,187,34,0,2022
FRA-Ligue 1,2021,Monaco,Axel Disasi,FRA,DF,23,1998,30.2,42,27,20,21,1,23,39,59.0,16,40,30,10,26,68,75,0,2022
FRA-Ligue 1,2021,Monaco,Benoît Badiashile,FRA,DF,20,2001,20.4,36,19,21,15,0,14,23,60.9,9,18,12,6,28,64,68,1,2022
FRA-Ligue 1,2021,Monaco,Caio Henrique Oliveira Silva,BRA,DF,24,1997,29.6,53,30,31,18,4,28,59,47.5,31,30,6,24,27,80,37,3,2022
FRA-Ligue 1,2021,Monaco,Cesc Fàbregas,ESP,MF,34,1987,0.4,1,0,0,1,0,1,1,100.0,0,0,0,0,1,2,0,0,2022
FRA-Ligue 1,2021,Monaco,Chrislain Matsima,FRA,DF,19,2002,1.5,3,2,1,2,0,2,7,28.6,5,3,3,0,1,4,6,1,2022
FRA-Ligue 1,2021,Monaco,Djibril Sidibé,FRA,DF,29,1992,10.5,24,13,13,8,3,9,24,37.5,15,10,1,9,16,40,13,0,2022
FRA-Ligue 1,2021,Monaco,Eliot Matazo,BEL,MF,19,2002,8.8,8,7,4,4,0,2,11,18.2,9,11,3,8,13,21,9,0,2022
FRA-Ligue 1,2021,Monaco,Félix Lemaréchal,CIV,MF,17,2003,0.1,0,0,0,0,0,0,1,0.0,1,0,0,0,0,0,0,0,2022
FRA-Ligue 1,2021,Monaco,Gelson Martins,POR,"MF,FW",26,1995,21.2,42,27,10,26,6,21,59,35.6,38,26,1,25,17,59,4,0,2022
FRA-Ligue 1,2021,Monaco,Guillermo Maripán,CHI,DF,27,1994,20.4,36,24,27,9,0,20,40,50.0,20,21,14,7,25,61,66,1,2022
FRA-Ligue 1,2021,Monaco,Ismail Jakobs,SEN,"DF,FW",21,1999,13.4,32,16,14,15,3,16,35,45.7,19,16,1,15,17,49,31,0,2022
FRA-Ligue 1,2021,Monaco,Jean Lucas,BRA,MF,23,1998,16.1,43,25,14,24,5,17,40,42.5,23,15,5,10,13,56,4,1,2022
FRA-Ligue 1,2021,Monaco,Kevin Volland,GER,"MF,FW",29,1992,27.1,24,10,2,18,4,6,31,19.4,25,20,0,20,3,27,9,0,2022
FRA-Ligue 1,2021,Monaco,Krépin Diatta,SEN,"MF,DF",22,1999,3.2,3,2,1,0,2,1,3,33.3,2,2,0,2,1,4,0,0,2022
FRA-Ligue 1,2021,Monaco,Maghnes Akliouche,FRA,"MF,FW",19,2002,0.6,2,0,0,2,0,0,1,0.0,1,2,0,2,0,2,0,0,2022
FRA-Ligue 1,2021,Monaco,Myron Boadu,NED,FW,20,2001,10.7,9,7,2,3,4,1,5,20.0,4,6,0,6,2,11,1,0,2022
FRA-Ligue 1,2021,Monaco,Ruben Aguilar,FRA,DF,28,1993,23.8,78,53,39,32,7,43,68,63.2,25,19,4,15,44,122,57,0,2022
FRA-Ligue 1,2021,Monaco,Sofiane Diop,FRA,"MF,FW",21,2000,21.6,38,20,12,19,7,15,47,31.9,32,10,0,10,23,61,4,0,2022
FRA-Ligue 1,2021,Monaco,Strahinja Pavlović,SRB,DF,20,2001,5.0,23,16,8,13,2,8,12,66.7,4,5,3,2,9,32,15,0,2022
FRA-Ligue 1,2021,Monaco,Tiago Ribeiro,POR,FW,19,2002,0.0,0,0,0,0,0,0,0,,0,0,0,0,0,0,0,0,2022
FRA-Ligue 1,2021,Monaco,Vanderson,BRA,"FW,DF",20,2001,12.4,35,19,10,19,6,15,23,65.2,8,17,4,13,13,48,12,0,2022
FRA-Ligue 1,2021,Monaco,Wilson Isidor,FRA,"FW,MF",20,2000,0.6,0,0,0,0,0,0,4,0.0,4,1,0,1,0,0,0,0,2022
FRA-Ligue 1,2021,Monaco,Wissam Ben Yedder,FRA,FW,30,1990,28.1,18,8,1,11,6,6,15,40.0,9,12,1,11,0,18,1,0,2022
FRA-Ligue 1,2021,Monaco,Youssouf Fofana,FRA,MF,22,1999,24.3,69,43,19,41,9,29,56,51.8,27,29,7,22,32,101,22,2,2022
FRA-Ligue 1,2021,Montpellier,Ambroise Oyongo,CMR,DF,30,1991,7.3,13,4,7,4,2,9,15,60.0,6,5,1,4,6,19,17,0,2022
FRA-Ligue 1,2021,Montpellier,Andy Delort,ALG,FW,29,1991,3.0,2,0,0,1,1,0,1,0.0,1,1,0,1,0,2,4,0,2022
FRA-Ligue 1,2021,Montpellier,Arnaud Souquet,FRA,DF,29,1992,25.9,56,35,30,17,9,32,65,49.2,33,21,7,14,34,90,60,1,2022
FRA-Ligue 1,2021,Montpellier,Béni Makouana,CGO,"FW,MF",18,2002,3.6,2,2,0,0,2,0,1,0.0,1,1,0,1,3,5,2,0,2022
FRA-Ligue 1,2021,Montpellier,Dimitry Bertaud,FRA,GK,23,1998,9.3,0,0,0,0,0,0,1,0.0,1,0,0,0,0,0,5,1,2022
FRA-Ligue 1,2021,Montpellier,Elye Wahi,FRA,FW,18,2003,19.8,18,10,9,6,3,6,16,37.5,10,7,0,7,4,22,4,0,2022
FRA-Ligue 1,2021,Montpellier,Florent Mollet,FRA,"FW,MF",29,1991,29.2,31,22,14,12,5,14,57,24.6,43,27,4,23,24,55,13,0,2022
FRA-Ligue 1,2021,Montpellier,Gaëtan Laborde,FRA,FW,27,1994,3.8,2,2,1,1,0,2,4,50.0,2,3,0,3,5,7,5,0,2022
FRA-Ligue 1,2021,Montpellier,Jonas Omlin,SUI,GK,27,1994,28.7,2,1,2,0,0,2,3,66.7,1,0,0,0,0,2,12,3,2022
FRA-Ligue 1,2021,Montpellier,Jordan Ferri,FRA,MF,29,1992,32.3,55,35,28,23,4,29,87,33.3,58,21,5,16,30,85,35,0,2022
FRA-Ligue 1,2021,Montpellier,Joris Chotard,FRA,MF,19,2001,32.6,59,30,33,23,3,36,78,46.2,42,27,15,12,42,101,56,0,2022
FRA-Ligue 1,2021,Montpellier,Junior Sambia,FRA,"DF,FW",24,1996,17.0,22,13,12,7,3,13,22,59.1,9,22,3,19,21,43,31,0,2022
FRA-Ligue 1,2021,Montpellier,Léo Leroy,FRA,MF,21,2000,7.0,31,21,17,11,3,12,34,35.3,22,20,4,16,8,39,8,0,2022
FRA-Ligue 1,2021,Montpellier,Mamadou Sakho,FRA,DF,31,1990,28.6,34,22,26,8,0,16,26,61.5,10,41,34,7,41,75,134,4,2022
FRA-Ligue 1,2021,Montpellier,Maxime Estève,FRA,DF,19,2002,20.6,27,18,22,4,1,15,27,55.6,12,31,24,7,22,49,69,1,2022
FRA-Ligue 1,2021,Montpellier,Mihailo Ristić,SRB,DF,25,1995,20.0,44,32,26,16,2,25,43,58.1,18,16,6,10,17,61,48,0,2022
FRA-Ligue 1,2021,Montpellier,Nicholas Gioacchini,USA,"FW,MF",21,2000,5.5,7,5,3,2,2,4,10,40.0,6,8,0,8,4,11,5,0,2022
FRA-Ligue 1,2021,Montpellier,Nicolas Cozza,FRA,DF,22,1999,30.8,80,47,50,23,7,35,65,53.8,30,35,19,16,38,118,82,1,2022
FRA-Ligue 1,2021,Montpellier,Pedro Mendes,POR,DF,30,1990,0.2,1,1,1,0,0,0,0,,0,1,1,0,0,1,2,0,2022
FRA-Ligue 1,2021,Montpellier,Rémy Cabella,FRA,"MF,FW",31,1990,3.5,15,7,4,8,3,5,15,33.3,10,7,0,7,5,20,1,0,2022
FRA-Ligue 1,2021,Montpellier,Sacha Delaye,FRA,"MF,FW",19,2002,2.9,8,6,3,2,3,2,8,25.0,6,1,0,1,1,9,1,1,2022
FRA-Ligue 1,2021,Montpellier,Stephy Mavididi,ENG,"FW,MF",23,1998,25.5,24,13,11,7,6,14,39,35.9,25,23,2,21,8,32,11,0,2022
FRA-Ligue 1,2021,Montpellier,Thuler,BRA,DF,22,1999,9.5,21,12,17,4,0,8,15,53.3,7,9,7,2,9,30,30,0,2022
FRA-Ligue 1,2021,Montpellier,Téji Savanier,FRA,MF,29,1991,26.8,46,27,18,19,9,21,59,35.6,38,23,1,22,25,71,12,1,2022
FRA-Ligue 1,2021,Montpellier,Valère Germain,FRA,FW,31,1990,21.9,23,14,6,11,6,8,31,25.8,23,13,1,12,9,32,27,0,2022
FRA-Ligue 1,2021,Montpellier,Yanis Guermouche,FRA,"MF,FW",20,2001,0.1,2,1,0,1,1,1,1,100.0,0,0,0,0,0,2,0,0,2022
FRA-Ligue 1,2021,Nantes,Abdoulaye Sylla,GUI,DF,21,2000,1.7,4,4,2,1,1,2,4,50.0,2,5,3,2,1,5,3,0,2022
FRA-Ligue 1,2021,Nantes,Alban Lafont,FRA,GK,22,1999,38.0,3,3,3,0,0,3,8,37.5,5,1,0,1,1,4,25,2,2022
FRA-Ligue 1,2021,Nantes,Andrei Girotto,BRA,"DF,MF",29,1992,35.0,85,52,49,32,4,52,103,50.5,51,67,33,34,69,154,143,0,2022
FRA-Ligue 1,2021,Nantes,Charles Traore,MLI,DF,29,1992,8.0,16,12,10,4,2,2,13,15.4,11,11,4,7,15,31,30,0,2022
FRA-Ligue 1,2021,Nantes,Dennis Appiah,FRA,DF,29,1992,23.3,55,34,35,18,2,28,48,58.3,20,30,13,17,27,82,74,0,2022
FRA-Ligue 1,2021,Nantes,Fábio,BRA,DF,31,1990,18.5,61,40,31,23,7,36,74,48.6,38,29,7,22,35,96,31,1,2022
FRA-Ligue 1,2021,Nantes,Jean-Charles Castelletto,CMR,DF,26,1995,27.9,45,24,27,17,1,25,35,71.4,10,38,27,11,30,75,73,0,2022
FRA-Ligue 1,2021,Nantes,Jean-Kévin Augustin,FRA,"FW,MF",24,1997,0.9,1,0,0,0,1,0,3,0.0,3,1,0,1,0,1,0,0,2022
FRA-Ligue 1,2021,Nantes,Kalifa Coulibaly,MLI,FW,29,1991,9.4,5,1,1,1,3,0,4,0.0,4,2,2,0,0,5,11,0,2022
FRA-Ligue 1,2021,Nantes,Lohann Doucet,FRA,"MF,DF",18,2002,0.1,0,0,0,0,0,0,0,,0,0,0,0,1,1,0,0,2022
FRA-Ligue 1,2021,Nantes,Ludovic Blas,FRA,"MF,FW",23,1997,32.9,33,18,7,20,6,15,44,34.1,29,33,3,30,31,64,6,1,2022
FRA-Ligue 1,2021,Nantes,Marcus Coco,FRA,"MF,FW",25,1996,10.3,34,14,17,11,6,8,18,44.4,10,11,1,10,10,44,15,0,2022
FRA-Ligue 1,2021,Nantes,Mohamed Achi,FRA,MF,19,2002,0.1,0,0,0,0,0,0,0,,0,0,0,0,0,0,0,0,2022
FRA-Ligue 1,2021,Nantes,Moses Simon,NGA,"FW,MF",26,1995,25.9,17,11,6,5,6,11,23,47.8,12,14,3,11,12,29,5,0,2022
FRA-Ligue 1,2021,Nantes,Nicolas Pallois,FRA,DF,33,1987,27.2,51,33,40,11,0,34,59,57.6,25,40,19,21,53,104,116,1,2022
FRA-Ligue 1,2021,Nantes,Osman Bukari,GHA,"FW,MF",22,1998,11.2,18,8,7,6,5,8,22,36.4,14,8,0,8,8,26,1,0,2022
FRA-Ligue 1,2021,Nantes,Pedro Chirivella,ESP,MF,24,1997,29.3,49,31,14,26,9,25,70,35.7,45,23,2,21,37,86,11,0,2022
FRA-Ligue 1,2021,Nantes,Quentin Merlin,FRA,"DF,MF",19,2002,21.4,45,28,19,20,6,26,49,53.1,23,25,4,21,27,72,29,2,2022
FRA-Ligue 1,2021,Nantes,Randal Kolo Muani,FRA,"FW,MF",22,1998,32.8,28,14,7,10,11,10,25,40.0,15,14,3,11,6,34,31,0,2022
FRA-Ligue 1,2021,Nantes,Renaud Emond,BEL,"FW,MF",29,1991,2.1,1,0,0,1,0,0,4,0.0,4,2,1,1,0,1,1,0,2022
FRA-Ligue 1,2021,Nantes,Roli Pereira de Sa,FRA,MF,24,1996,6.4,12,4,3,5,4,3,20,15.0,17,6,0,6,6,18,3,0,2022
FRA-Ligue 1,2021,Nantes,Samuel Moutoussamy,COD,MF,24,1996,16.8,48,32,20,20,8,23,62,37.1,39,14,2,12,17,65,16,0,2022
FRA-Ligue 1,2021,Nantes,Sébastien Corchia,FRA,DF,30,1990,14.7,33,20,17,11,5,24,42,57.1,18,24,3,21,13,46,36,0,2022
FRA-Ligue 1,2021,Nantes,Willem Geubbels,FRA,"FW,MF",19,2001,6.0,8,5,4,2,2,5,12,41.7,7,5,0,5,6,14,5,0,2022
FRA-Ligue 1,2021,Nantes,Wylan Cyprien,FRA,MF,26,1995,16.6,33,17,12,18,3,13,32,40.6,19,16,6,10,10,43,14,2,2022
FRA-Ligue 1,2021,Nantes,Yannis M'Bemba,FRA,"DF,FW",20,2001,0.1,0,0,0,0,0,0,0,,0,0,0,0,0,0,1,0,2022
FRA-Ligue 1,2021,Nice,Alexis Claude-Maurice,FRA,MF,23,1998,2.3,2,0,1,0,1,1,4,25.0,3,7,0,7,3,5,1,0,2022
FRA-Ligue 1,2021,Nice,Amine Gouiri,FRA,"FW,MF",21,2000,30.6,22,13,2,13,7,10,32,31.3,22,22,5,17,11,33,17,1,2022
FRA-Ligue 1,2021,Nice,Andy Delort,ALG,FW,29,1991,27.2,15,9,3,5,7,7,12,58.3,5,13,4,9,9,24,14,0,2022
FRA-Ligue 1,2021,Nice,Bilal Brahimi,ALG,MF,21,2000,4.2,1,1,0,1,0,0,2,0.0,2,1,0,1,2,3,1,0,2022
FRA-Ligue 1,2021,Nice,Calvin Stengs,NED,MF,22,1998,11.9,16,7,6,9,1,7,20,35.0,13,10,0,10,8,24,6,0,2022
FRA-Ligue 1,2021,Nice,Dan Ndoye,SUI,"FW,MF",20,2000,2.3,0,0,0,0,0,0,2,0.0,2,4,0,4,0,0,0,0,2022
FRA-Ligue 1,2021,Nice,Danilo Barbosa,BRA,DF,25,1996,1.0,0,0,0,0,0,0,0,,0,1,1,0,2,2,10,0,2022
FRA-Ligue 1,2021,Nice,Dante,BRA,DF,37,1983,31.9,42,29,30,12,0,23,33,69.7,10,43,27,16,49,91,96,1,2022
FRA-Ligue 1,2021,Nice,Evann Guessand,FRA,FW,20,2001,4.9,9,8,2,5,2,3,8,37.5,5,4,0,4,0,9,1,0,2022
FRA-Ligue 1,2021,Nice,Flavius Daniliuc,AUT,DF,20,2001,14.4,46,31,26,17,3,34,43,79.1,9,13,7,6,14,60,34,1,2022
FRA-Ligue 1,2021,Nice,Hassane Kamara,CIV,"MF,DF",27,1994,6.0,13,10,4,6,3,5,8,62.5,3,10,2,8,9,22,4,0,2022
FRA-Ligue 1,2021,Nice,Hicham Boudaoui,ALG,MF,21,1999,18.0,31,18,15,10,6,13,36,36.1,23,17,4,13,18,49,15,0,2022
FRA-Ligue 1,2021,Nice,Jean-Clair Todibo,FRA,DF,21,1999,34.6,59,37,43,15,1,39,60,65.0,21,45,21,24,51,110,130,2,2022
FRA-Ligue 1,2021,Nice,Jordan Amavi,FRA,DF,27,1994,4.6,16,10,8,7,1,10,17,58.8,7,3,1,2,15,31,7,0,2022
FRA-Ligue 1,2021,Nice,Jordan Lotomba,SUI,DF,22,1998,19.8,33,17,21,9,3,16,30,53.3,14,17,4,13,12,45,28,0,2022
FRA-Ligue 1,2021,Nice,Justin Kluivert,NED,MF,22,1999,20.8,19,9,6,12,1,5,21,23.8,16,13,1,12,14,33,6,0,2022
FRA-Ligue 1,2021,Nice,Kasper Dolberg,DEN,FW,23,1997,16.6,9,4,4,3,2,3,9,33.3,6,15,1,14,6,15,17,0,2022
FRA-Ligue 1,2021,Nice,Khéphren Thuram,FRA,MF,20,2001,21.1,33,19,11,18,4,17,35,48.6,18,31,11,20,28,61,19,0,2022
FRA-Ligue 1,2021,Nice,Lucas Da Cunha,FRA,MF,20,2001,4.4,13,7,2,7,4,6,11,54.5,5,2,0,2,1,14,2,0,2022
FRA-Ligue 1,2021,Nice,Marcin Bułka,POL,GK,21,1999,1.0,0,0,0,0,0,0,0,,0,0,0,0,0,0,0,0,2022
FRA-Ligue 1,2021,Nice,Mario Lemina,GAB,MF,27,1993,21.9,62,35,25,33,4,28,38,73.7,10,32,9,23,48,110,37,0,2022
FRA-Ligue 1,2021,Nice,Melvin Bard,FRA,DF,20,2000,28.8,59,37,38,17,4,41,63,65.1,22,33,10,23,51,110,56,0,2022
FRA-Ligue 1,2021,Nice,Morgan Schneiderlin,FRA,MF,31,1989,7.2,21,12,9,11,1,6,13,46.2,7,8,2,6,20,41,18,0,2022
FRA-Ligue 1,2021,Nice,Myziane Maolida,FRA,MF,22,1999,0.4,1,0,0,1,0,0,0,,0,1,0,1,0,1,0,0,2022
FRA-Ligue 1,2021,Nice,Pablo Rosario,NED,MF,24,1997,30.3,59,37,18,32,9,26,66,39.4,40,33,7,26,38,97,43,0,2022
FRA-Ligue 1,2021,Nice,Walter Benítez,ARG,GK,28,1993,37.0,0,0,0,0,0,0,2,0.0,2,1,0,1,0,0,12,2,2022
FRA-Ligue 1,2021,Nice,Youcef Atal,ALG,DF,25,1996,12.7,29,19,17,10,2,14,25,56.0,11,13,2,11,32,61,21,0,2022
FRA-Ligue 1,2021,Paris S-G,Abdou Diallo,SEN,DF,25,1996,9.7,22,14,10,9,3,8,14,57.1,6,6,2,4,10,32,19,1,2022
FRA-Ligue 1,2021,Paris S-G,Achraf Hakimi,MAR,DF,22,1998,27.5,74,51,38,27,9,40,72,55.6,32,26,5,21,28,102,23,2,2022
FRA-Ligue 1,2021,Paris S-G,Alexandre Letellier,FRA,GK,30,1990,0.1,0,0,0,0,0,0,0,,0,0,0,0,0,0,0,0,2022
FRA-Ligue 1,2021,Paris S-G,Ander Herrera,ESP,MF,31,1989,12.1,29,17,7,16,6,14,39,35.9,25,22,8,14,14,43,8,0,2022
FRA-Ligue 1,2021,Paris S-G,Arnaud Kalimuendo,FRA,FW,19,2002,0.1,0,0,0,0,0,0,0,,0,0,0,0,0,0,0,0,2022
FRA-Ligue 1,2021,Paris S-G,Colin Dagba,FRA,DF,22,1998,1.8,4,2,2,2,0,3,6,50.0,3,4,2,2,2,6,1,0,2022
FRA-Ligue 1,2021,Paris S-G,Danilo Pereira,POR,MF,29,1991,22.6,33,17,10,20,3,14,28,50.0,14,19,10,9,37,70,29,1,2022
FRA-Ligue 1,2021,Paris S-G,Djeidi Gassama,FRA,FW,17,2003,0.0,0,0,0,0,0,0,0,,0,1,1,0,0,0,0,0,2022
FRA-Ligue 1,2021,Paris S-G,Edouard Michut,FRA,MF,18,2003,0.8,0,0,0,0,0,0,2,0.0,2,2,0,2,1,1,2,0,2022
FRA-Ligue 1,2021,Paris S-G,El Chadaille Bitshiabu,FRA,DF,16,2005,0.1,0,0,0,0,0,0,0,,0,0,0,0,0,0,2,0,2022
FRA-Ligue 1,2021,Paris S-G,Georginio Wijnaldum,NED,MF,30,1990,18.4,15,9,2,12,1,11,19,57.9,8,13,3,10,9,24,7,0,2022
FRA-Ligue 1,2021,Paris S-G,Gianluigi Donnarumma,ITA,GK,22,1999,17.0,0,0,0,0,0,0,0,,0,0,0,0,0,0,9,2,2022
FRA-Ligue 1,2021,Paris S-G,Idrissa Gana Gueye,SEN,MF,31,1989,18.2,60,36,24,24,12,18,44,40.9,26,23,4,19,24,84,13,0,2022
FRA-Ligue 1,2021,Paris S-G,Ismaël Gharbi,ESP,FW,17,2004,0.0,0,0,0,0,0,0,0,,0,0,0,0,0,0,0,0,2022
FRA-Ligue 1,2021,Paris S-G,Juan Bernat,ESP,"DF,MF",28,1993,10.6,24,14,10,10,4,13,18,72.2,5,8,0,8,8,32,16,0,2022
FRA-Ligue 1,2021,Paris S-G,Julian Draxler,GER,"FW,MF",27,1993,6.1,3,2,0,3,0,0,4,0.0,4,3,0,3,5,8,3,0,2022
FRA-Ligue 1,2021,Paris S-G,Junior Dina Ebimbe,FRA,MF,20,2000,3.5,9,4,3,4,2,2,3,66.7,1,5,3,2,2,11,1,0,2022
FRA-Ligue 1,2021,Paris S-G,Keylor Navas,CRC,GK,34,1986,20.6,0,0,0,0,0,0,0,,0,0,0,0,0,0,5,1,2022
FRA-Ligue 1,2021,Paris S-G,Kylian Mbappé,FRA,FW,22,1998,33.6,11,8,1,4,6,7,13,53.8,6,6,0,6,5,16,13,0,2022
FRA-Ligue 1,2021,Paris S-G,Leandro Paredes,ARG,MF,27,1994,9.3,23,13,9,11,3,12,24,50.0,12,10,6,4,10,33,5,2,2022
FRA-Ligue 1,2021,Paris S-G,Lionel Messi,ARG,"FW,MF",34,1987,23.9,10,3,1,5,4,3,13,23.1,10,5,0,5,4,14,0,0,2022
FRA-Ligue 1,2021,Paris S-G,Marco Verratti,ITA,MF,28,1992,21.5,60,40,16,30,14,32,64,50.0,32,36,10,26,18,78,14,2,2022
FRA-Ligue 1,2021,Paris S-G,Marquinhos,BRA,DF,27,1994,31.8,37,14,25,11,1,20,35,57.1,15,35,19,16,16,53,102,0,2022
FRA-Ligue 1,2021,Paris S-G,Mauro Icardi,ARG,FW,28,1993,11.4,5,3,1,3,1,3,7,42.9,4,3,0,3,5,10,12,0,2022
FRA-Ligue 1,2021,Paris S-G,Nathan Bitu Mazala,FRA,DF,18,2002,0.1,0,0,0,0,0,0,0,,0,1,0,1,0,0,0,0,2022
FRA-Ligue 1,2021,Paris S-G,Neymar,BRA,"FW,MF",29,1992,20.6,29,19,5,12,12,12,36,33.3,24,9,1,8,4,33,2,1,2022
FRA-Ligue 1,2021,Paris S-G,Nuno Mendes,POR,DF,19,2002,18.4,48,29,23,18,7,25,47,53.2,22,27,5,22,21,69,17,1,2022
FRA-Ligue 1,2021,Paris S-G,Pablo Sarabia,ESP,FW,29,1992,0.2,0,0,0,0,0,0,1,0.0,1,0,0,0,0,0,0,0,2022
FRA-Ligue 1,2021,Paris S-G,Presnel Kimpembe,FRA,DF,25,1995,28.6,34,19,18,15,1,14,23,60.9,9,20,14,6,38,72,73,1,2022
FRA-Ligue 1,2021,Paris S-G,Rafinha,BRA,"FW,MF",28,1993,2.4,14,8,3,9,2,7,11,63.6,4,3,0,3,4,18,0,0,2022
FRA-Ligue 1,2021,Paris S-G,Sekou Yansané,GUI,FW,18,2003,0.2,0,0,0,0,0,0,1,0.0,1,0,0,0,0,0,1,0,2022
FRA-Ligue 1,2021,Paris S-G,Sergio Ramos,ESP,DF,35,1986,8.9,12,5,6,6,0,8,15,53.3,7,4,2,2,8,20,27,0,2022
FRA-Ligue 1,2021,Paris S-G,Sergio Rico,ESP,GK,27,1993,0.3,0,0,0,0,0,0,0,,0,0,0,0,0,0,1,0,2022
FRA-Ligue 1,2021,Paris S-G,Thilo Kehrer,GER,DF,24,1996,16.8,21,14,9,11,1,9,21,42.9,12,19,11,8,24,45,29,0,2022
FRA-Ligue 1,2021,Paris S-G,Xavi Simons,NED,"MF,FW",18,2003,1.5,1,1,0,1,0,1,2,50.0,1,3,0,3,0,1,0,0,2022
FRA-Ligue 1,2021,Paris S-G,Ángel Di María,ARG,FW,33,1988,18.3,29,18,6,13,10,14,37,37.8,23,17,0,17,6,35,3,0,2022
FRA-Ligue 1,2021,Reims,Alexis Flips,FRA,"MF,DF",21,2000,11.7,37,21,21,9,7,22,45,48.9,23,21,0,21,24,61,17,0,2022
FRA-Ligue 1,2021,Reims,Anastasios Donis,GRE,"FW,MF",24,1996,4.1,8,7,4,2,2,2,6,33.3,4,3,0,3,0,8,1,0,2022
FRA-Ligue 1,2021,Reims,Andrew Gravillon,GLP,DF,23,1998,23.7,32,24,19,13,0,17,27,63.0,10,25,15,10,33,65,83,1,2022
FRA-Ligue 1,2021,Reims,Arber Zeneli,KVX,FW,26,1995,4.5,1,0,0,0,1,1,5,20.0,4,0,0,0,1,2,1,0,2022
FRA-Ligue 1,2021,Reims,Azor Matusiwa,NED,MF,23,1998,27.4,58,32,28,26,4,26,55,47.3,29,49,19,30,62,120,43,0,2022
FRA-Ligue 1,2021,Reims,Banzouzi Locko,FRA,"MF,DF",19,2002,11.2,28,19,13,11,4,14,24,58.3,10,20,8,12,14,42,15,0,2022
FRA-Ligue 1,2021,Reims,Dion Lopy,SEN,MF,19,2002,18.2,53,29,22,24,7,21,53,39.6,32,20,4,16,22,75,17,0,2022
FRA-Ligue 1,2021,Reims,El Bilal Touré,MLI,FW,19,2001,13.3,13,6,4,6,3,2,7,28.6,5,10,3,7,6,19,19,0,2022
FRA-Ligue 1,2021,Reims,Fodé Doucouré,MLI,"DF,FW",20,2001,1.7,12,9,9,3,0,9,11,81.8,2,1,0,1,4,16,6,0,2022
FRA-Ligue 1,2021,Reims,Fraser Hornby,SCO,"FW,MF",21,1999,3.9,3,1,1,2,0,0,2,0.0,2,3,0,3,4,7,5,0,2022
FRA-Ligue 1,2021,Reims,Ghislain Konan,CIV,DF,25,1995,26.9,35,19,19,15,1,16,30,53.3,14,35,8,27,28,63,45,0,2022
FRA-Ligue 1,2021,Reims,Hugo Ekitike,FRA,FW,19,2002,14.1,18,10,8,6,4,4,11,36.4,7,9,2,7,6,24,15,0,2022
FRA-Ligue 1,2021,Reims,Ibrahim Diakité,GUI,MF,17,2003,0.0,0,0,0,0,0,0,1,0.0,1,0,0,0,0,0,0,0,2022
FRA-Ligue 1,2021,Reims,Ilan Kebbal,ALG,"MF,FW",23,1998,19.7,31,15,13,10,8,12,44,27.3,32,16,0,16,13,44,3,0,2022
FRA-Ligue 1,2021,Reims,Jens Cajuste,SWE,"MF,FW",21,1999,4.0,10,6,6,2,2,6,17,35.3,11,7,2,5,5,15,6,0,2022
FRA-Ligue 1,2021,Reims,Kaj Sierhuis,NED,FW,23,1998,0.9,1,1,1,0,0,1,3,33.3,2,0,0,0,0,1,1,0,2022
FRA-Ligue 1,2021,Reims,Kamory Doumbia,MLI,"MF,FW",18,2003,3.9,8,2,2,5,1,5,13,38.5,8,9,3,6,3,11,3,0,2022
FRA-Ligue 1,2021,Reims,Marshall Munetsi,ZIM,"MF,DF",25,1996,20.9,34,17,21,11,2,17,39,43.6,22,39,13,26,43,77,72,2,2022
FRA-Ligue 1,2021,Reims,Martin Adeline,FRA,"MF,FW",17,2003,3.9,15,11,5,8,2,8,16,50.0,8,0,0,0,11,26,6,0,2022
FRA-Ligue 1,2021,Reims,Mathieu Cafaro,FRA,"MF,FW",24,1997,2.1,4,2,3,1,0,0,7,0.0,7,2,0,2,3,7,1,0,2022
FRA-Ligue 1,2021,Reims,Maxime Busi,BEL,DF,21,1999,14.4,26,15,20,5,1,19,36,52.8,17,19,5,14,17,43,28,0,2022
FRA-Ligue 1,2021,Reims,Mitchell van Bergen,NED,"FW,MF",21,1999,10.9,8,5,7,0,1,6,15,40.0,9,9,0,9,4,12,7,0,2022
FRA-Ligue 1,2021,Reims,Moreto Cassamã,GNB,MF,23,1998,8.9,12,6,7,4,1,3,19,15.8,16,10,5,5,9,21,5,0,2022
FRA-Ligue 1,2021,Reims,Moussa Doumbia,MLI,FW,26,1994,1.0,0,0,0,0,0,0,1,0.0,1,0,0,0,0,0,0,0,2022
FRA-Ligue 1,2021,Reims,Moustapha Mbow,SEN,DF,21,2000,1.0,6,6,3,2,1,3,3,100.0,0,0,0,0,1,7,6,0,2022
FRA-Ligue 1,2021,Reims,Nathanael Mbuku,FRA,"FW,MF",19,2002,15.8,14,13,4,7,3,2,8,25.0,6,14,0,14,11,25,4,0,2022
FRA-Ligue 1,2021,Reims,Philippe Koffi,CIV,FW,19,2002,4.2,4,0,0,3,1,0,2,0.0,2,2,1,1,3,7,3,0,2022
FRA-Ligue 1,2021,Reims,Predrag Rajković,SRB,GK,25,1995,38.0,2,2,2,0,0,2,3,66.7,1,1,0,1,1,3,21,1,2022
FRA-Ligue 1,2021,Reims,Sambou Sissoko,FRA,"MF,DF",22,1999,2.0,12,6,6,4,2,6,8,75.0,2,2,0,2,2,14,7,0,2022
FRA-Ligue 1,2021,Reims,Samuel Koeberlé,FRA,FW,16,2004,0.0,0,0,0,0,0,0,0,,0,0,0,0,0,0,0,0,2022
FRA-Ligue 1,2021,Reims,Thomas Foket,BEL,"DF,FW",26,1994,24.8,28,19,12,13,3,18,40,45.0,22,26,4,22,33,61,35,0,2022
FRA-Ligue 1,2021,Reims,Valon Berisha,KVX,"MF,FW",28,1993,5.1,10,7,2,5,3,2,10,20.0,8,9,0,9,4,14,3,0,2022
FRA-Ligue 1,2021,Reims,Wout Faes,BEL,DF,23,1998,37.0,40,24,30,9,1,25,33,75.8,8,47,37,10,53,93,169,2,2022
FRA-Ligue 1,2021,Reims,Xavier Chavalerin,FRA,MF,30,1991,2.4,4,4,2,1,1,1,3,33.3,2,2,0,2,5,9,2,1,2022
FRA-Ligue 1,2021,Reims,Yunis Abdelhamid,MAR,DF,33,1987,33.1,48,27,34,14,0,16,32,50.0,16,50,25,25,68,116,104,0,2022
FRA-Ligue 1,2021,Rennes,Adrien Truffert,FRA,DF,19,2001,18.2,29,21,17,9,3,11,24,45.8,13,25,5,20,19,48,30,0,2022
FRA-Ligue 1,2021,Rennes,Alfred Gomis,SEN,GK,27,1993,25.0,1,0,1,0,0,1,2,50.0,1,0,0,0,1,2,8,2,2022
FRA-Ligue 1,2021,Rennes,Andy Diouf,FRA,MF,18,2003,0.2,1,1,1,0,0,1,1,100.0,0,1,0,1,0,1,0,0,2022
FRA-Ligue 1,2021,Rennes,Baptiste Santamaria,FRA,"MF,DF",26,1995,28.0,52,27,15,31,6,24,44,54.5,20,33,12,21,33,85,42,0,2022
FRA-Ligue 1,2021,Rennes,Benjamin Bourigeaud,FRA,"FW,MF",27,1994,35.5,46,24,16,18,12,24,67,35.8,43,33,3,30,30,76,44,0,2022
FRA-Ligue 1,2021,Rennes,Birger Meling,NOR,DF,26,1994,20.3,43,27,25,11,7,23,31,74.2,8,23,7,16,22,65,40,0,2022
FRA-Ligue 1,2021,Rennes,Chimuanya Ugochukwu,FRA,MF,17,2004,4.5,13,9,5,5,3,9,19,47.4,10,7,2,5,4,17,2,0,2022
FRA-Ligue 1,2021,Rennes,Doğan Alemdar,TUR,GK,18,2002,12.0,0,0,0,0,0,0,0,,0,0,0,0,0,0,9,1,2022
FRA-Ligue 1,2021,Rennes,Eduardo Camavinga,FRA,MF,18,2002,1.6,4,1,2,1,1,2,5,40.0,3,1,1,0,1,5,3,0,2022
FRA-Ligue 1,2021,Rennes,Flavien Tait,FRA,MF,28,1993,23.6,28,19,13,9,6,13,40,32.5,27,15,4,11,19,47,13,1,2022
FRA-Ligue 1,2021,Rennes,Gaëtan Laborde,FRA,FW,27,1994,30.3,19,7,5,8,6,3,22,13.6,19,29,3,26,8,27,16,0,2022
FRA-Ligue 1,2021,Rennes,Hamari Traoré,MLI,DF,29,1992,32.1,63,36,25,26,12,41,59,69.5,18,29,8,21,37,100,81,1,2022
FRA-Ligue 1,2021,Rennes,Jeanöel Belocian,FRA,DF,16,2005,0.1,0,0,0,0,0,0,0,,0,0,0,0,0,0,0,0,2022
FRA-Ligue 1,2021,Rennes,Jeremy Doku,BEL,"FW,MF",19,2002,5.2,10,5,3,5,2,3,6,50.0,3,4,0,4,3,13,0,0,2022
FRA-Ligue 1,2021,Rennes,Jonas Martin,FRA,MF,31,1990,23.4,35,20,12,21,2,19,53,35.8,34,17,3,14,22,57,28,1,2022
FRA-Ligue 1,2021,Rennes,Kamaldeen Sulemana,GHA,"MF,FW",19,2002,11.3,23,12,7,9,7,10,17,58.8,7,10,1,9,4,27,5,0,2022
FRA-Ligue 1,2021,Rennes,Lorenz Assignon,TOG,DF,21,2000,6.8,15,10,11,3,1,5,9,55.6,4,3,1,2,11,26,19,0,2022
FRA-Ligue 1,2021,Rennes,Loum Tchaouna,FRA,"FW,MF",17,2003,1.0,3,1,1,2,0,1,5,20.0,4,0,0,0,2,5,0,0,2022
FRA-Ligue 1,2021,Rennes,Lovro Majer,CRO,"MF,FW",23,1998,20.4,32,21,9,14,9,11,42,26.2,31,26,2,24,11,43,9,0,2022
FRA-Ligue 1,2021,Rennes,Loïc Bade,FRA,DF,21,2000,10.9,6,5,4,2,0,3,5,60.0,2,12,10,2,12,18,48,0,2022
FRA-Ligue 1,2021,Rennes,Martin Terrier,FRA,"FW,MF",24,1997,30.9,55,33,22,16,17,25,43,58.1,18,29,3,26,18,73,17,0,2022
FRA-Ligue 1,2021,Rennes,Mathys Tel,FRA,"FW,MF",16,2005,0.6,2,1,1,1,0,0,0,,0,0,0,0,1,3,2,0,2022
FRA-Ligue 1,2021,Rennes,Matthis Abline,FRA,FW,18,2003,1.1,0,0,0,0,0,0,0,,0,2,0,2,0,0,1,0,2022
FRA-Ligue 1,2021,Rennes,Nayef Aguerd,MAR,DF,25,1996,30.4,27,18,16,11,0,14,24,58.3,10,24,14,10,24,51,127,1,2022
FRA-Ligue 1,2021,Rennes,Romain Del Castillo,FRA,"MF,FW",25,1996,0.3,2,1,0,1,1,2,2,100.0,0,0,0,0,1,3,0,0,2022
FRA-Ligue 1,2021,Rennes,Romain Salin,FRA,GK,37,1984,1.0,0,0,0,0,0,0,0,,0,0,0,0,0,0,0,0,2022
FRA-Ligue 1,2021,Rennes,Sehrou Guirassy,GUI,FW,25,1996,11.3,4,2,1,2,1,1,7,14.3,6,4,0,4,1,5,8,0,2022
FRA-Ligue 1,2021,Rennes,Warmed Omari,FRA,DF,21,2000,31.1,33,17,22,10,1,15,23,65.2,8,20,13,7,31,64,94,5,2022
FRA-Ligue 1,2021,Saint-Étienne,Abdoulaye Bakayoko,FRA,DF,18,2002,3.4,15,9,13,2,0,8,12,66.7,4,5,4,1,12,27,15,0,2022
FRA-Ligue 1,2021,Saint-Étienne,Adil Aouchiche,FRA,"MF,FW",19,2002,12.0,13,6,5,5,3,5,33,15.2,28,18,1,17,17,30,4,0,2022
FRA-Ligue 1,2021,Saint-Étienne,Aimen Moueffek,FRA,MF,20,2001,4.8,7,4,2,3,2,2,8,25.0,6,3,0,3,2,9,4,0,2022
FRA-Ligue 1,2021,Saint-Étienne,Arnaud Nordin,FRA,"FW,MF",23,1998,20.8,21,11,8,8,5,8,22,36.4,14,19,0,19,6,27,8,0,2022
FRA-Ligue 1,2021,Saint-Étienne,Assane Dioussé,SEN,MF,23,1997,0.3,1,1,1,0,0,1,1,100.0,0,0,0,0,0,1,0,0,2022
FRA-Ligue 1,2021,Saint-Étienne,Bakary Sako,MLI,"FW,MF",33,1988,1.7,0,0,0,0,0,0,1,0.0,1,3,1,2,0,0,0,0,2022
FRA-Ligue 1,2021,Saint-Étienne,Bryan Djile Nokoué,CMR,"DF,MF",19,2002,0.6,3,3,1,2,0,2,2,100.0,0,1,0,1,1,4,2,0,2022
FRA-Ligue 1,2021,Saint-Étienne,Charles Abi,FRA,FW,21,2000,0.5,0,0,0,0,0,0,1,0.0,1,2,0,2,0,0,0,0,2022
FRA-Ligue 1,2021,Saint-Étienne,Denis Bouanga,GAB,"FW,MF",26,1994,27.1,46,25,14,13,19,22,63,34.9,41,30,0,30,8,54,34,1,2022
FRA-Ligue 1,2021,Saint-Étienne,Elhadji Dieye,SEN,"FW,MF",19,2002,0.4,3,2,2,1,0,0,1,0.0,1,2,0,2,1,4,0,0,2022
FRA-Ligue 1,2021,Saint-Étienne,Eliaquim Mangala,FRA,DF,30,1991,13.1,17,12,12,5,0,8,12,66.7,4,11,8,3,17,34,61,1,2022
FRA-Ligue 1,2021,Saint-Étienne,Enzo Crivelli,FRA,"FW,MF",26,1995,1.1,1,0,0,0,1,0,0,,0,0,0,0,0,1,1,0,2022
FRA-Ligue 1,2021,Saint-Étienne,Etienne Green,ENG,GK,21,2000,13.3,1,1,1,0,0,0,0,,0,0,0,0,1,2,9,0,2022
FRA-Ligue 1,2021,Saint-Étienne,Falaye Sacko,MLI,DF,26,1995,7.4,15,10,14,1,0,13,16,81.3,3,11,7,4,4,19,18,2,2022
FRA-Ligue 1,2021,Saint-Étienne,Gabriel Silva,BRA,"DF,MF",30,1991,7.9,12,7,7,2,3,9,13,69.2,4,9,3,6,18,30,13,0,2022
FRA-Ligue 1,2021,Saint-Étienne,Harold Moukoudi,CMR,DF,23,1997,18.5,25,12,17,8,0,14,25,56.0,11,27,14,13,35,60,48,0,2022
FRA-Ligue 1,2021,Saint-Étienne,Jean-Philippe Krasso,CIV,FW,24,1997,5.0,7,5,0,5,2,2,10,20.0,8,7,1,6,0,7,1,0,2022
FRA-Ligue 1,2021,Saint-Étienne,Juan Ignacio Ramírez,URU,FW,24,1997,1.4,2,1,0,1,1,0,0,,0,0,0,0,0,2,0,0,2022
FRA-Ligue 1,2021,Saint-Étienne,Lamine Ghezali,FRA,DF,22,1999,0.0,0,0,0,0,0,0,0,,0,1,0,1,0,0,0,0,2022
FRA-Ligue 1,2021,Saint-Étienne,Lucas Calodat,FRA,DF,19,2002,0.0,0,0,0,0,0,0,0,,0,0,0,0,0,0,0,0,2022
FRA-Ligue 1,2021,Saint-Étienne,Lucas Gourna-Douath,FRA,MF,17,2003,20.0,45,26,22,18,5,21,36,58.3,15,22,3,19,13,58,9,2,2022
FRA-Ligue 1,2021,Saint-Étienne,Mahdi Camara,FRA,"MF,DF",23,1998,34.1,101,57,39,50,12,39,70,55.7,31,44,8,36,57,158,35,1,2022
FRA-Ligue 1,2021,Saint-Étienne,Mathys Saban,FRA,"FW,MF",19,2002,0.8,4,2,2,2,0,1,1,100.0,0,1,0,1,0,4,0,0,2022
FRA-Ligue 1,2021,Saint-Étienne,Maxence Rivera,FRA,FW,19,2002,0.1,0,0,0,0,0,0,0,,0,0,0,0,0,0,0,0,2022
FRA-Ligue 1,2021,Saint-Étienne,Mickael Nade,FRA,DF,22,1999,28.5,57,35,37,18,2,23,38,60.5,15,29,15,14,60,117,84,0,2022
FRA-Ligue 1,2021,Saint-Étienne,Miguel Trauco,PER,"DF,MF",28,1992,12.4,25,18,16,8,1,12,22,54.5,10,13,4,9,23,48,17,0,2022
FRA-Ligue 1,2021,Saint-Étienne,Nelson Sissoko,FRA,DF,24,1997,0.5,2,0,2,0,0,1,1,100.0,0,0,0,0,0,2,2,0,2022
FRA-Ligue 1,2021,Saint-Étienne,Paul Bernardoni,FRA,GK,24,1997,19.0,0,0,0,0,0,0,0,,0,0,0,0,0,0,14,2,2022
FRA-Ligue 1,2021,Saint-Étienne,Romain Hamouma,FRA,"FW,MF",34,1987,9.8,10,7,1,5,4,2,13,15.4,11,8,0,8,4,14,1,0,2022
FRA-Ligue 1,2021,Saint-Étienne,Ryad Boudebouz,ALG,"MF,FW",31,1990,25.0,27,15,11,12,4,12,29,41.4,17,17,2,15,10,37,5,0,2022
FRA-Ligue 1,2021,Saint-Étienne,Sada Thioub,SEN,"DF,MF",26,1995,10.6,13,8,5,8,0,6,14,42.9,8,9,0,9,10,23,8,0,2022
FRA-Ligue 1,2021,Saint-Étienne,Saidou Sow,GUI,DF,19,2002,11.0,28,17,21,6,1,16,21,76.2,5,15,5,10,23,51,34,0,2022
FRA-Ligue 1,2021,Saint-Étienne,Stefan Bajic,FRA,GK,19,2001,5.7,0,0,0,0,0,0,0,,0,0,0,0,0,0,4,0,2022
FRA-Ligue 1,2021,Saint-Étienne,Timothée Kolodziejczak,FRA,DF,29,1991,28.5,43,24,22,14,7,20,36,55.6,16,29,7,22,60,103,72,1,2022
FRA-Ligue 1,2021,Saint-Étienne,Wahbi Khazri,TUN,"FW,MF",30,1991,24.7,33,18,7,17,9,9,34,26.5,25,21,0,21,12,45,7,0,2022
FRA-Ligue 1,2021,Saint-Étienne,Yanis Lhery,FRA,"FW,MF",18,2003,0.8,0,0,0,0,0,0,0,,0,4,0,4,0,0,0,0,2022
FRA-Ligue 1,2021,Saint-Étienne,Yvan Neyou,CMR,MF,24,1997,10.4,29,13,14,12,3,9,27,33.3,18,8,3,5,23,52,13,0,2022
FRA-Ligue 1,2021,Saint-Étienne,Yvann Macon,FRA,DF,22,1998,17.0,41,22,24,14,3,16,42,38.1,26,18,4,14,18,59,27,0,2022
FRA-Ligue 1,2021,Saint-Étienne,Zaydou Youssouf,FRA,MF,22,1999,17.3,48,26,21,25,2,14,34,41.2,20,11,3,8,17,65,13,0,2022
FRA-Ligue 1,2021,Strasbourg,Abdul Majeed Waris,GHA,"FW,MF",29,1991,3.6,5,3,2,3,0,5,10,50.0,5,2,0,2,0,5,1,0,2022
FRA-Ligue 1,2021,Strasbourg,Adrien Thomasson,FRA,MF,27,1993,26.5,64,31,18,27,19,30,93,32.3,63,56,4,52,29,93,16,1,2022
FRA-Ligue 1,2021,Strasbourg,Alexander Djiku,GHA,DF,26,1994,29.9,50,37,33,13,4,18,35,51.4,17,30,13,17,61,111,90,2,2022
FRA-Ligue 1,2021,Strasbourg,Anthony Caci,FRA,DF,24,1997,26.6,65,34,35,24,6,33,55,60.0,22,22,3,19,33,98,49,1,2022
FRA-Ligue 1,2021,Strasbourg,Dimitri Liénard,FRA,"DF,MF",33,1988,22.7,71,43,40,21,10,46,77,59.7,31,12,0,12,21,92,28,0,2022
FRA-Ligue 1,2021,Strasbourg,Dion Moise Sahi,CIV,"FW,MF",19,2001,1.4,0,0,0,0,0,0,0,,0,1,0,1,1,1,1,0,2022
FRA-Ligue 1,2021,Strasbourg,Eiji Kawashima,JPN,GK,38,1983,1.0,0,0,0,0,0,0,0,,0,0,0,0,0,0,0,0,2022
FRA-Ligue 1,2021,Strasbourg,Frederic Guilbert,FRA,DF,26,1994,28.0,69,39,33,24,12,32,62,51.6,30,37,11,26,55,124,39,0,2022
FRA-Ligue 1,2021,Strasbourg,Gerzino Nyamsi,FRA,DF,24,1997,33.2,35,21,24,9,2,20,27,74.1,7,25,16,9,25,60,90,1,2022
FRA-Ligue 1,2021,Strasbourg,Habib Diallo,SEN,FW,26,1995,17.1,9,5,0,8,1,0,8,0.0,8,13,4,9,4,13,11,0,2022
FRA-Ligue 1,2021,Strasbourg,Ibrahima Sissoko,FRA,"MF,DF",23,1997,25.6,47,23,18,20,9,19,46,41.3,27,32,11,21,35,82,31,0,2022
FRA-Ligue 1,2021,Strasbourg,Ismaël Doukouré,FRA,DF,18,2003,0.2,0,0,0,0,0,0,0,,0,0,0,0,0,0,1,0,2022
FRA-Ligue 1,2021,Strasbourg,Jean-Eudes Aholou,CIV,MF,27,1994,11.2,16,9,4,9,3,5,19,26.3,14,8,1,7,19,35,7,0,2022
FRA-Ligue 1,2021,Strasbourg,Jean-Ricner Bellegarde,FRA,MF,23,1998,25.9,51,32,21,21,9,17,41,41.5,24,29,4,25,27,78,19,0,2022
FRA-Ligue 1,2021,Strasbourg,Karol Fila,POL,DF,23,1998,6.2,10,8,5,4,1,4,8,50.0,4,7,2,5,4,14,6,0,2022
FRA-Ligue 1,2021,Strasbourg,Kévin Gameiro,FRA,FW,34,1987,26.5,19,10,5,9,5,6,18,33.3,12,22,1,21,6,25,1,0,2022
FRA-Ligue 1,2021,Strasbourg,Lebo Mothiba,RSA,FW,25,1996,0.0,0,0,0,0,0,0,0,,0,0,0,0,0,0,0,0,2022
FRA-Ligue 1,2021,Strasbourg,Lucas Perrin,FRA,DF,22,1998,27.8,43,32,24,17,2,26,45,57.8,19,28,11,17,42,85,67,0,2022
FRA-Ligue 1,2021,Strasbourg,Ludovic Ajorque,FRA,FW,27,1994,30.4,36,25,5,19,12,7,40,17.5,33,28,3,25,8,44,31,1,2022
FRA-Ligue 1,2021,Strasbourg,Mahame Siby,MLI,DF,25,1996,0.2,0,0,0,0,0,0,0,,0,0,0,0,1,1,2,0,2022
FRA-Ligue 1,2021,Strasbourg,Matz Sels,BEL,GK,29,1992,37.0,1,1,1,0,0,0,0,,0,0,0,0,1,2,22,0,2022
FRA-Ligue 1,2021,Strasbourg,Maxime Le Marchand,FRA,DF,31,1989,9.6,17,8,16,1,0,8,10,80.0,2,9,5,4,14,31,32,0,2022
FRA-Ligue 1,2021,Strasbourg,Mehdi Chahiri,MAR,DF,25,1996,0.2,1,1,1,0,0,1,1,100.0,0,0,0,0,0,1,0,0,2022
FRA-Ligue 1,2021,Strasbourg,Mouhamadou Diarra,SEN,MF,17,2004,1.2,2,1,1,1,0,1,1,100.0,0,0,0,0,0,2,0,0,2022
FRA-Ligue 1,2021,Strasbourg,Nordine Kandil,FRA,"MF,FW",19,2001,1.0,2,1,2,0,0,1,1,100.0,0,1,1,0,0,2,0,0,2022
FRA-Ligue 1,2021,Strasbourg,Sanjin Prcić,BIH,MF,27,1993,24.3,47,28,14,27,6,14,29,48.3,15,18,3,15,47,94,19,0,2022
FRA-Ligue 1,2021,Troyes,Abdu Conté,POR,DF,23,1998,15.0,22,12,16,5,1,12,24,50.0,12,12,2,10,4,26,10,0,2022
FRA-Ligue 1,2021,Troyes,Adil Rami,FRA,DF,35,1985,13.0,10,9,6,4,0,7,8,87.5,1,17,9,8,16,26,43,0,2022
FRA-Ligue 1,2021,Troyes,Brandon Domingues,FRA,"MF,FW",21,2000,2.6,6,2,2,4,0,2,3,66.7,1,3,0,3,3,9,0,0,2022
FRA-Ligue 1,2021,Troyes,Derek Mazou-Sacko,FRA,"FW,DF",16,2004,0.0,1,0,0,0,1,1,1,100.0,0,0,0,0,0,1,1,0,2022
FRA-Ligue 1,2021,Troyes,Dylan Chambost,FRA,"MF,FW",23,1997,8.4,16,11,6,9,1,4,25,16.0,21,9,2,7,8,24,4,0,2022
FRA-Ligue 1,2021,Troyes,Eric N'Jo,FRA,DF,17,2004,1.1,0,0,0,0,0,0,1,0.0,1,1,1,0,2,2,1,0,2022
FRA-Ligue 1,2021,Troyes,Erik Palmer-Brown,USA,DF,24,1997,19.3,37,22,29,8,0,20,26,76.9,6,26,18,8,34,71,87,1,2022
FRA-Ligue 1,2021,Troyes,Florian Tardieu,FRA,MF,29,1992,29.2,58,25,31,21,6,31,71,43.7,40,31,9,22,42,100,38,0,2022
FRA-Ligue 1,2021,Troyes,Gauthier Gallon,FRA,GK,28,1993,31.0,3,0,3,0,0,1,1,100.0,0,0,0,0,2,5,12,1,2022
FRA-Ligue 1,2021,Troyes,Gerson Rodrigues,LUX,"FW,MF",26,1995,9.4,12,9,2,6,4,1,17,5.9,16,8,1,7,0,12,2,0,2022
FRA-Ligue 1,2021,Troyes,Giulian Biancone,FRA,"DF,MF",21,2000,25.5,70,42,44,22,4,40,69,58.0,29,23,8,15,53,123,71,1,2022
FRA-Ligue 1,2021,Troyes,Ike Ugbo,CAN,FW,22,1998,9.0,3,1,0,1,2,0,1,0.0,1,4,1,3,2,5,1,0,2022
FRA-Ligue 1,2021,Troyes,Issa Kaboré,BFA,DF,20,2001,25.0,45,22,22,14,9,20,38,52.6,18,27,2,25,20,65,38,1,2022
FRA-Ligue 1,2021,Troyes,Jessy Moulin,FRA,GK,35,1986,7.0,0,0,0,0,0,0,0,,0,0,0,0,1,1,7,0,2022
FRA-Ligue 1,2021,Troyes,Jimmy Giraudon,FRA,DF,29,1992,18.0,14,6,10,4,0,7,22,31.8,15,24,14,10,37,51,68,1,2022
FRA-Ligue 1,2021,Troyes,Karim Azamoum,FRA,DF,31,1990,4.3,6,5,4,2,0,3,5,60.0,2,4,2,2,1,7,10,0,2022
FRA-Ligue 1,2021,Troyes,Lebo Mothiba,RSA,"FW,MF",25,1996,5.8,8,4,4,3,1,2,5,40.0,3,3,0,3,2,10,0,0,2022
FRA-Ligue 1,2021,Troyes,Levi Lumeka,ENG,"MF,FW",22,1998,0.7,0,0,0,0,0,0,2,0.0,2,0,0,0,0,0,2,0,2022
FRA-Ligue 1,2021,Troyes,Mama Samba Baldé,GNB,"MF,FW",25,1995,19.1,40,28,16,14,10,8,26,30.8,18,32,1,31,5,45,9,0,2022
FRA-Ligue 1,2021,Troyes,Mamadou Camara,FRA,FW,20,2001,0.4,1,1,1,0,0,0,0,,0,0,0,0,0,1,0,0,2022
FRA-Ligue 1,2021,Troyes,Mykola Kukharevych,UKR,FW,20,2001,0.2,0,0,0,0,0,0,0,,0,0,0,0,0,0,0,0,2022
FRA-Ligue 1,2021,Troyes,Nassim Chadli,FRA,"MF,DF",20,2001,1.1,5,3,3,0,2,2,4,50.0,2,1,0,1,0,5,0,0,2022
FRA-Ligue 1,2021,Troyes,Oualid El Hajjam,MAR,DF,30,1991,11.9,22,11,12,6,4,15,23,65.2,8,12,6,6,22,44,28,0,2022
FRA-Ligue 1,2021,Troyes,Patrick Roberts,ENG,MF,24,1997,0.2,0,0,0,0,0,0,0,,0,0,0,0,0,0,0,0,2022
FRA-Ligue 1,2021,Troyes,Philippe Sandler,NED,DF,24,1997,0.8,0,0,0,0,0,0,0,,0,1,1,0,3,3,6,0,2022
FRA-Ligue 1,2021,Troyes,Renaud Ripart,FRA,"MF,FW",28,1993,21.0,38,21,18,15,5,18,50,36.0,32,21,1,20,19,57,21,1,2022
FRA-Ligue 1,2021,Troyes,Rominigue Kouamé,MLI,MF,24,1996,33.0,47,22,24,20,3,19,58,32.8,39,33,5,28,46,93,22,2,2022
FRA-Ligue 1,2021,Troyes,Suk Hyun-jun,KOR,"FW,MF",30,1991,1.7,0,0,0,0,0,0,0,,0,2,0,2,0,0,2,0,2022
FRA-Ligue 1,2021,Troyes,Tanguy Zoukrou,FRA,DF,18,2003,0.9,1,0,1,0,0,1,2,50.0,1,0,0,0,0,1,2,0,2022
FRA-Ligue 1,2021,Troyes,Tristan Dingomé,CMR,"MF,FW",30,1991,12.0,23,11,10,12,1,10,18,55.6,8,7,1,6,9,32,3,0,2022
FRA-Ligue 1,2021,Troyes,Xavier Chavalerin,FRA,MF,30,1991,30.2,49,26,19,25,5,12,55,21.8,43,32,5,27,39,88,36,0,2022
FRA-Ligue 1,2021,Troyes,Yasser Larouci,FRA,DF,20,2001,3.8,6,5,2,4,0,3,3,100.0,0,1,0,1,7,13,5,0,2022
FRA-Ligue 1,2021,Troyes,Yoann Salmier,GUF,DF,28,1992,29.6,58,33,44,11,3,26,34,76.5,8,30,14,16,40,98,94,0,2022
FRA-Ligue 1,2021,Troyes,Yoann Touzghar,TUN,FW,34,1986,16.2,5,2,1,3,1,1,3,33.3,2,3,1,2,3,8,8,0,2022
FRA-Ligue 1,2021,Troyes,Youssouf Koné,MLI,DF,26,1995,10.9,30,18,21,8,1,19,30,63.3,11,8,3,5,10,40,25,0,2022
FRA-Ligue 1,2022,Ajaccio,Anthony Khelifa,FRA,DF,16,2005,0.1,0,0,0,0,0,0,0,,0,0,0,0,0,0,0,0,2023
FRA-Ligue 1,2022,Ajaccio,Ben Hamed Touré,CIV,FW,18,2003,2.3,4,4,2,2,0,1,5,20.0,4,2,0,2,1,5,4,0,2023
FRA-Ligue 1,2022,Ajaccio,Benjamin Leroy,FRA,GK,33,1989,31.1,0,0,0,0,0,0,2,0.0,2,0,0,0,1,1,16,2,2023
FRA-Ligue 1,2022,Ajaccio,Bevic Moussiti-Oko,CGO,FW,27,1995,7.8,3,1,1,1,1,1,2,50.0,1,5,3,2,2,5,8,0,2023
FRA-Ligue 1,2022,Ajaccio,Clément Vidal,FRA,"DF,MF",22,2000,21.1,25,15,14,11,0,18,38,47.4,20,27,16,11,27,52,73,1,2023
FRA-Ligue 1,2022,Ajaccio,Cyrille Bayala,BFA,MF,26,1996,22.3,53,37,16,20,17,23,47,48.9,24,20,3,17,25,78,21,0,2023
FRA-Ligue 1,2022,Ajaccio,Cédric Avinel,GLP,DF,35,1986,19.9,13,7,8,5,0,8,12,66.7,4,20,13,7,15,28,91,1,2023
FRA-Ligue 1,2022,Ajaccio,Fernand Mayembo,CGO,DF,26,1996,7.9,8,5,6,2,0,4,9,44.4,5,2,0,2,11,19,36,0,2023
FRA-Ligue 1,2022,Ajaccio,Florian Chabrolle,FRA,MF,24,1998,3.7,6,4,1,5,0,2,4,50.0,2,3,0,3,7,13,2,0,2023
FRA-Ligue 1,2022,Ajaccio,François-Joseph Sollacaro,FRA,GK,28,1994,6.0,0,0,0,0,0,0,0,,0,0,0,0,0,0,2,2,2023
FRA-Ligue 1,2022,Ajaccio,Ghjuvanni Quilichini,FRA,GK,19,2002,0.9,0,0,0,0,0,0,0,,0,0,0,0,0,0,1,0,2023
FRA-Ligue 1,2022,Ajaccio,Ismael Diallo,CIV,DF,25,1997,24.2,46,33,35,9,2,35,63,55.6,28,26,12,14,30,76,46,1,2023
FRA-Ligue 1,2022,Ajaccio,Ivane Chegra,FRA,"MF,FW",18,2004,2.1,8,3,6,1,1,4,11,36.4,7,0,0,0,1,9,0,0,2023
FRA-Ligue 1,2022,Ajaccio,Kevin Spadanuda,SUI,"MF,FW",25,1997,11.8,29,18,15,9,5,12,33,36.4,21,18,0,18,11,40,5,0,2023
FRA-Ligue 1,2022,Ajaccio,Kouamé Botué,BFA,"FW,MF",19,2002,2.5,4,2,2,1,1,0,2,0.0,2,1,0,1,0,4,1,0,2023
FRA-Ligue 1,2022,Ajaccio,Mathieu Coutadeur,FRA,MF,36,1986,21.6,23,13,13,10,0,8,28,28.6,20,19,3,16,19,42,21,0,2023
FRA-Ligue 1,2022,Ajaccio,Mehdi Puch Herrantz,FRA,MF,18,2004,0.5,2,2,0,1,1,1,2,50.0,1,1,0,1,3,5,0,0,2023
FRA-Ligue 1,2022,Ajaccio,Mickaël Alphonse,GLP,DF,33,1989,15.1,35,23,20,11,4,20,33,60.6,13,17,5,12,35,70,44,1,2023
FRA-Ligue 1,2022,Ajaccio,Mickaël Barreto,FRA,MF,31,1991,14.7,32,20,12,17,3,8,45,17.8,37,17,0,17,18,50,11,0,2023
FRA-Ligue 1,2022,Ajaccio,Mohamed Youssouf,COM,DF,34,1988,27.3,72,44,41,24,7,38,61,62.3,23,32,8,24,65,137,70,0,2023
FRA-Ligue 1,2022,Ajaccio,Mounaim El Idrissy,FRA,FW,23,1999,27.7,32,19,5,20,7,10,36,27.8,26,22,0,22,13,45,20,0,2023
FRA-Ligue 1,2022,Ajaccio,Moussa Djitte,SEN,FW,22,1999,1.5,1,0,0,0,1,1,2,50.0,1,0,0,0,0,1,1,0,2023
FRA-Ligue 1,2022,Ajaccio,Moussa Soumano,FRA,FW,17,2005,5.5,2,2,0,1,1,0,6,0.0,6,2,0,2,0,2,0,0,2023
FRA-Ligue 1,2022,Ajaccio,Oumar Gonzalez,CMR,DF,24,1998,28.6,51,28,34,13,4,23,37,62.2,14,32,11,21,52,103,82,0,2023
FRA-Ligue 1,2022,Ajaccio,Paolo Lebas,POR,MF,19,2003,0.6,0,0,0,0,0,0,0,,0,0,0,0,0,0,0,0,2023
FRA-Ligue 1,2022,Ajaccio,Qazim Laçi,ALB,MF,26,1996,2.4,6,3,2,3,1,4,9,44.4,5,5,0,5,2,8,3,0,2023
FRA-Ligue 1,2022,Ajaccio,Riad Nouri,FRA,"MF,FW",37,1985,18.8,21,12,7,10,4,12,29,41.4,17,8,1,7,15,36,11,0,2023
FRA-Ligue 1,2022,Ajaccio,Romain Hamouma,FRA,"FW,MF",35,1987,12.0,8,3,3,3,2,3,6,50.0,3,8,0,8,2,10,2,0,2023
FRA-Ligue 1,2022,Ajaccio,Ruan Levine,BRA,"MF,FW",23,1999,0.3,2,2,1,1,0,0,0,,0,1,0,1,2,4,0,0,2023
FRA-Ligue 1,2022,Ajaccio,Thomas Mangani,FRA,MF,35,1987,14.8,32,17,14,15,3,18,47,38.3,29,22,3,19,24,56,22,1,2023
FRA-Ligue 1,2022,Ajaccio,Tony Strata,FRA,"MF,DF",17,2004,1.5,4,3,4,0,0,4,5,80.0,1,2,0,2,1,5,7,0,2023
FRA-Ligue 1,2022,Ajaccio,Vincent Marchetti,FRA,MF,25,1997,27.2,55,26,29,19,7,25,68,36.8,43,23,3,20,19,74,31,0,2023
FRA-Ligue 1,2022,Ajaccio,Yanis Cimignani,FRA,"MF,DF",20,2002,3.1,11,5,3,7,1,4,5,80.0,1,5,1,4,2,13,2,0,2023
FRA-Ligue 1,2022,Ajaccio,Yoann Touzghar,TUN,FW,35,1986,5.0,3,2,0,2,1,0,1,0.0,1,0,0,0,0,3,1,0,2023
FRA-Ligue 1,2022,Ajaccio,Youcef Belaïli,ALG,"MF,FW",30,1992,12.8,18,10,3,9,6,8,20,40.0,12,10,1,9,5,23,4,0,2023
FRA-Ligue 1,2022,Ajaccio,Youssouf Koné,MLI,DF,27,1995,10.2,28,19,24,4,0,18,25,72.0,7,9,2,7,12,40,32,1,2023
FRA-Ligue 1,2022,Angers,Abdallah Sima,SEN,FW,21,2001,20.4,22,13,4,15,3,7,19,36.8,12,8,0,8,4,26,19,0,2023
FRA-Ligue 1,2022,Angers,Abdoulaye Bamba,CIV,DF,32,1990,15.2,22,12,15,5,2,16,19,84.2,3,7,3,4,18,40,38,0,2023
FRA-Ligue 1,2022,Angers,Adrien Hunou,FRA,"MF,FW",28,1994,24.8,39,20,17,16,6,16,45,35.6,29,35,0,35,7,46,7,0,2023
FRA-Ligue 1,2022,Angers,Amine Salama,FRA,"FW,MF",22,2000,13.9,11,9,3,7,1,2,12,16.7,10,8,2,6,10,21,2,0,2023
FRA-Ligue 1,2022,Angers,Antonin Bobichon,FRA,MF,26,1995,0.2,0,0,0,0,0,0,0,,0,1,0,1,0,0,0,0,2023
FRA-Ligue 1,2022,Angers,Azzedine Ounahi,MAR,"MF,FW",22,2000,12.5,19,8,5,13,1,10,20,50.0,10,8,0,8,15,34,4,1,2023
FRA-Ligue 1,2022,Angers,Batista Mendy,FRA,"MF,DF",22,2000,31.8,70,30,34,28,8,37,53,69.8,16,38,6,32,21,91,29,2,2023
FRA-Ligue 1,2022,Angers,Cédric Hountondji,BEN,DF,28,1994,34.4,50,36,31,17,2,19,29,65.5,10,44,22,22,59,109,132,1,2023
FRA-Ligue 1,2022,Angers,Faouzi Ghoulam,ALG,DF,31,1991,5.3,3,3,1,1,1,3,5,60.0,2,4,2,2,4,7,12,1,2023
FRA-Ligue 1,2022,Angers,Farid El Melali,ALG,"DF,FW",25,1997,9.0,21,12,7,12,2,11,22,50.0,11,16,0,16,8,29,7,0,2023
FRA-Ligue 1,2022,Angers,Halid Šabanović,BIH,DF,22,1999,7.1,8,6,7,1,0,6,8,75.0,2,8,2,6,8,16,12,0,2023
FRA-Ligue 1,2022,Angers,Himad Abdelli,ALG,"MF,FW",22,1999,23.7,64,38,22,32,10,31,67,46.3,36,30,1,29,28,92,15,0,2023
FRA-Ligue 1,2022,Angers,Ibrahim Amadou,FRA,"DF,MF",29,1993,4.7,10,7,6,3,1,7,11,63.6,4,7,3,4,10,20,20,0,2023
FRA-Ligue 1,2022,Angers,Ibrahima Niane,SEN,FW,23,1999,12.6,6,2,1,4,1,1,6,16.7,5,8,2,6,1,7,9,0,2023
FRA-Ligue 1,2022,Angers,Ilyes Cheti,ALG,DF,27,1995,2.3,6,4,4,0,2,5,8,62.5,3,5,1,4,4,10,7,0,2023
FRA-Ligue 1,2022,Angers,Jason Mbock,FRA,"MF,FW",22,1999,0.3,0,0,0,0,0,0,0,,0,0,0,0,0,0,0,0,2023
FRA-Ligue 1,2022,Angers,Jean Mattéo Bahoya,FRA,"FW,MF",17,2005,3.0,7,3,1,3,3,4,7,57.1,3,4,0,4,0,7,0,0,2023
FRA-Ligue 1,2022,Angers,Justin-Noël Kalumba,FRA,DF,17,2004,6.1,9,5,5,2,2,5,16,31.3,11,4,1,3,4,13,5,0,2023
FRA-Ligue 1,2022,Angers,Lilian Raolisoa,FRA,"DF,MF",22,2000,1.9,11,9,6,3,2,7,10,70.0,3,3,1,2,3,14,5,0,2023
FRA-Ligue 1,2022,Angers,Lois Diony,FRA,FW,29,1992,5.6,1,0,0,1,0,1,3,33.3,2,2,0,2,0,1,1,0,2023
FRA-Ligue 1,2022,Angers,Marin Jakoliš,CRO,FW,25,1996,0.3,1,1,0,0,1,0,0,,0,0,0,0,0,1,0,0,2023
FRA-Ligue 1,2022,Angers,Miha Blažič,SVN,DF,29,1993,22.0,8,6,8,0,0,7,15,46.7,8,25,19,6,22,30,80,1,2023
FRA-Ligue 1,2022,Angers,Nabil Bentaleb,ALG,MF,27,1994,27.7,74,40,31,35,8,36,61,59.0,25,33,11,22,44,118,29,3,2023
FRA-Ligue 1,2022,Angers,Ousmane Camara,FRA,DF,19,2003,5.8,10,6,5,5,0,5,12,41.7,7,4,2,2,11,21,15,0,2023
FRA-Ligue 1,2022,Angers,Paul Bernardoni,FRA,GK,25,1997,27.0,2,0,2,0,0,2,3,66.7,1,1,0,1,1,3,12,1,2023
FRA-Ligue 1,2022,Angers,Pierrick Capelle,FRA,"MF,DF",35,1987,15.9,36,21,17,15,4,22,55,40.0,33,24,3,21,15,51,24,0,2023
FRA-Ligue 1,2022,Angers,Sada Thioub,SEN,"DF,FW",27,1995,11.8,19,10,9,8,2,8,17,47.1,9,13,0,13,7,26,5,1,2023
FRA-Ligue 1,2022,Angers,Sofiane Boufal,MAR,"FW,MF",28,1993,9.3,14,9,7,4,3,3,14,21.4,11,6,0,6,5,19,1,0,2023
FRA-Ligue 1,2022,Angers,Souleyman Doumbia,CIV,"DF,FW",25,1996,19.9,45,31,31,13,1,17,31,54.8,14,20,3,17,27,72,27,1,2023
FRA-Ligue 1,2022,Angers,Waniss Taibi,FRA,MF,20,2002,2.1,9,5,4,4,1,2,4,50.0,2,1,0,1,2,11,2,0,2023
FRA-Ligue 1,2022,Angers,Yahia Fofana,FRA,GK,21,2000,11.0,0,0,0,0,0,0,0,,0,0,0,0,1,1,4,1,2023
FRA-Ligue 1,2022,Angers,Yan Valery,TUN,DF,23,1999,27.7,54,39,28,20,6,20,37,54.1,17,35,15,20,34,88,82,0,2023
FRA-Ligue 1,2022,Angers,Zinédine Ould Khaled,FRA,"MF,FW",22,2000,0.6,1,1,0,1,0,0,1,0.0,1,0,0,0,2,3,0,0,2023
FRA-Ligue 1,2022,Auxerre,Akim Zedadka,ALG,DF,27,1995,17.8,35,21,21,10,4,18,32,56.3,14,17,3,14,23,58,51,1,2023
FRA-Ligue 1,2022,Auxerre,Alexandre Coeff,FRA,DF,30,1992,6.5,10,5,6,4,0,4,9,44.4,5,9,4,5,8,18,35,1,2023
FRA-Ligue 1,2022,Auxerre,Benoît Costil,FRA,GK,35,1987,19.0,2,0,2,0,0,2,4,50.0,2,0,0,0,0,2,5,0,2023
FRA-Ligue 1,2022,Auxerre,Birama Touré,MLI,MF,30,1992,37.8,80,47,35,35,10,34,93,36.6,59,54,9,45,67,147,49,0,2023
FRA-Ligue 1,2022,Auxerre,Brayann Pereira,FRA,DF,19,2003,2.0,6,5,5,1,0,1,5,20.0,4,2,2,0,2,8,8,1,2023
FRA-Ligue 1,2022,Auxerre,Donovan Léon,GUF,GK,29,1992,2.0,0,0,0,0,0,0,0,,0,0,0,0,0,0,1,0,2023
FRA-Ligue 1,2022,Auxerre,Dénys Bain,FRA,DF,29,1993,1.4,4,3,3,1,0,1,2,50.0,1,2,1,1,2,6,4,0,2023
FRA-Ligue 1,2022,Auxerre,Gauthier Hein,FRA,"MF,FW",25,1996,20.8,27,20,13,11,3,18,48,37.5,30,10,0,10,6,33,10,0,2023
FRA-Ligue 1,2022,Auxerre,Gaëtan Charbonnier,FRA,"FW,MF",33,1988,2.8,2,1,0,2,0,0,4,0.0,4,2,0,2,0,2,5,0,2023
FRA-Ligue 1,2022,Auxerre,Gaëtan Perrin,FRA,"MF,FW",26,1996,15.5,17,8,5,6,6,8,30,26.7,22,15,0,15,10,27,9,0,2023
FRA-Ligue 1,2022,Auxerre,Gideon Mensah,GHA,DF,24,1998,25.1,80,44,43,32,5,44,77,57.1,33,33,10,23,38,118,41,0,2023
FRA-Ligue 1,2022,Auxerre,Hamza Sakhi,MAR,MF,26,1996,18.4,44,22,22,17,5,22,42,52.4,20,16,1,15,25,69,9,0,2023
FRA-Ligue 1,2022,Auxerre,Han-Noah Massengo,FRA,MF,21,2001,12.4,27,15,10,15,2,7,16,43.8,9,12,3,9,14,41,7,0,2023
FRA-Ligue 1,2022,Auxerre,Ionuț Radu,ROU,GK,25,1997,17.0,0,0,0,0,0,0,0,,0,0,0,0,0,0,3,2,2023
FRA-Ligue 1,2022,Auxerre,Jubal,BRA,DF,28,1993,35.7,41,26,29,11,1,19,38,50.0,19,57,34,23,53,94,193,0,2023
FRA-Ligue 1,2022,Auxerre,Julian Jeanvier,GUI,DF,30,1992,19.6,32,17,24,8,0,13,22,59.1,9,24,17,7,27,59,96,1,2023
FRA-Ligue 1,2022,Auxerre,Kays Ruiz,MAR,MF,19,2002,0.7,1,1,1,0,0,0,1,0.0,1,2,1,1,3,4,0,0,2023
FRA-Ligue 1,2022,Auxerre,Kenji-Van Boto,MAD,DF,26,1996,2.0,3,2,2,0,1,2,4,50.0,2,0,0,0,1,4,3,0,2023
FRA-Ligue 1,2022,Auxerre,Kévin Danois,FRA,MF,18,2004,0.0,1,1,0,1,0,0,0,,0,0,0,0,1,2,0,0,2023
FRA-Ligue 1,2022,Auxerre,Lassine Sinayoko,MLI,"MF,FW",22,1999,17.4,33,15,14,12,7,21,40,52.5,19,12,0,12,18,51,17,0,2023
FRA-Ligue 1,2022,Auxerre,M'Baye Niang,SEN,FW,27,1994,16.5,13,7,1,8,4,3,13,23.1,10,22,1,21,1,14,20,0,2023
FRA-Ligue 1,2022,Auxerre,Mathias Autret,FRA,"MF,FW",31,1991,14.3,22,10,10,10,2,7,16,43.8,9,14,2,12,12,34,13,0,2023
FRA-Ligue 1,2022,Auxerre,Matthis Abline,FRA,"FW,MF",19,2003,9.0,4,2,0,3,1,0,5,0.0,5,6,1,5,1,5,1,0,2023
FRA-Ligue 1,2022,Auxerre,Nuno da Costa,CPV,"FW,MF",31,1991,22.3,45,23,14,23,8,11,46,23.9,35,21,1,20,20,65,15,0,2023
FRA-Ligue 1,2022,Auxerre,Ousmane Camara,GUI,"FW,MF",20,2001,0.3,1,1,0,0,1,0,0,,0,0,0,0,0,1,0,0,2023
FRA-Ligue 1,2022,Auxerre,Paul Joly,FRA,DF,22,2000,9.6,33,21,21,10,2,19,35,54.3,16,13,2,11,24,57,29,2,2023
FRA-Ligue 1,2022,Auxerre,Quentin Bernard,FRA,DF,33,1989,7.0,9,7,4,2,3,7,15,46.7,8,9,1,8,15,24,17,0,2023
FRA-Ligue 1,2022,Auxerre,Rayan Raveloson,MAD,"DF,MF",25,1997,27.0,38,23,21,16,1,23,33,69.7,10,43,12,31,39,77,70,0,2023
FRA-Ligue 1,2022,Auxerre,Rémy Dugimont,FRA,"FW,MF",36,1986,1.3,2,1,0,1,1,1,2,50.0,1,3,0,3,0,2,5,0,2023
FRA-Ligue 1,2022,Auxerre,Siriki Dembélé,CIV,"MF,FW",25,1996,4.1,10,6,4,3,3,4,12,33.3,8,2,0,2,1,11,2,0,2023
FRA-Ligue 1,2022,Auxerre,Souleymane Touré,FRA,DF,19,2003,17.6,29,13,19,9,1,16,20,80.0,4,32,12,20,26,55,56,1,2023
FRA-Ligue 1,2022,Auxerre,Théo Pellenard,FRA,DF,28,1994,1.1,1,0,1,0,0,1,1,100.0,0,3,1,2,2,3,2,0,2023
FRA-Ligue 1,2022,Auxerre,Youssouf M'Changama,COM,MF,31,1990,12.0,22,11,7,12,3,7,13,53.8,6,6,0,6,15,37,6,1,2023
FRA-Ligue 1,2022,Brest,Achraf Dari,MAR,DF,23,1999,14.6,21,14,15,5,1,14,20,70.0,6,16,10,6,19,40,65,2,2023
FRA-Ligue 1,2022,Brest,Alberth Elis,HON,"MF,FW",26,1996,2.9,4,3,1,2,1,1,7,14.3,6,1,0,1,1,5,2,0,2023
FRA-Ligue 1,2022,Brest,Axel Camblan,FRA,"FW,MF",18,2003,0.8,2,2,1,1,0,0,1,0.0,1,0,0,0,0,2,0,0,2023
FRA-Ligue 1,2022,Brest,Banzouzi Locko,FRA,DF,20,2002,3.0,4,3,2,1,1,2,3,66.7,1,4,0,4,2,6,13,0,2023
FRA-Ligue 1,2022,Brest,Brendan Chardonnet,FRA,DF,27,1994,27.7,45,27,27,18,0,20,38,52.6,18,40,19,21,63,108,86,1,2023
FRA-Ligue 1,2022,Brest,Christophe Hérelle,MTQ,DF,29,1992,11.8,10,4,7,2,1,4,13,30.8,9,16,11,5,20,30,48,0,2023
FRA-Ligue 1,2022,Brest,Franck Honorat,FRA,"FW,MF",25,1996,28.2,41,29,20,8,13,19,34,55.9,15,22,2,20,21,62,18,0,2023
FRA-Ligue 1,2022,Brest,Félix Lemaréchal,CIV,MF,18,2003,3.2,5,5,2,1,2,0,3,0.0,3,6,0,6,1,6,2,0,2023
FRA-Ligue 1,2022,Brest,Haris Belkebla,ALG,MF,28,1994,29.5,80,48,35,40,5,44,85,51.8,41,32,6,26,52,132,21,3,2023
FRA-Ligue 1,2022,Brest,Hianga Mananga Mbock,FRA,MF,22,1999,0.2,0,0,0,0,0,0,1,0.0,1,0,0,0,0,0,0,0,2023
FRA-Ligue 1,2022,Brest,Hugo Magnetti,FRA,MF,24,1998,18.8,43,27,18,23,2,23,63,36.5,40,21,1,20,25,68,12,0,2023
FRA-Ligue 1,2022,Brest,Irvin Cardona,FRA,"FW,MF",24,1997,2.6,2,0,1,1,0,0,3,0.0,3,3,0,3,2,4,2,0,2023
FRA-Ligue 1,2022,Brest,Islam Slimani,ALG,FW,34,1988,11.0,5,3,2,2,1,0,3,0.0,3,2,0,2,1,6,11,0,2023
FRA-Ligue 1,2022,Brest,Jean-Kevin Duverne,FRA,DF,25,1997,27.9,72,38,44,24,4,42,73,57.5,31,33,5,28,28,100,65,1,2023
FRA-Ligue 1,2022,Brest,Jere Uronen,FIN,DF,28,1994,3.3,8,5,4,4,0,7,12,58.3,5,6,2,4,7,15,5,0,2023
FRA-Ligue 1,2022,Brest,Joaquín Blázquez,ARG,GK,21,2001,1.0,0,0,0,0,0,0,0,,0,0,0,0,0,0,2,0,2023
FRA-Ligue 1,2022,Brest,Jérémy Le Douaron,FRA,"MF,FW",24,1998,23.0,15,9,5,9,1,3,27,11.1,24,29,2,27,11,26,30,0,2023
FRA-Ligue 1,2022,Brest,Karamoko Dembele,SCO,"FW,MF",19,2003,2.0,2,0,1,1,0,2,2,100.0,0,1,0,1,1,3,0,0,2023
FRA-Ligue 1,2022,Brest,Kenny Lala,FRA,DF,30,1991,15.7,36,19,19,15,2,22,38,57.9,16,15,5,10,21,57,28,0,2023
FRA-Ligue 1,2022,Brest,Lilian Brassier,FRA,DF,22,1999,34.4,42,30,31,8,3,23,32,71.9,9,42,19,23,53,95,132,1,2023
FRA-Ligue 1,2022,Brest,Mahdi Camara,FRA,MF,24,1998,20.2,63,36,18,38,7,25,43,58.1,18,35,4,31,40,103,16,0,2023
FRA-Ligue 1,2022,Brest,Marco Bizot,NED,GK,31,1991,37.0,0,0,0,0,0,0,1,0.0,1,1,0,1,0,0,24,4,2023
FRA-Ligue 1,2022,Brest,Mathias Pereira Lage,POR,"MF,FW",25,1996,14.0,20,7,5,14,1,11,29,37.9,18,10,1,9,14,34,12,0,2023
FRA-Ligue 1,2022,Brest,Noah Fadiga,SEN,DF,22,1999,14.5,30,21,18,9,3,14,26,53.8,12,17,7,10,26,56,18,0,2023
FRA-Ligue 1,2022,Brest,Pierre Lees-Melou,FRA,MF,29,1993,30.7,97,55,55,37,5,57,123,46.3,66,48,13,35,52,149,46,1,2023
FRA-Ligue 1,2022,Brest,Romain Del Castillo,FRA,"MF,FW",26,1996,15.8,39,24,13,17,9,16,36,44.4,20,14,1,13,11,50,5,0,2023
FRA-Ligue 1,2022,Brest,Steve Mounié,BEN,FW,27,1994,18.4,13,5,1,7,5,5,14,35.7,9,18,7,11,3,16,20,0,2023
FRA-Ligue 1,2022,Brest,Taïryk Arconte,FRA,FW,18,2003,1.4,1,1,0,0,1,0,3,0.0,3,1,0,1,0,1,2,0,2023
FRA-Ligue 1,2022,Brest,Youcef Belaïli,ALG,"FW,MF",30,1992,4.0,5,2,3,2,0,2,7,28.6,5,2,0,2,1,6,1,0,2023
FRA-Ligue 1,2022,Clermont Foot,Alidu Seidu,GHA,DF,22,2000,27.3,52,31,35,14,3,31,51,60.8,20,28,14,14,52,104,50,2,2023
FRA-Ligue 1,2022,Clermont Foot,Arial Mendy,SEN,DF,27,1994,2.5,4,2,3,0,1,2,2,100.0,0,2,0,2,4,8,4,0,2023
FRA-Ligue 1,2022,Clermont Foot,Aïman Maurer,MAR,MF,17,2004,5.6,2,1,1,1,0,1,10,10.0,9,1,0,1,3,5,5,0,2023
FRA-Ligue 1,2022,Clermont Foot,Baila Diallo,FRA,"DF,MF",21,2001,1.0,1,0,1,0,0,0,0,,0,1,1,0,0,1,1,0,2023
FRA-Ligue 1,2022,Clermont Foot,Brandon Baiye,BEL,MF,21,2000,0.6,3,2,2,1,0,2,3,66.7,1,1,0,1,1,4,3,0,2023
FRA-Ligue 1,2022,Clermont Foot,Cheick Konaté,CIV,DF,18,2004,6.4,19,12,10,7,2,13,22,59.1,9,7,1,6,13,32,8,1,2023
FRA-Ligue 1,2022,Clermont Foot,Elba Rashani,KVX,"MF,FW",29,1993,24.0,39,26,13,19,7,13,39,33.3,26,27,2,25,21,60,19,0,2023
FRA-Ligue 1,2022,Clermont Foot,Florent Ogier,FRA,DF,33,1989,18.9,33,16,20,12,1,22,39,56.4,17,22,13,9,18,51,64,1,2023
FRA-Ligue 1,2022,Clermont Foot,Grejohn Kyei,FRA,FW,26,1995,24.8,16,7,2,9,5,4,13,30.8,9,14,3,11,6,22,22,0,2023
FRA-Ligue 1,2022,Clermont Foot,Jason Berthomier,FRA,MF,32,1990,0.3,0,0,0,0,0,0,0,,0,0,0,0,0,0,0,0,2023
FRA-Ligue 1,2022,Clermont Foot,Jean-Claude Billong,CMR,MF,28,1993,0.3,0,0,0,0,0,0,0,,0,1,1,0,1,1,0,0,2023
FRA-Ligue 1,2022,Clermont Foot,Jim Allevinah,GAB,"DF,FW",27,1995,24.9,39,24,24,11,4,19,62,30.6,43,24,2,22,24,63,26,1,2023
FRA-Ligue 1,2022,Clermont Foot,Jodel Dossou,BEN,"MF,DF",30,1992,2.9,7,4,3,2,2,4,4,100.0,0,2,1,1,1,8,0,0,2023
FRA-Ligue 1,2022,Clermont Foot,Johan Gastien,FRA,MF,34,1988,28.9,62,34,30,23,9,38,111,34.2,73,37,7,30,36,98,25,1,2023
FRA-Ligue 1,2022,Clermont Foot,Jérémie Bela,ANG,"DF,MF",29,1993,8.3,6,4,2,1,3,3,4,75.0,1,10,1,9,9,15,8,0,2023
FRA-Ligue 1,2022,Clermont Foot,Komnen Andrić,SRB,FW,27,1995,16.1,13,5,2,7,4,2,15,13.3,13,8,1,7,8,21,13,0,2023
FRA-Ligue 1,2022,Clermont Foot,Mateusz Wieteska,POL,DF,25,1997,34.6,41,23,28,13,0,19,33,57.6,14,44,28,16,56,97,97,4,2023
FRA-Ligue 1,2022,Clermont Foot,Maxime Gonalons,FRA,MF,33,1989,16.1,52,32,25,21,6,25,53,47.2,28,21,1,20,20,72,7,1,2023
FRA-Ligue 1,2022,Clermont Foot,Maximiliano Caufriez,BEL,DF,25,1997,24.7,40,24,31,8,1,20,28,71.4,8,33,18,15,34,74,70,0,2023
FRA-Ligue 1,2022,Clermont Foot,Mehdi Zeffane,ALG,"DF,MF",30,1992,7.3,12,7,5,7,0,4,21,19.0,17,14,6,8,22,34,12,0,2023
FRA-Ligue 1,2022,Clermont Foot,Mory Diaw,SEN,GK,29,1993,37.0,0,0,0,0,0,0,4,0.0,4,0,0,0,2,2,13,5,2023
FRA-Ligue 1,2022,Clermont Foot,Muhammed Saracevic Cham,AUT,MF,21,2000,21.9,30,15,15,4,11,13,35,37.1,22,13,0,13,7,37,5,0,2023
FRA-Ligue 1,2022,Clermont Foot,Neto Borges,BRA,DF,25,1996,31.5,75,45,45,20,10,46,75,61.3,29,45,11,34,41,116,62,1,2023
FRA-Ligue 1,2022,Clermont Foot,Ouparine Djoco,SEN,GK,24,1998,1.0,0,0,0,0,0,0,0,,0,0,0,0,0,0,1,0,2023
FRA-Ligue 1,2022,Clermont Foot,Saîf-Eddine Khaoui,TUN,MF,27,1995,22.5,47,28,14,25,8,15,47,31.9,32,17,2,15,33,80,8,0,2023
FRA-Ligue 1,2022,Clermont Foot,Souleymane Cissé,FRA,DF,19,2002,0.4,1,1,1,0,0,1,1,100.0,0,1,1,0,1,2,2,0,2023
FRA-Ligue 1,2022,Clermont Foot,Yanis Massolin,FRA,MF,19,2002,0.7,2,1,1,0,1,0,1,0.0,1,1,0,1,2,4,0,0,2023
FRA-Ligue 1,2022,Clermont Foot,Yohann Magnin,FRA,MF,25,1997,26.7,89,54,37,45,7,54,106,50.9,52,50,12,38,25,114,46,0,2023
FRA-Ligue 1,2022,Lens,Adam Buksa,POL,"FW,MF",26,1996,1.1,1,0,0,0,1,0,3,0.0,3,0,0,0,0,1,0,0,2023
FRA-Ligue 1,2022,Lens,Adrien Thomasson,FRA,"MF,FW",28,1993,14.2,24,17,8,11,5,12,45,26.7,33,25,2,23,4,28,17,0,2023
FRA-Ligue 1,2022,Lens,Alexis Claude-Maurice,FRA,"MF,FW",24,1998,6.7,14,9,5,8,1,6,16,37.5,10,6,0,6,2,16,1,0,2023
FRA-Ligue 1,2022,Lens,Angelo Fulgini,FRA,"MF,FW",25,1996,9.5,14,7,2,4,8,5,14,35.7,9,11,0,11,8,22,2,0,2023
FRA-Ligue 1,2022,Lens,Brice Samba,FRA,GK,28,1994,37.0,1,0,1,0,0,1,2,50.0,1,1,0,1,0,1,12,2,2023
FRA-Ligue 1,2022,Lens,Christopher Wooh,CMR,MF,20,2001,0.0,0,0,0,0,0,0,1,0.0,1,0,0,0,0,0,1,0,2023
FRA-Ligue 1,2022,Lens,David Pereira da Costa,POR,"MF,FW",21,2001,15.6,13,7,1,10,2,7,19,36.8,12,19,1,18,11,24,6,0,2023
FRA-Ligue 1,2022,Lens,Deiver Machado,COL,"DF,MF",28,1993,24.3,45,26,18,20,7,21,34,61.8,13,21,4,17,21,66,27,0,2023
FRA-Ligue 1,2022,Lens,Facundo Medina,ARG,DF,23,1999,30.9,31,20,16,15,0,13,35,37.1,22,25,9,16,26,57,62,1,2023
FRA-Ligue 1,2022,Lens,Florian Sotoca,FRA,"MF,FW",31,1990,33.9,39,19,11,17,11,15,40,37.5,25,41,2,39,29,68,51,0,2023
FRA-Ligue 1,2022,Lens,Gaël Kakuta,COD,FW,31,1991,0.2,0,0,0,0,0,0,0,,0,0,0,0,0,0,1,0,2023
FRA-Ligue 1,2022,Lens,Ignatius Ganago,CMR,FW,23,1999,0.7,0,0,0,0,0,0,0,,0,0,0,0,0,0,1,0,2023
FRA-Ligue 1,2022,Lens,Ismaëlben Boura,FRA,"DF,FW",21,2000,1.0,6,4,4,2,0,5,6,83.3,1,2,1,1,2,8,3,0,2023
FRA-Ligue 1,2022,Lens,Jean Onana,CMR,"MF,DF",22,2000,9.0,28,17,8,17,3,10,22,45.5,12,15,5,10,18,46,20,0,2023
FRA-Ligue 1,2022,Lens,Jean-Louis Leca,FRA,GK,36,1985,1.0,0,0,0,0,0,0,0,,0,0,0,0,0,0,0,1,2023
FRA-Ligue 1,2022,Lens,Jimmy Cabot,FRA,"DF,MF",28,1994,5.7,20,12,10,8,2,12,26,46.2,14,5,0,5,4,24,12,0,2023
FRA-Ligue 1,2022,Lens,Jonathan Gradit,FRA,DF,29,1992,31.4,62,40,30,25,7,31,53,58.5,22,40,26,14,38,100,83,0,2023
FRA-Ligue 1,2022,Lens,Julien Le Cardinal,FRA,DF,24,1997,1.8,6,4,5,0,1,4,6,66.7,2,3,0,3,2,8,5,0,2023
FRA-Ligue 1,2022,Lens,Kevin Danso,AUT,DF,23,1998,35.9,37,19,25,11,1,19,30,63.3,11,48,34,14,33,70,124,0,2023
FRA-Ligue 1,2022,Lens,Loïs Openda,BEL,FW,22,2000,28.0,11,9,2,6,3,2,13,15.4,11,9,0,9,2,13,6,0,2023
FRA-Ligue 1,2022,Lens,Massadio Haïdara,MLI,"DF,MF",29,1992,18.6,24,16,9,9,6,12,24,50.0,12,26,9,17,36,60,39,1,2023
FRA-Ligue 1,2022,Lens,Patrick Berg,NOR,"MF,FW",24,1997,0.3,0,0,0,0,0,0,1,0.0,1,0,0,0,1,1,0,0,2023
FRA-Ligue 1,2022,Lens,Przemysław Frankowski,POL,"DF,MF",27,1995,31.5,77,51,37,31,9,39,80,48.8,41,38,6,32,41,118,42,2,2023
FRA-Ligue 1,2022,Lens,Rémy Labeau Lascary,GLP,"FW,MF",19,2003,1.4,4,2,4,0,0,0,0,,0,4,0,4,1,5,0,0,2023
FRA-Ligue 1,2022,Lens,Salis Abdul Samed,GHA,MF,22,2000,32.2,46,26,18,23,5,29,52,55.8,23,38,9,29,36,82,26,0,2023
FRA-Ligue 1,2022,Lens,Seko Fofana,CIV,MF,27,1995,34.1,28,13,8,18,2,15,39,38.5,24,17,4,13,19,47,14,0,2023
FRA-Ligue 1,2022,Lens,Steven Fortes,CPV,DF,30,1992,0.1,0,0,0,0,0,0,0,,0,0,0,0,0,0,0,0,2023
FRA-Ligue 1,2022,Lens,Wesley Saïd,FRA,"FW,MF",27,1995,7.2,4,1,1,2,1,2,6,33.3,4,4,0,4,1,5,2,0,2023
FRA-Ligue 1,2022,Lens,Łukasz Poręba,POL,MF,22,2000,2.9,5,4,2,1,2,2,3,66.7,1,3,0,3,4,9,2,0,2023
FRA-Ligue 1,2022,Lille,Adam Ounas,ALG,"FW,MF",25,1996,11.8,20,11,4,10,6,8,13,61.5,5,16,0,16,7,27,5,0,2023
FRA-Ligue 1,2022,Lille,Akim Zedadka,ALG,"DF,MF",27,1995,3.9,1,1,1,0,0,0,2,0.0,2,3,0,3,2,3,6,0,2023
FRA-Ligue 1,2022,Lille,Alan Virginius,FRA,FW,19,2003,2.9,3,2,1,1,1,0,4,0.0,4,0,0,0,2,5,1,0,2023
FRA-Ligue 1,2022,Lille,Alexsandro Ribeiro,BRA,DF,22,1999,17.9,32,18,24,7,1,19,28,67.9,9,11,2,9,25,57,59,1,2023
FRA-Ligue 1,2022,Lille,Amine Messoussa,FRA,FW,17,2004,0.0,0,0,0,0,0,0,0,,0,0,0,0,0,0,0,0,2023
FRA-Ligue 1,2022,Lille,André Gomes,POR,MF,29,1993,18.1,37,19,12,17,8,19,52,36.5,33,20,5,15,9,46,16,1,2023
FRA-Ligue 1,2022,Lille,Angel Gomes,ENG,MF,21,2000,31.3,41,19,12,21,8,18,49,36.7,31,22,2,20,13,54,11,1,2023
FRA-Ligue 1,2022,Lille,Bafodé Diakité,FRA,DF,21,2001,29.5,54,35,23,24,7,32,57,56.1,25,37,8,29,17,71,58,0,2023
FRA-Ligue 1,2022,Lille,Benjamin André,FRA,MF,31,1990,32.4,128,74,51,60,17,65,121,53.7,56,50,8,42,47,175,60,0,2023
FRA-Ligue 1,2022,Lille,Carlos Baleba,CMR,MF,18,2004,5.3,13,11,2,9,2,9,14,64.3,5,13,3,10,1,14,3,2,2023
FRA-Ligue 1,2022,Lille,Edon Zhegrova,KVX,"FW,MF",23,1999,11.7,18,12,6,7,5,12,20,60.0,8,9,0,9,2,20,2,0,2023
FRA-Ligue 1,2022,Lille,Gabriel Gudmundsson,SWE,"DF,FW",23,1999,9.3,19,11,7,10,2,12,22,54.5,10,11,2,9,10,29,20,0,2023
FRA-Ligue 1,2022,Lille,Ismaily,BRA,DF,32,1990,19.8,41,18,16,16,9,17,32,53.1,15,25,5,20,21,62,39,0,2023
FRA-Ligue 1,2022,Lille,Jonas Martin,FRA,MF,32,1990,3.1,9,7,4,5,0,5,14,35.7,9,3,1,2,7,16,3,0,2023
FRA-Ligue 1,2022,Lille,Jonathan Bamba,CIV,FW,26,1996,30.9,37,17,12,14,11,14,45,31.1,31,36,1,35,22,59,14,0,2023
FRA-Ligue 1,2022,Lille,Jonathan David,CAN,FW,22,2000,35.2,24,17,6,11,7,10,27,37.0,17,20,2,18,8,32,13,0,2023
FRA-Ligue 1,2022,Lille,José Fonte,POR,DF,38,1983,28.8,23,17,18,4,1,10,21,47.6,11,27,14,13,25,48,112,2,2023
FRA-Ligue 1,2022,Lille,Leny Yoro,FRA,DF,16,2005,8.5,11,5,8,3,0,4,9,44.4,5,6,1,5,18,29,27,1,2023
FRA-Ligue 1,2022,Lille,Leonardo César Jardim,BRA,GK,27,1995,6.0,,0,,,,,,,,,,,0,,,,2023
FRA-Ligue 1,2022,Lille,Lucas Chevalier,FRA,GK,20,2001,32.0,2,1,2,0,0,2,2,100.0,0,1,0,1,2,4,7,2,2023
FRA-Ligue 1,2022,Lille,Mohamed Lamine Bayo,GUI,"FW,MF",24,1998,7.2,3,3,0,2,1,0,12,0.0,12,3,1,2,0,3,1,0,2023
FRA-Ligue 1,2022,Lille,Rémy Cabella,FRA,"MF,FW",32,1990,28.1,64,37,21,28,15,29,64,45.3,35,41,5,36,17,81,7,1,2023
FRA-Ligue 1,2022,Lille,Simon Ramet,FRA,DF,19,2003,0.0,0,0,0,0,0,0,0,,0,0,0,0,0,0,0,0,2023
FRA-Ligue 1,2022,Lille,Tiago Djaló,POR,DF,22,2000,22.4,31,21,23,7,1,13,20,65.0,7,17,11,6,23,54,60,1,2023
FRA-Ligue 1,2022,Lille,Timothy Weah,USA,"DF,FW",22,2000,19.4,24,14,13,9,2,16,29,55.2,13,17,3,14,23,47,18,0,2023
FRA-Ligue 1,2022,Lille,Yusuf Yazıcı,TUR,MF,25,1997,2.2,0,0,0,0,0,0,0,,0,2,0,2,0,0,1,0,2023
FRA-Ligue 1,2022,Lorient,Adil Aouchiche,FRA,MF,20,2002,2.8,5,2,3,1,1,1,9,11.1,8,1,0,1,4,9,1,0,2023
FRA-Ligue 1,2022,Lorient,Adrian Grbić,AUT,"MF,FW",25,1996,0.3,0,0,0,0,0,0,1,0.0,1,3,0,3,0,0,0,0,2023
FRA-Ligue 1,2022,Lorient,Armand Lauriente,FRA,FW,23,1998,3.0,8,7,3,4,1,3,7,42.9,4,5,1,4,4,12,1,0,2023
FRA-Ligue 1,2022,Lorient,Ayman Kari,FRA,"MF,DF",17,2004,1.1,0,0,0,0,0,0,0,,0,4,0,4,3,3,0,0,2023
FRA-Ligue 1,2022,Lorient,Bamba Dieng,SEN,FW,22,2000,8.3,19,10,5,12,2,3,11,27.3,8,6,0,6,2,21,6,0,2023
FRA-Ligue 1,2022,Lorient,Bamo Meïté,CIV,DF,21,2001,16.7,18,8,13,4,1,7,16,43.8,9,33,23,10,16,34,70,0,2023
FRA-Ligue 1,2022,Lorient,Bonke Innocent,NGA,MF,26,1996,13.1,28,17,13,14,1,11,36,30.6,25,22,5,17,26,54,31,0,2023
FRA-Ligue 1,2022,Lorient,Chrislain Matsima,FRA,"DF,MF",20,2002,2.5,0,0,0,0,0,0,0,,0,3,3,0,2,2,7,0,2023
FRA-Ligue 1,2022,Lorient,Ckene Doucouré,COM,"FW,MF",20,2002,1.5,2,2,2,0,0,1,2,50.0,1,0,0,0,1,3,0,0,2023
FRA-Ligue 1,2022,Lorient,Dango Ouattara,BFA,"FW,MF",20,2002,17.2,41,26,20,11,10,15,28,53.6,13,24,6,18,19,60,21,0,2023
FRA-Ligue 1,2022,Lorient,Darlin Yongwa,CMR,DF,21,2000,8.7,13,11,7,5,1,4,15,26.7,11,13,1,12,5,18,11,0,2023
FRA-Ligue 1,2022,Lorient,Eli Junior Kroupi,FRA,"FW,MF",16,2006,0.1,0,0,0,0,0,0,1,0.0,1,0,0,0,1,1,0,0,2023
FRA-Ligue 1,2022,Lorient,Enzo Le Fée,FRA,MF,22,2000,33.6,108,64,52,40,16,43,113,38.1,70,50,5,45,34,142,38,1,2023
FRA-Ligue 1,2022,Lorient,Gedeon Kalulu,COD,DF,24,1997,27.1,64,34,43,14,7,30,48,62.5,18,32,3,29,28,92,79,2,2023
FRA-Ligue 1,2022,Lorient,Ibrahima Koné,MLI,FW,23,1999,17.5,24,13,3,13,8,5,11,45.5,6,13,0,13,4,28,18,0,2023
FRA-Ligue 1,2022,Lorient,Igor Carioca,BRA,DF,25,1996,5.1,18,11,12,2,4,12,21,57.1,9,7,0,7,5,23,17,0,2023
FRA-Ligue 1,2022,Lorient,Jean-Victor Makengo,FRA,MF,24,1998,11.8,16,8,5,10,1,6,20,30.0,14,8,5,3,10,26,13,1,2023
FRA-Ligue 1,2022,Lorient,Julien Laporte,FRA,DF,28,1993,18.4,22,16,18,3,1,16,22,72.7,6,33,27,6,18,40,108,2,2023
FRA-Ligue 1,2022,Lorient,Julien Ponceau,FRA,MF,21,2000,18.4,28,19,10,14,4,10,32,31.3,22,27,3,24,14,42,12,0,2023
FRA-Ligue 1,2022,Lorient,Laurent Abergel,FRA,MF,29,1993,26.0,92,52,59,30,3,39,92,42.4,53,47,8,39,34,126,39,0,2023
FRA-Ligue 1,2022,Lorient,Montassar Talbi,TUN,DF,24,1998,38.0,53,25,40,13,0,22,35,62.9,13,55,34,21,40,93,190,3,2023
FRA-Ligue 1,2022,Lorient,Quentin Boisgard,FRA,MF,25,1997,2.0,6,2,1,4,1,3,4,75.0,1,3,1,2,4,10,2,0,2023
FRA-Ligue 1,2022,Lorient,Romain Faivre,FRA,"MF,FW",24,1998,13.8,13,8,5,4,4,5,25,20.0,20,11,0,11,1,14,4,0,2023
FRA-Ligue 1,2022,Lorient,Stéphane Diarra,FRA,"FW,MF",23,1998,11.8,25,17,14,9,2,11,29,37.9,18,13,1,12,22,47,9,0,2023
FRA-Ligue 1,2022,Lorient,Terem Moffi,NGA,FW,23,1999,15.4,8,5,1,4,3,3,5,60.0,2,11,3,8,3,11,10,0,2023
FRA-Ligue 1,2022,Lorient,Théo Le Bris,FRA,"MF,DF",19,2002,16.1,31,19,17,11,3,15,33,45.5,18,21,2,19,18,49,31,0,2023
FRA-Ligue 1,2022,Lorient,Vincent Le Goff,FRA,DF,32,1989,37.0,75,32,56,16,3,45,62,72.6,17,29,9,20,41,116,105,1,2023
FRA-Ligue 1,2022,Lorient,Vito Mannone,ITA,GK,34,1988,17.9,0,0,0,0,0,0,0,,0,0,0,0,0,0,4,3,2023
FRA-Ligue 1,2022,Lorient,Yoann Cathline,FRA,"FW,MF",20,2002,12.1,19,12,7,6,6,5,12,41.7,7,10,1,9,8,27,16,1,2023
FRA-Ligue 1,2022,Lorient,Yvon Mvogo,SUI,GK,28,1994,20.1,0,0,0,0,0,0,0,,0,0,0,0,2,2,6,3,2023
FRA-Ligue 1,2022,Lyon,Alexandre Lacazette,FRA,FW,31,1991,32.5,43,23,7,17,19,10,29,34.5,19,23,3,20,15,58,4,0,2023
FRA-Ligue 1,2022,Lyon,Amin Sarr,SWE,FW,21,2001,6.0,9,6,1,4,4,1,4,25.0,3,2,0,2,0,9,4,0,2023
FRA-Ligue 1,2022,Lyon,Anthony Lopes,POR,GK,31,1990,31.3,1,0,1,0,0,1,4,25.0,3,0,0,0,3,4,10,0,2023
FRA-Ligue 1,2022,Lyon,Bradley Barcola,FRA,"FW,MF",19,2002,16.0,25,16,8,10,7,8,39,20.5,31,29,0,29,19,44,10,0,2023
FRA-Ligue 1,2022,Lyon,Castello Lukeba,FRA,DF,19,2002,33.2,39,23,27,8,4,21,31,67.7,10,42,24,18,75,114,105,1,2023
FRA-Ligue 1,2022,Lyon,Corentin Tolisso,FRA,MF,27,1994,22.6,44,27,16,23,5,25,66,37.9,41,25,5,20,24,68,23,1,2023
FRA-Ligue 1,2022,Lyon,Damien Da Silva,FRA,DF,34,1988,3.8,8,7,5,3,0,3,3,100.0,0,4,3,1,5,13,12,0,2023
FRA-Ligue 1,2022,Lyon,Dejan Lovren,CRO,DF,33,1989,16.2,25,19,20,5,0,20,29,69.0,9,20,10,10,26,51,70,1,2023
FRA-Ligue 1,2022,Lyon,Henrique,BRA,"DF,FW",28,1994,4.0,9,4,3,2,4,6,13,46.2,7,3,1,2,5,14,8,0,2023
FRA-Ligue 1,2022,Lyon,Houssem Aouar,ALG,MF,24,1998,5.8,12,5,5,5,2,3,9,33.3,6,12,2,10,8,20,3,0,2023
FRA-Ligue 1,2022,Lyon,Jeff Reine-Adélaïde,FRA,MF,24,1998,3.7,8,5,1,5,2,5,9,55.6,4,4,0,4,6,14,0,0,2023
FRA-Ligue 1,2022,Lyon,Jefferson,BRA,FW,22,1999,5.0,17,4,4,9,4,6,15,40.0,9,6,0,6,1,18,0,0,2023
FRA-Ligue 1,2022,Lyon,Johann Lepenant,FRA,MF,19,2002,21.5,58,34,24,27,7,32,86,37.2,54,29,5,24,28,86,17,3,2023
FRA-Ligue 1,2022,Lyon,Jérôme Boateng,GER,DF,33,1988,4.8,3,0,2,1,0,2,6,33.3,4,8,5,3,6,9,16,0,2023
FRA-Ligue 1,2022,Lyon,Karl Toko Ekambi,CMR,"FW,MF",29,1992,15.0,9,9,2,4,3,4,15,26.7,11,12,2,10,9,18,6,0,2023
FRA-Ligue 1,2022,Lyon,Lucas Paquetá,BRA,MF,24,1997,1.8,5,4,0,5,0,1,3,33.3,2,2,0,2,1,6,3,0,2023
FRA-Ligue 1,2022,Lyon,Malo Gusto,FRA,DF,19,2003,17.7,42,26,23,11,8,21,43,48.8,22,22,5,17,28,70,23,1,2023
FRA-Ligue 1,2022,Lyon,Mamadou Sarr,FRA,MF,16,2005,0.1,0,0,0,0,0,0,0,,0,0,0,0,0,0,0,0,2023
FRA-Ligue 1,2022,Lyon,Maxence Caqueret,FRA,MF,22,2000,30.7,87,54,27,38,22,43,109,39.4,66,45,3,42,39,126,27,0,2023
FRA-Ligue 1,2022,Lyon,Mohamed El Arouch,FRA,MF,18,2004,0.0,1,1,1,0,0,0,0,,0,0,0,0,0,1,0,0,2023
FRA-Ligue 1,2022,Lyon,Moussa Dembélé,FRA,"FW,MF",26,1996,9.7,8,4,3,3,2,4,7,57.1,3,5,0,5,2,10,6,0,2023
FRA-Ligue 1,2022,Lyon,Nicolás Tagliafico,ARG,DF,29,1992,33.2,91,53,36,41,14,50,78,64.1,28,45,11,34,57,148,47,0,2023
FRA-Ligue 1,2022,Lyon,Rayan Cherki,FRA,"MF,FW",18,2003,20.8,14,8,2,5,7,8,23,34.8,15,6,0,6,5,19,1,0,2023
FRA-Ligue 1,2022,Lyon,Romain Faivre,FRA,MF,24,1998,3.3,6,3,2,2,2,1,3,33.3,2,3,0,3,0,6,0,0,2023
FRA-Ligue 1,2022,Lyon,Rémy Riou,FRA,GK,34,1987,6.7,1,0,1,0,0,1,1,100.0,0,0,0,0,0,1,3,0,2023
FRA-Ligue 1,2022,Lyon,Sael Kumbedi,FRA,DF,17,2005,14.7,47,27,27,13,7,20,38,52.6,18,23,7,16,10,57,16,0,2023
FRA-Ligue 1,2022,Lyon,Sinaly Diomande,CIV,DF,21,2001,21.7,42,24,26,15,1,31,49,63.3,18,26,13,13,49,91,75,1,2023
FRA-Ligue 1,2022,Lyon,Tetê,BRA,"FW,MF",22,2000,12.3,21,10,8,5,8,10,19,52.6,9,9,0,9,13,34,2,0,2023
FRA-Ligue 1,2022,Lyon,Thiago Mendes,BRA,"MF,DF",30,1992,22.9,48,27,24,21,3,30,40,75.0,10,28,8,20,47,95,51,4,2023
FRA-Ligue 1,2022,Marseille,Alexis Sánchez,CHI,"FW,MF",33,1988,29.8,27,17,5,16,6,3,24,12.5,21,14,0,14,5,32,6,0,2023
FRA-Ligue 1,2022,Marseille,Amine Harit,MAR,"MF,FW",25,1997,5.7,6,4,0,3,3,3,8,37.5,5,4,1,3,4,10,6,0,2023
FRA-Ligue 1,2022,Marseille,Arkadiusz Milik,POL,FW,28,1994,1.4,1,1,0,0,1,0,1,0.0,1,0,0,0,0,1,2,0,2023
FRA-Ligue 1,2022,Marseille,Azzedine Ounahi,MAR,"MF,FW",22,2000,1.3,2,1,1,1,0,0,2,0.0,2,1,0,1,0,2,0,0,2023
FRA-Ligue 1,2022,Marseille,Bamba Dieng,SEN,"FW,MF",22,2000,2.2,4,4,2,1,1,3,4,75.0,1,5,1,4,0,4,0,0,2023
FRA-Ligue 1,2022,Marseille,Cengiz Ünder,TUR,"MF,DF",25,1997,27.7,37,19,15,13,9,13,34,38.2,21,18,2,16,18,55,13,0,2023
FRA-Ligue 1,2022,Marseille,Chancel Mbemba,COD,DF,27,1994,31.7,43,26,24,17,2,22,31,71.0,9,25,12,13,42,85,89,0,2023
FRA-Ligue 1,2022,Marseille,Cédric Bakambu,COD,MF,31,1991,0.7,2,1,2,0,0,2,2,100.0,0,0,0,0,0,2,0,0,2023
FRA-Ligue 1,2022,Marseille,Dimitri Payet,FRA,"MF,FW",35,1987,9.3,6,4,2,2,2,3,10,30.0,7,4,0,4,0,6,4,0,2023
FRA-Ligue 1,2022,Marseille,Duje Ćaleta-Car,CRO,DF,25,1996,0.1,0,0,0,0,0,0,0,,0,0,0,0,0,0,1,0,2023
FRA-Ligue 1,2022,Marseille,Eric Bailly,CIV,DF,28,1994,6.0,13,10,6,6,1,7,7,100.0,0,15,12,3,12,25,18,1,2023
FRA-Ligue 1,2022,Marseille,François Mughe,CMR,MF,18,2004,0.1,0,0,0,0,0,0,0,,0,0,0,0,0,0,0,0,2023
FRA-Ligue 1,2022,Marseille,Gerson,BRA,MF,25,1997,4.6,6,4,1,4,1,3,5,60.0,2,5,0,5,2,8,4,0,2023
FRA-Ligue 1,2022,Marseille,Issa Kaboré,BFA,DF,21,2001,11.4,33,19,10,18,5,21,32,65.6,11,11,1,10,12,45,21,1,2023
FRA-Ligue 1,2022,Marseille,Jonathan Clauss,FRA,DF,29,1992,28.8,46,28,21,16,9,23,52,44.2,29,29,4,25,31,77,40,2,2023
FRA-Ligue 1,2022,Marseille,Jordan Veretout,FRA,MF,29,1993,31.8,56,35,17,32,7,25,53,47.2,28,22,7,15,36,92,40,2,2023
FRA-Ligue 1,2022,Marseille,Leonardo Balerdi,ARG,DF,23,1999,29.3,57,37,43,12,2,32,45,71.1,13,48,29,19,63,120,91,1,2023
FRA-Ligue 1,2022,Marseille,Luis Javier Suárez,COL,FW,24,1997,3.3,4,1,1,2,1,1,4,25.0,3,1,0,1,3,7,6,0,2023
FRA-Ligue 1,2022,Marseille,Mattéo Guendouzi,FRA,MF,23,1999,23.4,39,18,9,21,9,14,38,36.8,24,12,5,7,21,60,18,0,2023
FRA-Ligue 1,2022,Marseille,Nuno Tavares,POR,"DF,MF",22,2000,26.1,56,30,19,24,13,28,55,50.9,27,32,4,28,15,71,25,0,2023
FRA-Ligue 1,2022,Marseille,Pape Gueye,SEN,"MF,DF",23,1999,5.5,18,7,10,7,1,7,15,46.7,8,9,2,7,9,27,2,0,2023
FRA-Ligue 1,2022,Marseille,Pau López,ESP,GK,27,1994,32.5,0,0,0,0,0,0,1,0.0,1,0,0,0,0,0,5,1,2023
FRA-Ligue 1,2022,Marseille,Rubén Blanco,ESP,GK,27,1995,5.5,0,0,0,0,0,0,0,,0,0,0,0,0,0,1,0,2023
FRA-Ligue 1,2022,Marseille,Ruslan Malinovskyi,UKR,"MF,FW",29,1993,13.6,21,11,3,12,6,10,26,38.5,16,13,1,12,3,24,9,0,2023
FRA-Ligue 1,2022,Marseille,Salim Ben Seghir,FRA,MF,19,2003,0.0,0,0,0,0,0,0,0,,0,1,0,1,0,0,0,0,2023
FRA-Ligue 1,2022,Marseille,Samuel Gigot,FRA,DF,28,1993,20.9,46,24,22,21,3,12,15,80.0,3,24,7,17,45,91,85,1,2023
FRA-Ligue 1,2022,Marseille,Sead Kolašinac,BIH,DF,29,1993,24.6,52,36,24,22,6,24,37,64.9,13,19,2,17,43,95,35,1,2023
FRA-Ligue 1,2022,Marseille,Souleymane Touré,FRA,DF,19,2003,0.8,2,1,1,1,0,1,2,50.0,1,1,0,1,0,2,5,0,2023
FRA-Ligue 1,2022,Marseille,Valentin Rongier,FRA,MF,27,1994,33.7,93,59,33,47,13,41,77,53.2,36,50,11,39,54,147,38,1,2023
FRA-Ligue 1,2022,Marseille,Vitinha,POR,FW,22,2000,5.2,15,7,0,6,9,3,11,27.3,8,3,0,3,2,17,6,0,2023
FRA-Ligue 1,2022,Monaco,Aleksandr Golovin,RUS,"MF,FW",26,1996,27.4,62,36,19,32,11,28,72,38.9,44,28,1,27,37,99,10,0,2023
FRA-Ligue 1,2022,Monaco,Alexander Nübel,GER,GK,25,1996,38.0,0,0,0,0,0,0,1,0.0,1,0,0,0,1,1,10,3,2023
FRA-Ligue 1,2022,Monaco,Axel Disasi,FRA,DF,24,1998,37.0,30,20,13,13,4,13,27,48.1,14,51,31,20,56,86,112,2,2023
FRA-Ligue 1,2022,Monaco,Benoît Badiashile,FRA,DF,21,2001,9.3,10,8,6,4,0,5,10,50.0,5,9,6,3,17,27,40,1,2023
FRA-Ligue 1,2022,Monaco,Breel Embolo,SUI,FW,25,1997,20.7,15,9,2,7,6,5,10,50.0,5,14,3,11,5,20,12,0,2023
FRA-Ligue 1,2022,Monaco,Caio Henrique Oliveira Silva,BRA,DF,25,1997,32.2,74,51,42,28,4,44,76,57.9,32,28,8,20,26,100,68,1,2023
FRA-Ligue 1,2022,Monaco,Chrislain Matsima,FRA,DF,20,2002,5.0,11,6,7,2,2,4,7,57.1,3,5,5,0,9,20,16,0,2023
FRA-Ligue 1,2022,Monaco,Edan Diop,FRA,"DF,FW",17,2004,2.5,13,8,3,3,7,7,15,46.7,8,7,1,6,4,17,1,0,2023
FRA-Ligue 1,2022,Monaco,Eliesse Ben Seghir,FRA,"FW,MF",17,2005,11.7,18,10,4,12,2,4,12,33.3,8,18,1,17,4,22,1,0,2023
FRA-Ligue 1,2022,Monaco,Eliot Matazo,BEL,MF,20,2002,13.1,26,12,11,13,2,11,26,42.3,15,18,4,14,15,41,11,1,2023
FRA-Ligue 1,2022,Monaco,Gelson Martins,POR,"MF,FW",27,1995,3.8,15,8,6,4,5,4,13,30.8,9,4,1,3,3,18,2,0,2023
FRA-Ligue 1,2022,Monaco,Guillermo Maripán,CHI,DF,28,1994,24.0,46,26,26,20,0,17,33,51.5,16,39,27,12,38,84,87,0,2023
FRA-Ligue 1,2022,Monaco,Ismail Jakobs,SEN,"DF,FW",22,1999,12.4,11,5,7,3,1,5,12,41.7,7,9,1,8,9,20,18,0,2023
FRA-Ligue 1,2022,Monaco,Jean Lucas,BRA,MF,24,1998,3.2,9,5,3,5,1,6,12,50.0,6,2,1,1,4,13,2,0,2023
FRA-Ligue 1,2022,Monaco,Kevin Volland,GER,"FW,MF",30,1992,7.1,8,4,1,5,2,2,8,25.0,6,8,0,8,2,10,0,0,2023
FRA-Ligue 1,2022,Monaco,Krépin Diatta,SEN,"MF,FW",23,1999,23.0,30,21,4,17,9,13,32,40.6,19,29,1,28,17,47,12,0,2023
FRA-Ligue 1,2022,Monaco,Maghnes Akliouche,FRA,"MF,FW",20,2002,4.5,7,4,4,3,0,2,8,25.0,6,2,0,2,3,10,2,0,2023
FRA-Ligue 1,2022,Monaco,Malang Sarr,FRA,DF,23,1999,8.0,6,3,5,1,0,1,5,20.0,4,11,7,4,15,21,29,2,2023
FRA-Ligue 1,2022,Monaco,Mohamed Camara,MLI,MF,22,2000,24.4,83,45,38,39,6,48,92,52.2,44,45,6,39,27,110,14,1,2023
FRA-Ligue 1,2022,Monaco,Myron Boadu,NED,FW,21,2001,3.3,3,3,0,2,1,1,7,14.3,6,1,0,1,0,3,1,0,2023
FRA-Ligue 1,2022,Monaco,Ruben Aguilar,FRA,DF,29,1993,13.0,19,9,7,7,5,8,22,36.4,14,13,1,12,18,37,28,1,2023
FRA-Ligue 1,2022,Monaco,Sofiane Diop,FRA,MF,22,2000,0.7,0,0,0,0,0,0,0,,0,0,0,0,1,1,0,0,2023
FRA-Ligue 1,2022,Monaco,Soungoutou Magassa,FRA,MF,18,2003,0.9,4,1,2,2,0,2,4,50.0,2,3,0,3,1,5,1,0,2023
FRA-Ligue 1,2022,Monaco,Takumi Minamino,JPN,"MF,FW",27,1995,8.0,15,8,5,7,3,7,35,20.0,28,14,0,14,6,21,4,0,2023
FRA-Ligue 1,2022,Monaco,Vanderson,BRA,"DF,MF",21,2001,24.6,84,48,36,34,14,44,75,58.7,31,36,9,27,48,132,36,1,2023
FRA-Ligue 1,2022,Monaco,Wissam Ben Yedder,FRA,FW,31,1990,23.5,16,9,2,5,9,4,13,30.8,9,15,0,15,4,20,0,0,2023
FRA-Ligue 1,2022,Monaco,Youssouf Fofana,FRA,MF,23,1999,34.3,81,41,31,42,8,38,74,51.4,36,50,6,44,56,137,32,1,2023
FRA-Ligue 1,2022,Montpellier,Arnaud Nordin,FRA,FW,24,1998,26.7,26,14,10,12,4,12,28,42.9,16,19,1,18,14,40,7,0,2023
FRA-Ligue 1,2022,Montpellier,Arnaud Souquet,FRA,"DF,FW",30,1992,4.0,22,16,13,7,2,11,14,78.6,3,8,3,5,4,26,4,0,2023
FRA-Ligue 1,2022,Montpellier,Axel Gueguin,FRA,"FW,MF",17,2005,0.3,0,0,0,0,0,0,0,,0,1,0,1,0,0,0,0,2023
FRA-Ligue 1,2022,Montpellier,Benjamin Lecomte,FRA,GK,31,1991,19.0,0,0,0,0,0,0,2,0.0,2,0,0,0,0,0,6,0,2023
FRA-Ligue 1,2022,Montpellier,Bingourou Kamara,SEN,GK,25,1996,4.5,0,0,0,0,0,0,0,,0,0,0,0,0,0,2,0,2023
FRA-Ligue 1,2022,Montpellier,Boubakar Kouyaté,MLI,DF,25,1997,14.0,31,18,18,11,2,19,35,54.3,16,24,14,10,34,65,73,1,2023
FRA-Ligue 1,2022,Montpellier,Béni Makouana,CGO,"FW,MF",19,2002,2.2,1,0,0,1,0,0,2,0.0,2,3,1,2,0,1,1,0,2023
FRA-Ligue 1,2022,Montpellier,Cheikh Faye,SEN,FW,23,1999,0.4,0,0,0,0,0,0,0,,0,0,0,0,1,1,0,0,2023
FRA-Ligue 1,2022,Montpellier,Christopher Jullien,FRA,DF,29,1993,29.9,46,28,29,14,3,28,51,54.9,23,35,18,17,43,89,114,1,2023
FRA-Ligue 1,2022,Montpellier,Elye Wahi,FRA,FW,19,2003,27.9,9,3,2,3,4,5,14,35.7,9,14,2,12,3,12,5,0,2023
FRA-Ligue 1,2022,Montpellier,Enzo Tchato,CMR,DF,19,2002,12.2,26,17,14,11,1,13,22,59.1,9,17,2,15,7,33,33,0,2023
FRA-Ligue 1,2022,Montpellier,Faitout Maouassa,FRA,"FW,DF",24,1998,21.4,52,32,26,20,6,18,41,43.9,23,31,3,28,20,72,23,0,2023
FRA-Ligue 1,2022,Montpellier,Falaye Sacko,MLI,DF,27,1995,28.7,46,25,25,15,6,32,51,62.7,19,43,14,29,33,79,75,1,2023
FRA-Ligue 1,2022,Montpellier,Issiaga Sylla,GUI,DF,28,1994,14.5,28,16,19,8,1,15,31,48.4,16,19,3,16,32,60,35,0,2023
FRA-Ligue 1,2022,Montpellier,Jonas Omlin,SUI,GK,28,1994,13.0,1,0,1,0,0,0,0,,0,0,0,0,0,1,8,1,2023
FRA-Ligue 1,2022,Montpellier,Jordan Ferri,FRA,MF,30,1992,30.4,55,35,32,19,4,30,89,33.7,59,22,6,16,26,81,21,0,2023
FRA-Ligue 1,2022,Montpellier,Joris Chotard,FRA,MF,20,2001,27.3,64,34,37,23,4,40,78,51.3,38,40,11,29,40,104,42,1,2023
FRA-Ligue 1,2022,Montpellier,Khalil Fayad,FRA,MF,18,2004,8.0,30,14,12,16,2,12,21,57.1,9,8,1,7,9,39,4,0,2023
FRA-Ligue 1,2022,Montpellier,Léo Leroy,FRA,MF,22,2000,13.2,53,38,24,26,3,31,57,54.4,26,25,2,23,14,67,8,0,2023
FRA-Ligue 1,2022,Montpellier,Mamadou Sakho,FRA,DF,32,1990,8.5,9,5,4,5,0,3,5,60.0,2,17,12,5,8,17,35,1,2023
FRA-Ligue 1,2022,Montpellier,Matis Carvalho,POR,GK,23,1999,1.5,0,0,0,0,0,0,0,,0,0,0,0,1,1,0,0,2023
FRA-Ligue 1,2022,Montpellier,Maxime Estève,FRA,DF,20,2002,18.3,24,13,17,5,2,12,17,70.6,5,28,17,11,34,58,90,0,2023
FRA-Ligue 1,2022,Montpellier,Nicolas Cozza,FRA,DF,23,1999,14.2,38,21,27,9,2,26,38,68.4,12,11,5,6,21,59,35,1,2023
FRA-Ligue 1,2022,Montpellier,Pedro Mendes,POR,DF,31,1990,0.1,0,0,0,0,0,0,0,,0,0,0,0,0,0,0,1,2023
FRA-Ligue 1,2022,Montpellier,Sacha Delaye,FRA,"FW,MF",20,2002,0.2,1,0,0,0,1,1,1,100.0,0,0,0,0,0,1,0,0,2023
FRA-Ligue 1,2022,Montpellier,Stephy Mavididi,ENG,FW,24,1998,14.3,24,19,12,8,4,13,27,48.1,14,21,1,20,4,28,10,0,2023
FRA-Ligue 1,2022,Montpellier,Thibault Tamas,FRA,DF,21,2001,0.1,0,0,0,0,0,0,0,,0,0,0,0,1,1,0,0,2023
FRA-Ligue 1,2022,Montpellier,Théo Sainte-Luce,FRA,DF,23,1998,5.9,13,11,8,5,0,7,14,50.0,7,7,2,5,10,23,11,0,2023
FRA-Ligue 1,2022,Montpellier,Téji Savanier,FRA,MF,30,1991,28.3,46,30,16,19,11,23,70,32.9,47,30,2,28,30,76,12,1,2023
FRA-Ligue 1,2022,Montpellier,Valère Germain,FRA,"FW,MF",32,1990,7.6,13,11,3,5,5,4,12,33.3,8,8,0,8,6,19,12,0,2023
FRA-Ligue 1,2022,Montpellier,Wahbi Khazri,TUN,"FW,MF",31,1991,18.2,26,13,13,7,6,6,25,24.0,19,17,1,16,9,35,20,0,2023
FRA-Ligue 1,2022,Nantes,Abdoul Kader Bamba,FRA,"FW,MF",28,1994,0.9,0,0,0,0,0,0,2,0.0,2,3,1,2,0,0,1,0,2023
FRA-Ligue 1,2022,Nantes,Alban Lafont,FRA,GK,23,1999,37.0,0,0,0,0,0,0,1,0.0,1,0,0,0,0,0,20,4,2023
FRA-Ligue 1,2022,Nantes,Andrei Girotto,BRA,"DF,MF",30,1992,35.0,122,73,71,45,6,74,132,56.1,58,55,24,31,73,195,176,1,2023
FRA-Ligue 1,2022,Nantes,Andy Delort,ALG,FW,30,1991,5.2,5,4,1,2,2,2,6,33.3,4,3,0,3,0,5,2,0,2023
FRA-Ligue 1,2022,Nantes,Charles Traore,MLI,DF,30,1992,5.4,8,5,5,2,1,5,7,71.4,2,9,2,7,10,18,12,0,2023
FRA-Ligue 1,2022,Nantes,Dennis Appiah,FRA,"DF,MF",30,1992,8.8,21,11,14,7,0,10,27,37.0,17,13,5,8,10,31,16,0,2023
FRA-Ligue 1,2022,Nantes,Evann Guessand,FRA,"FW,MF",21,2001,14.0,24,16,8,13,3,6,12,50.0,6,17,1,16,9,33,6,0,2023
FRA-Ligue 1,2022,Nantes,Fabien Centonze,FRA,DF,26,1996,18.8,58,37,30,22,6,30,42,71.4,12,24,7,17,44,102,55,1,2023
FRA-Ligue 1,2022,Nantes,Florent Mollet,FRA,MF,30,1991,12.1,14,6,5,4,5,7,24,29.2,17,12,1,11,10,24,11,0,2023
FRA-Ligue 1,2022,Nantes,Fábio,BRA,"DF,MF",32,1990,2.5,4,2,1,2,1,4,6,66.7,2,2,0,2,3,7,11,0,2023
FRA-Ligue 1,2022,Nantes,Ignatius Ganago,CMR,"FW,MF",23,1999,16.9,9,7,2,3,4,4,7,57.1,3,13,1,12,2,11,12,0,2023
FRA-Ligue 1,2022,Nantes,Jaouen Hadjam,ALG,DF,19,2003,8.9,27,21,13,9,5,16,25,64.0,9,10,3,7,12,39,12,0,2023
FRA-Ligue 1,2022,Nantes,Jean-Charles Castelletto,CMR,DF,27,1995,28.5,43,26,29,12,2,22,36,61.1,14,35,22,13,58,101,90,0,2023
FRA-Ligue 1,2022,Nantes,João Victor,BRA,DF,24,1998,9.4,19,11,9,7,3,12,22,54.5,10,11,1,10,15,34,30,0,2023
FRA-Ligue 1,2022,Nantes,Lohann Doucet,FRA,"MF,FW",19,2002,1.0,3,0,2,0,1,3,4,75.0,1,2,0,2,2,5,4,0,2023
FRA-Ligue 1,2022,Nantes,Ludovic Blas,FRA,"MF,FW",24,1997,31.3,47,30,17,19,11,17,49,34.7,32,26,1,25,19,66,8,0,2023
FRA-Ligue 1,2022,Nantes,Marcus Coco,FRA,"FW,MF",26,1996,7.1,24,15,11,9,4,11,23,47.8,12,13,3,10,14,38,7,0,2023
FRA-Ligue 1,2022,Nantes,Mohamed Achi,FRA,FW,20,2002,0.4,1,1,1,0,0,1,1,100.0,0,0,0,0,0,1,0,0,2023
FRA-Ligue 1,2022,Nantes,Moses Simon,NGA,"FW,MF",27,1995,26.1,18,9,6,7,5,7,15,46.7,8,14,1,13,11,29,3,0,2023
FRA-Ligue 1,2022,Nantes,Mostafa Mohamed,EGY,FW,24,1997,21.5,18,13,5,7,6,9,20,45.0,11,23,1,22,10,28,33,0,2023
FRA-Ligue 1,2022,Nantes,Moussa Sissoko,FRA,MF,32,1989,21.3,26,16,16,7,3,12,18,66.7,6,22,5,17,16,42,17,0,2023
FRA-Ligue 1,2022,Nantes,Nathan Zeze,FRA,DF,17,2005,0.7,3,2,2,1,0,1,1,100.0,0,0,0,0,0,3,1,0,2023
FRA-Ligue 1,2022,Nantes,Nicolas Pallois,FRA,DF,34,1987,24.6,69,44,51,16,2,42,70,60.0,28,35,18,17,30,99,131,2,2023
FRA-Ligue 1,2022,Nantes,Pedro Chirivella,ESP,MF,25,1997,22.5,33,22,12,15,6,17,44,38.6,27,24,1,23,20,53,7,0,2023
FRA-Ligue 1,2022,Nantes,Quentin Merlin,FRA,DF,20,2002,19.9,31,19,19,8,4,18,38,47.4,20,27,4,23,24,55,30,0,2023
FRA-Ligue 1,2022,Nantes,Rémy Descamps,FRA,GK,26,1996,1.0,0,0,0,0,0,0,0,,0,0,0,0,0,0,0,0,2023
FRA-Ligue 1,2022,Nantes,Samuel Moutoussamy,COD,MF,25,1996,26.7,64,34,27,28,9,26,76,34.2,50,23,2,21,24,88,15,0,2023
FRA-Ligue 1,2022,Nantes,Stredair Appuah,FRA,"DF,MF",18,2004,0.7,2,1,0,2,0,0,0,,0,2,0,2,1,3,0,0,2023
FRA-Ligue 1,2022,Nantes,Sébastien Corchia,FRA,DF,31,1990,8.7,16,6,10,2,4,11,22,50.0,11,9,3,6,14,30,21,0,2023
FRA-Ligue 1,2022,Nice,Aaron Ramsey,WAL,MF,31,1990,17.6,47,25,18,19,10,16,39,41.0,23,25,4,21,17,64,18,1,2023
FRA-Ligue 1,2022,Nice,Alexis Beka Beka,FRA,"MF,DF",21,2001,6.1,16,5,6,9,1,4,15,26.7,11,9,1,8,12,28,6,0,2023
FRA-Ligue 1,2022,Nice,Alexis Claude-Maurice,FRA,FW,24,1998,0.7,3,2,2,1,0,3,3,100.0,0,0,0,0,2,5,1,0,2023
FRA-Ligue 1,2022,Nice,Amine Gouiri,FRA,"FW,MF",22,2000,2.5,1,1,1,0,0,0,1,0.0,1,1,0,1,0,1,3,0,2023
FRA-Ligue 1,2022,Nice,Andréa Dacourt,FRA,MF,17,2005,0.0,0,0,0,0,0,0,0,,0,0,0,0,0,0,0,0,2023
FRA-Ligue 1,2022,Nice,Andy Delort,ALG,FW,30,1991,8.7,2,0,1,1,0,1,2,50.0,1,0,0,0,1,3,7,0,2023
FRA-Ligue 1,2022,Nice,Antoine Mendy,FRA,DF,18,2004,5.8,22,13,16,5,1,9,15,60.0,6,6,1,5,2,24,16,0,2023
FRA-Ligue 1,2022,Nice,Ayoub Amraoui,MAR,"DF,FW",18,2004,3.3,6,5,3,3,0,2,5,40.0,3,1,0,1,4,10,4,0,2023
FRA-Ligue 1,2022,Nice,Badredine Bouanani,ALG,"FW,MF",17,2004,9.6,13,9,2,7,4,7,14,50.0,7,4,0,4,1,14,2,0,2023
FRA-Ligue 1,2022,Nice,Bilal Brahimi,ALG,"FW,MF",22,2000,8.9,8,5,2,5,1,1,7,14.3,6,4,0,4,4,12,0,0,2023
FRA-Ligue 1,2022,Nice,Calvin Stengs,NED,FW,23,1998,2.4,2,2,1,0,1,1,2,50.0,1,0,0,0,0,2,0,0,2023
FRA-Ligue 1,2022,Nice,Dante,BRA,DF,38,1983,36.7,70,40,45,21,4,36,59,61.0,23,52,31,21,47,117,125,2,2023
FRA-Ligue 1,2022,Nice,Flavius Daniliuc,AUT,DF,21,2001,1.0,2,0,2,0,0,1,1,100.0,0,4,1,3,0,2,1,0,2023
FRA-Ligue 1,2022,Nice,Gaëtan Laborde,FRA,FW,28,1994,27.8,45,25,13,17,15,18,40,45.0,22,27,2,25,9,54,13,0,2023
FRA-Ligue 1,2022,Nice,Hicham Boudaoui,ALG,MF,22,1999,20.8,67,32,31,30,6,35,53,66.0,18,34,5,29,36,103,16,0,2023
FRA-Ligue 1,2022,Nice,Jean-Clair Todibo,FRA,DF,22,1999,31.9,76,48,54,19,3,41,56,73.2,15,41,19,22,41,117,110,2,2023
FRA-Ligue 1,2022,Nice,Joe Bryan,ENG,"MF,DF",28,1993,2.0,5,4,3,2,0,4,4,100.0,0,2,0,2,1,6,1,0,2023
FRA-Ligue 1,2022,Nice,Jordan Lotomba,SUI,DF,23,1998,27.3,65,38,33,24,8,31,48,64.6,17,38,11,27,32,97,53,0,2023
FRA-Ligue 1,2022,Nice,Kasper Schmeichel,DEN,GK,35,1986,36.0,1,0,1,0,0,1,4,25.0,3,1,0,1,1,2,11,1,2023
FRA-Ligue 1,2022,Nice,Khéphren Thuram,FRA,MF,21,2001,28.3,51,25,22,23,6,19,43,44.2,24,33,13,20,38,89,34,0,2023
FRA-Ligue 1,2022,Nice,Marcin Bułka,POL,GK,22,1999,2.0,0,0,0,0,0,0,1,0.0,1,0,0,0,1,1,0,0,2023
FRA-Ligue 1,2022,Nice,Mario Lemina,GAB,"MF,DF",28,1993,9.3,32,21,11,14,7,12,18,66.7,6,13,5,8,11,43,20,0,2023
FRA-Ligue 1,2022,Nice,Mattia Viti,ITA,DF,20,2002,7.0,4,2,1,1,2,2,5,40.0,3,9,3,6,8,12,22,0,2023
FRA-Ligue 1,2022,Nice,Melvin Bard,FRA,DF,21,2000,27.3,96,60,61,29,6,59,89,66.3,30,35,4,31,64,160,40,1,2023
FRA-Ligue 1,2022,Nice,Nicolas Pépé,CIV,"FW,MF",27,1995,16.6,25,13,14,5,6,11,25,44.0,14,17,0,17,3,28,1,0,2023
FRA-Ligue 1,2022,Nice,Pablo Rosario,NED,"MF,DF",25,1997,19.6,46,26,22,20,4,18,34,52.9,16,15,5,10,23,69,32,1,2023
FRA-Ligue 1,2022,Nice,Rareş Ilie,ROU,"MF,FW",19,2003,1.6,3,3,0,1,2,2,4,50.0,2,2,0,2,1,4,1,0,2023
FRA-Ligue 1,2022,Nice,Reda Belahyane,FRA,MF,18,2004,2.0,8,6,5,3,0,3,5,60.0,2,5,1,4,2,10,0,0,2023
FRA-Ligue 1,2022,Nice,Ross Barkley,ENG,"MF,FW",28,1993,10.7,16,9,7,4,5,7,13,53.8,6,7,2,5,8,24,6,0,2023
FRA-Ligue 1,2022,Nice,Sofiane Diop,FRA,"MF,FW",22,2000,13.6,23,11,12,6,5,7,20,35.0,13,14,2,12,16,39,5,0,2023
FRA-Ligue 1,2022,Nice,Terem Moffi,NGA,FW,23,1999,14.8,12,6,0,6,6,2,12,16.7,10,3,0,3,2,14,5,0,2023
FRA-Ligue 1,2022,Nice,Théo Trinker,FRA,MF,21,2001,0.0,0,0,0,0,0,0,0,,0,0,0,0,0,0,0,0,2023
FRA-Ligue 1,2022,Nice,Youcef Atal,ALG,"DF,MF",26,1996,8.7,38,22,18,15,5,23,32,71.9,9,9,0,9,14,52,13,0,2023
FRA-Ligue 1,2022,Nice,Youssouf Ndayishimiye,BDI,"MF,DF",23,1998,6.3,13,9,8,5,0,6,11,54.5,5,8,5,3,12,25,22,1,2023
FRA-Ligue 1,2022,Paris S-G,Achraf Hakimi,MAR,"DF,MF",23,1998,22.8,54,34,19,20,15,31,59,52.5,28,34,2,32,16,70,19,0,2023
FRA-Ligue 1,2022,Paris S-G,Alexandre Letellier,FRA,GK,31,1990,0.1,0,0,0,0,0,0,0,,0,0,0,0,0,0,0,0,2023
FRA-Ligue 1,2022,Paris S-G,Carlos Soler,ESP,MF,25,1997,13.2,20,12,6,10,4,10,19,52.6,9,12,4,8,4,24,6,0,2023
FRA-Ligue 1,2022,Paris S-G,Danilo Pereira,POR,"DF,MF",30,1991,26.8,32,17,15,14,3,19,26,73.1,7,26,19,7,36,68,59,1,2023
FRA-Ligue 1,2022,Paris S-G,El Chadaille Bitshiabu,FRA,DF,17,2005,6.5,10,7,7,2,1,3,12,25.0,9,9,7,2,9,19,13,3,2023
FRA-Ligue 1,2022,Paris S-G,Fabián Ruiz Peña,ESP,MF,26,1996,21.0,62,28,25,30,7,43,79,54.4,36,24,1,23,18,80,23,1,2023
FRA-Ligue 1,2022,Paris S-G,Gianluigi Donnarumma,ITA,GK,23,1999,37.9,1,0,1,0,0,1,2,50.0,1,0,0,0,0,1,12,4,2023
FRA-Ligue 1,2022,Paris S-G,Hugo Ekitike,FRA,FW,20,2002,12.8,12,4,1,10,1,4,12,33.3,8,12,0,12,9,21,3,0,2023
FRA-Ligue 1,2022,Paris S-G,Ilyes Housni,FRA,FW,17,2005,0.1,1,1,1,0,0,1,1,100.0,0,0,0,0,0,1,0,0,2023
FRA-Ligue 1,2022,Paris S-G,Ismaël Gharbi,ESP,"MF,FW",18,2004,0.6,0,0,0,0,0,0,2,0.0,2,2,0,2,3,3,0,0,2023
FRA-Ligue 1,2022,Paris S-G,Juan Bernat,ESP,"DF,MF",29,1993,18.3,32,16,18,9,5,21,39,53.8,18,11,2,9,9,41,22,1,2023
FRA-Ligue 1,2022,Paris S-G,Kylian Mbappé,FRA,FW,23,1998,31.3,10,4,0,5,5,5,16,31.3,11,5,0,5,5,15,6,0,2023
FRA-Ligue 1,2022,Paris S-G,Leandro Paredes,ARG,MF,28,1994,0.6,1,1,1,0,0,1,1,100.0,0,2,1,1,1,2,0,0,2023
FRA-Ligue 1,2022,Paris S-G,Lionel Messi,ARG,"FW,MF",35,1987,31.5,26,18,1,13,12,11,27,40.7,16,11,0,11,2,28,0,0,2023
FRA-Ligue 1,2022,Paris S-G,Marco Verratti,ITA,MF,29,1992,24.4,76,49,34,36,6,38,89,42.7,51,42,6,36,27,103,11,3,2023
FRA-Ligue 1,2022,Paris S-G,Marquinhos,BRA,DF,28,1994,30.2,33,25,18,12,3,18,26,69.2,8,43,27,16,23,56,83,2,2023
FRA-Ligue 1,2022,Paris S-G,Neymar,BRA,"MF,FW",30,1992,17.2,22,14,6,9,7,9,19,47.4,10,7,1,6,4,26,1,1,2023
FRA-Ligue 1,2022,Paris S-G,Nordi Mukiele,FRA,DF,24,1997,12.6,31,23,16,6,9,19,29,65.5,10,22,9,13,14,45,16,0,2023
FRA-Ligue 1,2022,Paris S-G,Nuno Mendes,POR,DF,20,2002,17.2,45,30,29,12,4,30,41,73.2,11,19,3,16,17,62,18,0,2023
FRA-Ligue 1,2022,Paris S-G,Pablo Sarabia,ESP,"FW,MF",30,1992,4.1,5,4,2,2,1,1,7,14.3,6,3,0,3,2,7,0,0,2023
FRA-Ligue 1,2022,Paris S-G,Presnel Kimpembe,FRA,DF,26,1995,8.1,17,8,9,6,2,9,13,69.2,4,12,7,5,13,30,9,1,2023
FRA-Ligue 1,2022,Paris S-G,Renato Sanches,POR,MF,24,1997,8.0,8,1,1,3,4,5,14,35.7,9,13,3,10,9,17,4,0,2023
FRA-Ligue 1,2022,Paris S-G,Sergio Ramos,ESP,DF,36,1986,30.0,34,26,14,18,2,23,44,52.3,21,29,13,16,34,68,93,3,2023
FRA-Ligue 1,2022,Paris S-G,Timothee Pembele,FRA,DF,19,2002,2.9,5,5,3,1,1,2,4,50.0,2,2,0,2,4,9,2,0,2023
FRA-Ligue 1,2022,Paris S-G,Vitinha,POR,MF,22,2000,27.2,58,25,21,27,10,27,83,32.5,56,27,4,23,25,83,15,0,2023
FRA-Ligue 1,2022,Paris S-G,Warren Zaire-Emery,FRA,"MF,DF",16,2006,10.3,17,10,5,10,2,8,29,27.6,21,11,0,11,12,29,17,0,2023
FRA-Ligue 1,2022,Reims,Alexis Flips,FRA,"FW,MF",22,2000,22.0,51,30,18,17,16,27,64,42.2,37,35,5,30,24,75,12,0,2023
FRA-Ligue 1,2022,Reims,Andrew Gravillon,GLP,DF,24,1998,11.5,16,8,9,6,1,8,13,61.5,5,18,9,9,21,37,36,0,2023
FRA-Ligue 1,2022,Reims,Arber Zeneli,KVX,"FW,MF",27,1995,11.1,9,3,3,3,3,5,12,41.7,7,8,0,8,2,11,2,0,2023
FRA-Ligue 1,2022,Reims,Azor Matusiwa,NED,MF,24,1998,27.6,66,41,30,29,7,36,61,59.0,25,37,11,26,46,112,52,0,2023
FRA-Ligue 1,2022,Reims,Banzouzi Locko,FRA,DF,20,2002,11.8,31,16,21,4,6,15,27,55.6,12,17,4,13,20,51,21,0,2023
FRA-Ligue 1,2022,Reims,Check Keita,FRA,DF,19,2003,7.6,12,9,9,3,0,4,9,44.4,5,6,5,1,5,17,24,1,2023
FRA-Ligue 1,2022,Reims,Dion Lopy,SEN,MF,20,2002,15.3,45,24,22,16,7,23,62,37.1,39,27,3,24,22,67,18,0,2023
FRA-Ligue 1,2022,Reims,El Bilal Touré,MLI,FW,20,2001,1.0,0,0,0,0,0,0,0,,0,2,0,2,0,0,1,0,2023
FRA-Ligue 1,2022,Reims,Emmanuel Agbadou,CIV,DF,25,1997,26.5,71,49,53,16,2,42,65,64.6,23,30,14,16,32,103,107,3,2023
FRA-Ligue 1,2022,Reims,Fallou Fall,SEN,DF,18,2004,0.4,0,0,0,0,0,0,1,0.0,1,3,3,0,0,0,4,0,2023
FRA-Ligue 1,2022,Reims,Folarin Balogun,USA,FW,21,2001,33.3,9,5,1,5,3,2,20,10.0,18,20,1,19,3,12,15,0,2023
FRA-Ligue 1,2022,Reims,Ibrahim Diakité,GUI,DF,18,2003,1.5,3,3,3,0,0,2,3,66.7,1,0,0,0,5,8,6,0,2023
FRA-Ligue 1,2022,Reims,Jens Cajuste,SWE,MF,22,1999,17.0,46,25,25,14,7,25,48,52.1,23,30,6,24,18,64,22,0,2023
FRA-Ligue 1,2022,Reims,Junya Ito,JPN,FW,29,1993,32.4,40,20,14,15,11,13,53,24.5,40,29,1,28,8,48,4,1,2023
FRA-Ligue 1,2022,Reims,Kaj Sierhuis,NED,"FW,MF",24,1998,2.4,3,3,1,0,2,0,5,0.0,5,3,1,2,1,4,2,0,2023
FRA-Ligue 1,2022,Reims,Kamory Doumbia,MLI,MF,19,2003,12.8,31,16,9,14,8,12,37,32.4,25,17,1,16,13,44,3,0,2023
FRA-Ligue 1,2022,Reims,Mamadou Diakhon,FRA,FW,16,2005,0.2,2,0,2,0,0,0,1,0.0,1,1,0,1,1,3,0,0,2023
FRA-Ligue 1,2022,Reims,Marshall Munetsi,ZIM,MF,26,1996,30.0,58,27,13,31,14,20,48,41.7,28,37,11,26,26,84,41,1,2023
FRA-Ligue 1,2022,Reims,Martin Adeline,FRA,"MF,FW",18,2003,1.2,3,3,2,1,0,3,4,75.0,1,3,1,2,3,6,3,0,2023
FRA-Ligue 1,2022,Reims,Maxime Busi,BEL,DF,22,1999,11.6,21,16,9,11,1,13,29,44.8,16,14,6,8,14,35,24,0,2023
FRA-Ligue 1,2022,Reims,Mitchell van Bergen,NED,"FW,DF",22,1999,10.1,18,8,6,7,5,8,20,40.0,12,8,2,6,6,24,11,0,2023
FRA-Ligue 1,2022,Reims,Mohamed Toure,AUS,"FW,MF",18,2004,0.3,0,0,0,0,0,0,0,,0,0,0,0,0,0,0,0,2023
FRA-Ligue 1,2022,Reims,Myziane Maolida,FRA,"MF,FW",23,1999,2.6,8,3,2,5,1,5,12,41.7,7,1,0,1,2,10,0,0,2023
FRA-Ligue 1,2022,Reims,Nathanael Mbuku,FRA,"FW,MF",20,2002,0.7,2,1,2,0,0,2,2,100.0,0,0,0,0,0,2,0,0,2023
FRA-Ligue 1,2022,Reims,Noah Holm,NOR,"FW,MF",21,2001,2.2,6,4,2,2,2,2,5,40.0,3,0,0,0,0,6,5,0,2023
FRA-Ligue 1,2022,Reims,Patrick Pentz,AUT,GK,25,1997,7.0,0,0,0,0,0,0,0,,0,0,0,0,0,0,1,0,2023
FRA-Ligue 1,2022,Reims,Rafik Guitane,FRA,FW,23,1999,0.0,0,0,0,0,0,0,0,,0,0,0,0,0,0,1,0,2023
FRA-Ligue 1,2022,Reims,Samuel Koeberlé,FRA,MF,17,2004,0.0,0,0,0,0,0,0,0,,0,0,0,0,0,0,0,0,2023
FRA-Ligue 1,2022,Reims,Thibault De Smet,BEL,DF,24,1998,19.5,24,17,10,14,0,11,37,29.7,26,28,5,23,20,44,40,1,2023
FRA-Ligue 1,2022,Reims,Thomas Foket,BEL,DF,27,1994,22.0,35,22,18,11,6,17,46,37.0,29,21,7,14,33,68,29,2,2023
FRA-Ligue 1,2022,Reims,Valentin Atangana Edoa,FRA,MF,16,2005,1.9,8,3,4,2,2,3,6,50.0,3,2,1,1,0,8,1,0,2023
FRA-Ligue 1,2022,Reims,Wout Faes,BEL,DF,24,1998,3.0,1,1,1,0,0,1,2,50.0,1,6,3,3,7,8,19,0,2023
FRA-Ligue 1,2022,Reims,Yehvann Diouf,FRA,GK,22,1999,31.0,2,0,2,0,0,1,3,33.3,2,0,0,0,1,3,13,5,2023
FRA-Ligue 1,2022,Reims,Yunis Abdelhamid,MAR,DF,34,1987,37.0,82,50,47,33,2,39,52,75.0,13,65,27,38,64,146,116,1,2023
FRA-Ligue 1,2022,Rennes,Adrien Truffert,FRA,DF,20,2001,21.7,62,32,36,17,9,31,46,67.4,15,32,8,24,22,84,55,0,2023
FRA-Ligue 1,2022,Rennes,Alan Do Marcolino,GAB,FW,20,2002,0.2,0,0,0,0,0,0,0,,0,0,0,0,0,0,1,0,2023
FRA-Ligue 1,2022,Rennes,Amine Gouiri,FRA,"FW,MF",22,2000,28.0,42,25,14,16,12,14,33,42.4,19,21,0,21,12,54,10,0,2023
FRA-Ligue 1,2022,Rennes,Arnaud Kalimuendo,FRA,FW,20,2002,20.5,15,8,3,6,6,5,20,25.0,15,15,2,13,2,17,9,0,2023
FRA-Ligue 1,2022,Rennes,Arthur Theate,BEL,DF,22,2000,34.7,29,19,17,8,4,17,30,56.7,13,26,14,12,30,59,114,3,2023
FRA-Ligue 1,2022,Rennes,Baptiste Santamaria,FRA,MF,27,1995,20.1,41,22,13,23,5,21,41,51.2,20,21,5,16,21,62,23,0,2023
FRA-Ligue 1,2022,Rennes,Benjamin Bourigeaud,FRA,"MF,FW",28,1994,34.1,45,29,16,23,6,21,65,32.3,44,38,3,35,31,76,32,0,2023
FRA-Ligue 1,2022,Rennes,Birger Meling,NOR,DF,27,1994,13.4,24,15,9,12,3,12,25,48.0,13,18,2,16,23,47,26,0,2023
FRA-Ligue 1,2022,Rennes,Chimuanya Ugochukwu,FRA,MF,18,2004,14.8,36,19,13,20,3,16,24,66.7,8,24,10,14,21,57,16,0,2023
FRA-Ligue 1,2022,Rennes,Christopher Wooh,CMR,DF,20,2001,11.2,16,7,8,8,0,9,11,81.8,2,11,5,6,6,22,49,0,2023
FRA-Ligue 1,2022,Rennes,Djed Spence,ENG,DF,21,2000,6.4,14,6,8,2,4,11,18,61.1,7,10,3,7,4,18,15,0,2023
FRA-Ligue 1,2022,Rennes,Doğan Alemdar,TUR,GK,19,2002,4.5,0,0,0,0,0,0,0,,0,0,0,0,0,0,1,1,2023
FRA-Ligue 1,2022,Rennes,Désiré Doué,FRA,"MF,FW",17,2005,12.4,37,18,10,23,4,13,32,40.6,19,17,1,16,13,50,3,0,2023
FRA-Ligue 1,2022,Rennes,Flavien Tait,FRA,MF,29,1993,18.7,30,15,8,17,5,19,42,45.2,23,16,4,12,20,50,12,0,2023
FRA-Ligue 1,2022,Rennes,Gaëtan Laborde,FRA,FW,28,1994,2.8,1,1,1,0,0,0,1,0.0,1,1,0,1,0,1,1,0,2023
FRA-Ligue 1,2022,Rennes,Guela Doué,FRA,"FW,MF",19,2002,0.1,0,0,0,0,0,0,0,,0,0,0,0,0,0,0,0,2023
FRA-Ligue 1,2022,Rennes,Hamari Traoré,MLI,DF,30,1992,28.1,48,32,26,15,7,28,52,53.8,24,33,7,26,38,86,64,0,2023
FRA-Ligue 1,2022,Rennes,Ibrahim Salah,MAR,"FW,MF",20,2001,2.5,8,1,5,3,0,2,15,13.3,13,3,0,3,2,10,0,0,2023
FRA-Ligue 1,2022,Rennes,Jeanöel Belocian,FRA,DF,17,2005,5.6,10,7,3,5,2,5,9,55.6,4,6,3,3,6,16,11,0,2023
FRA-Ligue 1,2022,Rennes,Jeremy Doku,BEL,"MF,FW",20,2002,14.3,25,16,6,13,6,12,24,50.0,12,10,0,10,5,30,2,0,2023
FRA-Ligue 1,2022,Rennes,Joe Rodon,WAL,DF,24,1997,15.7,11,7,9,2,0,4,10,40.0,6,16,12,4,9,20,54,1,2023
FRA-Ligue 1,2022,Rennes,Kamaldeen Sulemana,GHA,"FW,MF",20,2002,3.6,6,3,1,4,1,1,5,20.0,4,2,0,2,4,10,2,0,2023
FRA-Ligue 1,2022,Rennes,Karl Toko Ekambi,CMR,"FW,MF",29,1992,10.8,3,1,1,1,1,3,9,33.3,6,5,0,5,9,12,3,0,2023
FRA-Ligue 1,2022,Rennes,Lorenz Assignon,TOG,DF,22,2000,2.9,6,2,4,2,0,2,4,50.0,2,6,0,6,2,8,9,0,2023
FRA-Ligue 1,2022,Rennes,Lovro Majer,CRO,"MF,FW",24,1998,18.5,34,23,16,13,5,8,29,27.6,21,21,1,20,21,55,5,1,2023
FRA-Ligue 1,2022,Rennes,Loïc Bade,FRA,DF,22,2000,1.0,1,1,1,0,0,0,0,,0,0,0,0,1,2,3,0,2023
FRA-Ligue 1,2022,Rennes,Martin Terrier,FRA,"FW,MF",25,1997,14.7,25,11,7,9,9,13,24,54.2,11,15,2,13,14,39,6,0,2023
FRA-Ligue 1,2022,Rennes,Matthis Abline,FRA,"FW,MF",19,2003,1.2,1,1,0,0,1,1,1,100.0,0,1,0,1,2,3,1,0,2023
FRA-Ligue 1,2022,Rennes,Sehrou Guirassy,GUI,MF,26,1996,0.3,0,0,0,0,0,0,0,,0,0,0,0,0,0,0,0,2023
FRA-Ligue 1,2022,Rennes,Steve Mandanda,FRA,GK,37,1985,33.5,0,0,0,0,0,0,2,0.0,2,0,0,0,0,0,9,3,2023
FRA-Ligue 1,2022,Rennes,Warmed Omari,FRA,DF,22,2000,15.1,20,11,14,6,0,14,28,50.0,14,13,7,6,17,37,43,1,2023
FRA-Ligue 1,2022,Rennes,Xeka,POR,MF,27,1994,6.1,10,3,6,3,1,7,16,43.8,9,11,2,9,6,16,8,0,2023
FRA-Ligue 1,2022,Strasbourg,Adrien Thomasson,FRA,MF,28,1993,10.4,19,9,8,6,5,9,30,30.0,21,18,0,18,3,22,2,0,2023
FRA-Ligue 1,2022,Strasbourg,Alexander Djiku,GHA,DF,27,1994,29.7,53,36,37,16,0,26,46,56.5,20,45,19,26,66,119,151,3,2023
FRA-Ligue 1,2022,Strasbourg,Colin Dagba,FRA,"DF,MF",23,1998,10.6,32,20,17,10,5,19,26,73.1,7,18,2,16,17,49,19,0,2023
FRA-Ligue 1,2022,Strasbourg,Dany Jean,HAI,"DF,MF",19,2002,0.1,0,0,0,0,0,0,1,0.0,1,1,0,1,0,0,0,0,2023
FRA-Ligue 1,2022,Strasbourg,Dimitri Liénard,FRA,"DF,MF",34,1988,17.1,46,29,20,18,8,34,57,59.6,23,28,4,24,16,62,24,0,2023
FRA-Ligue 1,2022,Strasbourg,Eduard Sobol,UKR,DF,27,1995,9.7,19,10,10,6,3,9,13,69.2,4,10,1,9,8,27,19,0,2023
FRA-Ligue 1,2022,Strasbourg,Franci Bouebari,FRA,DF,18,2003,0.8,3,0,1,2,0,3,5,60.0,2,0,0,0,2,5,2,0,2023
FRA-Ligue 1,2022,Strasbourg,Frederic Guilbert,FRA,DF,27,1994,16.2,47,29,18,23,6,25,43,58.1,18,24,3,21,43,90,33,1,2023
FRA-Ligue 1,2022,Strasbourg,Gerzino Nyamsi,FRA,DF,25,1997,17.5,28,20,14,12,2,10,12,83.3,2,19,11,8,10,38,63,1,2023
FRA-Ligue 1,2022,Strasbourg,Habib Diallo,SEN,FW,27,1995,32.0,18,10,8,7,3,6,16,37.5,10,19,4,15,12,30,26,0,2023
FRA-Ligue 1,2022,Strasbourg,Ibrahima Sissoko,FRA,MF,24,1997,14.6,40,22,18,17,5,22,42,52.4,20,20,6,14,10,50,19,0,2023
FRA-Ligue 1,2022,Strasbourg,Ismaël Doukouré,FRA,"DF,MF",19,2003,25.5,48,24,23,21,4,20,34,58.8,14,26,8,18,27,75,54,0,2023
FRA-Ligue 1,2022,Strasbourg,Jean-Eudes Aholou,CIV,MF,28,1994,14.4,34,20,10,20,4,12,31,38.7,19,25,0,25,24,58,15,0,2023
FRA-Ligue 1,2022,Strasbourg,Jean-Ricner Bellegarde,FRA,"MF,FW",24,1998,26.9,47,25,15,21,11,11,25,44.0,14,26,3,23,26,73,22,0,2023
FRA-Ligue 1,2022,Strasbourg,Karol Fila,POL,DF,24,1998,0.5,0,0,0,0,0,0,0,,0,0,0,0,1,1,1,0,2023
FRA-Ligue 1,2022,Strasbourg,Kévin Gameiro,FRA,FW,35,1987,23.3,20,10,6,10,4,8,28,28.6,20,10,1,9,9,29,0,0,2023
FRA-Ligue 1,2022,Strasbourg,Lebo Mothiba,RSA,"FW,MF",26,1996,4.8,1,0,1,0,0,0,1,0.0,1,6,1,5,0,1,4,0,2023
FRA-Ligue 1,2022,Strasbourg,Lucas Perrin,FRA,DF,23,1998,19.6,44,27,28,14,2,25,49,51.0,24,13,5,8,36,80,53,0,2023
FRA-Ligue 1,2022,Strasbourg,Ludovic Ajorque,FRA,FW,28,1994,8.6,5,4,1,4,0,3,9,33.3,6,3,1,2,2,7,7,0,2023
FRA-Ligue 1,2022,Strasbourg,Marvin Senaya,TOG,DF,21,2001,0.1,0,0,0,0,0,0,1,0.0,1,1,0,1,0,0,1,0,2023
FRA-Ligue 1,2022,Strasbourg,Matz Sels,BEL,GK,30,1992,38.0,4,3,4,0,0,4,4,100.0,0,0,0,0,4,8,23,0,2023
FRA-Ligue 1,2022,Strasbourg,Maxime Le Marchand,FRA,DF,32,1989,22.4,39,24,23,14,2,19,31,61.3,12,22,14,8,37,76,74,0,2023
FRA-Ligue 1,2022,Strasbourg,Morgan Sanson,FRA,MF,27,1994,15.8,36,25,10,16,10,17,56,30.4,39,21,1,20,22,58,9,0,2023
FRA-Ligue 1,2022,Strasbourg,Mouhamadou Diarra,SEN,"MF,FW",18,2004,18.1,24,16,10,11,3,15,29,51.7,14,17,1,16,11,35,13,0,2023
FRA-Ligue 1,2022,Strasbourg,Nordine Kandil,FRA,"MF,FW",20,2001,1.1,3,2,1,2,0,0,3,0.0,3,2,0,2,1,4,1,0,2023
FRA-Ligue 1,2022,Strasbourg,Ronaël Pierre-Gabriel,FRA,DF,24,1998,7.3,25,18,11,12,2,15,17,88.2,2,16,3,13,9,34,22,0,2023
FRA-Ligue 1,2022,Strasbourg,Sanjin Prcić,BIH,MF,28,1993,18.1,27,12,6,16,5,19,31,61.3,12,22,7,15,25,52,22,0,2023
FRA-Ligue 1,2022,Strasbourg,Thomas Delaine,FRA,"DF,MF",30,1992,11.9,28,14,16,6,6,13,26,50.0,13,8,3,5,16,44,9,0,2023
FRA-Ligue 1,2022,Strasbourg,Yuito Suzuki,JPN,"FW,MF",20,2001,0.4,0,0,0,0,0,0,0,,0,3,0,3,0,0,0,0,2023
FRA-Ligue 1,2022,Toulouse,Ado Onaiwu,JPN,FW,26,1995,12.0,11,6,4,4,3,5,13,38.5,8,5,1,4,2,13,5,0,2023
FRA-Ligue 1,2022,Toulouse,Anthony Rouault,FRA,DF,21,2001,36.8,66,37,54,10,2,30,58,51.7,28,52,26,26,56,122,126,4,2023
FRA-Ligue 1,2022,Toulouse,Branco van den Boomen,NED,MF,27,1995,32.1,71,36,26,32,13,36,89,40.4,53,27,4,23,10,81,27,2,2023
FRA-Ligue 1,2022,Toulouse,Brecht Dejaegere,BEL,MF,31,1991,20.1,40,23,10,20,10,15,51,29.4,36,25,5,20,14,54,11,0,2023
FRA-Ligue 1,2022,Toulouse,Christian Mawissa,FRA,DF,17,2005,1.1,2,0,1,1,0,1,3,33.3,2,0,0,0,3,5,1,0,2023
FRA-Ligue 1,2022,Toulouse,Denis Genreau,AUS,MF,23,1999,7.3,35,13,16,12,7,13,31,41.9,18,16,1,15,8,43,9,0,2023
FRA-Ligue 1,2022,Toulouse,Fares Chaïbi,ALG,"FW,MF",19,2002,26.0,31,18,8,15,8,17,50,34.0,33,38,5,33,19,50,36,1,2023
FRA-Ligue 1,2022,Toulouse,Gabriel Suazo,CHI,DF,24,1997,14.0,38,22,20,15,3,29,63,46.0,34,21,5,16,22,60,24,1,2023
FRA-Ligue 1,2022,Toulouse,Issiaga Sylla,GUI,DF,28,1994,15.2,28,15,14,9,5,15,34,44.1,19,15,5,10,38,66,38,0,2023
FRA-Ligue 1,2022,Toulouse,Kévin Keben Biakolo,CMR,DF,18,2004,4.0,3,2,2,0,1,0,4,0.0,4,1,0,1,5,8,9,0,2023
FRA-Ligue 1,2022,Toulouse,Logan Costa,CPV,DF,21,2001,4.6,9,4,7,1,1,6,9,66.7,3,6,3,3,4,13,12,0,2023
FRA-Ligue 1,2022,Toulouse,Maxime Dupé,FRA,GK,29,1993,38.0,0,0,0,0,0,0,0,,0,0,0,0,0,0,9,3,2023
FRA-Ligue 1,2022,Toulouse,Mikkel Desler,DEN,DF,27,1995,25.1,71,38,36,27,8,43,67,64.2,24,35,6,29,36,107,48,2,2023
FRA-Ligue 1,2022,Toulouse,Moussa Diarra,MLI,DF,21,2000,13.6,20,9,9,9,2,9,15,60.0,6,25,10,15,19,39,27,1,2023
FRA-Ligue 1,2022,Toulouse,Naatan Skyttä,FIN,MF,20,2002,0.3,0,0,0,0,0,0,0,,0,0,0,0,1,1,0,0,2023
FRA-Ligue 1,2022,Toulouse,Nathan N'Goumou,FRA,FW,22,2000,1.0,3,2,2,1,0,1,1,100.0,0,2,0,2,2,5,0,0,2023
FRA-Ligue 1,2022,Toulouse,Oliver Zandén,SWE,"DF,MF",20,2001,1.6,2,1,1,0,1,2,5,40.0,3,0,0,0,1,3,7,0,2023
FRA-Ligue 1,2022,Toulouse,Rafael Ratão,BRA,"FW,MF",26,1995,20.6,52,36,29,16,7,27,73,37.0,46,34,0,34,21,73,7,0,2023
FRA-Ligue 1,2022,Toulouse,Rasmus Nicolaisen,DEN,DF,25,1997,33.3,48,21,34,14,0,29,46,63.0,17,58,45,13,50,98,152,0,2023
FRA-Ligue 1,2022,Toulouse,Rhys Healey,WAL,FW,27,1994,0.7,0,0,0,0,0,0,0,,0,0,0,0,0,0,0,0,2023
FRA-Ligue 1,2022,Toulouse,Saïd Hamulic,BIH,FW,21,2000,1.2,0,0,0,0,0,0,0,,0,0,0,0,0,0,0,0,2023
FRA-Ligue 1,2022,Toulouse,Stijn Spierings,NED,MF,26,1996,34.7,95,67,37,49,9,43,101,42.6,58,49,11,38,53,148,44,0,2023
FRA-Ligue 1,2022,Toulouse,Theocharis Tsingaras,GRE,MF,21,2000,0.1,0,0,0,0,0,0,0,,0,0,0,0,0,0,0,0,2023
FRA-Ligue 1,2022,Toulouse,Thijs Dallinga,NED,FW,21,2000,26.1,8,6,2,2,4,1,13,7.7,12,17,3,14,3,11,20,0,2023
FRA-Ligue 1,2022,Toulouse,Veljko Birmančević,SRB,"FW,MF",24,1998,4.9,13,7,5,4,4,7,21,33.3,14,12,2,10,7,20,1,0,2023
FRA-Ligue 1,2022,Toulouse,Vincent Sierro,SUI,MF,26,1995,7.4,19,11,9,9,1,11,29,37.9,18,12,3,9,4,23,11,1,2023
FRA-Ligue 1,2022,Toulouse,Waren Kamanzi,NOR,DF,21,2000,7.4,16,9,9,5,2,13,19,68.4,6,8,2,6,8,24,9,0,2023
FRA-Ligue 1,2022,Toulouse,Yanis Begraoui,MAR,"FW,MF",21,2001,0.7,2,0,1,0,1,1,2,50.0,1,0,0,0,1,3,0,0,2023
FRA-Ligue 1,2022,Toulouse,Zakaria Aboukhlal,MAR,"FW,MF",22,2000,27.5,33,23,13,9,11,14,45,31.1,31,18,1,17,22,55,23,0,2023
FRA-Ligue 1,2022,Troyes,Abdu Conté,POR,DF,24,1998,14.6,25,17,14,8,3,12,22,54.5,10,13,6,7,6,31,25,0,2023
FRA-Ligue 1,2022,Troyes,Adil Rami,FRA,DF,36,1985,17.7,19,14,13,5,1,17,32,53.1,15,23,16,7,25,44,75,3,2023
FRA-Ligue 1,2022,Troyes,Alexis Tibidi,FRA,"FW,MF",18,2003,0.8,1,1,1,0,0,0,0,,0,0,0,0,0,1,0,0,2023
FRA-Ligue 1,2022,Troyes,Amar Ahmed,SWE,FW,18,2004,0.2,1,1,0,1,0,0,1,0.0,1,0,0,0,1,2,0,0,2023
FRA-Ligue 1,2022,Troyes,Andreas Bruus,DEN,"DF,FW",23,1999,18.1,12,6,9,3,0,8,20,40.0,12,13,2,11,17,29,24,0,2023
FRA-Ligue 1,2022,Troyes,Ante Palaversa,CRO,MF,22,2000,0.3,1,1,1,0,0,0,0,,0,0,0,0,1,2,0,0,2023
FRA-Ligue 1,2022,Troyes,Derek Mazou-Sacko,FRA,MF,17,2004,0.2,0,0,0,0,0,0,1,0.0,1,1,0,1,1,1,1,0,2023
FRA-Ligue 1,2022,Troyes,Erik Palmer-Brown,USA,DF,25,1997,35.5,42,27,31,10,1,18,33,54.5,15,56,29,27,26,68,166,1,2023
FRA-Ligue 1,2022,Troyes,Florian Tardieu,FRA,MF,30,1992,11.2,31,20,19,12,0,12,31,38.7,19,19,4,15,23,54,15,0,2023
FRA-Ligue 1,2022,Troyes,Gauthier Gallon,FRA,GK,29,1993,29.6,2,2,2,0,0,2,4,50.0,2,0,0,0,2,4,17,0,2023
FRA-Ligue 1,2022,Troyes,Ike Ugbo,CAN,"FW,MF",23,1998,9.9,5,2,2,2,1,3,11,27.3,8,8,2,6,2,7,4,0,2023
FRA-Ligue 1,2022,Troyes,Jackson Porozo,ECU,DF,21,2000,18.0,32,20,24,7,1,13,31,41.9,18,24,17,7,33,65,75,0,2023
FRA-Ligue 1,2022,Troyes,Jeff Reine-Adélaïde,FRA,MF,24,1998,2.6,3,2,2,1,0,1,2,50.0,1,2,0,2,2,5,1,0,2023
FRA-Ligue 1,2022,Troyes,Jordan Dongmo,CMR,MF,21,2001,0.2,1,0,0,1,0,1,1,100.0,0,0,0,0,0,1,0,0,2023
FRA-Ligue 1,2022,Troyes,Kyliane Dong,FRA,"MF,FW",17,2004,2.4,3,1,0,2,1,1,2,50.0,1,1,0,1,1,4,0,0,2023
FRA-Ligue 1,2022,Troyes,Lucien Agoume,FRA,MF,20,2002,12.2,42,25,18,15,9,17,33,51.5,16,14,5,9,27,69,24,0,2023
FRA-Ligue 1,2022,Troyes,Mama Samba Baldé,GNB,FW,26,1995,29.6,46,21,14,21,11,13,28,46.4,15,30,3,27,10,56,13,0,2023
FRA-Ligue 1,2022,Troyes,Marlos Moreno,COL,"MF,DF",25,1996,0.1,2,2,2,0,0,2,3,66.7,1,1,1,0,0,2,0,0,2023
FRA-Ligue 1,2022,Troyes,Mateusz Lis,POL,GK,25,1997,8.3,0,0,0,0,0,0,1,0.0,1,1,0,1,0,0,3,0,2023
FRA-Ligue 1,2022,Troyes,Mathis Hamdi,FRA,DF,18,2003,0.8,0,0,0,0,0,0,1,0.0,1,0,0,0,1,1,1,0,2023
FRA-Ligue 1,2022,Troyes,Papa Ndiaga Yade,SEN,"DF,MF",22,2000,6.3,10,6,6,2,2,7,22,31.8,15,10,2,8,8,18,10,0,2023
FRA-Ligue 1,2022,Troyes,Renaud Ripart,FRA,"FW,MF",29,1993,14.7,40,23,14,20,6,19,52,36.5,33,29,2,27,7,47,5,0,2023
FRA-Ligue 1,2022,Troyes,Rominigue Kouamé,MLI,MF,25,1996,29.6,44,27,28,14,2,17,41,41.5,24,32,11,21,49,93,46,1,2023
FRA-Ligue 1,2022,Troyes,Rony Lopes,POR,"MF,FW",26,1995,26.1,24,12,6,15,3,7,31,22.6,24,14,2,12,9,33,10,0,2023
FRA-Ligue 1,2022,Troyes,Rudy Kohon,FRA,DF,18,2004,0.7,4,3,4,0,0,2,2,100.0,0,1,0,1,1,5,2,0,2023
FRA-Ligue 1,2022,Troyes,Tanguy Zoukrou,FRA,DF,19,2003,5.7,14,7,8,6,0,10,14,71.4,4,18,11,7,2,16,24,0,2023
FRA-Ligue 1,2022,Troyes,Thierno Balde,FRA,"DF,MF",20,2002,23.9,27,14,19,4,4,18,30,60.0,12,15,3,12,23,50,39,0,2023
FRA-Ligue 1,2022,Troyes,Tristan Dingomé,CMR,MF,31,1991,1.1,1,1,0,1,0,0,2,0.0,2,0,0,0,0,1,0,0,2023
FRA-Ligue 1,2022,Troyes,Wilson Odobert,FRA,"MF,FW",17,2004,19.6,20,14,10,7,3,9,25,36.0,16,11,0,11,15,35,5,0,2023
FRA-Ligue 1,2022,Troyes,Xavier Chavalerin,FRA,MF,31,1991,27.0,82,50,39,30,13,27,71,38.0,44,31,8,23,41,123,24,0,2023
FRA-Ligue 1,2022,Troyes,Yasser Larouci,FRA,"DF,MF",21,2001,20.0,23,13,13,8,2,15,24,62.5,9,15,1,14,26,49,46,0,2023
FRA-Ligue 1,2022,Troyes,Yoann Salmier,GUF,DF,29,1992,29.4,51,29,34,12,5,21,35,60.0,14,34,19,15,39,90,124,0,2023
GER-Bundesliga,2017,Augsburg,Alfreð Finnbogason,ISL,FW,28,1989,20.2,18,13,7,5,6,8,15,53.3,7,15,1,14,14,32,7,0,2018
GER-Bundesliga,2017,Augsburg,Andreas Luthe,GER,GK,30,1987,2.0,0,0,0,0,0,0,0,,0,0,0,0,0,0,2,0,2018
GER-Bundesliga,2017,Augsburg,Caiuby,BRA,FW,29,1988,31.7,53,40,20,27,6,17,42,40.5,25,36,1,35,15,68,42,2,2018
GER-Bundesliga,2017,Augsburg,Christoph Janker,GER,"DF,MF",32,1985,0.9,4,3,3,1,0,2,3,66.7,1,0,0,0,1,5,4,1,2018
GER-Bundesliga,2017,Augsburg,Daniel Baier,GER,MF,33,1984,28.2,83,62,38,40,5,46,83,55.4,37,26,5,21,57,140,41,1,2018
GER-Bundesliga,2017,Augsburg,Daniel Opare,GHA,DF,26,1990,15.7,31,27,20,10,1,21,27,77.8,6,14,5,9,28,59,56,0,2018
GER-Bundesliga,2017,Augsburg,Erik Thommy,GER,FW,22,1994,1.9,6,5,1,3,2,3,8,37.5,5,2,0,2,5,11,0,0,2018
GER-Bundesliga,2017,Augsburg,Gojko Kačar,SRB,DF,30,1987,2.5,7,6,6,1,0,3,7,42.9,4,3,2,1,4,11,7,0,2018
GER-Bundesliga,2017,Augsburg,Jan Morávek,CZE,MF,27,1989,7.8,41,37,17,23,1,21,36,58.3,15,19,3,16,11,52,11,0,2018
GER-Bundesliga,2017,Augsburg,Jeffrey Gouweleeuw,NED,DF,26,1991,26.5,57,44,36,18,3,27,41,65.9,14,36,10,26,54,111,128,0,2018
GER-Bundesliga,2017,Augsburg,Ji Dong-won,KOR,"FW,MF",26,1991,0.2,2,1,0,1,1,0,0,,0,1,1,0,1,3,0,0,2018
GER-Bundesliga,2017,Augsburg,Jonathan Schmid,FRA,"DF,FW",27,1990,16.4,23,16,6,13,4,11,18,61.1,7,16,1,15,10,33,35,1,2018
GER-Bundesliga,2017,Augsburg,Kevin Danso,AUT,DF,18,1998,12.3,18,12,13,5,0,12,16,75.0,4,21,14,7,20,38,63,1,2018
GER-Bundesliga,2017,Augsburg,Kilian Jakob,GER,FW,19,1998,0.6,0,0,0,0,0,0,0,,0,1,0,1,0,0,1,0,2018
GER-Bundesliga,2017,Augsburg,Koo Ja-cheol,KOR,MF,28,1989,22.7,54,41,18,31,5,27,44,61.4,17,22,3,19,27,81,34,2,2018
GER-Bundesliga,2017,Augsburg,Kostas Stafylidis,GRE,"FW,DF",23,1993,0.4,1,1,1,0,0,0,0,,0,1,0,1,0,1,2,0,2018
GER-Bundesliga,2017,Augsburg,Marcel Heller,GER,"FW,MF",31,1986,14.4,37,24,21,14,2,12,28,42.9,16,22,1,21,10,47,7,0,2018
GER-Bundesliga,2017,Augsburg,Marco Richter,GER,FW,19,1997,7.2,17,14,8,8,1,8,17,47.1,9,5,1,4,1,18,10,0,2018
GER-Bundesliga,2017,Augsburg,Martin Hinteregger,AUT,DF,24,1992,29.5,79,51,55,22,2,47,61,77.0,14,40,27,13,49,128,135,3,2018
GER-Bundesliga,2017,Augsburg,Marwin Hitz,SUI,GK,29,1987,32.0,1,1,1,0,0,1,3,33.3,2,0,0,0,0,1,12,3,2018
GER-Bundesliga,2017,Augsburg,Michael Gregoritsch,AUT,"MF,FW",23,1994,28.1,35,27,13,15,7,11,26,42.3,15,27,1,26,10,45,56,0,2018
GER-Bundesliga,2017,Augsburg,Philipp Max,GER,DF,23,1993,32.9,65,47,36,19,10,34,59,57.6,25,27,8,19,33,98,65,1,2018
GER-Bundesliga,2017,Augsburg,Rani Khedira,GER,"MF,DF",23,1994,25.3,62,47,25,28,9,33,47,70.2,14,41,18,23,36,98,96,0,2018
GER-Bundesliga,2017,Augsburg,Raphael Framberger,GER,DF,21,1995,7.7,22,18,14,6,2,15,16,93.8,1,12,3,9,14,36,15,0,2018
GER-Bundesliga,2017,Augsburg,Sergio Córdova,VEN,"FW,MF",19,1997,6.5,5,5,0,2,3,3,4,75.0,1,12,2,10,0,5,6,0,2018
GER-Bundesliga,2017,Augsburg,Shawn Parker,GER,"FW,MF",24,1993,0.5,0,0,0,0,0,0,0,,0,0,0,0,0,0,0,0,2018
GER-Bundesliga,2017,Augsburg,Simon Asta,GER,MF,16,2001,0.1,2,1,2,0,0,2,2,100.0,0,1,0,1,0,2,0,0,2018
GER-Bundesliga,2017,Bayern Munich,Arjen Robben,NED,"FW,MF",33,1984,16.7,14,11,1,7,6,4,12,33.3,8,9,0,9,4,18,4,0,2018
GER-Bundesliga,2017,Bayern Munich,Arturo Vidal,CHI,MF,30,1987,16.2,69,51,36,28,5,33,69,47.8,36,22,1,21,28,97,20,1,2018
GER-Bundesliga,2017,Bayern Munich,Corentin Tolisso,FRA,MF,22,1994,17.5,33,22,8,18,7,14,32,43.8,18,13,3,10,16,49,8,0,2018
GER-Bundesliga,2017,Bayern Munich,David Alaba,AUT,DF,25,1992,17.2,23,14,11,9,3,14,20,70.0,6,21,6,15,10,33,23,0,2018
GER-Bundesliga,2017,Bayern Munich,Franck Evina,CMR,FW,17,2000,1.2,2,2,2,0,0,2,2,100.0,0,5,0,5,0,2,0,0,2018
GER-Bundesliga,2017,Bayern Munich,Franck Ribéry,FRA,"FW,MF",34,1983,13.4,19,16,9,5,5,13,17,76.5,4,11,0,11,7,26,3,0,2018
GER-Bundesliga,2017,Bayern Munich,James Rodríguez,COL,"MF,FW",26,1991,18.0,35,27,10,15,10,15,30,50.0,15,16,1,15,12,47,4,0,2018
GER-Bundesliga,2017,Bayern Munich,Javi Martínez,ESP,"MF,DF",28,1988,17.9,31,22,11,15,5,9,19,47.4,10,16,5,11,33,64,40,1,2018
GER-Bundesliga,2017,Bayern Munich,Joshua Kimmich,GER,DF,22,1995,25.9,32,23,14,13,5,20,38,52.6,18,26,5,21,20,52,40,0,2018
GER-Bundesliga,2017,Bayern Munich,Juan Bernat,ESP,"DF,FW",24,1993,9.9,25,19,13,8,4,11,18,61.1,7,11,1,10,10,35,9,1,2018
GER-Bundesliga,2017,Bayern Munich,Jérôme Boateng,GER,DF,28,1988,18.2,26,18,18,7,1,19,32,59.4,13,20,12,8,21,47,52,1,2018
GER-Bundesliga,2017,Bayern Munich,Kingsley Coman,FRA,"FW,MF",21,1996,12.8,11,10,2,6,3,5,10,50.0,5,6,0,6,7,18,1,0,2018
GER-Bundesliga,2017,Bayern Munich,Kwasi Okyere Wriedt,GHA,MF,23,1994,0.3,2,2,1,1,0,0,0,,0,0,0,0,0,2,0,0,2018
GER-Bundesliga,2017,Bayern Munich,Lars Lukas Mai,GER,DF,17,2000,2.0,4,4,4,0,0,3,4,75.0,1,3,2,1,3,7,3,0,2018
GER-Bundesliga,2017,Bayern Munich,Manuel Neuer,GER,GK,31,1986,3.0,0,0,0,0,0,0,0,,0,0,0,0,0,0,1,0,2018
GER-Bundesliga,2017,Bayern Munich,Marco Friedl,AUT,MF,19,1998,0.5,0,0,0,0,0,0,0,,0,1,0,1,1,1,0,0,2018
GER-Bundesliga,2017,Bayern Munich,Mats Hummels,GER,DF,28,1988,24.6,62,52,41,18,3,35,51,68.6,16,31,12,19,55,117,59,2,2018
GER-Bundesliga,2017,Bayern Munich,Meritan Shabani,ALB,FW,18,1999,0.6,2,1,1,0,1,1,2,50.0,1,1,0,1,0,2,0,1,2018
GER-Bundesliga,2017,Bayern Munich,Niklas Dorsch,GER,MF,19,1998,1.0,1,1,0,1,0,0,2,0.0,2,0,0,0,1,2,0,0,2018
GER-Bundesliga,2017,Bayern Munich,Niklas Süle,GER,DF,21,1995,21.4,34,25,25,7,2,24,31,77.4,7,24,16,8,33,67,58,0,2018
GER-Bundesliga,2017,Bayern Munich,Rafinha,BRA,DF,31,1985,20.6,39,33,24,11,4,28,47,59.6,19,17,6,11,32,71,30,0,2018
GER-Bundesliga,2017,Bayern Munich,Robert Lewandowski,POL,FW,28,1988,24.1,5,3,1,1,3,0,3,0.0,3,6,0,6,5,10,10,0,2018
GER-Bundesliga,2017,Bayern Munich,Sandro Wagner,GER,FW,29,1987,8.1,9,6,3,5,1,1,1,100.0,0,4,0,4,2,11,1,0,2018
GER-Bundesliga,2017,Bayern Munich,Sebastian Rudy,GER,MF,27,1990,16.8,50,40,12,33,5,28,55,50.9,27,11,1,10,18,68,7,1,2018
GER-Bundesliga,2017,Bayern Munich,Sven Ulreich,GER,GK,28,1988,29.0,1,0,1,0,0,1,1,100.0,0,0,0,0,3,4,6,1,2018
GER-Bundesliga,2017,Bayern Munich,Thiago Alcántara,ESP,"MF,FW",26,1991,13.9,45,35,11,25,9,15,26,57.7,11,22,3,19,27,72,6,1,2018
GER-Bundesliga,2017,Bayern Munich,Thomas Müller,GER,"MF,FW",27,1989,22.3,35,30,10,15,10,13,27,48.1,14,17,1,16,7,42,14,1,2018
GER-Bundesliga,2017,Bayern Munich,Tom Starke,GER,GK,36,1981,2.0,0,0,0,0,0,0,0,,0,0,0,0,0,0,0,0,2018
GER-Bundesliga,2017,Dortmund,Alexander Isak,SWE,"FW,MF",17,1999,1.3,1,0,0,1,0,0,1,0.0,1,1,0,1,0,1,0,0,2018
GER-Bundesliga,2017,Dortmund,Andriy Yarmolenko,UKR,"FW,MF",27,1989,11.5,17,12,6,6,5,7,16,43.8,9,4,0,4,7,24,4,0,2018
GER-Bundesliga,2017,Dortmund,André Schürrle,GER,FW,26,1990,13.7,22,19,8,7,7,9,18,50.0,9,13,1,12,7,29,7,1,2018
GER-Bundesliga,2017,Dortmund,Christian Pulisic,USA,"FW,DF",18,1998,25.6,46,30,12,20,14,26,44,59.1,18,24,2,22,16,62,11,0,2018
GER-Bundesliga,2017,Dortmund,Dan-Axel Zagadou,FRA,DF,18,1999,7.3,9,8,5,3,1,6,7,85.7,1,9,0,9,11,20,20,1,2018
GER-Bundesliga,2017,Dortmund,Felix Passlack,GER,DF,19,1998,0.1,0,0,0,0,0,0,0,,0,0,0,0,1,1,0,0,2018
GER-Bundesliga,2017,Dortmund,Gonzalo Castro,GER,MF,30,1987,13.4,26,18,7,18,1,5,22,22.7,17,23,3,20,10,36,13,1,2018
GER-Bundesliga,2017,Dortmund,Jacob Bruun Larsen,DEN,DF,18,1998,0.1,1,1,1,0,0,1,2,50.0,1,0,0,0,0,1,0,0,2018
GER-Bundesliga,2017,Dortmund,Jadon Sancho,ENG,FW,17,2000,7.7,5,5,2,2,1,2,7,28.6,5,8,0,8,5,10,2,0,2018
GER-Bundesliga,2017,Dortmund,Jeremy Toljan,GER,DF,22,1994,13.5,29,20,17,11,1,19,32,59.4,13,17,2,15,12,41,45,0,2018
GER-Bundesliga,2017,Dortmund,Julian Weigl,GER,MF,21,1995,21.6,69,49,20,42,7,42,66,63.6,24,26,6,20,34,103,29,2,2018
GER-Bundesliga,2017,Dortmund,Mahmoud Dahoud,GER,MF,21,1996,12.7,38,23,11,21,6,13,30,43.3,17,18,2,16,12,50,7,0,2018
GER-Bundesliga,2017,Dortmund,Manuel Akanji,SUI,DF,22,1995,10.0,22,15,14,8,0,15,17,88.2,2,11,4,7,7,29,43,2,2018
GER-Bundesliga,2017,Dortmund,Marc Bartra,ESP,DF,26,1991,9.0,28,19,16,12,0,15,24,62.5,9,14,2,12,28,56,43,1,2018
GER-Bundesliga,2017,Dortmund,Marcel Schmelzer,GER,DF,29,1988,16.6,35,27,21,12,2,20,30,66.7,10,27,6,21,30,65,57,1,2018
GER-Bundesliga,2017,Dortmund,Marco Reus,GER,"MF,FW",28,1989,10.3,16,8,2,12,2,5,12,41.7,7,16,3,13,4,20,9,0,2018
GER-Bundesliga,2017,Dortmund,Mario Götze,GER,MF,25,1992,17.8,50,43,19,24,7,14,34,41.2,20,17,1,16,8,58,9,0,2018
GER-Bundesliga,2017,Dortmund,Maximilian Philipp,GER,FW,23,1994,13.4,24,19,9,12,3,6,19,31.6,13,12,0,12,6,30,7,0,2018
GER-Bundesliga,2017,Dortmund,Michy Batshuayi,BEL,FW,23,1993,9.3,8,6,1,4,3,2,4,50.0,2,4,0,4,0,8,5,0,2018
GER-Bundesliga,2017,Dortmund,Neven Subotić,SRB,DF,28,1988,3.0,9,9,5,3,1,6,7,85.7,1,6,2,4,5,14,16,0,2018
GER-Bundesliga,2017,Dortmund,Nuri Şahin,TUR,MF,28,1988,13.6,40,34,9,28,3,15,39,38.5,24,12,0,12,20,60,29,1,2018
GER-Bundesliga,2017,Dortmund,Pierre-Emerick Aubameyang,GAB,FW,28,1989,15.7,5,5,1,1,3,2,8,25.0,6,16,1,15,3,8,1,0,2018
GER-Bundesliga,2017,Dortmund,Raphaël Guerreiro,POR,"DF,MF",23,1993,6.1,10,8,5,4,1,2,5,40.0,3,3,0,3,11,21,8,0,2018
GER-Bundesliga,2017,Dortmund,Roman Bürki,SUI,GK,26,1990,33.0,1,1,1,0,0,1,3,33.3,2,1,0,1,0,1,10,4,2018
GER-Bundesliga,2017,Dortmund,Roman Weidenfeller,GER,GK,36,1980,1.0,0,0,0,0,0,0,0,,0,0,0,0,0,0,0,1,2018
GER-Bundesliga,2017,Dortmund,Sergio Gómez,ESP,MF,16,2000,0.1,0,0,0,0,0,0,0,,0,0,0,0,0,0,0,0,2018
GER-Bundesliga,2017,Dortmund,Shinji Kagawa,JPN,MF,28,1989,13.0,32,22,11,14,7,18,27,66.7,9,6,0,6,6,38,2,0,2018
GER-Bundesliga,2017,Dortmund,Sokratis Papastathopoulos,GRE,DF,29,1988,26.4,65,47,50,13,2,39,47,83.0,8,36,11,25,30,95,112,0,2018
GER-Bundesliga,2017,Dortmund,Ömer Toprak,TUR,DF,28,1989,22.4,36,25,29,6,1,26,29,89.7,3,27,16,11,21,57,104,1,2018
GER-Bundesliga,2017,Dortmund,Łukasz Piszczek,POL,DF,32,1985,23.8,51,37,23,23,5,30,52,57.7,22,39,11,28,42,93,64,1,2018
GER-Bundesliga,2017,Eint Frankfurt,Alexander Meier,GER,FW,34,1983,0.0,0,0,0,0,0,0,0,,0,0,0,0,0,0,0,0,2018
GER-Bundesliga,2017,Eint Frankfurt,Ante Rebić,CRO,FW,23,1993,19.5,37,29,7,21,9,7,24,29.2,17,27,2,25,6,43,13,0,2018
GER-Bundesliga,2017,Eint Frankfurt,Aymen Barkok,MAR,"FW,MF",19,1998,3.5,11,11,6,4,1,5,7,71.4,2,8,2,6,2,13,3,0,2018
GER-Bundesliga,2017,Eint Frankfurt,Branimir Hrgota,SWE,"MF,FW",24,1993,2.2,5,4,0,3,2,4,7,57.1,3,2,0,2,0,5,1,0,2018
GER-Bundesliga,2017,Eint Frankfurt,Carlos Salcedo,MEX,DF,23,1993,17.9,26,22,16,9,1,19,29,65.5,10,28,12,16,21,47,94,1,2018
GER-Bundesliga,2017,Eint Frankfurt,Daichi Kamada,JPN,"MF,FW",20,1996,1.6,1,1,0,1,0,0,0,,0,0,0,0,1,2,0,0,2018
GER-Bundesliga,2017,Eint Frankfurt,Danny Blum,GER,"MF,DF",26,1991,0.3,0,0,0,0,0,0,0,,0,0,0,0,1,1,0,0,2018
GER-Bundesliga,2017,Eint Frankfurt,Danny da Costa,GER,"DF,FW",24,1993,13.4,41,34,17,14,10,24,28,85.7,4,21,4,17,13,54,47,0,2018
GER-Bundesliga,2017,Eint Frankfurt,David Abraham,ARG,DF,31,1986,25.6,40,32,29,10,1,27,36,75.0,9,29,15,14,40,80,141,1,2018
GER-Bundesliga,2017,Eint Frankfurt,Gelson Fernandes,SUI,MF,30,1986,11.5,58,46,25,29,4,23,45,51.1,22,23,3,20,16,74,21,0,2018
GER-Bundesliga,2017,Eint Frankfurt,Jetro Willems,NED,"FW,DF",23,1994,18.5,55,42,28,23,4,27,42,64.3,15,31,1,30,20,75,53,0,2018
GER-Bundesliga,2017,Eint Frankfurt,Jonathan de Guzmán,NED,MF,29,1987,12.1,16,16,8,8,0,6,16,37.5,10,13,0,13,13,29,12,0,2018
GER-Bundesliga,2017,Eint Frankfurt,Kevin-Prince Boateng,GHA,"MF,FW",30,1987,26.2,34,22,10,22,2,11,36,30.6,25,29,6,23,23,57,43,1,2018
GER-Bundesliga,2017,Eint Frankfurt,Luka Jović,SRB,FW,19,1997,10.4,5,5,0,5,0,1,3,33.3,2,6,2,4,1,6,2,0,2018
GER-Bundesliga,2017,Eint Frankfurt,Lukáš Hrádecký,FIN,GK,27,1989,34.0,0,0,0,0,0,0,2,0.0,2,0,0,0,0,0,23,3,2018
GER-Bundesliga,2017,Eint Frankfurt,Makoto Hasebe,JPN,"DF,MF",33,1984,23.2,38,23,19,19,0,21,33,63.6,12,40,19,21,25,63,74,0,2018
GER-Bundesliga,2017,Eint Frankfurt,Marc Stendera,GER,MF,21,1995,4.1,23,20,6,15,2,8,20,40.0,12,10,1,9,8,31,2,0,2018
GER-Bundesliga,2017,Eint Frankfurt,Marco Fabián,MEX,"MF,FW",28,1989,4.7,5,3,2,3,0,3,4,75.0,1,2,0,2,3,8,1,0,2018
GER-Bundesliga,2017,Eint Frankfurt,Marco Russ,GER,DF,31,1985,12.7,17,11,9,8,0,13,19,68.4,6,23,11,12,24,41,66,0,2018
GER-Bundesliga,2017,Eint Frankfurt,Marijan Ćavar,BIH,MF,19,1998,0.4,0,0,0,0,0,0,3,0.0,3,0,0,0,0,0,0,0,2018
GER-Bundesliga,2017,Eint Frankfurt,Marius Wolf,GER,"MF,FW",22,1995,26.3,37,28,15,18,4,18,46,39.1,28,45,1,44,27,64,46,0,2018
GER-Bundesliga,2017,Eint Frankfurt,Mijat Gaćinović,SRB,"MF,FW",22,1995,20.2,56,44,21,27,8,20,52,38.5,32,38,1,37,39,95,22,1,2018
GER-Bundesliga,2017,Eint Frankfurt,Omar Mascarell,ESP,MF,24,1993,8.6,20,16,8,12,0,10,18,55.6,8,14,1,13,21,41,10,0,2018
GER-Bundesliga,2017,Eint Frankfurt,Simon Falette,GUI,DF,25,1992,24.6,34,30,23,10,1,19,31,61.3,12,37,15,22,58,92,134,1,2018
GER-Bundesliga,2017,Eint Frankfurt,Slobodan Medojević,SRB,MF,26,1990,0.3,0,0,0,0,0,0,0,,0,0,0,0,0,0,1,0,2018
GER-Bundesliga,2017,Eint Frankfurt,Sébastien Haller,CIV,FW,23,1994,26.1,25,16,4,16,5,7,14,50.0,7,17,4,13,8,33,39,0,2018
GER-Bundesliga,2017,Eint Frankfurt,Taleb Tawatha,ISR,"DF,MF",25,1992,4.9,12,7,7,5,0,5,9,55.6,4,7,1,6,6,18,18,0,2018
GER-Bundesliga,2017,Eint Frankfurt,Timothy Chandler,USA,"DF,FW",27,1990,21.0,27,21,11,13,3,11,17,64.7,6,15,0,15,33,60,52,0,2018
GER-Bundesliga,2017,Freiburg,Alexander Schwolow,GER,GK,25,1992,32.3,0,0,0,0,0,0,1,0.0,1,0,0,0,0,0,9,1,2018
GER-Bundesliga,2017,Freiburg,Amir Abrashi,ALB,MF,27,1990,9.4,35,32,15,18,2,16,23,69.6,7,22,5,17,19,54,20,0,2018
GER-Bundesliga,2017,Freiburg,Bartosz Kapustka,POL,"FW,MF",20,1996,2.6,9,5,2,6,1,4,6,66.7,2,4,0,4,3,12,0,0,2018
GER-Bundesliga,2017,Freiburg,Caleb Stanko,USA,DF,24,1993,2.1,2,2,1,1,0,1,2,50.0,1,3,0,3,1,3,8,0,2018
GER-Bundesliga,2017,Freiburg,Christian Günter,GER,"DF,MF",24,1993,34.0,73,54,45,21,7,38,63,60.3,25,38,7,31,20,93,68,0,2018
GER-Bundesliga,2017,Freiburg,Florian Kath,GER,"FW,MF",22,1994,7.5,15,10,3,9,3,9,17,52.9,8,9,0,9,8,23,1,0,2018
GER-Bundesliga,2017,Freiburg,Florian Niederlechner,GER,"FW,MF",26,1990,7.7,8,6,1,5,2,2,5,40.0,3,5,1,4,3,11,6,0,2018
GER-Bundesliga,2017,Freiburg,Janik Haberer,GER,"MF,FW",23,1994,30.5,62,49,20,34,8,23,57,40.4,34,43,1,42,30,92,42,0,2018
GER-Bundesliga,2017,Freiburg,Julian Schuster,GER,"DF,MF",32,1985,14.5,14,10,6,7,1,6,11,54.5,5,17,10,7,19,33,56,0,2018
GER-Bundesliga,2017,Freiburg,Karim Guédé,SVK,FW,32,1985,0.7,2,2,2,0,0,2,2,100.0,0,1,1,0,1,3,0,0,2018
GER-Bundesliga,2017,Freiburg,Lucas Höler,GER,"FW,MF",23,1994,10.1,24,20,8,13,3,9,24,37.5,15,10,0,10,7,31,13,0,2018
GER-Bundesliga,2017,Freiburg,Lukas Kübler,GER,"DF,MF",24,1992,12.8,31,19,16,15,0,13,23,56.5,10,15,6,9,18,49,41,0,2018
GER-Bundesliga,2017,Freiburg,Manuel Gulde,GER,DF,26,1991,17.0,16,10,14,2,0,10,19,52.6,9,24,17,7,14,30,71,0,2018
GER-Bundesliga,2017,Freiburg,Marc-Oliver Kempf,GER,DF,22,1995,10.0,13,12,9,4,0,5,8,62.5,3,7,7,0,17,30,52,0,2018
GER-Bundesliga,2017,Freiburg,Marco Terrazzino,GER,"MF,FW",26,1991,16.5,31,24,12,13,6,21,39,53.8,18,16,0,16,9,40,19,0,2018
GER-Bundesliga,2017,Freiburg,Mike Frantz,GER,MF,30,1986,11.6,23,16,9,11,3,6,16,37.5,10,13,3,10,13,36,15,0,2018
GER-Bundesliga,2017,Freiburg,Mohamed Dräger,TUN,"MF,FW",21,1996,0.6,0,0,0,0,0,0,1,0.0,1,1,0,1,0,0,0,0,2018
GER-Bundesliga,2017,Freiburg,Nicolas Höfler,GER,MF,27,1990,25.1,57,36,23,30,4,31,50,62.0,19,42,10,32,44,101,51,2,2018
GER-Bundesliga,2017,Freiburg,Nils Petersen,GER,FW,28,1988,24.9,27,18,7,18,2,10,27,37.0,17,28,2,26,17,44,33,0,2018
GER-Bundesliga,2017,Freiburg,Onur Bulut,TUR,FW,23,1994,0.4,0,0,0,0,0,0,1,0.0,1,0,0,0,0,0,0,0,2018
GER-Bundesliga,2017,Freiburg,Pascal Stenzel,GER,"MF,DF",21,1996,21.6,62,45,35,25,2,34,57,59.6,23,20,3,17,35,97,51,1,2018
GER-Bundesliga,2017,Freiburg,Philipp Lienhart,AUT,DF,21,1996,9.6,16,14,12,4,0,6,17,35.3,11,14,9,5,11,27,60,0,2018
GER-Bundesliga,2017,Freiburg,Rafał Gikiewicz,POL,GK,29,1987,1.7,0,0,0,0,0,0,0,,0,0,0,0,0,0,0,0,2018
GER-Bundesliga,2017,Freiburg,Robin Koch,GER,"MF,DF",21,1996,21.3,34,24,21,13,0,10,18,55.6,8,27,11,16,35,69,67,0,2018
GER-Bundesliga,2017,Freiburg,Ryan Kent,ENG,"FW,MF",20,1996,2.7,4,3,2,1,1,2,5,40.0,3,6,0,6,1,5,1,0,2018
GER-Bundesliga,2017,Freiburg,Tim Kleindienst,GER,"FW,DF",21,1995,12.6,22,15,6,12,4,4,17,23.5,13,17,3,14,6,28,21,0,2018
GER-Bundesliga,2017,Freiburg,Vincent Sierro,SUI,"MF,FW",21,1995,2.4,8,6,2,6,0,4,9,44.4,5,2,1,1,4,12,0,0,2018
GER-Bundesliga,2017,Freiburg,Yoric Ravet,FRA,"FW,MF",27,1989,5.5,9,7,3,6,0,3,7,42.9,4,7,0,7,3,12,6,0,2018
GER-Bundesliga,2017,Freiburg,Çağlar Söyüncü,TUR,DF,21,1996,23.9,42,26,26,15,1,15,26,57.7,11,30,20,10,54,96,91,2,2018
GER-Bundesliga,2017,Hamburger SV,Aaron Hunt,GER,"MF,FW",30,1986,23.1,36,24,12,20,4,11,37,29.7,26,20,2,18,14,50,18,2,2018
GER-Bundesliga,2017,Hamburger SV,Albin Ekdal,SWE,MF,28,1989,12.3,39,28,19,19,1,18,29,62.1,11,20,3,17,21,60,19,0,2018
GER-Bundesliga,2017,Hamburger SV,André Hahn,GER,FW,26,1990,15.1,33,24,15,13,5,10,32,31.3,22,30,2,28,10,43,26,0,2018
GER-Bundesliga,2017,Hamburger SV,Bakery Jatta,GAM,"MF,FW",19,1998,3.3,14,12,2,12,0,4,6,66.7,2,6,1,5,3,17,5,0,2018
GER-Bundesliga,2017,Hamburger SV,Bobby Wood,USA,"FW,MF",24,1992,17.9,13,8,2,4,7,3,9,33.3,6,4,0,4,2,15,13,0,2018
GER-Bundesliga,2017,Hamburger SV,Christian Mathenia,GER,GK,25,1992,24.0,0,0,0,0,0,0,3,0.0,3,0,0,0,0,0,11,3,2018
GER-Bundesliga,2017,Hamburger SV,Dennis Diekmeier,GER,DF,27,1989,20.8,47,43,31,10,6,25,36,69.4,11,22,11,11,16,63,50,0,2018
GER-Bundesliga,2017,Hamburger SV,Douglas Santos,BRA,DF,23,1994,26.4,90,60,53,34,3,50,87,57.5,37,63,2,61,56,146,96,1,2018
GER-Bundesliga,2017,Hamburger SV,Filip Kostić,SRB,"FW,MF",24,1992,27.1,48,38,16,21,11,20,41,48.8,21,42,1,41,10,58,12,0,2018
GER-Bundesliga,2017,Hamburger SV,Gideon Jung,GER,"MF,DF",22,1994,28.6,59,41,32,24,3,22,38,57.9,16,29,12,17,38,97,71,1,2018
GER-Bundesliga,2017,Hamburger SV,Gōtoku Sakai,JPN,"DF,MF",26,1991,25.4,50,40,25,18,7,22,47,46.8,25,40,12,28,44,94,55,0,2018
GER-Bundesliga,2017,Hamburger SV,Jann-Fiete Arp,GER,"FW,MF",17,2000,9.4,7,5,0,3,4,1,7,14.3,6,6,0,6,2,9,7,0,2018
GER-Bundesliga,2017,Hamburger SV,Josha Vagnoman,GER,MF,16,2000,0.2,1,1,0,1,0,1,1,100.0,0,0,0,0,0,1,0,0,2018
GER-Bundesliga,2017,Hamburger SV,Julian Pollersbeck,GER,GK,22,1994,10.0,0,0,0,0,0,0,1,0.0,1,0,0,0,0,0,4,1,2018
GER-Bundesliga,2017,Hamburger SV,Kyriakos Papadopoulos,GRE,DF,25,1992,29.0,60,54,36,24,0,41,69,59.4,28,54,35,19,43,103,181,2,2018
GER-Bundesliga,2017,Hamburger SV,Lewis Holtby,GER,"MF,FW",26,1990,13.3,44,29,14,26,4,17,32,53.1,15,23,2,21,10,54,9,0,2018
GER-Bundesliga,2017,Hamburger SV,Luca Waldschmidt,GER,"MF,FW",21,1996,8.8,10,6,1,8,1,3,10,30.0,7,11,0,11,3,13,2,0,2018
GER-Bundesliga,2017,Hamburger SV,Mohamed Gouaida,TUN,MF,24,1993,0.6,3,3,1,1,1,0,0,,0,0,0,0,0,3,3,0,2018
GER-Bundesliga,2017,Hamburger SV,Mërgim Mavraj,ALB,DF,31,1986,16.1,45,32,32,11,2,22,37,59.5,15,28,12,16,21,66,91,3,2018
GER-Bundesliga,2017,Hamburger SV,Nicolai Müller,GER,"DF,MF",29,1987,1.1,2,0,0,1,1,0,0,,0,1,0,1,0,2,0,0,2018
GER-Bundesliga,2017,Hamburger SV,Rick van Drongelen,NED,DF,18,1998,16.0,30,25,23,7,0,21,28,75.0,7,20,11,9,19,49,58,1,2018
GER-Bundesliga,2017,Hamburger SV,Sejad Salihović,BIH,MF,32,1984,4.1,7,5,3,3,1,0,3,0.0,3,5,0,5,5,12,1,0,2018
GER-Bundesliga,2017,Hamburger SV,Stephan Ambrosius,GHA,DF,18,1998,0.5,0,0,0,0,0,0,0,,0,2,1,1,1,1,4,0,2018
GER-Bundesliga,2017,Hamburger SV,Sven Schipplock,GER,"FW,MF",28,1988,3.8,7,6,1,5,1,0,1,0.0,1,4,0,4,1,8,3,0,2018
GER-Bundesliga,2017,Hamburger SV,Tatsuya Ito,JPN,"MF,FW",20,1997,11.2,16,13,4,8,4,11,22,50.0,11,28,0,28,6,22,1,0,2018
GER-Bundesliga,2017,Hamburger SV,Törles Knöll,GER,"MF,FW",19,1997,0.2,0,0,0,0,0,0,0,,0,1,0,1,0,0,0,0,2018
GER-Bundesliga,2017,Hamburger SV,Vasilije Janjicic,SUI,MF,18,1998,3.6,14,11,5,9,0,2,4,50.0,2,6,1,5,3,17,5,0,2018
GER-Bundesliga,2017,Hamburger SV,Ville Matti Steinmann,GER,MF,22,1995,6.6,16,10,6,8,2,8,17,47.1,9,6,1,5,18,34,9,1,2018
GER-Bundesliga,2017,Hamburger SV,Walace,BRA,MF,22,1995,14.6,38,25,13,23,2,19,44,43.2,25,25,3,22,21,59,14,1,2018
GER-Bundesliga,2017,Hannover 96,Charlison Benschop,CUW,"MF,DF",27,1989,2.0,4,4,1,3,0,3,8,37.5,5,1,0,1,2,6,2,0,2018
GER-Bundesliga,2017,Hannover 96,Felipe,BRA,DF,30,1987,5.1,8,8,4,4,0,2,4,50.0,2,4,3,1,11,19,29,0,2018
GER-Bundesliga,2017,Hannover 96,Felix Klaus,GER,"MF,FW",24,1992,22.0,48,38,20,21,7,23,50,46.0,27,29,4,25,8,56,28,0,2018
GER-Bundesliga,2017,Hannover 96,Florian Hübner,GER,DF,26,1991,3.6,10,9,8,2,0,5,9,55.6,4,3,2,1,6,16,21,0,2018
GER-Bundesliga,2017,Hannover 96,Ihlas Bebou,TOG,"MF,FW",23,1994,23.8,37,29,15,17,5,14,27,51.9,13,34,3,31,24,61,27,0,2018
GER-Bundesliga,2017,Hannover 96,Iver Fossum,NOR,MF,21,1996,14.5,27,19,8,13,6,10,31,32.3,21,28,3,25,15,42,14,0,2018
GER-Bundesliga,2017,Hannover 96,Jonathas,BRA,FW,28,1989,7.0,7,3,2,4,1,1,2,50.0,1,3,1,2,0,7,9,0,2018
GER-Bundesliga,2017,Hannover 96,Josip Elez,CRO,DF,23,1994,8.6,12,8,9,2,1,5,9,55.6,4,9,7,2,16,28,39,1,2018
GER-Bundesliga,2017,Hannover 96,Julian Korb,GER,"DF,MF",25,1992,26.0,52,41,27,19,6,37,68,54.4,31,30,2,28,22,74,77,0,2018
GER-Bundesliga,2017,Hannover 96,Kenan Karaman,TUR,"MF,FW",23,1994,9.5,16,13,9,6,1,6,7,85.7,1,10,4,6,1,17,17,0,2018
GER-Bundesliga,2017,Hannover 96,Linton Maina,GER,MF,18,1999,0.1,1,1,0,0,1,0,0,,0,0,0,0,1,2,0,0,2018
GER-Bundesliga,2017,Hannover 96,Manuel Schmiedebach,GER,MF,28,1988,1.8,5,5,5,0,0,4,9,44.4,5,2,0,2,5,10,6,0,2018
GER-Bundesliga,2017,Hannover 96,Martin Harnik,AUT,"FW,MF",30,1987,21.0,17,10,4,10,3,4,25,16.0,21,21,2,19,8,25,26,0,2018
GER-Bundesliga,2017,Hannover 96,Marvin Bakalorz,GER,MF,27,1989,22.8,44,25,19,23,2,22,37,59.5,15,38,7,31,20,64,46,1,2018
GER-Bundesliga,2017,Hannover 96,Matthias Ostrzolek,GER,"DF,MF",27,1990,26.4,68,53,43,20,5,38,57,66.7,19,39,10,29,30,98,58,1,2018
GER-Bundesliga,2017,Hannover 96,Michael Esser,GER,GK,29,1987,3.0,0,0,0,0,0,0,1,0.0,1,0,0,0,0,0,0,0,2018
GER-Bundesliga,2017,Hannover 96,Miiko Albornoz,CHI,"DF,MF",26,1990,7.8,24,20,17,4,3,11,16,68.8,5,15,2,13,5,29,23,0,2018
GER-Bundesliga,2017,Hannover 96,Niclas Füllkrug,GER,FW,24,1993,26.5,16,11,4,8,4,10,20,50.0,10,22,3,19,8,24,30,0,2018
GER-Bundesliga,2017,Hannover 96,Noah Joel Sarenren Bazee,NGA,"FW,MF",20,1996,1.3,0,0,0,0,0,0,0,,0,3,0,3,0,0,3,0,2018
GER-Bundesliga,2017,Hannover 96,Oliver Sorg,GER,"DF,MF",27,1990,18.7,46,28,27,18,1,23,53,43.4,30,24,7,17,42,88,71,0,2018
GER-Bundesliga,2017,Hannover 96,Philipp Tschauner,GER,GK,31,1985,31.0,1,0,1,0,0,1,2,50.0,1,2,0,2,0,1,8,5,2018
GER-Bundesliga,2017,Hannover 96,Pirmin Schwegler,SUI,MF,30,1987,25.8,81,57,25,55,1,42,70,60.0,28,33,9,24,49,130,46,1,2018
GER-Bundesliga,2017,Hannover 96,Salif Sané,SEN,DF,26,1990,32.0,57,43,46,10,1,40,64,62.5,24,49,29,20,57,114,238,6,2018
GER-Bundesliga,2017,Hannover 96,Sebastian Maier,GER,MF,23,1993,2.9,11,6,4,7,0,2,12,16.7,10,6,1,5,4,15,1,1,2018
GER-Bundesliga,2017,Hannover 96,Timo Hübers,GER,DF,21,1996,5.0,11,10,9,2,0,9,15,60.0,6,13,8,5,9,20,31,0,2018
GER-Bundesliga,2017,Hannover 96,Waldemar Anton,GER,"DF,MF",21,1996,25.3,65,49,39,21,5,41,65,63.1,24,56,27,29,39,104,112,3,2018
GER-Bundesliga,2017,Hertha BSC,Alexander Esswein,GER,"FW,MF",27,1990,6.9,25,16,13,10,2,12,25,48.0,13,4,0,4,9,34,11,0,2018
GER-Bundesliga,2017,Hertha BSC,Arne Maier,GER,MF,18,1999,13.6,29,23,12,16,1,18,24,75.0,6,19,3,16,24,53,20,0,2018
GER-Bundesliga,2017,Hertha BSC,Davie Selke,GER,FW,22,1995,21.0,13,10,1,5,7,4,9,44.4,5,26,5,21,2,15,20,1,2018
GER-Bundesliga,2017,Hertha BSC,Fabian Lustenberger,SUI,"MF,DF",29,1988,17.6,47,34,26,20,1,21,31,67.7,10,31,12,19,24,71,74,1,2018
GER-Bundesliga,2017,Hertha BSC,Genki Haraguchi,JPN,FW,26,1991,2.3,6,6,2,3,1,2,6,33.3,4,4,0,4,2,8,3,0,2018
GER-Bundesliga,2017,Hertha BSC,Jordan Torunarigha,GER,DF,19,1997,7.4,18,12,16,2,0,7,13,53.8,6,20,13,7,23,41,43,1,2018
GER-Bundesliga,2017,Hertha BSC,Julian Schieber,GER,"MF,FW",28,1989,0.6,1,1,0,0,1,1,1,100.0,0,1,0,1,0,1,2,0,2018
GER-Bundesliga,2017,Hertha BSC,Karim Rekik,NED,DF,22,1994,25.6,38,29,32,6,0,24,26,92.3,2,27,11,16,28,66,116,2,2018
GER-Bundesliga,2017,Hertha BSC,Marvin Plattenhardt,GER,DF,25,1992,33.0,57,43,39,15,3,35,50,70.0,15,24,7,17,27,84,92,0,2018
GER-Bundesliga,2017,Hertha BSC,Mathew Leckie,AUS,"FW,MF",26,1991,20.6,35,30,16,15,4,20,35,57.1,15,26,3,23,19,54,32,1,2018
GER-Bundesliga,2017,Hertha BSC,Maximilian Mittelstädt,GER,"MF,DF",20,1997,4.7,19,11,14,4,1,10,19,52.6,9,8,1,7,9,28,11,0,2018
GER-Bundesliga,2017,Hertha BSC,Mitchell Weiser,GER,"DF,FW",23,1994,22.0,54,43,20,27,7,17,38,44.7,21,28,1,27,44,98,37,1,2018
GER-Bundesliga,2017,Hertha BSC,Niklas Stark,GER,"DF,MF",22,1995,24.6,49,31,32,17,0,22,30,73.3,8,39,14,25,34,83,165,0,2018
GER-Bundesliga,2017,Hertha BSC,Ondrej Duda,SVK,MF,22,1994,8.3,16,12,7,6,3,6,14,42.9,8,15,0,15,4,20,8,0,2018
GER-Bundesliga,2017,Hertha BSC,Palkó Dárdai,HUN,"FW,MF",18,1999,0.3,0,0,0,0,0,0,0,,0,0,0,0,0,0,1,0,2018
GER-Bundesliga,2017,Hertha BSC,Per Ciljan Skjelbred,NOR,MF,30,1987,24.3,89,66,33,54,2,42,64,65.6,22,31,6,25,45,134,23,0,2018
GER-Bundesliga,2017,Hertha BSC,Peter Pekarík,SVK,DF,30,1986,15.3,42,33,17,21,4,21,29,72.4,8,23,3,20,18,60,44,0,2018
GER-Bundesliga,2017,Hertha BSC,Rune Jarstein,NOR,GK,32,1984,31.0,1,1,1,0,0,1,2,50.0,1,0,0,0,0,1,8,5,2018
GER-Bundesliga,2017,Hertha BSC,Salomon Kalou,CIV,"FW,MF",31,1985,24.5,19,11,12,5,2,9,17,52.9,8,37,1,36,10,29,29,0,2018
GER-Bundesliga,2017,Hertha BSC,Sebastian Langkamp,GER,DF,29,1988,10.6,15,12,9,6,0,11,18,61.1,7,7,4,3,21,36,58,1,2018
GER-Bundesliga,2017,Hertha BSC,Thomas Kraft,GER,GK,29,1988,3.0,0,0,0,0,0,0,0,,0,0,0,0,0,0,1,0,2018
GER-Bundesliga,2017,Hertha BSC,Valentin Stocker,SUI,MF,28,1989,0.6,1,0,0,1,0,0,0,,0,1,0,1,0,1,0,0,2018
GER-Bundesliga,2017,Hertha BSC,Valentino Lazaro,AUT,"MF,FW",21,1996,20.7,33,28,11,12,10,15,31,48.4,16,35,2,33,15,48,32,0,2018
GER-Bundesliga,2017,Hertha BSC,Vedad Ibišević,BIH,FW,32,1984,16.1,10,8,1,5,4,4,7,57.1,3,8,1,7,4,14,23,0,2018
GER-Bundesliga,2017,Hertha BSC,Vladimír Darida,CZE,MF,26,1990,18.2,38,28,11,18,9,11,26,42.3,15,22,4,18,24,62,23,0,2018
GER-Bundesliga,2017,Hoffenheim,Andrej Kramarić,CRO,"FW,MF",26,1991,24.8,8,6,4,3,1,3,8,37.5,5,15,0,15,6,14,7,0,2018
GER-Bundesliga,2017,Hoffenheim,Benjamin Hübner,GER,DF,28,1989,25.7,71,56,43,27,1,31,46,67.4,15,40,18,22,51,122,114,0,2018
GER-Bundesliga,2017,Hoffenheim,Dennis Geiger,GER,MF,19,1998,17.6,52,36,19,31,2,16,40,40.0,24,38,2,36,15,67,7,0,2018
GER-Bundesliga,2017,Hoffenheim,Ermin Bičakčić,BIH,DF,27,1990,6.1,17,15,8,8,1,8,12,66.7,4,4,2,2,9,26,26,0,2018
GER-Bundesliga,2017,Hoffenheim,Eugen Polanski,POL,MF,31,1986,2.9,8,7,3,4,1,5,6,83.3,1,6,1,5,4,12,4,0,2018
GER-Bundesliga,2017,Hoffenheim,Felix Passlack,GER,"FW,DF",19,1998,0.7,2,2,2,0,0,2,3,66.7,1,0,0,0,0,2,2,0,2018
GER-Bundesliga,2017,Hoffenheim,Florian Grillitsch,AUT,MF,21,1995,21.0,68,46,30,36,2,35,58,60.3,23,26,3,23,39,107,25,1,2018
GER-Bundesliga,2017,Hoffenheim,Håvard Nordtveit,NOR,DF,27,1990,10.8,19,16,10,9,0,13,18,72.2,5,19,8,11,10,29,50,0,2018
GER-Bundesliga,2017,Hoffenheim,Jeremy Toljan,GER,"DF,FW",22,1994,2.0,3,1,1,2,0,2,3,66.7,1,3,0,3,0,3,3,0,2018
GER-Bundesliga,2017,Hoffenheim,Kerem Demirbay,GER,MF,24,1993,13.5,38,30,15,17,6,12,28,42.9,16,21,3,18,14,52,21,0,2018
GER-Bundesliga,2017,Hoffenheim,Kevin Akpoguma,NGA,DF,22,1995,18.8,47,39,29,16,2,24,35,68.6,11,18,4,14,22,69,60,1,2018
GER-Bundesliga,2017,Hoffenheim,Kevin Vogt,GER,DF,25,1991,31.0,38,28,30,7,1,23,34,67.6,11,37,23,14,25,63,114,2,2018
GER-Bundesliga,2017,Hoffenheim,Lukas Rupp,GER,"MF,FW",26,1991,12.9,36,32,18,14,4,19,36,52.8,17,18,0,18,13,49,13,2,2018
GER-Bundesliga,2017,Hoffenheim,Mark Uth,GER,FW,25,1991,24.2,32,23,4,21,7,5,22,22.7,17,30,3,27,9,41,19,0,2018
GER-Bundesliga,2017,Hoffenheim,Nadiem Amiri,GER,MF,20,1996,19.4,39,26,13,21,5,19,42,45.2,23,33,4,29,17,56,7,0,2018
GER-Bundesliga,2017,Hoffenheim,Nico Schulz,GER,"FW,MF",24,1993,19.8,40,29,17,14,9,20,27,74.1,7,33,5,28,23,63,24,0,2018
GER-Bundesliga,2017,Hoffenheim,Oliver Baumann,GER,GK,27,1990,34.0,0,0,0,0,0,0,2,0.0,2,0,0,0,1,1,15,6,2018
GER-Bundesliga,2017,Hoffenheim,Pavel Kadeřábek,CZE,"FW,DF",25,1992,24.4,44,30,22,18,4,20,44,45.5,24,27,8,19,34,78,45,1,2018
GER-Bundesliga,2017,Hoffenheim,Philipp Ochs,GER,"FW,DF",20,1997,0.8,5,4,1,3,1,1,2,50.0,1,0,0,0,1,6,0,0,2018
GER-Bundesliga,2017,Hoffenheim,Robert Žulj,AUT,"MF,FW",25,1992,2.3,3,3,1,2,0,1,1,100.0,0,3,0,3,0,3,2,0,2018
GER-Bundesliga,2017,Hoffenheim,Robin Hack,GER,"FW,MF",18,1998,0.8,2,2,1,0,1,0,1,0.0,1,1,1,0,0,2,1,0,2018
GER-Bundesliga,2017,Hoffenheim,Sandro Wagner,GER,FW,29,1987,9.7,8,5,3,5,0,5,6,83.3,1,11,3,8,3,11,13,0,2018
GER-Bundesliga,2017,Hoffenheim,Serge Gnabry,GER,FW,22,1995,16.7,32,22,10,18,4,13,24,54.2,11,15,1,14,8,40,9,2,2018
GER-Bundesliga,2017,Hoffenheim,Stefan Posch,AUT,DF,20,1997,8.4,28,21,18,7,3,15,27,55.6,12,15,4,11,24,52,30,0,2018
GER-Bundesliga,2017,Hoffenheim,Steven Zuber,SUI,"FW,DF",25,1991,15.9,40,30,22,13,5,26,41,63.4,15,18,3,15,17,57,27,0,2018
GER-Bundesliga,2017,Hoffenheim,Ádám Szalai,HUN,FW,29,1987,10.0,8,7,1,4,3,2,5,40.0,3,9,2,7,0,8,10,0,2018
GER-Bundesliga,2017,Köln,Anas Ouahim,GER,MF,19,1997,0.2,1,1,0,1,0,1,1,100.0,0,0,0,0,0,1,0,0,2018
GER-Bundesliga,2017,Köln,Birk Risa,NOR,FW,19,1998,0.9,1,1,0,1,0,0,3,0.0,3,2,1,1,0,1,0,0,2018
GER-Bundesliga,2017,Köln,Chris Führich,GER,MF,19,1998,1.1,4,3,1,2,1,2,5,40.0,3,3,0,3,0,4,1,0,2018
GER-Bundesliga,2017,Köln,Christian Clemens,GER,"MF,FW",25,1991,7.2,12,11,6,5,1,4,13,30.8,9,8,0,8,4,16,7,0,2018
GER-Bundesliga,2017,Köln,Claudio Pizarro,PER,"FW,MF",38,1978,6.4,11,9,3,6,2,6,9,66.7,3,10,2,8,3,14,5,0,2018
GER-Bundesliga,2017,Köln,Dominic Maroh,SVN,DF,30,1987,10.2,22,15,18,4,0,15,18,83.3,3,17,9,8,21,43,68,1,2018
GER-Bundesliga,2017,Köln,Dominique Heintz,GER,DF,23,1993,31.0,60,42,47,13,0,38,64,59.4,26,35,17,18,53,113,140,0,2018
GER-Bundesliga,2017,Köln,Filip Kusić,SRB,"DF,MF",21,1996,0.2,0,0,0,0,0,0,0,,0,0,0,0,0,0,1,0,2018
GER-Bundesliga,2017,Köln,Frederik Sørensen,DEN,DF,25,1992,22.2,56,45,40,14,2,30,41,73.2,11,35,17,18,37,93,130,3,2018
GER-Bundesliga,2017,Köln,Jannes Horn,GER,DF,20,1997,9.2,16,11,11,4,1,11,14,78.6,3,12,3,9,17,33,26,0,2018
GER-Bundesliga,2017,Köln,Jhon Córdoba,COL,FW,24,1993,10.6,13,10,0,11,2,1,5,20.0,4,6,2,4,1,14,9,0,2018
GER-Bundesliga,2017,Köln,Jonas Hector,GER,"DF,MF",27,1990,19.5,47,35,23,18,6,18,40,45.0,22,39,6,33,28,75,65,2,2018
GER-Bundesliga,2017,Köln,Jorge Meré,ESP,DF,20,1997,21.0,34,23,25,9,0,23,35,65.7,12,25,13,12,34,68,110,1,2018
GER-Bundesliga,2017,Köln,Konstantin Rausch,RUS,DF,27,1990,10.3,21,16,13,7,1,11,26,42.3,15,9,2,7,17,38,25,0,2018
GER-Bundesliga,2017,Köln,Leonardo Bittencourt,GER,"MF,FW",23,1993,17.9,49,42,17,21,11,19,43,44.2,24,26,0,26,17,66,11,1,2018
GER-Bundesliga,2017,Köln,Lukas Klünter,GER,"DF,FW",21,1996,14.8,25,20,16,8,1,16,24,66.7,8,11,2,9,13,38,28,1,2018
GER-Bundesliga,2017,Köln,Marcel Risse,GER,"DF,MF",27,1989,13.0,21,14,17,4,0,11,19,57.9,8,21,3,18,6,27,10,2,2018
GER-Bundesliga,2017,Köln,Marco Höger,GER,MF,27,1989,18.6,60,40,31,28,1,30,64,46.9,34,35,5,30,25,85,27,1,2018
GER-Bundesliga,2017,Köln,Matthias Lehmann,GER,MF,34,1983,16.8,33,23,14,18,1,17,29,58.6,12,15,7,8,26,59,24,1,2018
GER-Bundesliga,2017,Köln,Miloš Jojić,SRB,MF,25,1992,16.2,36,26,18,15,3,16,40,40.0,24,31,4,27,15,51,16,0,2018
GER-Bundesliga,2017,Köln,Nikolas Nartey,DEN,MF,17,2000,0.1,0,0,0,0,0,0,0,,0,0,0,0,0,0,0,0,2018
GER-Bundesliga,2017,Köln,Paweł Olkowski,POL,DF,27,1990,5.0,17,12,9,8,0,5,9,55.6,4,11,2,9,3,20,17,0,2018
GER-Bundesliga,2017,Köln,Salih Özcan,TUR,MF,19,1998,18.6,56,42,24,29,3,28,54,51.9,26,27,5,22,29,85,22,1,2018
GER-Bundesliga,2017,Köln,Sehrou Guirassy,GUI,FW,21,1996,9.5,3,3,0,2,1,1,5,20.0,4,9,1,8,1,4,11,0,2018
GER-Bundesliga,2017,Köln,Simon Terodde,GER,FW,29,1988,12.9,11,9,3,8,0,4,11,36.4,7,3,0,3,4,15,7,0,2018
GER-Bundesliga,2017,Köln,Simon Zoller,GER,"MF,FW",26,1991,10.7,11,7,3,6,2,7,10,70.0,3,5,2,3,8,19,9,0,2018
GER-Bundesliga,2017,Köln,Tim Handwerker,GER,"MF,DF",19,1998,4.4,12,7,9,2,1,5,7,71.4,2,3,0,3,6,18,10,0,2018
GER-Bundesliga,2017,Köln,Timo Horn,GER,GK,24,1993,34.0,3,2,3,0,0,3,6,50.0,3,0,0,0,0,3,18,2,2018
GER-Bundesliga,2017,Köln,Vincent Koziello,FRA,MF,21,1995,8.8,28,21,6,21,1,10,21,47.6,11,9,0,9,10,38,5,1,2018
GER-Bundesliga,2017,Köln,Yann Aurel Bisseck,GER,"DF,MF",16,2000,1.7,2,2,2,0,0,1,1,100.0,0,1,1,0,3,5,8,0,2018
GER-Bundesliga,2017,Köln,Yuya Osako,JPN,"FW,MF",27,1990,21.1,13,10,4,9,0,4,18,22.2,14,13,2,11,8,21,22,0,2018
GER-Bundesliga,2017,Leverkusen,Admir Mehmedi,SUI,"DF,MF",26,1991,7.8,20,18,6,11,3,4,13,30.8,9,13,0,13,13,33,5,0,2018
GER-Bundesliga,2017,Leverkusen,Aleksandar Dragović,AUT,DF,26,1991,0.5,0,0,0,0,0,0,1,0.0,1,0,0,0,0,0,0,1,2018
GER-Bundesliga,2017,Leverkusen,André Ramalho,BRA,"DF,FW",25,1992,0.4,3,1,2,1,0,2,2,100.0,0,1,0,1,1,4,1,0,2018
GER-Bundesliga,2017,Leverkusen,Benjamin Henrichs,GER,DF,20,1997,14.1,42,28,23,16,3,27,43,62.8,16,23,3,20,31,73,32,0,2018
GER-Bundesliga,2017,Leverkusen,Bernd Leno,GER,GK,25,1992,33.0,0,0,0,0,0,0,1,0.0,1,0,0,0,1,1,11,2,2018
GER-Bundesliga,2017,Leverkusen,Charles Aránguiz,CHI,MF,28,1989,25.6,75,61,17,50,8,33,62,53.2,29,46,5,41,48,123,27,2,2018
GER-Bundesliga,2017,Leverkusen,Dominik Kohr,GER,MF,23,1994,18.5,49,26,20,25,4,25,41,61.0,16,39,5,34,30,79,24,0,2018
GER-Bundesliga,2017,Leverkusen,Joel Pohjanpalo,FIN,"MF,FW",22,1994,1.3,0,0,0,0,0,0,2,0.0,2,1,1,0,0,0,2,0,2018
GER-Bundesliga,2017,Leverkusen,Jonathan Tah,GER,DF,21,1996,27.0,47,34,35,12,0,30,38,78.9,8,22,13,9,34,81,112,2,2018
GER-Bundesliga,2017,Leverkusen,Julian Baumgartlinger,AUT,"MF,DF",29,1988,15.5,47,37,21,21,5,14,29,48.3,15,25,2,23,18,65,23,0,2018
GER-Bundesliga,2017,Leverkusen,Julian Brandt,GER,"FW,MF",21,1996,25.8,24,18,11,9,4,11,29,37.9,18,23,1,22,16,40,12,1,2018
GER-Bundesliga,2017,Leverkusen,Kai Havertz,GER,"MF,FW",18,1999,23.8,34,23,8,23,3,12,25,48.0,13,33,2,31,19,53,23,0,2018
GER-Bundesliga,2017,Leverkusen,Karim Bellarabi,GER,"MF,FW",27,1990,12.7,22,17,10,9,3,10,19,52.6,9,26,1,25,13,35,5,0,2018
GER-Bundesliga,2017,Leverkusen,Kevin Kampl,SVN,MF,26,1990,0.3,1,1,1,0,0,1,1,100.0,0,0,0,0,0,1,0,0,2018
GER-Bundesliga,2017,Leverkusen,Kevin Volland,GER,"FW,MF",25,1992,28.8,23,20,7,8,8,11,26,42.3,15,16,1,15,3,26,35,0,2018
GER-Bundesliga,2017,Leverkusen,Lars Bender,GER,"DF,MF",28,1989,17.7,63,52,26,32,5,35,53,66.0,18,34,7,27,28,91,40,0,2018
GER-Bundesliga,2017,Leverkusen,Leon Bailey,JAM,"FW,DF",19,1997,24.6,16,12,7,4,5,8,13,61.5,5,28,0,28,15,31,6,0,2018
GER-Bundesliga,2017,Leverkusen,Lucas Alario,ARG,FW,24,1992,17.2,16,10,2,12,2,3,8,37.5,5,17,4,13,4,20,16,0,2018
GER-Bundesliga,2017,Leverkusen,Panagiotis Retsos,GRE,DF,18,1998,19.1,48,40,32,14,2,33,46,71.7,13,29,8,21,29,77,47,0,2018
GER-Bundesliga,2017,Leverkusen,Ramazan Özcan,AUT,GK,33,1984,1.0,0,0,0,0,0,0,1,0.0,1,0,0,0,0,0,0,0,2018
GER-Bundesliga,2017,Leverkusen,Stefan Kießling,GER,"DF,MF",33,1984,0.9,0,0,0,0,0,0,0,,0,2,0,2,0,0,1,0,2018
GER-Bundesliga,2017,Leverkusen,Sven Bender,GER,DF,28,1989,26.1,51,37,33,18,0,26,34,76.5,8,49,21,28,50,101,123,1,2018
GER-Bundesliga,2017,Leverkusen,Tin Jedvaj,CRO,DF,21,1995,6.7,10,6,2,6,2,8,15,53.3,7,9,1,8,9,19,18,0,2018
GER-Bundesliga,2017,Leverkusen,Wendell,BRA,DF,24,1993,23.5,54,41,29,20,5,32,58,55.2,26,44,8,36,28,82,58,0,2018
GER-Bundesliga,2017,M'Gladbach,Christoph Kramer,GER,MF,26,1991,23.9,89,70,43,34,12,39,76,51.3,37,29,4,25,43,132,37,1,2018
GER-Bundesliga,2017,M'Gladbach,Denis Zakaria,SUI,MF,20,1996,25.5,74,48,38,32,4,40,61,65.6,21,52,9,43,45,119,40,1,2018
GER-Bundesliga,2017,M'Gladbach,Fabian Johnson,USA,"MF,DF",29,1987,5.2,16,10,7,7,2,6,7,85.7,1,10,2,8,2,18,13,0,2018
GER-Bundesliga,2017,M'Gladbach,Florian Mayer,GER,DF,19,1998,0.2,1,1,1,0,0,1,1,100.0,0,0,0,0,0,1,1,0,2018
GER-Bundesliga,2017,M'Gladbach,Ibrahima Traoré,GUI,MF,29,1988,2.2,4,2,2,2,0,4,7,57.1,3,2,0,2,0,4,1,0,2018
GER-Bundesliga,2017,M'Gladbach,Jannik Vestergaard,DEN,DF,24,1992,32.0,58,41,43,15,0,32,48,66.7,16,55,39,16,40,98,161,3,2018
GER-Bundesliga,2017,M'Gladbach,Jonas Hofmann,GER,"MF,FW",25,1992,11.5,23,19,12,11,0,12,26,46.2,14,15,4,11,12,35,16,0,2018
GER-Bundesliga,2017,M'Gladbach,Josip Drmić,SUI,"FW,MF",24,1992,5.2,0,0,0,0,0,0,4,0.0,4,1,0,1,0,0,1,1,2018
GER-Bundesliga,2017,M'Gladbach,Julio Villalba,PAR,DF,18,1998,0.1,0,0,0,0,0,0,0,,0,0,0,0,0,0,0,0,2018
GER-Bundesliga,2017,M'Gladbach,Lars Stindl,GER,"FW,MF",28,1988,30.3,52,39,11,29,12,14,38,36.8,24,53,4,49,31,83,32,1,2018
GER-Bundesliga,2017,M'Gladbach,László Bénes,SVK,MF,19,1997,0.4,0,0,0,0,0,0,1,0.0,1,2,1,1,1,1,2,0,2018
GER-Bundesliga,2017,M'Gladbach,Mandela Egbo,ENG,"DF,MF",19,1997,0.1,0,0,0,0,0,0,0,,0,0,0,0,0,0,2,0,2018
GER-Bundesliga,2017,M'Gladbach,Marcel Benger,GER,MF,19,1998,0.0,0,0,0,0,0,0,0,,0,0,0,0,0,0,0,0,2018
GER-Bundesliga,2017,M'Gladbach,Matthias Ginter,GER,DF,23,1994,34.0,48,37,27,20,1,35,45,77.8,10,40,17,23,40,88,114,1,2018
GER-Bundesliga,2017,M'Gladbach,Mickaël Cuisance,FRA,"MF,FW",17,1999,13.4,31,20,16,11,4,19,29,65.5,10,22,4,18,10,41,10,1,2018
GER-Bundesliga,2017,M'Gladbach,Nico Elvedi,SUI,DF,20,1996,32.4,66,46,41,22,3,37,55,67.3,18,39,9,30,51,117,108,3,2018
GER-Bundesliga,2017,M'Gladbach,Oscar Wendt,SWE,DF,31,1985,27.3,54,40,31,19,4,30,45,66.7,15,46,12,34,27,81,71,0,2018
GER-Bundesliga,2017,M'Gladbach,Patrick Herrmann,GER,"MF,FW",26,1991,12.5,29,21,9,13,7,17,29,58.6,12,13,0,13,17,46,19,0,2018
GER-Bundesliga,2017,M'Gladbach,Raffael,BRA,FW,32,1985,23.0,40,32,12,23,5,17,36,47.2,19,18,0,18,8,48,2,0,2018
GER-Bundesliga,2017,M'Gladbach,Raúl Bobadilla,PAR,"FW,MF",30,1987,5.0,7,6,1,3,3,4,8,50.0,4,6,0,6,0,7,1,0,2018
GER-Bundesliga,2017,M'Gladbach,Reece Oxford,ENG,"DF,MF",18,1998,5.1,8,6,3,4,1,3,4,75.0,1,4,0,4,9,17,26,1,2018
GER-Bundesliga,2017,M'Gladbach,Thorgan Hazard,BEL,"MF,FW",24,1993,32.7,49,32,16,23,10,20,54,37.0,34,39,1,38,28,77,18,0,2018
GER-Bundesliga,2017,M'Gladbach,Tobias Sippel,GER,GK,29,1988,4.8,1,1,1,0,0,1,2,50.0,1,0,0,0,0,1,5,1,2018
GER-Bundesliga,2017,M'Gladbach,Tobias Strobl,GER,MF,27,1990,1.3,3,1,0,2,1,0,1,0.0,1,2,0,2,6,9,2,0,2018
GER-Bundesliga,2017,M'Gladbach,Tony Jantschke,GER,DF,27,1990,8.1,13,11,9,4,0,8,13,61.5,5,10,1,9,6,19,25,0,2018
GER-Bundesliga,2017,M'Gladbach,Vincenzo Grifo,ITA,"MF,FW",24,1993,8.7,8,5,3,3,2,4,8,50.0,4,8,1,7,5,13,6,0,2018
GER-Bundesliga,2017,M'Gladbach,Yann Sommer,SUI,GK,28,1988,29.2,0,0,0,0,0,0,0,,0,0,0,0,3,3,6,3,2018
GER-Bundesliga,2017,Mainz 05,Abdou Diallo,SEN,DF,21,1996,26.8,75,53,45,25,5,38,50,76.0,12,37,14,23,50,125,75,0,2018
GER-Bundesliga,2017,Mainz 05,Alexander Hack,GER,DF,23,1993,14.3,46,34,25,19,2,24,37,64.9,13,31,18,13,26,72,87,2,2018
GER-Bundesliga,2017,Mainz 05,Alexandru Maxim,ROU,MF,27,1990,10.6,17,12,6,8,3,7,22,31.8,15,20,2,18,6,23,3,0,2018
GER-Bundesliga,2017,Mainz 05,Anthony Ujah,NGA,FW,26,1990,2.3,4,3,0,2,2,1,1,100.0,0,2,0,2,0,4,6,0,2018
GER-Bundesliga,2017,Mainz 05,Daniel Brosinski,GER,"DF,FW",29,1988,27.8,45,35,21,18,6,22,44,50.0,22,46,11,35,24,69,75,2,2018
GER-Bundesliga,2017,Mainz 05,Danny Latza,GER,MF,27,1989,26.1,67,48,28,33,6,33,73,45.2,40,43,8,35,26,93,47,1,2018
GER-Bundesliga,2017,Mainz 05,Emil Berggreen,DEN,FW,24,1993,7.4,2,2,0,0,2,1,4,25.0,3,7,1,6,1,3,10,0,2018
GER-Bundesliga,2017,Mainz 05,Fabian Frei,SUI,MF,28,1989,8.9,22,15,7,12,3,8,15,53.3,7,10,0,10,16,38,17,1,2018
GER-Bundesliga,2017,Mainz 05,Florian Müller,GER,GK,19,1997,5.0,0,0,0,0,0,0,0,,0,0,0,0,0,0,1,1,2018
GER-Bundesliga,2017,Mainz 05,Gerrit Holtmann,PHI,"FW,DF",22,1995,10.0,16,13,8,5,3,11,22,50.0,11,19,2,17,12,28,9,0,2018
GER-Bundesliga,2017,Mainz 05,Giulio Donati,ITA,"DF,FW",27,1990,25.4,56,42,30,21,5,34,50,68.0,16,38,8,30,35,91,66,1,2018
GER-Bundesliga,2017,Mainz 05,Jairo Samperio,ESP,"MF,FW",24,1993,0.4,1,1,0,1,0,1,1,100.0,0,0,0,0,0,1,0,0,2018
GER-Bundesliga,2017,Mainz 05,Jean-Philippe Gbamin,CIV,"MF,DF",21,1995,28.8,78,63,48,26,4,43,65,66.2,22,50,10,40,50,128,80,0,2018
GER-Bundesliga,2017,Mainz 05,Karim Onisiwo,AUT,"DF,FW",25,1992,2.8,7,5,5,1,1,3,7,42.9,4,4,0,4,1,8,8,0,2018
GER-Bundesliga,2017,Mainz 05,Kenan Kodro,BIH,"FW,DF",23,1993,2.6,1,1,0,1,0,0,0,,0,1,0,1,3,4,0,0,2018
GER-Bundesliga,2017,Mainz 05,Leon Balogun,NGA,DF,29,1988,13.0,39,32,27,11,1,22,31,71.0,9,21,9,12,32,71,64,0,2018
GER-Bundesliga,2017,Mainz 05,Levin Öztunalı,GER,"FW,MF",21,1996,19.3,26,19,8,15,3,10,20,50.0,10,25,0,25,11,37,9,0,2018
GER-Bundesliga,2017,Mainz 05,Nigel de Jong,NED,MF,32,1984,8.2,17,12,7,9,1,10,14,71.4,4,5,1,4,12,29,22,1,2018
GER-Bundesliga,2017,Mainz 05,Pablo de Blasis,ARG,"FW,MF",29,1988,18.4,39,23,19,11,9,16,33,48.5,17,33,0,33,10,49,34,0,2018
GER-Bundesliga,2017,Mainz 05,René Adler,GER,GK,32,1985,14.0,1,1,1,0,0,1,1,100.0,0,0,0,0,0,1,8,1,2018
GER-Bundesliga,2017,Mainz 05,Ridle Baku,GER,MF,19,1998,2.6,3,3,1,1,1,0,1,0.0,1,3,0,3,3,6,2,0,2018
GER-Bundesliga,2017,Mainz 05,Robin Quaison,SWE,FW,23,1993,15.7,17,14,1,10,6,7,11,63.6,4,16,2,14,7,24,9,0,2018
GER-Bundesliga,2017,Mainz 05,Robin Zentner,GER,GK,22,1994,15.0,0,0,0,0,0,0,1,0.0,1,0,0,0,1,1,10,2,2018
GER-Bundesliga,2017,Mainz 05,Stefan Bell,GER,DF,25,1991,24.2,36,25,23,13,0,27,39,69.2,12,35,18,17,46,82,123,2,2018
GER-Bundesliga,2017,Mainz 05,Suat Serdar,GER,MF,20,1997,18.9,59,47,21,26,12,27,64,42.2,37,38,3,35,21,80,17,1,2018
GER-Bundesliga,2017,Mainz 05,Viktor Fischer,DEN,"FW,MF",23,1994,3.7,4,4,2,1,1,2,5,40.0,3,2,0,2,3,7,2,0,2018
GER-Bundesliga,2017,Mainz 05,Yoshinori Mutō,JPN,FW,25,1992,21.2,21,15,6,8,7,5,14,35.7,9,16,0,16,6,27,12,0,2018
GER-Bundesliga,2017,RB Leipzig,Ademola Lookman,NGA,"MF,FW",19,1997,6.4,5,4,2,3,0,0,0,,0,3,0,3,2,7,2,0,2018
GER-Bundesliga,2017,RB Leipzig,Benno Schmitz,GER,DF,22,1994,0.9,3,2,2,1,0,2,3,66.7,1,0,0,0,0,3,1,0,2018
GER-Bundesliga,2017,RB Leipzig,Bernardo,BRA,DF,22,1995,15.0,43,30,18,22,3,29,40,72.5,11,30,6,24,18,61,81,0,2018
GER-Bundesliga,2017,RB Leipzig,Bruma,POR,"MF,FW",22,1994,17.9,18,16,7,7,4,9,18,50.0,9,28,2,26,12,30,11,0,2018
GER-Bundesliga,2017,RB Leipzig,Dayot Upamecano,FRA,DF,18,1998,25.2,57,43,36,17,4,31,45,68.9,14,32,9,23,55,112,141,1,2018
GER-Bundesliga,2017,RB Leipzig,Diego Demme,GER,MF,25,1991,25.4,81,57,29,48,4,47,87,54.0,40,31,3,28,48,129,29,0,2018
GER-Bundesliga,2017,RB Leipzig,Dominik Kaiser,GER,"MF,FW",28,1988,3.1,5,5,1,3,1,4,11,36.4,7,6,0,6,1,6,8,0,2018
GER-Bundesliga,2017,RB Leipzig,Emil Forsberg,SWE,MF,25,1991,15.2,24,17,3,15,6,9,21,42.9,12,19,1,18,8,32,4,0,2018
GER-Bundesliga,2017,RB Leipzig,Ibrahima Konaté,FRA,DF,18,1999,13.6,32,25,20,12,0,18,23,78.3,5,14,3,11,20,52,66,0,2018
GER-Bundesliga,2017,RB Leipzig,Jean-Kévin Augustin,FRA,FW,20,1997,14.1,16,11,4,11,1,3,7,42.9,4,17,1,16,4,20,4,0,2018
GER-Bundesliga,2017,RB Leipzig,Kevin Kampl,SVN,MF,26,1990,22.4,42,33,16,20,6,16,39,41.0,23,37,2,35,33,75,33,0,2018
GER-Bundesliga,2017,RB Leipzig,Konrad Laimer,AUT,"DF,MF",20,1997,14.9,57,39,31,22,4,28,57,49.1,29,37,2,35,11,68,32,0,2018
GER-Bundesliga,2017,RB Leipzig,Lukas Klostermann,GER,DF,21,1996,24.3,56,41,34,18,4,28,37,75.7,9,33,6,27,33,89,79,0,2018
GER-Bundesliga,2017,RB Leipzig,Marcel Halstenberg,GER,DF,25,1991,13.1,29,19,16,9,4,15,19,78.9,4,15,1,14,23,52,42,1,2018
GER-Bundesliga,2017,RB Leipzig,Marcel Sabitzer,AUT,"MF,FW",23,1994,19.9,38,28,12,20,6,23,49,46.9,26,23,2,21,24,62,21,1,2018
GER-Bundesliga,2017,RB Leipzig,Marvin Compper,GER,DF,32,1985,1.0,2,2,0,2,0,2,3,66.7,1,2,2,0,0,2,8,0,2018
GER-Bundesliga,2017,RB Leipzig,Naby Keïta,GUI,MF,22,1995,21.8,65,48,25,33,7,17,43,39.5,26,26,3,23,36,101,18,0,2018
GER-Bundesliga,2017,RB Leipzig,Péter Gulácsi,HUN,GK,27,1990,33.0,0,0,0,0,0,0,2,0.0,2,0,0,0,0,0,12,4,2018
GER-Bundesliga,2017,RB Leipzig,Stefan Ilsanker,AUT,"DF,MF",28,1989,14.3,37,29,23,11,3,22,39,56.4,17,23,10,13,25,62,55,1,2018
GER-Bundesliga,2017,RB Leipzig,Timo Werner,GER,FW,21,1996,27.7,16,11,2,8,6,3,19,15.8,16,26,0,26,7,23,11,0,2018
GER-Bundesliga,2017,RB Leipzig,Willi Orban,HUN,DF,24,1992,23.6,49,30,35,14,0,29,43,67.4,14,45,18,27,28,77,155,1,2018
GER-Bundesliga,2017,RB Leipzig,Yussuf Poulsen,DEN,FW,23,1994,18.5,23,19,2,13,8,7,12,58.3,5,24,5,19,9,32,8,0,2018
GER-Bundesliga,2017,RB Leipzig,Yvon Mvogo,SUI,GK,23,1994,1.0,0,0,0,0,0,0,0,,0,0,0,0,0,0,1,1,2018
GER-Bundesliga,2017,Schalke 04,Alessandro Schöpf,AUT,"DF,FW",23,1994,9.0,22,17,10,9,3,11,23,47.8,12,16,0,16,15,37,13,1,2018
GER-Bundesliga,2017,Schalke 04,Alexander Nübel,GER,GK,20,1996,0.5,0,0,0,0,0,0,0,,0,0,0,0,0,0,0,0,2018
GER-Bundesliga,2017,Schalke 04,Amine Harit,MAR,"MF,FW",20,1997,22.7,39,27,11,21,7,13,37,35.1,24,23,0,23,19,58,11,0,2018
GER-Bundesliga,2017,Schalke 04,Baba Rahman,GHA,DF,23,1994,0.4,1,0,0,1,0,0,0,,0,2,0,2,2,3,1,0,2018
GER-Bundesliga,2017,Schalke 04,Bastian Oczipka,GER,"DF,MF",28,1989,25.8,60,48,29,26,5,29,37,78.4,8,41,2,39,40,100,40,1,2018
GER-Bundesliga,2017,Schalke 04,Benjamin Stambouli,FRA,"DF,MF",26,1990,24.4,95,75,45,48,2,49,74,66.2,25,39,7,32,64,159,76,1,2018
GER-Bundesliga,2017,Schalke 04,Breel Embolo,SUI,"FW,MF",20,1997,10.2,14,10,3,7,4,2,9,22.2,7,13,0,13,6,20,3,0,2018
GER-Bundesliga,2017,Schalke 04,Cedric Teuchert,GER,FW,20,1997,0.4,0,0,0,0,0,0,0,,0,1,0,1,0,0,0,0,2018
GER-Bundesliga,2017,Schalke 04,Coke,ESP,MF,30,1987,0.0,0,0,0,0,0,0,0,,0,0,0,0,0,0,0,0,2018
GER-Bundesliga,2017,Schalke 04,Daniel Caligiuri,ITA,"DF,MF",29,1988,32.4,100,66,48,43,9,49,94,52.1,45,59,4,55,67,167,71,0,2018
GER-Bundesliga,2017,Schalke 04,Fabian Reese,GER,"FW,MF",19,1997,0.8,2,2,1,1,0,1,2,50.0,1,1,0,1,2,4,1,0,2018
GER-Bundesliga,2017,Schalke 04,Franco Di Santo,ARG,"FW,MF",28,1989,18.4,17,13,3,13,1,7,15,46.7,8,12,1,11,2,19,24,0,2018
GER-Bundesliga,2017,Schalke 04,Guido Burgstaller,AUT,FW,28,1989,25.8,14,9,0,10,4,4,14,28.6,10,28,3,25,10,24,9,0,2018
GER-Bundesliga,2017,Schalke 04,Leon Goretzka,GER,MF,22,1995,22.0,50,34,22,22,6,14,50,28.0,36,45,4,41,41,91,35,0,2018
GER-Bundesliga,2017,Schalke 04,Marko Pjaca,CRO,"FW,MF",22,1995,2.9,5,3,2,3,0,4,6,66.7,2,3,0,3,1,6,2,0,2018
GER-Bundesliga,2017,Schalke 04,Matija Nastasić,SRB,DF,24,1993,22.1,48,38,37,10,1,28,37,75.7,9,40,22,18,36,84,85,0,2018
GER-Bundesliga,2017,Schalke 04,Max Meyer,GER,MF,21,1995,19.2,48,38,23,21,4,19,47,40.4,28,25,3,22,54,102,11,0,2018
GER-Bundesliga,2017,Schalke 04,Nabil Bentaleb,ALG,MF,22,1994,11.2,25,22,7,17,1,8,23,34.8,15,18,6,12,23,48,27,2,2018
GER-Bundesliga,2017,Schalke 04,Naldo,BRA,DF,34,1982,34.0,51,36,38,12,1,31,46,67.4,15,39,21,18,55,106,200,1,2018
GER-Bundesliga,2017,Schalke 04,Pablo Insua,ESP,DF,23,1993,0.3,0,0,0,0,0,0,0,,0,1,1,0,0,0,1,0,2018
GER-Bundesliga,2017,Schalke 04,Ralf Fährmann,GER,GK,28,1988,33.5,1,0,1,0,0,1,3,33.3,2,1,0,1,1,2,12,7,2018
GER-Bundesliga,2017,Schalke 04,Thilo Kehrer,GER,DF,20,1996,26.3,81,64,41,36,4,46,68,67.6,22,42,12,30,35,116,113,2,2018
GER-Bundesliga,2017,Schalke 04,Weston McKennie,USA,MF,18,1998,14.0,36,23,11,21,4,13,32,40.6,19,16,2,14,20,56,32,0,2018
GER-Bundesliga,2017,Schalke 04,Yevhen Konoplyanka,UKR,"FW,MF",27,1989,17.4,11,9,3,4,4,3,11,27.3,8,18,1,17,5,16,6,0,2018
GER-Bundesliga,2017,Stuttgart,Ailton,BRA,"DF,MF",22,1995,1.2,8,5,3,5,0,4,8,50.0,4,5,0,5,2,10,5,0,2018
GER-Bundesliga,2017,Stuttgart,Anastasios Donis,GRE,"MF,FW",20,1996,10.5,20,14,10,6,4,6,8,75.0,2,2,0,2,9,29,7,0,2018
GER-Bundesliga,2017,Stuttgart,Andreas Beck,GER,DF,30,1987,21.4,46,29,27,16,3,21,31,67.7,10,32,2,30,19,65,46,1,2018
GER-Bundesliga,2017,Stuttgart,Anto Grgić,SUI,MF,20,1996,0.1,0,0,0,0,0,0,0,,0,0,0,0,0,0,0,0,2018
GER-Bundesliga,2017,Stuttgart,Benjamin Pavard,FRA,DF,21,1996,34.0,55,40,40,13,2,36,47,76.6,11,59,34,25,70,125,192,1,2018
GER-Bundesliga,2017,Stuttgart,Berkay Özcan,TUR,"MF,FW",19,1998,11.1,19,10,7,9,3,7,11,63.6,4,14,2,12,3,22,8,0,2018
GER-Bundesliga,2017,Stuttgart,Chadrac Akolo,COD,"MF,FW",22,1995,12.2,20,14,3,12,5,6,14,42.9,8,19,0,19,5,25,5,0,2018
GER-Bundesliga,2017,Stuttgart,Christian Gentner,GER,MF,31,1985,26.8,91,67,35,44,12,44,84,52.4,40,41,5,36,35,126,52,0,2018
GER-Bundesliga,2017,Stuttgart,Daniel Ginczek,GER,FW,26,1991,16.9,8,4,3,5,0,2,12,16.7,10,16,1,15,5,13,13,0,2018
GER-Bundesliga,2017,Stuttgart,Dennis Aogo,GER,"MF,DF",30,1987,21.7,35,26,17,18,0,14,22,63.6,8,27,3,24,29,64,27,1,2018
GER-Bundesliga,2017,Stuttgart,Dženis Burnić,GER,MF,19,1998,3.4,9,6,2,5,2,4,10,40.0,6,2,0,2,4,13,3,0,2018
GER-Bundesliga,2017,Stuttgart,Ebenezer Ofori,GHA,MF,22,1995,0.1,0,0,0,0,0,0,1,0.0,1,1,0,1,0,0,0,0,2018
GER-Bundesliga,2017,Stuttgart,Emiliano Insúa,ARG,DF,28,1989,23.4,46,34,27,16,3,17,32,53.1,15,30,4,26,36,82,48,1,2018
GER-Bundesliga,2017,Stuttgart,Erik Thommy,GER,MF,22,1994,10.9,19,11,7,7,5,9,17,52.9,8,17,2,15,9,28,8,1,2018
GER-Bundesliga,2017,Stuttgart,Holger Badstuber,GER,"DF,MF",28,1989,24.1,44,32,29,14,1,22,39,56.4,17,27,14,13,41,85,111,4,2018
GER-Bundesliga,2017,Stuttgart,Jacob Bruun Larsen,DEN,"MF,DF",18,1998,1.2,0,0,0,0,0,0,0,,0,1,0,1,1,1,2,0,2018
GER-Bundesliga,2017,Stuttgart,Josip Brekalo,CRO,"MF,FW",19,1998,8.1,20,12,7,8,5,6,8,75.0,2,8,2,6,3,23,1,0,2018
GER-Bundesliga,2017,Stuttgart,Marcin Kamiński,POL,DF,25,1992,12.6,17,14,5,11,1,12,18,66.7,6,12,3,9,30,47,55,0,2018
GER-Bundesliga,2017,Stuttgart,Mario Gómez,GER,FW,32,1985,15.4,13,11,0,8,5,2,10,20.0,8,6,0,6,4,17,17,0,2018
GER-Bundesliga,2017,Stuttgart,Matthias Zimmermann,GER,DF,25,1992,0.9,3,1,2,1,0,3,4,75.0,1,0,0,0,1,4,5,1,2018
GER-Bundesliga,2017,Stuttgart,Orel Mangala,BEL,MF,19,1998,8.7,28,18,7,19,2,11,21,52.4,10,8,2,6,18,46,15,0,2018
GER-Bundesliga,2017,Stuttgart,Ron-Robert Zieler,GER,GK,28,1989,34.0,1,1,1,0,0,1,1,100.0,0,2,0,2,1,2,14,5,2018
GER-Bundesliga,2017,Stuttgart,Santiago Ascacíbar,ARG,MF,20,1997,26.5,91,65,41,43,7,41,74,55.4,33,45,10,35,47,138,38,1,2018
GER-Bundesliga,2017,Stuttgart,Simon Terodde,GER,FW,29,1988,10.6,9,6,1,7,1,2,5,40.0,3,8,2,6,5,14,8,0,2018
GER-Bundesliga,2017,Stuttgart,Takuma Asano,JPN,"FW,MF",22,1994,8.0,7,5,3,3,1,2,8,25.0,6,7,0,7,3,10,2,0,2018
GER-Bundesliga,2017,Stuttgart,Timo Baumgartl,GER,DF,21,1996,29.0,87,71,55,29,3,56,75,74.7,19,50,21,29,34,121,132,1,2018
GER-Bundesliga,2017,Werder Bremen,Aron Jóhannsson,USA,"MF,FW",26,1990,3.1,4,3,2,2,0,1,7,14.3,6,3,0,3,1,5,5,0,2018
GER-Bundesliga,2017,Werder Bremen,Fin Bartels,GER,FW,30,1987,12.5,12,9,4,3,5,4,12,33.3,8,5,1,4,7,19,1,1,2018
GER-Bundesliga,2017,Werder Bremen,Florian Kainz,AUT,"MF,FW",24,1992,19.0,33,25,9,18,6,9,19,47.4,10,23,0,23,17,50,13,0,2018
GER-Bundesliga,2017,Werder Bremen,Ishak Belfodil,ALG,FW,25,1992,15.0,7,6,2,3,2,0,3,0.0,3,10,1,9,1,8,9,0,2018
GER-Bundesliga,2017,Werder Bremen,Izet Hajrović,BIH,"MF,FW",25,1991,2.1,1,0,1,0,0,0,1,0.0,1,0,0,0,2,3,1,0,2018
GER-Bundesliga,2017,Werder Bremen,Jiří Pavlenka,CZE,GK,25,1992,34.0,1,1,1,0,0,0,0,,0,2,0,2,0,1,17,4,2018
GER-Bundesliga,2017,Werder Bremen,Johannes Eggestein,GER,"FW,DF",19,1998,1.1,0,0,0,0,0,0,1,0.0,1,2,1,1,1,1,0,0,2018
GER-Bundesliga,2017,Werder Bremen,Jérôme Gondorf,GER,"MF,FW",29,1988,8.9,12,9,3,9,0,4,18,22.2,14,11,2,9,6,18,12,0,2018
GER-Bundesliga,2017,Werder Bremen,Lamine Sané,SEN,DF,30,1987,8.7,19,14,15,4,0,8,10,80.0,2,8,6,2,20,39,49,1,2018
GER-Bundesliga,2017,Werder Bremen,Luca Caldirola,ITA,DF,26,1991,1.0,1,0,0,1,0,1,1,100.0,0,1,0,1,3,4,3,0,2018
GER-Bundesliga,2017,Werder Bremen,Ludwig Augustinsson,SWE,"DF,FW",23,1994,28.1,45,34,22,20,3,22,32,68.8,10,25,3,22,39,84,53,0,2018
GER-Bundesliga,2017,Werder Bremen,Marco Friedl,AUT,"DF,MF",19,1998,6.7,9,8,4,4,1,7,10,70.0,3,10,1,9,8,17,17,1,2018
GER-Bundesliga,2017,Werder Bremen,Max Kruse,GER,FW,29,1988,27.3,17,12,3,10,4,5,22,22.7,17,9,0,9,11,28,4,1,2018
GER-Bundesliga,2017,Werder Bremen,Maximilian Eggestein,GER,MF,20,1996,29.9,70,48,32,34,4,34,58,58.6,24,41,6,35,40,110,51,0,2018
GER-Bundesliga,2017,Werder Bremen,Milot Rashica,KVX,"FW,MF",21,1996,4.3,2,2,1,1,0,1,8,12.5,7,3,0,3,3,5,4,0,2018
GER-Bundesliga,2017,Werder Bremen,Miloš Veljković,SRB,DF,21,1995,29.5,45,32,30,13,2,30,52,57.7,22,34,12,22,34,79,134,1,2018
GER-Bundesliga,2017,Werder Bremen,Niklas Moisander,FIN,DF,31,1985,25.0,36,28,22,13,1,24,36,66.7,12,21,9,12,38,74,98,2,2018
GER-Bundesliga,2017,Werder Bremen,Ole Käuper,GER,MF,20,1997,0.8,6,5,2,4,0,1,4,25.0,3,1,0,1,2,8,0,0,2018
GER-Bundesliga,2017,Werder Bremen,Philipp Bargfrede,GER,MF,28,1989,20.7,60,45,29,30,1,33,55,60.0,22,35,12,23,47,107,52,0,2018
GER-Bundesliga,2017,Werder Bremen,Robert Bauer,GER,"DF,FW",22,1995,10.6,31,25,21,9,1,15,25,60.0,10,8,2,6,21,52,25,2,2018
GER-Bundesliga,2017,Werder Bremen,Sebastian Langkamp,GER,DF,29,1988,4.6,7,3,4,3,0,4,4,100.0,0,7,5,2,8,15,18,0,2018
GER-Bundesliga,2017,Werder Bremen,Theodor Gebre Selassie,CZE,"DF,FW",30,1986,31.4,67,41,36,25,6,36,57,63.2,21,34,2,32,51,118,83,1,2018
GER-Bundesliga,2017,Werder Bremen,Thomas Delaney,DEN,MF,25,1991,31.1,79,61,27,46,6,36,53,67.9,17,37,12,25,43,122,74,4,2018
GER-Bundesliga,2017,Werder Bremen,Ulisses Garcia,SUI,FW,21,1996,1.0,1,1,1,0,0,1,2,50.0,1,0,0,0,0,1,3,0,2018
GER-Bundesliga,2017,Werder Bremen,Zlatko Junuzović,AUT,"MF,FW",29,1987,18.1,35,23,17,12,6,18,38,47.4,20,23,2,21,18,53,12,0,2018
GER-Bundesliga,2017,Wolfsburg,Admir Mehmedi,SUI,"FW,MF",26,1991,3.2,4,2,3,1,0,2,2,100.0,0,1,1,0,1,5,3,0,2018
GER-Bundesliga,2017,Wolfsburg,Daniel Didavi,GER,MF,27,1990,24.9,34,19,10,19,5,14,33,42.4,19,20,1,19,7,41,12,0,2018
GER-Bundesliga,2017,Wolfsburg,Divock Origi,BEL,FW,22,1995,21.9,6,5,2,3,1,1,7,14.3,6,16,2,14,3,9,17,0,2018
GER-Bundesliga,2017,Wolfsburg,Elvis Rexhbeçaj,GER,"DF,MF",19,1997,1.4,4,2,1,2,1,1,1,100.0,0,3,0,3,2,6,3,0,2018
GER-Bundesliga,2017,Wolfsburg,Gian-Luca Itter,GER,DF,18,1999,4.6,19,12,15,2,2,14,22,63.6,8,6,0,6,5,24,15,0,2018
GER-Bundesliga,2017,Wolfsburg,Ignacio Camacho,ESP,"MF,DF",27,1990,10.6,27,21,10,16,1,9,23,39.1,14,14,5,9,41,68,43,0,2018
GER-Bundesliga,2017,Wolfsburg,Jakub Błaszczykowski,POL,"FW,MF",31,1985,5.8,12,8,8,2,2,6,13,46.2,7,11,3,8,5,17,3,0,2018
GER-Bundesliga,2017,Wolfsburg,Jeffrey Bruma,NED,DF,25,1991,11.0,13,11,13,0,0,6,14,42.9,8,17,12,5,14,27,43,2,2018
GER-Bundesliga,2017,Wolfsburg,John Brooks,USA,DF,24,1993,8.1,20,13,15,4,1,16,22,72.7,6,11,5,6,10,30,46,0,2018
GER-Bundesliga,2017,Wolfsburg,Josip Brekalo,CRO,FW,19,1998,9.7,15,12,6,7,2,6,12,50.0,6,17,0,17,4,19,3,0,2018
GER-Bundesliga,2017,Wolfsburg,Josuha Guilavogui,FRA,MF,26,1990,26.7,65,46,43,20,2,30,50,60.0,20,34,10,24,66,131,63,0,2018
GER-Bundesliga,2017,Wolfsburg,Kaylen Hinds,ENG,FW,19,1998,1.0,1,1,1,0,0,0,0,,0,1,0,1,1,2,0,0,2018
GER-Bundesliga,2017,Wolfsburg,Koen Casteels,BEL,GK,25,1992,34.0,2,1,2,0,0,2,2,100.0,0,0,0,0,1,3,16,1,2018
GER-Bundesliga,2017,Wolfsburg,Landry Dimata,BEL,FW,19,1997,10.0,7,6,4,3,0,5,6,83.3,1,6,2,4,2,9,5,0,2018
GER-Bundesliga,2017,Wolfsburg,Marcel Tisserand,COD,DF,24,1993,13.9,15,10,10,4,1,7,14,50.0,7,18,13,5,31,46,50,0,2018
GER-Bundesliga,2017,Wolfsburg,Mario Gómez,GER,FW,32,1985,10.4,6,6,2,3,1,2,6,33.3,4,10,1,9,0,6,16,0,2018
GER-Bundesliga,2017,Wolfsburg,Maximilian Arnold,GER,MF,23,1994,27.3,51,41,23,23,5,25,57,43.9,32,31,4,27,28,79,34,0,2018
GER-Bundesliga,2017,Wolfsburg,Ohis Felix Uduokhai,GER,DF,19,1997,17.3,42,23,27,13,2,17,24,70.8,7,23,10,13,34,76,66,6,2018
GER-Bundesliga,2017,Wolfsburg,Paul Jaeckel,GER,DF,19,1998,3.0,3,3,3,0,0,1,2,50.0,1,5,2,3,1,4,8,0,2018
GER-Bundesliga,2017,Wolfsburg,Paul Verhaegh,NED,DF,33,1983,29.0,45,38,21,22,2,24,33,72.7,9,38,10,28,33,78,60,0,2018
GER-Bundesliga,2017,Wolfsburg,Paul-Georges Ntep,CMR,"FW,MF",25,1992,1.8,2,2,0,0,2,0,1,0.0,1,3,1,2,1,3,0,0,2018
GER-Bundesliga,2017,Wolfsburg,Renato Steffen,SUI,"FW,MF",25,1991,7.3,10,9,6,3,1,8,12,66.7,4,6,0,6,5,15,6,0,2018
GER-Bundesliga,2017,Wolfsburg,Riechedly Bazoer,NED,MF,20,1996,6.6,8,7,5,2,1,2,4,50.0,2,2,1,1,8,16,4,1,2018
GER-Bundesliga,2017,Wolfsburg,Robin Knoche,GER,DF,25,1992,23.4,34,20,26,8,0,25,35,71.4,10,36,24,12,25,59,89,1,2018
GER-Bundesliga,2017,Wolfsburg,Sebastian Jung,GER,DF,27,1990,0.9,2,2,1,1,0,1,1,100.0,0,0,0,0,0,2,5,0,2018
GER-Bundesliga,2017,Wolfsburg,Victor Osimhen,NGA,"FW,MF",18,1998,3.2,4,4,3,1,0,2,5,40.0,3,2,1,1,2,6,7,0,2018
GER-Bundesliga,2017,Wolfsburg,William,BRA,DF,22,1995,17.9,76,61,43,26,7,46,86,53.5,40,41,6,35,46,122,65,1,2018
GER-Bundesliga,2017,Wolfsburg,Yannick Gerhardt,GER,"DF,MF",23,1994,13.6,37,28,18,14,5,22,34,64.7,12,25,5,20,15,52,31,0,2018
GER-Bundesliga,2017,Wolfsburg,Yunus Mallı,TUR,"FW,MF",25,1992,24.9,25,17,8,14,3,12,25,48.0,13,23,0,23,12,37,17,0,2018
GER-Bundesliga,2018,Augsburg,Alfreð Finnbogason,ISL,FW,29,1989,14.8,7,3,2,5,0,1,9,11.1,8,6,1,5,3,10,11,0,2019
GER-Bundesliga,2018,Augsburg,Andreas Luthe,GER,GK,31,1987,14.6,0,0,0,0,0,0,0,,0,0,0,0,0,0,4,0,2019
GER-Bundesliga,2018,Augsburg,André Hahn,GER,"FW,MF",27,1990,22.8,64,38,22,39,3,22,53,41.5,31,28,2,26,27,91,32,0,2019
GER-Bundesliga,2018,Augsburg,Caiuby,BRA,"MF,FW",30,1988,11.2,12,10,5,6,1,3,11,27.3,8,16,1,15,5,17,10,0,2019
GER-Bundesliga,2018,Augsburg,Christoph Janker,GER,"MF,FW",33,1985,0.8,2,1,2,0,0,0,0,,0,1,0,1,0,2,1,0,2019
GER-Bundesliga,2018,Augsburg,Daniel Baier,GER,MF,34,1984,31.3,62,39,21,37,4,24,66,36.4,42,27,8,19,60,122,48,2,2019
GER-Bundesliga,2018,Augsburg,Fabian Giefer,GER,GK,28,1990,4.0,0,0,0,0,0,0,2,0.0,2,0,0,0,0,0,1,2,2019
GER-Bundesliga,2018,Augsburg,Felix Götze,GER,MF,20,1998,1.4,4,2,2,2,0,3,3,100.0,0,1,0,1,3,7,7,0,2019
GER-Bundesliga,2018,Augsburg,Fredrik Jensen,FIN,"FW,MF",20,1997,2.3,5,4,3,1,1,2,4,50.0,2,6,0,6,2,7,3,0,2019
GER-Bundesliga,2018,Augsburg,Georg Teigl,AUT,"MF,FW",27,1991,3.3,5,3,4,0,1,2,2,100.0,0,1,0,1,7,12,5,1,2019
GER-Bundesliga,2018,Augsburg,Gregor Kobel,SUI,GK,20,1997,15.4,1,1,1,0,0,1,1,100.0,0,0,0,0,2,3,5,3,2019
GER-Bundesliga,2018,Augsburg,Jan Morávek,CZE,MF,28,1989,8.4,38,21,17,16,5,19,42,45.2,23,21,1,20,9,47,13,0,2019
GER-Bundesliga,2018,Augsburg,Jan-Ingwer Callsen-Bracker,GER,DF,33,1984,0.1,0,0,0,0,0,0,0,,0,0,0,0,0,0,0,0,2019
GER-Bundesliga,2018,Augsburg,Jeffrey Gouweleeuw,NED,DF,27,1991,23.2,42,31,23,19,0,24,39,61.5,15,44,21,23,56,98,71,1,2019
GER-Bundesliga,2018,Augsburg,Ji Dong-won,KOR,"MF,FW",27,1991,9.9,10,6,5,3,2,6,16,37.5,10,13,2,11,8,18,10,0,2019
GER-Bundesliga,2018,Augsburg,Jonathan Schmid,FRA,DF,28,1990,28.0,44,22,23,19,2,16,28,57.1,12,22,8,14,43,87,70,2,2019
GER-Bundesliga,2018,Augsburg,Jozo Stanić,CRO,MF,19,1999,0.0,0,0,0,0,0,0,0,,0,0,0,0,0,0,0,0,2019
GER-Bundesliga,2018,Augsburg,Julian Schieber,GER,FW,29,1989,2.9,3,2,1,2,0,0,1,0.0,1,1,0,1,1,4,3,0,2019
GER-Bundesliga,2018,Augsburg,Kevin Danso,AUT,DF,19,1998,13.9,25,14,21,3,1,11,14,78.6,3,25,17,8,19,44,72,0,2019
GER-Bundesliga,2018,Augsburg,Koo Ja-cheol,KOR,MF,29,1989,18.2,36,23,10,20,6,12,30,40.0,18,28,5,23,27,63,21,0,2019
GER-Bundesliga,2018,Augsburg,Kostas Stafylidis,GRE,DF,24,1993,10.2,22,14,17,4,1,10,19,52.6,9,13,2,11,15,37,31,0,2019
GER-Bundesliga,2018,Augsburg,Marco Richter,GER,"MF,FW",20,1997,15.8,13,8,4,5,4,7,20,35.0,13,16,1,15,13,26,9,1,2019
GER-Bundesliga,2018,Augsburg,Martin Hinteregger,AUT,DF,25,1992,17.5,48,35,31,16,1,24,35,68.6,11,24,13,11,22,70,68,0,2019
GER-Bundesliga,2018,Augsburg,Michael Gregoritsch,AUT,"MF,FW",24,1994,27.6,22,13,7,9,6,4,28,14.3,24,29,10,19,15,37,58,0,2019
GER-Bundesliga,2018,Augsburg,Philipp Max,GER,"DF,MF",24,1993,28.5,35,24,17,15,3,21,39,53.8,18,16,3,13,22,57,46,1,2019
GER-Bundesliga,2018,Augsburg,Rani Khedira,GER,"DF,MF",24,1994,29.2,56,39,22,28,6,18,36,50.0,18,44,22,22,80,136,95,1,2019
GER-Bundesliga,2018,Augsburg,Raphael Framberger,GER,"DF,MF",22,1995,6.1,8,6,4,4,0,0,3,0.0,3,10,3,7,11,19,15,1,2019
GER-Bundesliga,2018,Augsburg,Reece Oxford,ENG,DF,19,1998,5.6,12,9,9,3,0,4,6,66.7,2,10,9,1,11,23,39,0,2019
GER-Bundesliga,2018,Augsburg,Sergio Córdova,VEN,FW,20,1997,5.9,9,5,3,4,2,2,6,33.3,4,0,0,0,3,12,5,0,2019
GER-Bundesliga,2018,Augsburg,Simon Asta,GER,DF,17,2001,1.0,6,3,4,2,0,2,2,100.0,0,2,1,1,3,9,1,0,2019
GER-Bundesliga,2018,Bayern Munich,Alphonso Davies,CAN,"MF,FW",17,2000,0.9,1,1,1,0,0,0,0,,0,2,0,2,2,3,1,0,2019
GER-Bundesliga,2018,Bayern Munich,Arjen Robben,NED,"FW,MF",34,1984,6.3,3,1,0,3,0,0,1,0.0,1,6,1,5,3,6,0,0,2019
GER-Bundesliga,2018,Bayern Munich,Corentin Tolisso,FRA,MF,23,1994,0.6,0,0,0,0,0,0,2,0.0,2,1,1,0,0,0,0,0,2019
GER-Bundesliga,2018,Bayern Munich,David Alaba,AUT,DF,26,1992,28.1,34,21,13,13,8,17,26,65.4,9,24,3,21,31,65,40,0,2019
GER-Bundesliga,2018,Bayern Munich,Franck Ribéry,FRA,"MF,FW",35,1983,13.0,15,7,7,6,2,4,10,40.0,6,9,0,9,7,22,1,0,2019
GER-Bundesliga,2018,Bayern Munich,James Rodríguez,COL,MF,27,1991,12.6,12,8,3,4,5,5,19,26.3,14,9,0,9,4,16,1,0,2019
GER-Bundesliga,2018,Bayern Munich,Javi Martínez,ESP,MF,29,1988,14.5,26,15,7,17,2,5,16,31.3,11,17,5,12,31,57,13,0,2019
GER-Bundesliga,2018,Bayern Munich,Jeong Woo-yeong,KOR,FW,18,1999,0.1,0,0,0,0,0,0,1,0.0,1,0,0,0,0,0,0,0,2019
GER-Bundesliga,2018,Bayern Munich,Joshua Kimmich,GER,"DF,MF",23,1995,34.0,46,26,17,22,7,25,54,46.3,29,35,9,26,34,80,41,3,2019
GER-Bundesliga,2018,Bayern Munich,Jérôme Boateng,GER,DF,29,1988,18.8,21,15,12,9,0,10,22,45.5,12,8,3,5,25,46,49,0,2019
GER-Bundesliga,2018,Bayern Munich,Kingsley Coman,FRA,"FW,MF",22,1996,15.3,11,6,4,4,3,6,19,31.6,13,20,0,20,5,16,3,0,2019
GER-Bundesliga,2018,Bayern Munich,Leon Goretzka,GER,MF,23,1995,22.5,41,22,7,27,7,14,38,36.8,24,25,4,21,26,67,14,1,2019
GER-Bundesliga,2018,Bayern Munich,Manuel Neuer,GER,GK,32,1986,25.6,1,1,1,0,0,0,1,0.0,1,1,0,1,0,1,8,3,2019
GER-Bundesliga,2018,Bayern Munich,Mats Hummels,GER,DF,29,1988,19.7,26,17,19,6,1,9,24,37.5,15,20,8,12,34,60,50,1,2019
GER-Bundesliga,2018,Bayern Munich,Meritan Shabani,ALB,MF,19,1999,0.0,0,0,0,0,0,0,0,,0,0,0,0,0,0,0,0,2019
GER-Bundesliga,2018,Bayern Munich,Niklas Süle,GER,DF,22,1995,29.5,28,23,17,10,1,18,25,72.0,7,23,13,10,40,68,83,0,2019
GER-Bundesliga,2018,Bayern Munich,Rafinha,BRA,DF,32,1985,10.0,15,7,6,6,3,6,14,42.9,8,8,3,5,19,34,11,0,2019
GER-Bundesliga,2018,Bayern Munich,Renato Sanches,POR,MF,20,1997,6.4,5,5,2,1,2,3,10,30.0,7,7,0,7,4,9,2,0,2019
GER-Bundesliga,2018,Bayern Munich,Robert Lewandowski,POL,FW,29,1988,32.9,12,9,0,8,4,3,11,27.3,8,11,1,10,7,19,15,0,2019
GER-Bundesliga,2018,Bayern Munich,Sandro Wagner,GER,FW,30,1987,1.6,3,2,0,2,1,0,1,0.0,1,0,0,0,0,3,2,0,2019
GER-Bundesliga,2018,Bayern Munich,Serge Gnabry,GER,"FW,MF",23,1995,19.6,36,20,12,13,11,5,30,16.7,25,18,0,18,11,47,3,0,2019
GER-Bundesliga,2018,Bayern Munich,Sven Ulreich,GER,GK,29,1988,8.4,0,0,0,0,0,0,0,,0,0,0,0,0,0,2,1,2019
GER-Bundesliga,2018,Bayern Munich,Thiago Alcántara,ESP,MF,27,1991,26.8,87,65,31,44,12,25,48,52.1,23,23,4,19,44,131,17,1,2019
GER-Bundesliga,2018,Bayern Munich,Thomas Müller,GER,"MF,FW",28,1989,26.4,42,23,13,15,14,10,38,26.3,28,46,6,40,9,51,12,0,2019
GER-Bundesliga,2018,Dortmund,Abdou Diallo,SEN,DF,22,1996,26.4,36,20,20,13,3,11,15,73.3,4,28,15,13,26,62,91,1,2019
GER-Bundesliga,2018,Dortmund,Achraf Hakimi,MAR,DF,19,1998,19.3,34,19,25,8,1,17,36,47.2,19,27,4,23,29,63,45,2,2019
GER-Bundesliga,2018,Dortmund,Axel Witsel,BEL,MF,29,1989,31.9,47,33,19,24,4,17,28,60.7,11,33,6,27,47,94,49,0,2019
GER-Bundesliga,2018,Dortmund,Christian Pulisic,USA,FW,19,1998,10.4,10,6,2,6,2,2,6,33.3,4,12,2,10,6,16,10,0,2019
GER-Bundesliga,2018,Dortmund,Dan-Axel Zagadou,FRA,DF,19,1999,14.1,13,10,10,2,1,4,6,66.7,2,17,11,6,25,38,70,2,2019
GER-Bundesliga,2018,Dortmund,Jacob Bruun Larsen,DEN,FW,19,1998,14.1,15,9,8,2,5,7,17,41.2,10,15,1,14,13,28,12,0,2019
GER-Bundesliga,2018,Dortmund,Jadon Sancho,ENG,"FW,MF",18,2000,27.3,19,10,7,6,6,10,31,32.3,21,21,1,20,14,33,12,1,2019
GER-Bundesliga,2018,Dortmund,Julian Weigl,GER,"DF,MF",22,1995,16.2,32,18,19,12,1,24,41,58.5,17,18,10,8,16,48,56,2,2019
GER-Bundesliga,2018,Dortmund,Mahmoud Dahoud,GER,MF,22,1996,7.7,16,10,4,10,2,3,15,20.0,12,10,0,10,17,33,8,0,2019
GER-Bundesliga,2018,Dortmund,Manuel Akanji,SUI,DF,23,1995,24.5,29,19,14,13,2,14,25,56.0,11,22,13,9,27,56,92,2,2019
GER-Bundesliga,2018,Dortmund,Marcel Schmelzer,GER,DF,30,1988,6.3,10,5,7,2,1,5,9,55.6,4,7,1,6,9,19,14,0,2019
GER-Bundesliga,2018,Dortmund,Marco Reus,GER,"MF,FW",29,1989,25.7,33,22,11,16,6,6,31,19.4,25,28,1,27,8,41,32,0,2019
GER-Bundesliga,2018,Dortmund,Mario Götze,GER,"FW,MF",26,1992,18.6,26,19,6,11,9,4,25,16.0,21,10,0,10,8,34,4,1,2019
GER-Bundesliga,2018,Dortmund,Marius Wolf,GER,"DF,FW",23,1995,9.2,14,10,11,3,0,5,13,38.5,8,6,0,6,13,27,12,0,2019
GER-Bundesliga,2018,Dortmund,Marwin Hitz,SUI,GK,30,1987,2.0,0,0,0,0,0,0,0,,0,0,0,0,0,0,0,1,2019
GER-Bundesliga,2018,Dortmund,Maximilian Philipp,GER,"FW,MF",24,1994,8.4,7,5,3,4,0,2,9,22.2,7,10,0,10,3,10,6,0,2019
GER-Bundesliga,2018,Dortmund,Paco Alcácer,ESP,FW,24,1993,13.5,3,1,2,0,1,0,6,0.0,6,5,0,5,6,9,7,0,2019
GER-Bundesliga,2018,Dortmund,Raphaël Guerreiro,POR,"FW,DF",24,1993,17.0,25,12,11,7,7,12,23,52.2,11,7,1,6,18,43,12,1,2019
GER-Bundesliga,2018,Dortmund,Roman Bürki,SUI,GK,27,1990,32.0,1,0,1,0,0,1,2,50.0,1,1,0,1,2,3,8,4,2019
GER-Bundesliga,2018,Dortmund,Shinji Kagawa,JPN,MF,29,1989,1.1,0,0,0,0,0,0,0,,0,0,0,0,0,0,0,0,2019
GER-Bundesliga,2018,Dortmund,Thomas Delaney,DEN,MF,26,1991,25.4,69,54,28,39,2,19,30,63.3,11,30,9,21,58,127,43,0,2019
GER-Bundesliga,2018,Dortmund,Ömer Toprak,TUR,DF,29,1989,2.6,1,1,0,1,0,0,1,0.0,1,1,1,0,0,1,7,0,2019
GER-Bundesliga,2018,Dortmund,Łukasz Piszczek,POL,DF,33,1985,19.5,57,36,34,15,8,18,33,54.5,15,26,3,23,39,96,69,0,2019
GER-Bundesliga,2018,Düsseldorf,Adam Bodzek,GER,"MF,DF",32,1985,17.7,44,27,27,16,1,17,43,39.5,26,15,6,9,26,70,39,0,2019
GER-Bundesliga,2018,Düsseldorf,Alfredo Morales,USA,MF,28,1990,17.0,32,18,16,15,1,6,24,25.0,18,18,9,9,24,56,31,0,2019
GER-Bundesliga,2018,Düsseldorf,André Hoffmann,GER,"DF,MF",25,1993,11.7,22,14,12,10,0,9,25,36.0,16,17,12,5,21,43,44,0,2019
GER-Bundesliga,2018,Düsseldorf,Aymen Barkok,MAR,MF,20,1998,5.7,13,6,4,9,0,4,19,21.1,15,8,1,7,4,17,3,0,2019
GER-Bundesliga,2018,Düsseldorf,Benito Raman,BEL,"MF,FW",23,1994,18.7,35,20,14,16,5,11,53,20.8,42,30,2,28,15,50,8,0,2019
GER-Bundesliga,2018,Düsseldorf,Davor Lovren,CRO,MF,19,1998,0.5,1,1,0,0,1,0,0,,0,1,0,1,0,1,0,0,2019
GER-Bundesliga,2018,Düsseldorf,Dawid Kownacki,POL,"MF,FW",21,1997,6.4,13,6,9,3,1,7,16,43.8,9,8,0,8,2,15,8,0,2019
GER-Bundesliga,2018,Düsseldorf,Dodi Lukebakio,BEL,"FW,MF",20,1997,21.9,25,17,11,6,8,8,15,53.3,7,13,0,13,9,34,19,0,2019
GER-Bundesliga,2018,Düsseldorf,Jaroslav Drobný,CZE,GK,38,1979,2.0,0,0,0,0,0,0,0,,0,0,0,0,0,0,1,0,2019
GER-Bundesliga,2018,Düsseldorf,Jean Zimmer,GER,"DF,FW",24,1993,15.9,17,11,11,5,1,6,16,37.5,10,13,2,11,11,28,32,1,2019
GER-Bundesliga,2018,Düsseldorf,Kaan Ayhan,TUR,DF,23,1994,27.2,53,29,38,15,0,23,47,48.9,24,34,16,18,59,112,118,3,2019
GER-Bundesliga,2018,Düsseldorf,Kenan Karaman,TUR,"FW,MF",24,1994,10.2,13,9,3,10,0,7,12,58.3,5,5,1,4,2,15,8,0,2019
GER-Bundesliga,2018,Düsseldorf,Kevin Stöger,AUT,MF,24,1993,23.5,63,35,28,27,8,30,67,44.8,37,32,5,27,31,94,19,1,2019
GER-Bundesliga,2018,Düsseldorf,Marcel Sobottka,GER,MF,24,1994,10.5,30,20,12,18,0,10,19,52.6,9,13,5,8,24,54,17,0,2019
GER-Bundesliga,2018,Düsseldorf,Marcin Kamiński,POL,DF,26,1992,27.0,18,13,14,3,1,7,11,63.6,4,21,11,10,39,57,103,2,2019
GER-Bundesliga,2018,Düsseldorf,Markus Suttner,AUT,"DF,MF",31,1987,5.4,10,7,5,4,1,4,8,50.0,4,8,3,5,8,18,10,0,2019
GER-Bundesliga,2018,Düsseldorf,Marvin Ducksch,GER,FW,24,1994,9.1,3,1,0,2,1,1,5,20.0,4,4,0,4,4,7,11,0,2019
GER-Bundesliga,2018,Düsseldorf,Matthias Zimmermann,GER,"DF,MF",26,1992,33.9,97,64,69,24,4,45,90,50.0,45,51,18,33,67,164,90,2,2019
GER-Bundesliga,2018,Düsseldorf,Michael Rensing,GER,GK,34,1984,32.0,2,1,2,0,0,1,5,20.0,4,1,0,1,2,4,13,2,2019
GER-Bundesliga,2018,Düsseldorf,Niko Gießelmann,GER,DF,26,1991,28.8,57,37,38,14,5,26,59,44.1,33,25,6,19,36,93,85,1,2019
GER-Bundesliga,2018,Düsseldorf,Oliver Fink,GER,MF,36,1982,11.7,38,22,17,17,4,12,38,31.6,26,20,3,17,13,51,19,0,2019
GER-Bundesliga,2018,Düsseldorf,Robin Bormuth,GER,DF,22,1995,6.8,7,4,7,0,0,5,10,50.0,5,6,4,2,10,17,49,1,2019
GER-Bundesliga,2018,Düsseldorf,Rouwen Hennings,GER,FW,30,1987,20.4,14,10,1,8,5,2,13,15.4,11,16,1,15,4,18,20,0,2019
GER-Bundesliga,2018,Düsseldorf,Takashi Usami,JPN,"MF,FW",26,1992,9.8,18,12,7,11,0,9,26,34.6,17,15,2,13,8,26,13,1,2019
GER-Bundesliga,2018,Eint Frankfurt,Allan,BRA,MF,21,1997,2.0,4,4,2,2,0,0,4,0.0,4,4,2,2,0,4,1,0,2019
GER-Bundesliga,2018,Eint Frankfurt,Almamy Touré,MLI,"DF,MF",22,1996,5.8,18,11,7,11,0,5,8,62.5,3,4,1,3,9,27,25,0,2019
GER-Bundesliga,2018,Eint Frankfurt,Ante Rebić,CRO,"FW,MF",24,1993,22.0,22,9,5,12,5,5,12,41.7,7,18,1,17,8,30,3,0,2019
GER-Bundesliga,2018,Eint Frankfurt,Branimir Hrgota,SWE,FW,25,1993,0.1,0,0,0,0,0,0,0,,0,0,0,0,0,0,0,0,2019
GER-Bundesliga,2018,Eint Frankfurt,Carlos Salcedo,MEX,DF,24,1993,5.1,7,3,4,3,0,4,7,57.1,3,7,3,4,9,16,22,0,2019
GER-Bundesliga,2018,Eint Frankfurt,Danny Blum,GER,MF,27,1991,0.0,0,0,0,0,0,0,0,,0,0,0,0,0,0,5,0,2019
GER-Bundesliga,2018,Eint Frankfurt,Danny da Costa,GER,"DF,FW",25,1993,33.7,61,35,29,25,7,18,42,42.9,24,51,9,42,32,93,67,0,2019
GER-Bundesliga,2018,Eint Frankfurt,David Abraham,ARG,DF,32,1986,15.8,22,14,13,8,1,11,25,44.0,14,23,12,11,24,46,64,0,2019
GER-Bundesliga,2018,Eint Frankfurt,Filip Kostić,SRB,"DF,FW",25,1992,32.8,64,42,35,22,7,23,65,35.4,42,80,6,74,23,87,50,0,2019
GER-Bundesliga,2018,Eint Frankfurt,Frederik Rønnow,DEN,GK,25,1992,1.4,0,0,0,0,0,0,0,,0,0,0,0,0,0,1,0,2019
GER-Bundesliga,2018,Eint Frankfurt,Gelson Fernandes,SUI,MF,31,1986,24.7,74,48,33,38,3,23,65,35.4,42,45,9,36,53,127,16,0,2019
GER-Bundesliga,2018,Eint Frankfurt,Gonçalo Paciência,POR,FW,23,1994,4.3,3,2,0,2,1,1,2,50.0,1,8,1,7,0,3,1,0,2019
GER-Bundesliga,2018,Eint Frankfurt,Jetro Willems,NED,"MF,DF",24,1994,8.1,20,15,10,8,2,9,15,60.0,6,10,4,6,10,30,14,0,2019
GER-Bundesliga,2018,Eint Frankfurt,Jonathan de Guzmán,NED,MF,30,1987,17.4,34,24,11,20,3,13,28,46.4,15,18,2,16,11,45,16,0,2019
GER-Bundesliga,2018,Eint Frankfurt,Kevin Trapp,GER,GK,28,1990,32.6,0,0,0,0,0,0,2,0.0,2,0,0,0,0,0,17,1,2019
GER-Bundesliga,2018,Eint Frankfurt,Lucas Torró,ESP,MF,24,1994,6.2,14,7,5,7,2,5,11,45.5,6,12,1,11,14,28,13,0,2019
GER-Bundesliga,2018,Eint Frankfurt,Luka Jović,SRB,"FW,MF",20,1997,24.9,10,5,1,8,1,1,12,8.3,11,8,0,8,3,13,30,0,2019
GER-Bundesliga,2018,Eint Frankfurt,Makoto Hasebe,JPN,"DF,MF",34,1984,28.0,52,34,35,17,0,25,42,59.5,17,43,22,21,40,92,101,3,2019
GER-Bundesliga,2018,Eint Frankfurt,Marc Stendera,GER,MF,22,1995,1.2,6,1,2,4,0,2,4,50.0,2,4,1,3,0,6,0,0,2019
GER-Bundesliga,2018,Eint Frankfurt,Marco Fabián,MEX,FW,29,1989,0.7,3,2,2,1,0,1,1,100.0,0,0,0,0,3,6,0,0,2019
GER-Bundesliga,2018,Eint Frankfurt,Marco Russ,GER,DF,32,1985,4.2,7,2,5,2,0,4,6,66.7,2,2,2,0,7,14,8,0,2019
GER-Bundesliga,2018,Eint Frankfurt,Martin Hinteregger,AUT,DF,25,1992,12.7,34,26,19,12,3,13,28,46.4,15,20,7,13,13,47,51,0,2019
GER-Bundesliga,2018,Eint Frankfurt,Mijat Gaćinović,SRB,MF,23,1995,18.1,31,20,7,13,11,11,42,26.2,31,26,1,25,24,55,10,0,2019
GER-Bundesliga,2018,Eint Frankfurt,Nicolai Müller,GER,"FW,MF",30,1987,2.4,4,2,3,1,0,1,2,50.0,1,4,1,3,0,4,0,0,2019
GER-Bundesliga,2018,Eint Frankfurt,Obite N'Dicka,FRA,DF,18,1999,25.6,43,28,31,10,2,31,52,59.6,21,29,11,18,29,72,123,0,2019
GER-Bundesliga,2018,Eint Frankfurt,Sebastian Rode,GER,MF,27,1990,10.3,31,19,17,9,5,16,35,45.7,19,17,0,17,19,50,14,0,2019
GER-Bundesliga,2018,Eint Frankfurt,Simon Falette,GUI,DF,26,1992,6.7,9,6,7,1,1,2,6,33.3,4,11,5,6,14,23,32,0,2019
GER-Bundesliga,2018,Eint Frankfurt,Sébastien Haller,CIV,FW,24,1994,24.2,24,11,7,10,7,8,21,38.1,13,21,1,20,15,39,23,0,2019
GER-Bundesliga,2018,Eint Frankfurt,Taleb Tawatha,ISR,"FW,DF",26,1992,1.4,1,1,1,0,0,1,2,50.0,1,0,0,0,0,1,1,0,2019
GER-Bundesliga,2018,Eint Frankfurt,Timothy Chandler,USA,DF,28,1990,0.2,0,0,0,0,0,0,0,,0,0,0,0,0,0,0,0,2019
GER-Bundesliga,2018,Freiburg,Alexander Schwolow,GER,GK,26,1992,33.0,0,0,0,0,0,0,1,0.0,1,0,0,0,0,0,13,2,2019
GER-Bundesliga,2018,Freiburg,Amir Abrashi,ALB,MF,28,1990,8.8,20,11,7,10,3,6,19,31.6,13,11,3,8,14,34,15,0,2019
GER-Bundesliga,2018,Freiburg,Chima Okoroji,NGA,"DF,MF",21,1997,1.2,3,0,1,1,1,1,1,100.0,0,0,0,0,1,4,1,0,2019
GER-Bundesliga,2018,Freiburg,Christian Günter,GER,"DF,MF",25,1993,32.0,38,26,16,16,6,20,43,46.5,23,31,7,24,14,52,55,0,2019
GER-Bundesliga,2018,Freiburg,Christoph Daferner,GER,FW,20,1998,0.3,1,0,1,0,0,0,0,,0,0,0,0,1,2,0,0,2019
GER-Bundesliga,2018,Freiburg,Dominique Heintz,GER,DF,24,1993,33.9,41,21,34,6,1,18,32,56.3,14,45,22,23,45,86,214,0,2019
GER-Bundesliga,2018,Freiburg,Florian Niederlechner,GER,"FW,MF",27,1990,10.8,7,5,1,4,2,0,5,0.0,5,12,4,8,6,13,10,0,2019
GER-Bundesliga,2018,Freiburg,Janik Haberer,GER,"MF,FW",24,1994,26.0,71,47,37,24,10,30,75,40.0,45,31,4,27,36,107,49,0,2019
GER-Bundesliga,2018,Freiburg,Jérôme Gondorf,GER,"MF,FW",30,1988,14.4,33,18,12,19,2,14,28,50.0,14,29,5,24,19,52,23,1,2019
GER-Bundesliga,2018,Freiburg,Keven Schlotterbeck,GER,DF,21,1997,8.6,22,16,19,2,1,8,12,66.7,4,17,11,6,13,35,26,0,2019
GER-Bundesliga,2018,Freiburg,Luca Waldschmidt,GER,"FW,MF",22,1996,19.1,20,13,7,10,3,2,20,10.0,18,20,3,17,13,33,8,1,2019
GER-Bundesliga,2018,Freiburg,Lucas Höler,GER,FW,24,1994,11.2,18,13,6,9,3,4,18,22.2,14,10,1,9,3,21,15,2,2019
GER-Bundesliga,2018,Freiburg,Lukas Kübler,GER,"DF,MF",25,1992,13.2,35,22,23,12,0,16,26,61.5,10,15,5,10,30,65,50,1,2019
GER-Bundesliga,2018,Freiburg,Manuel Gulde,GER,DF,27,1991,19.0,24,16,18,5,1,12,16,75.0,4,25,13,12,26,50,90,0,2019
GER-Bundesliga,2018,Freiburg,Marco Terrazzino,GER,"MF,FW",27,1991,5.7,6,3,4,2,0,1,7,14.3,6,5,2,3,3,9,2,0,2019
GER-Bundesliga,2018,Freiburg,Mark Flekken,NED,GK,25,1993,1.0,0,0,0,0,0,0,0,,0,0,0,0,0,0,0,0,2019
GER-Bundesliga,2018,Freiburg,Mike Frantz,GER,"MF,FW",31,1986,24.6,34,26,15,15,4,6,20,30.0,14,24,4,20,21,55,32,0,2019
GER-Bundesliga,2018,Freiburg,Nico Schlotterbeck,GER,DF,18,1999,2.5,6,6,6,0,0,2,2,100.0,0,3,1,2,5,11,10,0,2019
GER-Bundesliga,2018,Freiburg,Nicolas Höfler,GER,MF,28,1990,17.9,45,22,19,22,4,14,36,38.9,22,21,4,17,32,77,41,0,2019
GER-Bundesliga,2018,Freiburg,Nils Petersen,GER,FW,29,1988,21.4,29,21,10,16,3,4,24,16.7,20,28,2,26,13,42,34,0,2019
GER-Bundesliga,2018,Freiburg,Pascal Stenzel,GER,"DF,MF",22,1996,16.1,42,26,26,14,2,24,43,55.8,19,16,3,13,30,72,48,1,2019
GER-Bundesliga,2018,Freiburg,Patrick Kammerbauer,GER,FW,21,1997,0.0,0,0,0,0,0,0,0,,0,0,0,0,1,1,1,0,2019
GER-Bundesliga,2018,Freiburg,Philipp Lienhart,AUT,DF,22,1996,6.8,6,6,4,2,0,3,6,50.0,3,9,7,2,11,17,42,0,2019
GER-Bundesliga,2018,Freiburg,Robin Koch,GER,"MF,DF",22,1996,21.1,25,14,17,7,1,7,24,29.2,17,31,18,13,32,57,77,4,2019
GER-Bundesliga,2018,Freiburg,Roland Sallai,HUN,MF,21,1997,5.9,12,7,5,5,2,5,13,38.5,8,3,0,3,3,15,8,0,2019
GER-Bundesliga,2018,Freiburg,Tim Kleindienst,GER,FW,22,1995,2.2,4,3,1,2,1,1,3,33.3,2,3,0,3,0,4,7,0,2019
GER-Bundesliga,2018,Freiburg,Vincenzo Grifo,ITA,"MF,FW",25,1993,15.9,26,14,11,8,7,14,27,51.9,13,10,1,9,2,28,10,0,2019
GER-Bundesliga,2018,Freiburg,Yoric Ravet,FRA,"FW,MF",28,1989,0.8,2,1,1,0,1,1,2,50.0,1,2,1,1,0,2,1,0,2019
GER-Bundesliga,2018,Hannover 96,Benjamin Hadžić,BIH,"FW,MF",19,1999,0.3,0,0,0,0,0,0,1,0.0,1,0,0,0,0,0,0,0,2019
GER-Bundesliga,2018,Hannover 96,Bobby Wood,USA,"FW,MF",25,1992,13.1,13,10,2,10,1,5,8,62.5,3,2,0,2,4,17,6,0,2019
GER-Bundesliga,2018,Hannover 96,Edgar Prib,GER,MF,28,1989,2.2,10,9,3,5,2,2,4,50.0,2,4,0,4,2,12,1,0,2019
GER-Bundesliga,2018,Hannover 96,Felipe,BRA,DF,31,1987,12.2,23,15,21,2,0,9,17,52.9,8,17,9,8,35,58,71,0,2019
GER-Bundesliga,2018,Hannover 96,Florent Muslija,KVX,"MF,FW",20,1998,7.5,16,10,8,6,2,8,12,66.7,4,4,0,4,3,19,4,0,2019
GER-Bundesliga,2018,Hannover 96,Genki Haraguchi,JPN,"MF,DF",27,1991,23.7,44,26,21,20,3,17,66,25.8,49,34,5,29,21,65,33,0,2019
GER-Bundesliga,2018,Hannover 96,Hendrik Weydandt,GER,FW,23,1995,19.1,18,12,7,8,3,3,24,12.5,21,14,4,10,5,23,44,0,2019
GER-Bundesliga,2018,Hannover 96,Ihlas Bebou,TOG,"MF,FW",24,1994,11.8,15,9,4,10,1,4,9,44.4,5,18,2,16,9,24,9,0,2019
GER-Bundesliga,2018,Hannover 96,Iver Fossum,NOR,MF,22,1996,5.1,9,5,1,7,1,4,8,50.0,4,8,2,6,7,16,10,0,2019
GER-Bundesliga,2018,Hannover 96,Jonathas,BRA,FW,29,1989,6.7,7,4,3,4,0,3,10,30.0,7,9,1,8,3,10,4,0,2019
GER-Bundesliga,2018,Hannover 96,Josip Elez,CRO,DF,24,1994,7.2,8,3,5,3,0,2,11,18.2,9,13,4,9,6,14,27,0,2019
GER-Bundesliga,2018,Hannover 96,Julian Korb,GER,DF,26,1992,11.2,26,17,16,9,1,10,29,34.5,19,27,4,23,23,49,34,1,2019
GER-Bundesliga,2018,Hannover 96,Kevin Akpoguma,NGA,DF,23,1995,3.5,10,6,5,5,0,6,7,85.7,1,7,2,5,10,20,7,2,2019
GER-Bundesliga,2018,Hannover 96,Kevin Wimmer,AUT,DF,25,1992,18.7,25,17,17,6,2,15,27,55.6,12,30,23,7,41,66,63,0,2019
GER-Bundesliga,2018,Hannover 96,Linton Maina,GER,"FW,MF",19,1999,15.7,28,14,13,10,5,12,23,52.2,11,20,0,20,14,42,4,0,2019
GER-Bundesliga,2018,Hannover 96,Marvin Bakalorz,GER,MF,28,1989,16.3,18,11,7,9,2,6,36,16.7,30,29,4,25,28,46,47,0,2019
GER-Bundesliga,2018,Hannover 96,Matthias Ostrzolek,GER,DF,28,1990,16.3,32,18,24,8,0,20,33,60.6,13,20,5,15,26,58,44,2,2019
GER-Bundesliga,2018,Hannover 96,Michael Esser,GER,GK,30,1987,32.0,3,2,3,0,0,2,5,40.0,3,1,0,1,1,4,15,0,2019
GER-Bundesliga,2018,Hannover 96,Miiko Albornoz,CHI,"DF,MF",27,1990,18.4,46,26,31,10,5,21,45,46.7,24,23,3,20,16,62,37,1,2019
GER-Bundesliga,2018,Hannover 96,Niclas Füllkrug,GER,FW,25,1993,12.4,3,0,0,1,2,1,5,20.0,4,10,4,6,1,4,17,0,2019
GER-Bundesliga,2018,Hannover 96,Nicolai Müller,GER,"MF,FW",30,1987,10.0,18,9,7,7,4,8,27,29.6,19,9,1,8,1,19,7,0,2019
GER-Bundesliga,2018,Hannover 96,Noah Joel Sarenren Bazee,NGA,"FW,MF",21,1996,1.7,0,0,0,0,0,0,0,,0,1,0,1,0,0,3,0,2019
GER-Bundesliga,2018,Hannover 96,Oliver Sorg,GER,DF,28,1990,17.6,42,28,26,16,0,20,43,46.5,23,16,9,7,46,88,47,0,2019
GER-Bundesliga,2018,Hannover 96,Philipp Tschauner,GER,GK,32,1985,1.0,0,0,0,0,0,0,0,,0,0,0,0,0,0,0,0,2019
GER-Bundesliga,2018,Hannover 96,Pirmin Schwegler,SUI,MF,31,1987,23.1,63,34,30,29,4,34,60,56.7,26,21,5,16,41,104,54,0,2019
GER-Bundesliga,2018,Hannover 96,Samuel Şahin-Radlinger,AUT,GK,25,1992,1.0,0,0,0,0,0,0,0,,0,1,0,1,0,0,2,0,2019
GER-Bundesliga,2018,Hannover 96,Sebastian Soto,USA,"MF,FW",18,2000,0.3,0,0,0,0,0,0,0,,0,0,0,0,0,0,0,0,2019
GER-Bundesliga,2018,Hannover 96,Takuma Asano,JPN,"MF,FW",23,1994,7.8,5,3,1,1,3,1,6,16.7,5,9,0,9,2,7,2,0,2019
GER-Bundesliga,2018,Hannover 96,Tim Dierßen,GER,MF,22,1996,0.2,0,0,0,0,0,0,0,,0,1,0,1,0,0,0,0,2019
GER-Bundesliga,2018,Hannover 96,Uffe Bech,DEN,FW,25,1993,0.2,0,0,0,0,0,0,1,0.0,1,0,0,0,0,0,0,0,2019
GER-Bundesliga,2018,Hannover 96,Walace,BRA,MF,23,1995,22.2,52,22,17,28,7,27,61,44.3,34,30,4,26,45,97,36,1,2019
GER-Bundesliga,2018,Hannover 96,Waldemar Anton,GER,DF,22,1996,34.0,49,32,33,14,2,22,50,44.0,28,56,33,23,69,118,169,3,2019
GER-Bundesliga,2018,Hertha BSC,Arne Maier,GER,MF,19,1999,22.9,31,16,12,19,0,6,25,24.0,19,32,9,23,28,59,35,0,2019
GER-Bundesliga,2018,Hertha BSC,Davie Selke,GER,FW,23,1995,19.3,5,2,1,4,0,2,9,22.2,7,11,0,11,1,6,7,0,2019
GER-Bundesliga,2018,Hertha BSC,Dennis Jastrzembski,POL,"FW,DF",18,2000,0.7,0,0,0,0,0,0,3,0.0,3,0,0,0,1,1,0,0,2019
GER-Bundesliga,2018,Hertha BSC,Derrick Luckassen,NED,DF,23,1995,2.8,4,2,4,0,0,1,3,33.3,2,1,0,1,0,4,13,0,2019
GER-Bundesliga,2018,Hertha BSC,Fabian Lustenberger,SUI,"DF,MF",30,1988,24.1,45,30,23,21,1,15,33,45.5,18,39,18,21,39,84,108,2,2019
GER-Bundesliga,2018,Hertha BSC,Florian Baak,GER,MF,19,1999,0.0,0,0,0,0,0,0,0,,0,0,0,0,0,0,0,0,2019
GER-Bundesliga,2018,Hertha BSC,Javairô Dilrosun,NED,"FW,MF",20,1998,10.0,14,10,7,5,2,3,7,42.9,4,18,2,16,7,21,9,0,2019
GER-Bundesliga,2018,Hertha BSC,Jordan Torunarigha,GER,DF,20,1997,12.9,34,30,23,10,1,18,28,64.3,10,19,7,12,29,63,55,0,2019
GER-Bundesliga,2018,Hertha BSC,Karim Rekik,NED,DF,23,1994,23.0,36,22,23,12,1,12,18,66.7,6,24,16,8,34,70,88,0,2019
GER-Bundesliga,2018,Hertha BSC,Lukas Klünter,GER,DF,22,1996,6.6,11,8,6,5,0,4,5,80.0,1,6,2,4,12,23,20,0,2019
GER-Bundesliga,2018,Hertha BSC,Marko Grujić,SRB,MF,22,1996,19.8,45,33,17,20,8,13,38,34.2,25,29,6,23,29,74,51,1,2019
GER-Bundesliga,2018,Hertha BSC,Marvin Plattenhardt,GER,DF,26,1992,21.4,27,21,12,10,5,14,21,66.7,7,18,3,15,7,34,56,0,2019
GER-Bundesliga,2018,Hertha BSC,Mathew Leckie,AUS,"FW,MF",27,1991,10.5,20,13,5,10,5,7,16,43.8,9,10,1,9,13,33,16,0,2019
GER-Bundesliga,2018,Hertha BSC,Maximilian Mittelstädt,GER,"DF,MF",21,1997,20.0,61,37,33,23,5,23,49,46.9,26,32,4,28,46,107,64,0,2019
GER-Bundesliga,2018,Hertha BSC,Niklas Stark,GER,DF,23,1995,20.8,34,19,23,11,0,9,24,37.5,15,45,26,19,37,71,141,1,2019
GER-Bundesliga,2018,Hertha BSC,Ondrej Duda,SVK,MF,23,1994,28.5,54,33,13,35,6,15,55,27.3,40,36,4,32,15,69,17,1,2019
GER-Bundesliga,2018,Hertha BSC,Palkó Dárdai,HUN,"FW,MF",19,1999,1.3,1,1,1,0,0,0,0,,0,1,0,1,0,1,0,0,2019
GER-Bundesliga,2018,Hertha BSC,Pascal Köpke,GER,"FW,MF",22,1995,0.8,1,0,1,0,0,1,2,50.0,1,0,0,0,0,1,0,0,2019
GER-Bundesliga,2018,Hertha BSC,Per Ciljan Skjelbred,NOR,MF,31,1987,11.1,26,18,13,12,1,5,22,22.7,17,10,1,9,20,46,14,0,2019
GER-Bundesliga,2018,Hertha BSC,Peter Pekarík,SVK,DF,31,1986,2.4,2,1,1,1,0,1,3,33.3,2,2,1,1,1,3,5,0,2019
GER-Bundesliga,2018,Hertha BSC,Rune Jarstein,NOR,GK,33,1984,30.5,0,0,0,0,0,0,0,,0,0,0,0,1,1,8,1,2019
GER-Bundesliga,2018,Hertha BSC,Salomon Kalou,CIV,"FW,MF",32,1985,25.7,21,12,5,11,5,6,24,25.0,18,23,1,22,6,27,25,0,2019
GER-Bundesliga,2018,Hertha BSC,Thomas Kraft,GER,GK,30,1988,3.5,0,0,0,0,0,0,0,,0,0,0,0,0,0,1,1,2019
GER-Bundesliga,2018,Hertha BSC,Valentino Lazaro,AUT,"DF,FW",22,1996,30.5,46,31,23,17,6,21,53,39.6,32,52,12,40,44,90,65,0,2019
GER-Bundesliga,2018,Hertha BSC,Vedad Ibišević,BIH,FW,33,1984,20.1,12,8,2,5,5,0,10,0.0,10,10,4,6,3,15,20,0,2019
GER-Bundesliga,2018,Hertha BSC,Vladimír Darida,CZE,MF,27,1990,4.2,8,5,3,4,1,2,3,66.7,1,5,0,5,8,16,5,0,2019
GER-Bundesliga,2018,Hoffenheim,Alfons Amade,GER,MF,18,1999,0.1,1,1,0,1,0,1,2,50.0,1,0,0,0,1,2,0,0,2019
GER-Bundesliga,2018,Hoffenheim,Andrej Kramarić,CRO,"MF,FW",27,1991,26.6,9,4,1,5,3,4,26,15.4,22,15,3,12,8,17,13,0,2019
GER-Bundesliga,2018,Hoffenheim,Benjamin Hübner,GER,DF,29,1989,9.0,29,18,18,9,2,14,18,77.8,4,16,7,9,21,50,35,0,2019
GER-Bundesliga,2018,Hoffenheim,Christoph Baumgartner,AUT,MF,18,1999,0.9,1,0,0,0,1,1,3,33.3,2,2,0,2,0,1,0,0,2019
GER-Bundesliga,2018,Hoffenheim,David Otto,GER,"MF,FW",19,1999,0.3,2,1,1,1,0,0,1,0.0,1,0,0,0,0,2,0,0,2019
GER-Bundesliga,2018,Hoffenheim,Dennis Geiger,GER,MF,20,1998,2.7,2,1,1,1,0,1,6,16.7,5,1,0,1,3,5,1,0,2019
GER-Bundesliga,2018,Hoffenheim,Ermin Bičakčić,BIH,DF,28,1990,19.9,32,19,18,11,3,13,22,59.1,9,36,15,21,56,88,79,1,2019
GER-Bundesliga,2018,Hoffenheim,Florian Grillitsch,AUT,MF,22,1995,26.6,77,49,30,38,9,36,80,45.0,44,34,8,26,72,149,56,1,2019
GER-Bundesliga,2018,Hoffenheim,Gregor Kobel,SUI,GK,20,1997,1.0,0,0,0,0,0,0,0,,0,0,0,0,0,0,0,0,2019
GER-Bundesliga,2018,Hoffenheim,Håvard Nordtveit,NOR,"MF,DF",28,1990,5.2,8,5,2,4,2,3,7,42.9,4,8,5,3,4,12,14,0,2019
GER-Bundesliga,2018,Hoffenheim,Ishak Belfodil,ALG,"FW,MF",26,1992,20.7,13,10,5,6,2,4,16,25.0,12,6,0,6,3,16,14,0,2019
GER-Bundesliga,2018,Hoffenheim,Joelinton,BRA,"FW,MF",21,1996,23.7,35,22,9,20,6,10,30,33.3,20,36,3,33,14,49,8,0,2019
GER-Bundesliga,2018,Hoffenheim,Joshua Brenet,NED,DF,24,1994,10.1,20,13,12,5,3,7,13,53.8,6,16,1,15,8,28,19,0,2019
GER-Bundesliga,2018,Hoffenheim,Justin Hoogma,NED,"DF,MF",20,1998,1.2,4,2,2,1,1,2,2,100.0,0,3,1,2,2,6,1,0,2019
GER-Bundesliga,2018,Hoffenheim,Kasim Nuhu,GHA,DF,23,1995,10.0,19,11,14,3,2,10,23,43.5,13,11,5,6,23,42,44,0,2019
GER-Bundesliga,2018,Hoffenheim,Kerem Demirbay,GER,MF,25,1993,22.4,57,35,20,27,10,11,51,21.6,40,34,10,24,22,79,25,0,2019
GER-Bundesliga,2018,Hoffenheim,Kevin Akpoguma,NGA,DF,23,1995,5.5,23,15,13,10,0,11,21,52.4,10,18,5,13,12,35,20,2,2019
GER-Bundesliga,2018,Hoffenheim,Kevin Vogt,GER,DF,26,1991,26.6,24,15,20,4,0,12,32,37.5,20,28,11,17,33,57,103,3,2019
GER-Bundesliga,2018,Hoffenheim,Leonardo Bittencourt,GER,MF,24,1993,11.9,37,26,9,22,6,8,32,25.0,24,22,1,21,13,50,7,0,2019
GER-Bundesliga,2018,Hoffenheim,Lukas Rupp,GER,"MF,DF",27,1991,0.3,1,1,0,0,1,0,0,,0,0,0,0,0,1,0,0,2019
GER-Bundesliga,2018,Hoffenheim,Nadiem Amiri,GER,MF,21,1996,8.4,14,9,8,4,2,3,13,23.1,10,11,0,11,7,21,4,0,2019
GER-Bundesliga,2018,Hoffenheim,Nico Schulz,GER,DF,25,1993,28.2,34,20,19,12,3,15,36,41.7,21,32,4,28,24,58,36,0,2019
GER-Bundesliga,2018,Hoffenheim,Oliver Baumann,GER,GK,28,1990,33.0,0,0,0,0,0,0,0,,0,0,0,0,2,2,11,5,2019
GER-Bundesliga,2018,Hoffenheim,Pavel Kadeřábek,CZE,DF,26,1992,27.9,30,19,12,13,5,11,24,45.8,13,37,10,27,34,64,71,1,2019
GER-Bundesliga,2018,Hoffenheim,Reiss Nelson,ENG,"MF,FW",18,1999,7.1,17,10,8,4,5,2,13,15.4,11,12,1,11,5,22,2,0,2019
GER-Bundesliga,2018,Hoffenheim,Stefan Posch,AUT,DF,21,1997,15.6,45,32,28,15,2,17,28,60.7,11,26,11,15,21,66,58,0,2019
GER-Bundesliga,2018,Hoffenheim,Steven Zuber,SUI,"MF,FW",26,1991,6.3,12,9,5,6,1,6,13,46.2,7,5,1,4,5,17,4,0,2019
GER-Bundesliga,2018,Hoffenheim,Vincenzo Grifo,ITA,"MF,FW",25,1993,3.7,6,3,2,3,1,0,5,0.0,5,2,1,1,2,8,5,0,2019
GER-Bundesliga,2018,Hoffenheim,Ádám Szalai,HUN,FW,30,1987,18.1,19,13,3,12,4,4,11,36.4,7,8,1,7,4,23,8,0,2019
GER-Bundesliga,2018,Leverkusen,Aleksandar Dragović,AUT,DF,27,1991,14.8,18,12,14,4,0,9,14,64.3,5,15,8,7,25,43,66,0,2019
GER-Bundesliga,2018,Leverkusen,Benjamin Henrichs,GER,DF,21,1997,0.7,0,0,0,0,0,0,0,,0,2,0,2,3,3,0,0,2019
GER-Bundesliga,2018,Leverkusen,Charles Aránguiz,CHI,MF,29,1989,21.0,48,30,21,22,5,21,66,31.8,45,31,2,29,25,73,27,1,2019
GER-Bundesliga,2018,Leverkusen,Dominik Kohr,GER,MF,24,1994,10.8,42,29,21,21,0,14,35,40.0,21,25,12,13,15,57,17,1,2019
GER-Bundesliga,2018,Leverkusen,Isaac Kiese Thelin,SWE,"FW,MF",26,1992,2.0,2,1,0,2,0,1,2,50.0,1,1,0,1,0,2,4,0,2019
GER-Bundesliga,2018,Leverkusen,Jonathan Tah,GER,DF,22,1996,32.6,44,30,30,10,4,17,32,53.1,15,39,26,13,45,89,142,1,2019
GER-Bundesliga,2018,Leverkusen,Julian Baumgartlinger,AUT,MF,30,1988,17.3,52,30,24,20,8,20,45,44.4,25,18,6,12,26,78,21,1,2019
GER-Bundesliga,2018,Leverkusen,Julian Brandt,GER,"MF,FW",22,1996,29.6,27,16,13,10,4,7,43,16.3,36,27,1,26,17,44,12,1,2019
GER-Bundesliga,2018,Leverkusen,Kai Havertz,GER,"MF,FW",19,1999,32.2,26,17,10,11,5,8,32,25.0,24,31,4,27,16,42,29,0,2019
GER-Bundesliga,2018,Leverkusen,Karim Bellarabi,GER,FW,28,1990,11.7,13,6,7,4,2,3,19,15.8,16,13,0,13,10,23,8,0,2019
GER-Bundesliga,2018,Leverkusen,Kevin Volland,GER,FW,26,1992,31.3,33,20,7,14,12,13,27,48.1,14,17,1,16,6,39,33,0,2019
GER-Bundesliga,2018,Leverkusen,Lars Bender,GER,"MF,DF",29,1989,15.1,43,29,20,20,3,18,35,51.4,17,26,4,22,21,64,26,0,2019
GER-Bundesliga,2018,Leverkusen,Leon Bailey,JAM,FW,20,1997,21.3,15,11,9,2,4,6,20,30.0,14,20,0,20,14,29,11,0,2019
GER-Bundesliga,2018,Leverkusen,Lucas Alario,ARG,"FW,MF",25,1992,14.1,15,8,5,6,4,4,14,28.6,10,9,0,9,1,16,16,0,2019
GER-Bundesliga,2018,Leverkusen,Lukáš Hrádecký,FIN,GK,28,1989,32.0,0,0,0,0,0,0,1,0.0,1,0,0,0,1,1,9,1,2019
GER-Bundesliga,2018,Leverkusen,Mitchell Weiser,GER,DF,24,1994,23.5,63,37,34,22,7,26,50,52.0,24,31,3,28,27,90,48,0,2019
GER-Bundesliga,2018,Leverkusen,Paulinho,BRA,"FW,MF",18,2000,2.0,4,4,2,2,0,1,2,50.0,1,3,0,3,2,6,0,1,2019
GER-Bundesliga,2018,Leverkusen,Ramazan Özcan,AUT,GK,34,1984,2.0,0,0,0,0,0,0,0,,0,0,0,0,1,1,2,0,2019
GER-Bundesliga,2018,Leverkusen,Sven Bender,GER,DF,29,1989,22.1,40,25,25,15,0,18,30,60.0,12,31,14,17,52,92,98,0,2019
GER-Bundesliga,2018,Leverkusen,Tin Jedvaj,CRO,DF,22,1995,12.5,23,15,9,8,6,10,19,52.6,9,28,2,26,22,45,52,0,2019
GER-Bundesliga,2018,Leverkusen,Wendell,BRA,DF,25,1993,25.3,75,48,47,24,4,34,57,59.6,23,49,13,36,29,104,66,0,2019
GER-Bundesliga,2018,M'Gladbach,Alassane Pléa,FRA,FW,25,1993,27.8,14,10,7,4,3,5,22,22.7,17,17,2,15,3,17,15,2,2019
GER-Bundesliga,2018,M'Gladbach,Christoph Kramer,GER,MF,27,1991,12.6,41,22,17,23,1,15,40,37.5,25,19,4,15,21,62,23,0,2019
GER-Bundesliga,2018,M'Gladbach,Denis Zakaria,SUI,MF,21,1996,21.8,40,21,15,24,1,12,30,40.0,18,38,9,29,26,66,20,0,2019
GER-Bundesliga,2018,M'Gladbach,Fabian Johnson,USA,"DF,FW",30,1987,11.2,13,5,2,8,3,6,8,75.0,2,8,3,5,10,23,16,0,2019
GER-Bundesliga,2018,M'Gladbach,Florian Neuhaus,GER,MF,21,1997,22.9,22,15,9,9,4,10,36,27.8,26,20,1,19,10,32,23,0,2019
GER-Bundesliga,2018,M'Gladbach,Ibrahima Traoré,GUI,"FW,MF",30,1988,6.1,12,6,8,2,2,3,11,27.3,8,3,1,2,3,15,1,0,2019
GER-Bundesliga,2018,M'Gladbach,Jonas Hofmann,GER,MF,26,1992,21.2,37,18,11,19,7,9,37,24.3,28,33,2,31,16,53,14,1,2019
GER-Bundesliga,2018,M'Gladbach,Jordan Beyer,GER,DF,18,2000,8.0,32,18,21,10,1,17,24,70.8,7,12,6,6,11,43,32,0,2019
GER-Bundesliga,2018,M'Gladbach,Josip Drmić,SUI,FW,25,1992,2.5,2,0,0,2,0,1,2,50.0,1,1,0,1,1,3,0,0,2019
GER-Bundesliga,2018,M'Gladbach,Lars Stindl,GER,"FW,MF",29,1988,16.8,21,14,8,11,2,3,15,20.0,12,22,2,20,14,35,13,0,2019
GER-Bundesliga,2018,M'Gladbach,László Bénes,SVK,"MF,FW",20,1997,0.3,3,1,3,0,0,3,3,100.0,0,1,0,1,0,3,0,0,2019
GER-Bundesliga,2018,M'Gladbach,Matthias Ginter,GER,DF,24,1994,26.4,24,14,16,7,1,9,17,52.9,8,31,19,12,17,41,98,1,2019
GER-Bundesliga,2018,M'Gladbach,Michael Lang,SUI,DF,27,1991,13.9,14,9,7,6,1,6,16,37.5,10,14,3,11,16,30,42,1,2019
GER-Bundesliga,2018,M'Gladbach,Mickaël Cuisance,FRA,MF,18,1999,3.1,11,6,6,3,2,3,8,37.5,5,3,0,3,5,16,4,0,2019
GER-Bundesliga,2018,M'Gladbach,Nico Elvedi,SUI,DF,21,1996,29.1,41,19,34,7,0,23,33,69.7,10,30,13,17,47,88,135,6,2019
GER-Bundesliga,2018,M'Gladbach,Oscar Wendt,SWE,DF,32,1985,30.3,45,34,34,8,3,31,53,58.5,22,37,11,26,19,64,90,0,2019
GER-Bundesliga,2018,M'Gladbach,Patrick Herrmann,GER,"FW,DF",27,1991,12.0,20,14,8,7,5,6,17,35.3,11,6,3,3,6,26,12,0,2019
GER-Bundesliga,2018,M'Gladbach,Raffael,BRA,FW,33,1985,6.0,8,4,2,4,2,2,7,28.6,5,5,0,5,1,9,0,0,2019
GER-Bundesliga,2018,M'Gladbach,Thorgan Hazard,BEL,"FW,MF",25,1993,31.9,50,33,22,20,8,17,48,35.4,31,35,2,33,27,77,12,0,2019
GER-Bundesliga,2018,M'Gladbach,Tobias Strobl,GER,"MF,DF",28,1990,25.5,31,17,17,13,1,9,29,31.0,20,36,14,22,29,60,35,1,2019
GER-Bundesliga,2018,M'Gladbach,Tony Jantschke,GER,DF,28,1990,10.4,15,10,9,5,1,6,8,75.0,2,10,7,3,27,42,51,1,2019
GER-Bundesliga,2018,M'Gladbach,Yann Sommer,SUI,GK,29,1988,34.0,2,2,2,0,0,2,2,100.0,0,1,0,1,1,3,12,5,2019
GER-Bundesliga,2018,Mainz 05,Aarón Martín,ESP,DF,21,1997,32.0,55,30,29,21,5,20,38,52.6,18,38,11,27,38,93,75,1,2019
GER-Bundesliga,2018,Mainz 05,Ahmet Gürleyen,GER,DF,19,1999,0.1,0,0,0,0,0,0,0,,0,0,0,0,0,0,1,0,2019
GER-Bundesliga,2018,Mainz 05,Alexander Hack,GER,DF,24,1993,11.3,29,13,20,9,0,19,28,67.9,9,26,15,11,41,70,59,2,2019
GER-Bundesliga,2018,Mainz 05,Alexandru Maxim,ROU,"MF,FW",28,1990,6.4,16,10,6,9,1,10,19,52.6,9,12,0,12,5,21,7,0,2019
GER-Bundesliga,2018,Mainz 05,Anthony Ujah,NGA,FW,27,1990,8.2,2,0,0,1,1,1,2,50.0,1,7,2,5,1,3,10,0,2019
GER-Bundesliga,2018,Mainz 05,Daniel Brosinski,GER,DF,30,1988,24.5,27,16,16,10,1,18,33,54.5,15,30,9,21,26,53,58,0,2019
GER-Bundesliga,2018,Mainz 05,Danny Latza,GER,MF,28,1989,20.7,41,22,16,23,2,20,61,32.8,41,49,10,39,20,61,31,0,2019
GER-Bundesliga,2018,Mainz 05,Florian Müller,GER,GK,20,1997,24.0,1,1,1,0,0,1,2,50.0,1,0,0,0,3,4,8,5,2019
GER-Bundesliga,2018,Mainz 05,Gaëtan Bussmann,FRA,DF,27,1991,1.0,2,1,2,0,0,2,5,40.0,3,0,0,0,1,3,2,0,2019
GER-Bundesliga,2018,Mainz 05,Gerrit Holtmann,PHI,"FW,MF",23,1995,1.6,2,0,1,0,1,1,2,50.0,1,3,2,1,4,6,1,0,2019
GER-Bundesliga,2018,Mainz 05,Giulio Donati,ITA,DF,28,1990,6.9,9,7,6,3,0,8,10,80.0,2,5,3,2,16,25,24,0,2019
GER-Bundesliga,2018,Mainz 05,Issah Abbas,GHA,FW,19,1998,0.1,0,0,0,0,0,0,0,,0,0,0,0,0,0,0,0,2019
GER-Bundesliga,2018,Mainz 05,Jean-Paul Boëtius,NED,MF,24,1994,23.6,51,32,21,25,5,16,44,36.4,28,59,2,57,37,88,13,0,2019
GER-Bundesliga,2018,Mainz 05,Jean-Philippe Gbamin,CIV,MF,22,1995,29.7,51,31,29,15,7,23,51,45.1,28,39,5,34,30,81,32,1,2019
GER-Bundesliga,2018,Mainz 05,Jean-Philippe Mateta,FRA,FW,21,1997,27.6,13,9,4,4,5,1,10,10.0,9,15,2,13,3,16,22,0,2019
GER-Bundesliga,2018,Mainz 05,Jonathan Burkardt,GER,"FW,MF",18,2000,2.9,4,4,2,1,1,1,2,50.0,1,2,0,2,3,7,5,0,2019
GER-Bundesliga,2018,Mainz 05,Karim Onisiwo,AUT,"FW,MF",26,1992,12.9,23,15,6,12,5,4,12,33.3,8,14,3,11,9,32,13,0,2019
GER-Bundesliga,2018,Mainz 05,Leandro Barreiro Martins,LUX,MF,18,2000,1.0,4,4,2,0,2,1,2,50.0,1,0,0,0,2,6,1,0,2019
GER-Bundesliga,2018,Mainz 05,Levin Öztunalı,GER,"MF,FW",22,1996,10.2,17,7,5,9,3,4,18,22.2,14,14,2,12,7,24,10,0,2019
GER-Bundesliga,2018,Mainz 05,Moussa Niakhate,SEN,DF,22,1996,31.0,49,30,35,12,2,20,33,60.6,13,42,24,18,44,93,143,1,2019
GER-Bundesliga,2018,Mainz 05,Niko Bungert,GER,DF,31,1986,3.2,7,5,5,2,0,5,5,100.0,0,7,6,1,4,11,16,0,2019
GER-Bundesliga,2018,Mainz 05,Pablo de Blasis,ARG,FW,30,1988,1.0,2,0,0,1,1,2,3,66.7,1,0,0,0,1,3,0,0,2019
GER-Bundesliga,2018,Mainz 05,Phillipp Mwene,AUT,"DF,MF",24,1994,3.0,7,2,3,4,0,5,6,83.3,1,6,0,6,6,13,10,0,2019
GER-Bundesliga,2018,Mainz 05,Pierre Kunde,CMR,MF,23,1995,21.2,48,29,20,26,2,16,27,59.3,11,34,14,20,24,72,49,1,2019
GER-Bundesliga,2018,Mainz 05,Ridle Baku,GER,MF,20,1998,10.4,18,9,6,9,3,2,7,28.6,5,13,1,12,8,26,9,0,2019
GER-Bundesliga,2018,Mainz 05,Robin Quaison,SWE,"FW,MF",24,1993,24.4,19,12,3,10,6,5,12,41.7,7,9,1,8,7,26,4,0,2019
GER-Bundesliga,2018,Mainz 05,Robin Zentner,GER,GK,23,1994,10.0,0,0,0,0,0,0,1,0.0,1,0,0,0,1,1,3,0,2019
GER-Bundesliga,2018,Mainz 05,Stefan Bell,GER,DF,26,1991,25.0,31,20,18,13,0,15,34,44.1,19,31,11,20,54,85,122,1,2019
GER-Bundesliga,2018,Nürnberg,Adam Zreľák,SVK,FW,24,1994,10.5,14,9,2,11,1,5,9,55.6,4,14,2,12,2,16,13,0,2019
GER-Bundesliga,2018,Nürnberg,Alexander Fuchs,GER,"MF,FW",21,1997,7.3,14,12,5,7,2,5,15,33.3,10,9,1,8,5,19,10,0,2019
GER-Bundesliga,2018,Nürnberg,Christian Mathenia,GER,GK,26,1992,21.5,0,0,0,0,0,0,0,,0,1,0,1,1,1,18,2,2019
GER-Bundesliga,2018,Nürnberg,Edgar Salli,CMR,"FW,MF",25,1992,1.3,2,1,1,1,0,0,1,0.0,1,0,0,0,1,3,1,0,2019
GER-Bundesliga,2018,Nürnberg,Eduard Löwen,GER,"MF,FW",21,1997,18.0,30,22,14,13,3,11,34,32.4,23,15,2,13,8,38,23,0,2019
GER-Bundesliga,2018,Nürnberg,Enrico Valentini,ITA,DF,29,1989,14.4,44,27,31,10,3,22,40,55.0,18,17,3,14,13,57,58,0,2019
GER-Bundesliga,2018,Nürnberg,Ewerton,BRA,DF,29,1989,14.9,24,20,21,3,0,8,14,57.1,6,23,16,7,25,49,108,1,2019
GER-Bundesliga,2018,Nürnberg,Fabian Bredlow,GER,GK,23,1995,12.5,1,1,1,0,0,1,1,100.0,0,0,0,0,1,2,3,4,2019
GER-Bundesliga,2018,Nürnberg,Federico Palacios Martínez,GER,"MF,FW",23,1995,10.5,21,10,11,8,2,10,20,50.0,10,10,0,10,9,30,4,0,2019
GER-Bundesliga,2018,Nürnberg,Georg Margreitter,AUT,DF,29,1988,22.9,39,24,28,8,3,31,38,81.6,7,29,26,3,26,65,141,0,2019
GER-Bundesliga,2018,Nürnberg,Hanno Behrens,GER,MF,28,1990,29.3,46,26,29,17,0,21,47,44.7,26,43,13,30,33,79,49,0,2019
GER-Bundesliga,2018,Nürnberg,Ivo Iličević,CRO,MF,31,1986,0.4,1,0,0,1,0,1,2,50.0,1,1,0,1,0,1,0,0,2019
GER-Bundesliga,2018,Nürnberg,Kevin Goden,GER,"DF,MF",19,1999,3.0,4,3,3,1,0,2,7,28.6,5,4,1,3,4,8,11,0,2019
GER-Bundesliga,2018,Nürnberg,Lukas Jäger,AUT,"FW,MF",24,1994,0.3,0,0,0,0,0,0,2,0.0,2,0,0,0,0,0,0,0,2019
GER-Bundesliga,2018,Nürnberg,Lukas Mühl,GER,DF,21,1997,31.0,57,34,49,6,2,32,51,62.7,19,53,18,35,48,105,139,2,2019
GER-Bundesliga,2018,Nürnberg,Matheus Pereira,POR,"MF,FW",22,1996,13.7,16,11,4,8,4,2,13,15.4,11,15,2,13,14,30,7,0,2019
GER-Bundesliga,2018,Nürnberg,Mikael Ishak,SWE,FW,25,1993,21.3,9,6,3,6,0,3,16,18.8,13,8,3,5,3,12,10,0,2019
GER-Bundesliga,2018,Nürnberg,Ondřej Petrák,CZE,MF,26,1992,18.0,36,24,17,18,1,14,25,56.0,11,18,4,14,40,76,22,0,2019
GER-Bundesliga,2018,Nürnberg,Patrick Erras,GER,MF,23,1995,13.6,15,10,7,7,1,7,19,36.8,12,24,13,11,23,38,45,0,2019
GER-Bundesliga,2018,Nürnberg,Robert Bauer,GER,DF,23,1995,19.1,48,29,32,13,3,20,39,51.3,19,19,5,14,28,76,80,0,2019
GER-Bundesliga,2018,Nürnberg,Sebastian Kerk,GER,"MF,FW",24,1994,13.1,16,9,8,5,3,7,23,30.4,16,14,5,9,3,19,22,1,2019
GER-Bundesliga,2018,Nürnberg,Simon Rhein,GER,MF,20,1998,5.5,7,4,7,0,0,2,7,28.6,5,6,1,5,7,14,6,0,2019
GER-Bundesliga,2018,Nürnberg,Tim Leibold,GER,DF,24,1993,30.7,62,42,45,16,1,33,71,46.5,38,23,3,20,38,100,57,0,2019
GER-Bundesliga,2018,Nürnberg,Timothy Tillman,GER,"FW,MF",19,1999,2.3,0,0,0,0,0,0,4,0.0,4,3,0,3,3,3,0,2,2019
GER-Bundesliga,2018,Nürnberg,Törles Knöll,GER,"FW,MF",20,1997,4.1,3,2,1,1,1,0,4,0.0,4,5,1,4,0,3,2,0,2019
GER-Bundesliga,2018,Nürnberg,Virgil Misidjan,NED,"MF,FW",25,1993,17.1,21,13,10,5,6,4,25,16.0,21,17,0,17,9,30,5,0,2019
GER-Bundesliga,2018,Nürnberg,Yuya Kubo,JPN,"FW,MF",24,1993,15.1,21,11,6,10,5,12,33,36.4,21,11,0,11,10,31,6,0,2019
GER-Bundesliga,2018,RB Leipzig,Amadou Haidara,MLI,MF,20,1998,4.2,13,11,4,8,1,8,14,57.1,6,9,1,8,4,17,7,0,2019
GER-Bundesliga,2018,RB Leipzig,Bruma,POR,MF,23,1994,6.1,5,2,3,1,1,1,5,20.0,4,4,0,4,4,9,2,0,2019
GER-Bundesliga,2018,RB Leipzig,Dayot Upamecano,FRA,DF,19,1998,14.4,22,16,14,8,0,15,18,83.3,3,19,5,14,33,55,47,0,2019
GER-Bundesliga,2018,RB Leipzig,Diego Demme,GER,MF,26,1991,22.8,75,47,24,43,8,33,67,49.3,34,36,3,33,26,101,15,0,2019
GER-Bundesliga,2018,RB Leipzig,Emil Forsberg,SWE,"MF,FW",26,1991,13.9,12,7,0,12,0,5,16,31.3,11,16,1,15,3,15,6,0,2019
GER-Bundesliga,2018,RB Leipzig,Emile Smith Rowe,ENG,MF,18,2000,0.3,1,0,0,1,0,1,1,100.0,0,0,0,0,1,2,0,0,2019
GER-Bundesliga,2018,RB Leipzig,Ibrahima Konaté,FRA,DF,19,1999,27.0,44,32,30,14,0,17,27,63.0,10,29,18,11,58,102,126,0,2019
GER-Bundesliga,2018,RB Leipzig,Jean-Kévin Augustin,FRA,FW,21,1997,5.1,2,0,0,0,2,0,1,0.0,1,6,0,6,3,5,0,0,2019
GER-Bundesliga,2018,RB Leipzig,Kevin Kampl,SVN,MF,27,1990,23.5,41,24,16,21,4,8,28,28.6,20,32,2,30,33,74,22,0,2019
GER-Bundesliga,2018,RB Leipzig,Konrad Laimer,AUT,"MF,DF",21,1997,20.8,72,38,21,34,17,20,71,28.2,51,67,2,65,32,104,23,0,2019
GER-Bundesliga,2018,RB Leipzig,Lukas Klostermann,GER,DF,22,1996,22.3,50,29,33,12,5,29,45,64.4,16,37,5,32,29,79,74,0,2019
GER-Bundesliga,2018,RB Leipzig,Marcel Halstenberg,GER,"DF,FW",26,1991,26.8,68,44,31,24,13,42,65,64.6,23,27,4,23,38,106,69,0,2019
GER-Bundesliga,2018,RB Leipzig,Marcel Sabitzer,AUT,MF,24,1994,26.1,45,28,17,21,7,18,46,39.1,28,21,2,19,33,78,31,0,2019
GER-Bundesliga,2018,RB Leipzig,Marcelo Saracchi,URU,DF,20,1998,7.3,17,11,12,4,1,8,13,61.5,5,12,1,11,11,28,14,0,2019
GER-Bundesliga,2018,RB Leipzig,Matheus Cunha,BRA,"FW,MF",19,1999,9.5,10,6,3,5,2,3,13,23.1,10,13,1,12,4,14,8,0,2019
GER-Bundesliga,2018,RB Leipzig,Nordi Mukiele,FRA,DF,20,1997,13.6,38,21,23,12,3,19,22,86.4,3,17,3,14,24,62,35,0,2019
GER-Bundesliga,2018,RB Leipzig,Péter Gulácsi,HUN,GK,28,1990,32.5,0,0,0,0,0,0,0,,0,0,0,0,0,0,11,0,2019
GER-Bundesliga,2018,RB Leipzig,Stefan Ilsanker,AUT,"DF,MF",29,1989,10.4,26,17,15,10,1,14,23,60.9,9,9,2,7,18,44,43,1,2019
GER-Bundesliga,2018,RB Leipzig,Timo Werner,GER,FW,22,1996,27.9,18,12,6,8,4,3,16,18.8,13,18,2,16,3,21,7,0,2019
GER-Bundesliga,2018,RB Leipzig,Tyler Adams,USA,MF,19,1999,8.0,29,17,12,16,1,11,26,42.3,15,17,1,16,16,45,8,0,2019
GER-Bundesliga,2018,RB Leipzig,Willi Orban,HUN,DF,25,1992,22.8,49,26,31,15,3,24,38,63.2,14,33,15,18,36,85,140,0,2019
GER-Bundesliga,2018,RB Leipzig,Yussuf Poulsen,DEN,FW,24,1994,27.2,20,10,5,10,5,3,25,12.0,22,33,2,31,7,27,28,0,2019
GER-Bundesliga,2018,RB Leipzig,Yvon Mvogo,SUI,GK,24,1994,1.5,0,0,0,0,0,0,0,,0,0,0,0,0,0,1,0,2019
GER-Bundesliga,2018,Schalke 04,Ahmed Kutucu,TUR,"FW,MF",18,2000,4.7,8,3,3,4,1,1,3,33.3,2,2,1,1,0,8,0,0,2019
GER-Bundesliga,2018,Schalke 04,Alessandro Schöpf,AUT,"MF,DF",24,1994,11.2,26,16,12,13,1,12,29,41.4,17,14,0,14,9,35,12,0,2019
GER-Bundesliga,2018,Schalke 04,Alexander Nübel,GER,GK,21,1996,17.6,0,0,0,0,0,0,1,0.0,1,0,0,0,1,1,4,1,2019
GER-Bundesliga,2018,Schalke 04,Amine Harit,MAR,"MF,FW",21,1997,12.0,15,8,4,9,2,8,24,33.3,16,11,1,10,9,24,2,0,2019
GER-Bundesliga,2018,Schalke 04,Baba Rahman,GHA,DF,24,1994,1.8,3,1,1,1,1,1,1,100.0,0,3,0,3,2,5,2,0,2019
GER-Bundesliga,2018,Schalke 04,Bastian Oczipka,GER,"DF,FW",29,1989,20.8,41,27,20,19,2,21,26,80.8,5,23,5,18,24,65,24,2,2019
GER-Bundesliga,2018,Schalke 04,Benjamin Stambouli,FRA,"DF,MF",27,1990,19.6,51,31,24,24,3,25,46,54.3,21,41,9,32,32,83,65,2,2019
GER-Bundesliga,2018,Schalke 04,Breel Embolo,SUI,FW,21,1997,14.9,22,17,4,13,5,1,9,11.1,8,11,0,11,4,26,6,0,2019
GER-Bundesliga,2018,Schalke 04,Cedric Teuchert,GER,"FW,MF",21,1997,1.8,0,0,0,0,0,0,0,,0,2,0,2,1,1,0,0,2019
GER-Bundesliga,2018,Schalke 04,Daniel Caligiuri,ITA,"DF,FW",30,1988,30.6,93,52,55,29,9,44,103,42.7,59,66,10,56,50,143,72,1,2019
GER-Bundesliga,2018,Schalke 04,Franco Di Santo,ARG,"MF,FW",29,1989,2.7,2,1,0,2,0,1,4,25.0,3,3,1,2,1,3,3,0,2019
GER-Bundesliga,2018,Schalke 04,George Timotheou,AUS,DF,21,1997,1.0,3,3,3,0,0,0,0,,0,1,1,0,1,4,4,0,2019
GER-Bundesliga,2018,Schalke 04,Guido Burgstaller,AUT,FW,29,1989,17.0,11,9,2,5,4,3,8,37.5,5,5,0,5,2,13,10,0,2019
GER-Bundesliga,2018,Schalke 04,Haji Wright,USA,FW,20,1998,2.2,3,2,1,1,1,0,1,0.0,1,1,0,1,0,3,1,0,2019
GER-Bundesliga,2018,Schalke 04,Hamza Mendyl,MAR,DF,20,1997,6.0,17,15,6,8,3,8,18,44.4,10,11,2,9,8,25,8,0,2019
GER-Bundesliga,2018,Schalke 04,Jeffrey Bruma,NED,DF,26,1991,6.9,12,11,8,4,0,6,12,50.0,6,8,2,6,4,16,35,0,2019
GER-Bundesliga,2018,Schalke 04,Jonas Carls,GER,FW,21,1997,1.0,5,2,4,0,1,5,5,100.0,0,0,0,0,1,6,0,0,2019
GER-Bundesliga,2018,Schalke 04,Mark Uth,GER,"FW,MF",26,1991,15.6,20,11,8,8,4,4,23,17.4,19,19,2,17,8,28,12,0,2019
GER-Bundesliga,2018,Schalke 04,Matija Nastasić,SRB,DF,25,1993,27.2,35,23,22,13,0,20,29,69.0,9,32,20,12,38,73,114,1,2019
GER-Bundesliga,2018,Schalke 04,Nabil Bentaleb,ALG,MF,23,1994,19.9,32,17,8,21,3,4,18,22.2,14,28,8,20,35,67,19,0,2019
GER-Bundesliga,2018,Schalke 04,Naldo,BRA,DF,35,1982,7.0,10,7,8,2,0,5,8,62.5,3,8,3,5,14,24,25,0,2019
GER-Bundesliga,2018,Schalke 04,Nassim Boujellab,MAR,MF,19,1999,4.2,10,4,3,6,1,3,11,27.3,8,6,0,6,2,12,3,0,2019
GER-Bundesliga,2018,Schalke 04,Omar Mascarell,ESP,MF,25,1993,11.0,20,10,9,9,2,10,24,41.7,14,21,7,14,23,43,8,0,2019
GER-Bundesliga,2018,Schalke 04,Rabbi Matondo,WAL,"FW,MF",17,2000,2.1,4,1,4,0,0,1,5,20.0,4,2,0,2,0,4,1,0,2019
GER-Bundesliga,2018,Schalke 04,Ralf Fährmann,GER,GK,29,1988,16.3,0,0,0,0,0,0,0,,0,0,0,0,2,2,10,4,2019
GER-Bundesliga,2018,Schalke 04,Salif Sané,SEN,DF,27,1990,29.0,54,37,34,19,1,27,46,58.7,19,44,29,15,68,122,146,3,2019
GER-Bundesliga,2018,Schalke 04,Sascha Riether,GER,FW,35,1983,0.0,0,0,0,0,0,0,0,,0,0,0,0,0,0,0,0,2019
GER-Bundesliga,2018,Schalke 04,Sebastian Rudy,GER,MF,28,1990,15.1,44,24,11,27,6,11,41,26.8,30,23,2,21,15,59,15,0,2019
GER-Bundesliga,2018,Schalke 04,Steven Skrzybski,GER,"FW,MF",25,1992,7.4,9,3,0,6,3,3,11,27.3,8,8,1,7,3,12,2,0,2019
GER-Bundesliga,2018,Schalke 04,Suat Serdar,GER,MF,21,1997,19.2,51,32,20,26,5,14,49,28.6,35,37,6,31,23,74,5,1,2019
GER-Bundesliga,2018,Schalke 04,Weston McKennie,USA,"MF,FW",19,1998,19.4,28,14,5,17,6,11,35,31.4,24,28,9,19,36,64,46,1,2019
GER-Bundesliga,2018,Schalke 04,Yevhen Konoplyanka,UKR,"FW,MF",28,1989,7.3,2,0,0,0,2,2,4,50.0,2,6,0,6,3,5,3,0,2019
GER-Bundesliga,2018,Stuttgart,Alexander Esswein,GER,"MF,FW",28,1990,13.9,17,11,6,4,7,6,21,28.6,15,17,0,17,12,29,16,0,2019
GER-Bundesliga,2018,Stuttgart,Anastasios Donis,GRE,"FW,MF",21,1996,10.7,15,13,8,4,3,3,11,27.3,8,7,0,7,4,19,0,0,2019
GER-Bundesliga,2018,Stuttgart,Andreas Beck,GER,DF,31,1987,19.7,35,19,17,17,1,11,27,40.7,16,32,6,26,22,57,54,0,2019
GER-Bundesliga,2018,Stuttgart,Antonis Aidonis,GER,DF,17,2001,0.9,3,1,1,1,1,1,4,25.0,3,1,0,1,2,5,2,0,2019
GER-Bundesliga,2018,Stuttgart,Benjamin Pavard,FRA,DF,22,1996,29.0,28,20,21,6,1,12,19,63.2,7,27,19,8,48,76,189,2,2019
GER-Bundesliga,2018,Stuttgart,Berkay Özcan,TUR,"MF,DF",20,1998,0.6,0,0,0,0,0,0,0,,0,1,0,1,0,0,0,0,2019
GER-Bundesliga,2018,Stuttgart,Borna Sosa,CRO,"DF,MF",20,1998,6.8,13,7,8,4,1,4,9,44.4,5,5,1,4,6,19,34,0,2019
GER-Bundesliga,2018,Stuttgart,Chadrac Akolo,COD,"MF,FW",23,1995,5.8,9,6,2,7,0,1,3,33.3,2,7,0,7,4,13,1,0,2019
GER-Bundesliga,2018,Stuttgart,Christian Gentner,GER,"MF,FW",32,1985,22.4,61,38,29,26,6,16,50,32.0,34,30,3,27,31,92,41,1,2019
GER-Bundesliga,2018,Stuttgart,Daniel Didavi,GER,"MF,FW",28,1990,10.6,21,15,8,10,3,7,20,35.0,13,11,1,10,4,25,5,0,2019
GER-Bundesliga,2018,Stuttgart,Dennis Aogo,GER,MF,31,1987,11.4,15,10,6,7,2,6,15,40.0,9,8,1,7,9,24,19,0,2019
GER-Bundesliga,2018,Stuttgart,Emiliano Insúa,ARG,DF,29,1989,23.5,51,33,26,18,7,25,42,59.5,17,29,2,27,31,82,55,1,2019
GER-Bundesliga,2018,Stuttgart,Erik Thommy,GER,"MF,FW",23,1994,8.8,5,3,3,1,1,1,7,14.3,6,16,1,15,14,19,4,0,2019
GER-Bundesliga,2018,Stuttgart,Gonzalo Castro,GER,MF,31,1987,18.8,50,28,21,25,4,19,43,44.2,24,23,5,18,29,79,22,1,2019
GER-Bundesliga,2018,Stuttgart,Hans Nunoo Sarpei,GHA,"FW,MF",19,1998,0.5,1,1,0,1,0,0,0,,0,0,0,0,0,1,0,0,2019
GER-Bundesliga,2018,Stuttgart,Holger Badstuber,GER,DF,29,1989,5.8,12,4,8,4,0,7,8,87.5,1,6,2,4,9,21,21,1,2019
GER-Bundesliga,2018,Stuttgart,Leon Dajaku,GER,"DF,MF",17,2001,0.3,2,1,0,1,1,0,0,,0,1,0,1,0,2,0,0,2019
GER-Bundesliga,2018,Stuttgart,Marc-Oliver Kempf,GER,DF,23,1995,22.5,33,18,26,7,0,12,24,50.0,12,35,21,14,46,79,141,1,2019
GER-Bundesliga,2018,Stuttgart,Mario Gómez,GER,FW,33,1985,24.6,19,11,6,10,3,2,12,16.7,10,17,6,11,5,24,33,0,2019
GER-Bundesliga,2018,Stuttgart,Nicolás González,ARG,"FW,MF",20,1998,24.0,19,14,3,7,9,9,19,47.4,10,32,2,30,11,30,27,0,2019
GER-Bundesliga,2018,Stuttgart,Ozan Kabak,TUR,DF,18,2000,15.0,33,19,22,9,2,9,19,47.4,10,15,8,7,23,56,58,1,2019
GER-Bundesliga,2018,Stuttgart,Pablo Maffeo,ESP,"DF,MF",21,1997,6.6,15,13,10,5,0,6,13,46.2,7,8,4,4,13,28,17,0,2019
GER-Bundesliga,2018,Stuttgart,Ron-Robert Zieler,GER,GK,29,1989,34.0,2,1,2,0,0,1,4,25.0,3,1,0,1,1,3,19,3,2019
GER-Bundesliga,2018,Stuttgart,Santiago Ascacíbar,ARG,MF,21,1997,27.0,78,50,43,29,6,34,74,45.9,40,48,10,38,43,121,34,1,2019
GER-Bundesliga,2018,Stuttgart,Steven Zuber,SUI,"MF,FW",26,1991,11.7,6,3,2,2,2,1,13,7.7,12,14,2,12,6,12,6,0,2019
GER-Bundesliga,2018,Stuttgart,Timo Baumgartl,GER,DF,22,1996,18.0,33,23,21,12,0,11,19,57.9,8,31,22,9,26,59,100,0,2019
GER-Bundesliga,2018,Werder Bremen,Aron Jóhannsson,USA,MF,27,1990,0.0,0,0,0,0,0,0,0,,0,0,0,0,0,0,0,0,2019
GER-Bundesliga,2018,Werder Bremen,Claudio Pizarro,PER,FW,39,1978,7.7,10,6,4,2,4,4,7,57.1,3,14,1,13,1,11,7,0,2019
GER-Bundesliga,2018,Werder Bremen,Davy Klaassen,NED,MF,25,1993,31.3,64,47,24,33,7,14,49,28.6,35,44,9,35,47,111,47,0,2019
GER-Bundesliga,2018,Werder Bremen,Fin Bartels,GER,"MF,FW",31,1987,0.3,0,0,0,0,0,0,1,0.0,1,0,0,0,1,1,0,0,2019
GER-Bundesliga,2018,Werder Bremen,Florian Kainz,AUT,FW,25,1992,4.1,6,5,5,1,0,3,6,50.0,3,4,1,3,3,9,5,0,2019
GER-Bundesliga,2018,Werder Bremen,Jiří Pavlenka,CZE,GK,26,1992,33.1,3,0,3,0,0,3,6,50.0,3,1,0,1,3,6,14,1,2019
GER-Bundesliga,2018,Werder Bremen,Johannes Eggestein,GER,"FW,MF",20,1998,12.4,13,9,7,4,2,5,19,26.3,14,13,0,13,4,17,7,0,2019
GER-Bundesliga,2018,Werder Bremen,Josh Sargent,USA,FW,18,2000,2.4,2,1,1,0,1,2,2,100.0,0,2,0,2,0,2,3,0,2019
GER-Bundesliga,2018,Werder Bremen,Kevin Möhwald,GER,MF,25,1993,9.7,16,10,3,11,2,3,20,15.0,17,14,0,14,17,33,14,0,2019
GER-Bundesliga,2018,Werder Bremen,Luca Plogmann,GER,GK,18,2000,0.4,0,0,0,0,0,0,0,,0,0,0,0,0,0,0,0,2019
GER-Bundesliga,2018,Werder Bremen,Ludwig Augustinsson,SWE,DF,24,1994,33.6,53,31,25,22,6,23,39,59.0,16,37,11,26,38,91,86,1,2019
GER-Bundesliga,2018,Werder Bremen,Marco Friedl,AUT,DF,20,1998,5.3,8,6,4,3,1,3,11,27.3,8,9,6,3,13,21,21,0,2019
GER-Bundesliga,2018,Werder Bremen,Martin Harnik,AUT,"FW,MF",31,1987,9.2,12,7,4,3,5,4,15,26.7,11,8,0,8,3,15,10,0,2019
GER-Bundesliga,2018,Werder Bremen,Max Kruse,GER,"FW,MF",30,1988,31.5,17,5,2,13,2,6,38,15.8,32,16,1,15,8,25,6,2,2019
GER-Bundesliga,2018,Werder Bremen,Maximilian Eggestein,GER,MF,21,1996,33.9,68,42,29,34,5,24,54,44.4,30,49,10,39,30,98,69,0,2019
GER-Bundesliga,2018,Werder Bremen,Milot Rashica,KVX,"FW,MF",22,1996,17.2,24,16,8,11,5,9,24,37.5,15,16,2,14,6,30,6,1,2019
GER-Bundesliga,2018,Werder Bremen,Miloš Veljković,SRB,DF,22,1995,20.9,36,24,29,6,1,22,37,59.5,15,27,13,14,27,63,111,0,2019
GER-Bundesliga,2018,Werder Bremen,Niklas Moisander,FIN,DF,32,1985,29.3,34,23,26,8,0,22,51,43.1,29,42,19,23,39,73,140,2,2019
GER-Bundesliga,2018,Werder Bremen,Nuri Şahin,TUR,MF,29,1988,16.4,60,33,22,33,5,23,59,39.0,36,30,3,27,37,97,39,1,2019
GER-Bundesliga,2018,Werder Bremen,Philipp Bargfrede,GER,"MF,DF",29,1989,12.0,23,15,9,12,2,10,28,35.7,18,35,11,24,34,57,45,1,2019
GER-Bundesliga,2018,Werder Bremen,Sebastian Langkamp,GER,DF,30,1988,15.7,24,15,18,6,0,7,14,50.0,7,17,11,6,20,44,79,1,2019
GER-Bundesliga,2018,Werder Bremen,Stefanos Kapino,GRE,GK,24,1994,0.5,0,0,0,0,0,0,0,,0,0,0,0,0,0,0,0,2019
GER-Bundesliga,2018,Werder Bremen,Theodor Gebre Selassie,CZE,DF,31,1986,31.3,53,38,27,16,10,22,51,43.1,29,33,8,25,69,122,100,0,2019
GER-Bundesliga,2018,Werder Bremen,Yuya Osako,JPN,"FW,MF",28,1990,15.0,23,11,6,12,5,7,22,31.8,15,15,3,12,7,30,8,0,2019
GER-Bundesliga,2018,Wolfsburg,Admir Mehmedi,SUI,"FW,MF",27,1991,18.8,46,28,19,19,8,18,44,40.9,26,25,0,25,12,58,9,0,2019
GER-Bundesliga,2018,Wolfsburg,Daniel Ginczek,GER,FW,27,1991,14.2,9,7,4,3,2,5,19,26.3,14,12,2,10,3,12,23,1,2019
GER-Bundesliga,2018,Wolfsburg,Elvis Rexhbeçaj,GER,MF,20,1997,12.7,28,18,11,12,5,12,24,50.0,12,18,2,16,14,42,21,0,2019
GER-Bundesliga,2018,Wolfsburg,Felix Klaus,GER,"FW,MF",25,1992,4.9,10,7,4,5,1,2,7,28.6,5,5,0,5,4,14,0,0,2019
GER-Bundesliga,2018,Wolfsburg,Gian-Luca Itter,GER,DF,19,1999,1.0,4,3,3,1,0,1,2,50.0,1,2,0,2,1,5,2,0,2019
GER-Bundesliga,2018,Wolfsburg,Ignacio Camacho,ESP,MF,28,1990,6.0,15,9,9,6,0,3,7,42.9,4,7,2,5,18,33,12,0,2019
GER-Bundesliga,2018,Wolfsburg,Jakub Błaszczykowski,POL,MF,32,1985,0.1,0,0,0,0,0,0,0,,0,0,0,0,0,0,0,0,2019
GER-Bundesliga,2018,Wolfsburg,John Brooks,USA,DF,25,1993,29.0,29,15,18,9,2,13,27,48.1,14,28,13,15,37,66,135,3,2019
GER-Bundesliga,2018,Wolfsburg,John Yeboah,GER,"MF,FW",18,2000,0.6,0,0,0,0,0,0,3,0.0,3,1,0,1,1,1,0,0,2019
GER-Bundesliga,2018,Wolfsburg,Josip Brekalo,CRO,"FW,MF",20,1998,15.7,15,7,7,6,2,5,18,27.8,13,15,1,14,12,27,9,1,2019
GER-Bundesliga,2018,Wolfsburg,Josuha Guilavogui,FRA,MF,27,1990,17.4,31,16,18,13,0,14,25,56.0,11,17,8,9,43,74,56,2,2019
GER-Bundesliga,2018,Wolfsburg,Jérôme Roussillon,FRA,DF,25,1993,27.3,42,29,25,15,2,20,30,66.7,10,50,7,43,31,73,54,0,2019
GER-Bundesliga,2018,Wolfsburg,Koen Casteels,BEL,GK,26,1992,25.5,1,0,1,0,0,1,2,50.0,1,1,0,1,0,1,11,1,2019
GER-Bundesliga,2018,Wolfsburg,Marcel Tisserand,COD,DF,25,1993,9.8,14,9,9,5,0,10,13,76.9,3,12,5,7,20,34,42,1,2019
GER-Bundesliga,2018,Wolfsburg,Maximilian Arnold,GER,MF,24,1994,31.9,52,30,21,27,4,21,61,34.4,40,31,10,21,35,87,48,1,2019
GER-Bundesliga,2018,Wolfsburg,Ohis Felix Uduokhai,GER,DF,20,1997,2.7,13,7,7,5,1,9,10,90.0,1,6,2,4,6,19,11,1,2019
GER-Bundesliga,2018,Wolfsburg,Paul Verhaegh,NED,DF,34,1983,2.0,1,0,0,0,1,1,2,50.0,1,5,0,5,1,2,7,1,2019
GER-Bundesliga,2018,Wolfsburg,Pavao Pervan,AUT,GK,30,1987,8.5,0,0,0,0,0,0,0,,0,0,0,0,0,0,3,1,2019
GER-Bundesliga,2018,Wolfsburg,Renato Steffen,SUI,"FW,MF",26,1991,16.7,26,17,5,17,4,7,17,41.2,10,13,2,11,16,42,14,0,2019
GER-Bundesliga,2018,Wolfsburg,Robin Knoche,GER,DF,26,1992,31.0,26,20,19,6,1,16,29,55.2,13,46,29,17,44,70,138,2,2019
GER-Bundesliga,2018,Wolfsburg,Sebastian Jung,GER,DF,28,1990,0.6,1,0,0,1,0,1,1,100.0,0,0,0,0,0,1,1,0,2019
GER-Bundesliga,2018,Wolfsburg,William,BRA,DF,23,1995,29.7,82,57,52,21,9,35,75,46.7,40,41,2,39,85,167,127,3,2019
GER-Bundesliga,2018,Wolfsburg,Wout Weghorst,NED,FW,25,1992,32.5,30,23,10,12,8,7,35,20.0,28,27,3,24,9,39,33,0,2019
GER-Bundesliga,2018,Wolfsburg,Yannick Gerhardt,GER,MF,24,1994,27.3,52,34,22,20,10,16,43,37.2,27,35,7,28,30,82,34,0,2019
GER-Bundesliga,2018,Wolfsburg,Yunus Mallı,TUR,"MF,FW",26,1992,7.8,15,7,8,6,1,2,11,18.2,9,2,0,2,4,19,1,0,2019
GER-Bundesliga,2019,Augsburg,Alfreð Finnbogason,ISL,FW,30,1989,10.7,11,6,1,9,1,2,7,28.6,5,8,2,6,3,14,8,0,2020
GER-Bundesliga,2019,Augsburg,Andreas Luthe,GER,GK,32,1987,10.0,1,0,1,0,0,1,2,50.0,1,0,0,0,0,1,5,1,2020
GER-Bundesliga,2019,Augsburg,André Hahn,GER,"FW,MF",28,1990,7.8,15,9,7,5,3,5,21,23.8,16,23,5,18,13,28,14,0,2020
GER-Bundesliga,2019,Augsburg,Carlos Gruezo,ECU,MF,24,1995,9.8,28,12,12,15,1,5,24,20.8,19,5,0,5,6,34,5,0,2020
GER-Bundesliga,2019,Augsburg,Daniel Baier,GER,MF,35,1984,21.6,33,17,14,14,5,15,43,34.9,28,19,7,12,58,91,27,0,2020
GER-Bundesliga,2019,Augsburg,Eduard Löwen,GER,MF,22,1997,7.5,10,8,6,2,2,6,18,33.3,12,11,2,9,5,15,7,0,2020
GER-Bundesliga,2019,Augsburg,Florian Niederlechner,GER,"FW,MF",28,1990,30.2,21,13,7,9,5,4,21,19.0,17,21,5,16,8,29,38,0,2020
GER-Bundesliga,2019,Augsburg,Fredrik Jensen,FIN,"MF,FW",21,1997,5.1,3,1,2,1,0,2,7,28.6,5,7,1,6,1,4,3,0,2020
GER-Bundesliga,2019,Augsburg,Georg Teigl,AUT,"DF,MF",28,1991,1.2,3,1,1,2,0,2,4,50.0,2,0,0,0,3,6,1,0,2020
GER-Bundesliga,2019,Augsburg,Iago,BRA,"DF,MF",22,1997,7.5,19,12,12,7,0,9,18,50.0,9,6,2,4,14,33,27,0,2020
GER-Bundesliga,2019,Augsburg,Jan Morávek,CZE,MF,29,1989,5.3,23,12,9,14,0,11,24,45.8,13,4,1,3,8,31,11,0,2020
GER-Bundesliga,2019,Augsburg,Jeffrey Gouweleeuw,NED,DF,28,1991,18.3,28,16,22,5,1,12,21,57.1,9,15,8,7,37,65,97,0,2020
GER-Bundesliga,2019,Augsburg,Julian Schieber,GER,FW,30,1989,0.5,1,1,0,1,0,0,0,,0,0,0,0,0,1,0,0,2020
GER-Bundesliga,2019,Augsburg,Mads Pedersen,DEN,DF,22,1996,1.1,4,2,3,0,1,2,6,33.3,4,3,1,2,2,6,0,0,2020
GER-Bundesliga,2019,Augsburg,Marco Richter,GER,"MF,FW",21,1997,25.3,21,16,7,9,5,14,51,27.5,37,15,0,15,24,45,17,0,2020
GER-Bundesliga,2019,Augsburg,Marek Suchý,CZE,DF,31,1988,4.4,7,5,7,0,0,4,6,66.7,2,4,1,3,6,13,15,0,2020
GER-Bundesliga,2019,Augsburg,Michael Gregoritsch,AUT,"MF,FW",25,1994,3.4,2,2,0,2,0,0,4,0.0,4,4,1,3,3,5,7,0,2020
GER-Bundesliga,2019,Augsburg,Noah Joel Sarenren Bazee,NGA,FW,22,1996,4.2,4,3,0,4,0,1,4,25.0,3,2,1,1,5,9,4,0,2020
GER-Bundesliga,2019,Augsburg,Ohis Felix Uduokhai,GER,DF,21,1997,21.8,43,26,30,12,1,19,29,65.5,10,40,30,10,36,79,125,2,2020
GER-Bundesliga,2019,Augsburg,Philipp Max,GER,DF,25,1993,30.1,42,29,22,16,4,20,45,44.4,25,19,4,15,26,68,50,0,2020
GER-Bundesliga,2019,Augsburg,Rani Khedira,GER,MF,25,1994,29.4,60,36,21,35,4,18,45,40.0,27,47,12,35,48,108,62,0,2020
GER-Bundesliga,2019,Augsburg,Raphael Framberger,GER,DF,23,1995,13.1,43,25,23,16,4,21,29,72.4,8,23,9,14,20,63,26,0,2020
GER-Bundesliga,2019,Augsburg,Reece Oxford,ENG,MF,20,1998,4.2,7,4,2,4,1,2,8,25.0,6,8,5,3,5,12,10,1,2020
GER-Bundesliga,2019,Augsburg,Ruben Vargas,SUI,"FW,MF",20,1998,28.1,32,16,18,7,7,8,36,22.2,28,26,1,25,26,58,35,0,2020
GER-Bundesliga,2019,Augsburg,Sergio Córdova,VEN,FW,21,1997,4.1,3,0,0,2,1,1,10,10.0,9,0,0,0,0,3,3,0,2020
GER-Bundesliga,2019,Augsburg,Stephan Lichtsteiner,SUI,DF,35,1984,14.9,23,14,16,5,2,10,22,45.5,12,15,7,8,16,39,35,0,2020
GER-Bundesliga,2019,Augsburg,Tin Jedvaj,CRO,DF,23,1995,29.3,44,26,25,19,0,23,47,48.9,24,36,18,18,60,104,123,1,2020
GER-Bundesliga,2019,Augsburg,Tomáš Koubek,CZE,GK,26,1992,24.0,3,2,3,0,0,3,11,27.3,8,1,0,1,1,4,23,3,2020
GER-Bundesliga,2019,Bayern Munich,Alphonso Davies,CAN,DF,18,2000,24.8,70,43,35,24,11,38,58,65.5,20,35,6,29,31,101,51,0,2020
GER-Bundesliga,2019,Bayern Munich,Benjamin Pavard,FRA,DF,23,1996,31.0,34,22,15,10,9,16,28,57.1,12,28,10,18,52,86,60,0,2020
GER-Bundesliga,2019,Bayern Munich,Chris Richards,USA,DF,19,2000,0.1,0,0,0,0,0,0,0,,0,0,0,0,0,0,1,0,2020
GER-Bundesliga,2019,Bayern Munich,Corentin Tolisso,FRA,MF,24,1994,7.1,9,4,4,3,2,1,9,11.1,8,9,3,6,4,13,2,1,2020
GER-Bundesliga,2019,Bayern Munich,David Alaba,AUT,DF,27,1992,27.8,30,17,14,15,1,16,25,64.0,9,19,10,9,29,59,40,0,2020
GER-Bundesliga,2019,Bayern Munich,Ivan Perišić,CRO,"FW,MF",30,1989,13.4,16,12,5,6,5,8,33,24.2,25,14,3,11,4,20,8,0,2020
GER-Bundesliga,2019,Bayern Munich,Jamal Musiala,GER,MF,16,2003,0.0,0,0,0,0,0,0,0,,0,0,0,0,0,0,0,0,2020
GER-Bundesliga,2019,Bayern Munich,Javi Martínez,ESP,"DF,MF",30,1988,7.5,16,12,9,7,0,9,11,81.8,2,9,8,1,18,34,30,0,2020
GER-Bundesliga,2019,Bayern Munich,Joshua Kimmich,GER,"MF,DF",24,1995,31.3,52,29,21,20,11,22,55,40.0,33,38,9,29,29,81,29,0,2020
GER-Bundesliga,2019,Bayern Munich,Joshua Zirkzee,NED,FW,18,2001,3.3,5,2,0,2,3,2,4,50.0,2,2,0,2,1,6,0,0,2020
GER-Bundesliga,2019,Bayern Munich,Jérôme Boateng,GER,DF,30,1988,20.0,21,14,9,12,0,11,22,50.0,11,15,11,4,33,54,58,1,2020
GER-Bundesliga,2019,Bayern Munich,Kingsley Coman,FRA,"FW,MF",23,1996,16.7,19,11,6,7,6,12,27,44.4,15,9,0,9,4,23,3,0,2020
GER-Bundesliga,2019,Bayern Munich,Kwasi Okyere Wriedt,GHA,FW,25,1994,0.2,0,0,0,0,0,0,0,,0,0,0,0,0,0,0,0,2020
GER-Bundesliga,2019,Bayern Munich,Leon Dajaku,GER,"DF,MF",18,2001,0.1,0,0,0,0,0,0,1,0.0,1,0,0,0,0,0,0,0,2020
GER-Bundesliga,2019,Bayern Munich,Leon Goretzka,GER,MF,24,1995,16.8,28,15,7,18,3,10,32,31.3,22,18,2,16,24,52,8,0,2020
GER-Bundesliga,2019,Bayern Munich,Lucas Hernández,FRA,DF,23,1996,10.2,18,9,13,3,2,9,15,60.0,6,6,1,5,15,33,17,0,2020
GER-Bundesliga,2019,Bayern Munich,Manuel Neuer,GER,GK,33,1986,33.0,2,1,1,0,1,2,4,50.0,2,0,0,0,0,2,15,4,2020
GER-Bundesliga,2019,Bayern Munich,Mickaël Cuisance,FRA,"MF,FW",19,1999,3.4,2,1,0,2,0,1,9,11.1,8,1,1,0,3,5,0,0,2020
GER-Bundesliga,2019,Bayern Munich,Niklas Süle,GER,DF,23,1995,7.1,10,6,8,2,0,4,5,80.0,1,8,6,2,8,18,22,1,2020
GER-Bundesliga,2019,Bayern Munich,Oliver Batista-Meier,GER,MF,18,2001,0.1,0,0,0,0,0,0,2,0.0,2,0,0,0,0,0,0,0,2020
GER-Bundesliga,2019,Bayern Munich,Philippe Coutinho,BRA,"MF,FW",27,1992,15.7,21,15,1,13,7,2,13,15.4,11,9,2,7,6,27,0,0,2020
GER-Bundesliga,2019,Bayern Munich,Renato Sanches,POR,MF,21,1997,0.1,0,0,0,0,0,0,0,,0,0,0,0,0,0,0,0,2020
GER-Bundesliga,2019,Bayern Munich,Robert Lewandowski,POL,FW,30,1988,30.7,18,9,3,9,6,3,15,20.0,12,13,1,12,7,25,13,0,2020
GER-Bundesliga,2019,Bayern Munich,Sarpreet Singh,NZL,"FW,MF",20,1999,0.8,1,0,0,1,0,0,1,0.0,1,0,0,0,0,1,0,0,2020
GER-Bundesliga,2019,Bayern Munich,Serge Gnabry,GER,"FW,MF",24,1995,24.4,36,16,4,19,13,9,29,31.0,20,17,0,17,16,52,2,1,2020
GER-Bundesliga,2019,Bayern Munich,Sven Ulreich,GER,GK,30,1988,1.0,0,0,0,0,0,0,0,,0,0,0,0,0,0,0,0,2020
GER-Bundesliga,2019,Bayern Munich,Thiago Alcántara,ESP,MF,28,1991,19.7,45,26,17,23,5,12,33,36.4,21,12,3,9,45,90,13,1,2020
GER-Bundesliga,2019,Bayern Munich,Thomas Müller,GER,"MF,FW",29,1989,25.1,45,27,7,26,12,22,69,31.9,47,27,3,24,12,57,8,0,2020
GER-Bundesliga,2019,Bayern Munich,Álvaro Odriozola,ESP,DF,23,1995,1.7,2,2,1,0,1,2,3,66.7,1,1,0,1,1,3,2,0,2020
GER-Bundesliga,2019,Dortmund,Achraf Hakimi,MAR,"DF,MF",20,1998,30.2,60,41,38,14,8,27,64,42.2,37,26,2,24,30,90,27,2,2020
GER-Bundesliga,2019,Dortmund,Axel Witsel,BEL,MF,30,1989,24.9,28,20,10,17,1,14,33,42.4,19,26,7,19,31,59,19,1,2020
GER-Bundesliga,2019,Dortmund,Dan-Axel Zagadou,FRA,DF,20,1999,10.9,16,10,12,4,0,6,8,75.0,2,12,8,4,15,31,38,0,2020
GER-Bundesliga,2019,Dortmund,Emre Can,GER,"MF,DF",25,1994,10.6,19,12,11,7,1,5,12,41.7,7,14,6,8,19,38,15,0,2020
GER-Bundesliga,2019,Dortmund,Erling Haaland,NOR,FW,19,2000,11.8,4,2,1,0,3,0,4,0.0,4,7,4,3,4,8,4,0,2020
GER-Bundesliga,2019,Dortmund,Gio Reyna,USA,"MF,FW",16,2002,3.9,6,2,1,5,0,1,4,25.0,3,3,0,3,0,6,2,0,2020
GER-Bundesliga,2019,Dortmund,Jacob Bruun Larsen,DEN,FW,20,1998,0.8,0,0,0,0,0,0,0,,0,0,0,0,0,0,0,0,2020
GER-Bundesliga,2019,Dortmund,Jadon Sancho,ENG,"FW,MF",19,2000,25.4,14,11,6,6,2,8,24,33.3,16,8,0,8,14,28,6,0,2020
GER-Bundesliga,2019,Dortmund,Julian Brandt,GER,"MF,FW",23,1996,24.5,48,33,15,21,12,25,55,45.5,30,35,2,33,16,64,10,1,2020
GER-Bundesliga,2019,Dortmund,Julian Weigl,GER,"MF,DF",23,1995,11.3,16,9,12,3,1,9,16,56.3,7,10,0,10,8,24,21,0,2020
GER-Bundesliga,2019,Dortmund,Leonardo Balerdi,ARG,"DF,MF",20,1999,1.5,2,1,1,1,0,2,2,100.0,0,0,0,0,4,6,3,0,2020
GER-Bundesliga,2019,Dortmund,Mahmoud Dahoud,GER,MF,23,1996,6.2,10,6,4,4,2,6,18,33.3,12,8,2,6,8,18,4,0,2020
GER-Bundesliga,2019,Dortmund,Manuel Akanji,SUI,DF,24,1995,25.7,38,21,23,14,1,12,20,60.0,8,20,11,9,30,68,61,2,2020
GER-Bundesliga,2019,Dortmund,Marcel Schmelzer,GER,DF,31,1988,0.7,2,1,1,1,0,1,1,100.0,0,0,0,0,1,3,2,0,2020
GER-Bundesliga,2019,Dortmund,Marco Reus,GER,"MF,FW",30,1989,16.6,26,16,5,11,10,3,19,15.8,16,17,2,15,9,35,11,0,2020
GER-Bundesliga,2019,Dortmund,Mario Götze,GER,FW,27,1992,5.8,10,7,0,6,4,3,12,25.0,9,3,0,3,2,12,1,0,2020
GER-Bundesliga,2019,Dortmund,Marwin Hitz,SUI,GK,31,1987,3.2,0,0,0,0,0,0,0,,0,0,0,0,0,0,0,0,2020
GER-Bundesliga,2019,Dortmund,Mateu Morey,ESP,"DF,MF",19,2000,2.2,7,3,2,4,1,4,10,40.0,6,4,0,4,5,12,3,0,2020
GER-Bundesliga,2019,Dortmund,Mats Hummels,GER,DF,30,1988,28.7,57,30,30,26,1,20,38,52.6,18,41,18,23,59,116,110,1,2020
GER-Bundesliga,2019,Dortmund,Nico Schulz,GER,"DF,MF",26,1993,6.6,11,7,3,6,2,8,13,61.5,5,14,4,10,9,20,9,0,2020
GER-Bundesliga,2019,Dortmund,Paco Alcácer,ESP,FW,25,1993,5.9,2,2,0,2,0,1,5,20.0,4,4,1,3,2,4,3,0,2020
GER-Bundesliga,2019,Dortmund,Raphaël Guerreiro,POR,"DF,MF",25,1993,25.9,44,24,18,21,5,20,32,62.5,12,27,3,24,42,86,26,0,2020
GER-Bundesliga,2019,Dortmund,Roman Bürki,SUI,GK,28,1990,30.8,2,2,2,0,0,2,3,66.7,1,1,0,1,2,4,13,1,2020
GER-Bundesliga,2019,Dortmund,Thomas Delaney,DEN,MF,27,1991,9.2,22,10,10,11,1,9,15,60.0,6,16,7,9,26,48,26,0,2020
GER-Bundesliga,2019,Dortmund,Thorgan Hazard,BEL,"FW,MF",26,1993,26.4,40,27,17,14,9,12,50,24.0,38,29,0,29,13,53,2,1,2020
GER-Bundesliga,2019,Dortmund,Tobias Raschl,GER,MF,19,2000,0.3,0,0,0,0,0,0,1,0.0,1,1,0,1,0,0,0,0,2020
GER-Bundesliga,2019,Dortmund,Łukasz Piszczek,POL,DF,34,1985,23.4,45,32,27,16,2,28,50,56.0,22,27,11,16,26,71,47,1,2020
GER-Bundesliga,2019,Düsseldorf,Adam Bodzek,GER,MF,33,1985,22.4,42,26,21,20,1,14,46,30.4,32,34,11,23,25,67,39,0,2020
GER-Bundesliga,2019,Düsseldorf,Alfredo Morales,USA,MF,29,1990,19.2,31,15,11,16,4,11,35,31.4,24,17,6,11,18,49,37,0,2020
GER-Bundesliga,2019,Düsseldorf,André Hoffmann,GER,DF,26,1993,27.0,48,22,30,18,0,16,50,32.0,34,22,9,13,56,104,90,0,2020
GER-Bundesliga,2019,Düsseldorf,Aymen Barkok,MAR,"FW,MF",21,1998,0.9,1,1,0,0,1,0,2,0.0,2,2,0,2,3,4,1,0,2020
GER-Bundesliga,2019,Düsseldorf,Bernard Tekpetey,GHA,"FW,MF",21,1997,5.0,4,4,1,2,1,0,2,0.0,2,5,0,5,2,6,0,0,2020
GER-Bundesliga,2019,Düsseldorf,Dawid Kownacki,POL,"FW,MF",22,1997,12.1,13,8,5,7,1,9,20,45.0,11,13,2,11,6,19,8,0,2020
GER-Bundesliga,2019,Düsseldorf,Erik Thommy,GER,"MF,FW",24,1994,25.1,40,23,16,16,8,15,39,38.5,24,23,2,21,16,56,20,1,2020
GER-Bundesliga,2019,Düsseldorf,Florian Kastenmeier,GER,GK,22,1997,17.0,1,1,1,0,0,0,0,,0,0,0,0,2,3,3,1,2020
GER-Bundesliga,2019,Düsseldorf,Jean Zimmer,GER,"DF,FW",25,1993,8.0,11,6,5,5,1,5,10,50.0,5,3,1,2,3,14,0,0,2020
GER-Bundesliga,2019,Düsseldorf,Kaan Ayhan,TUR,DF,24,1994,30.3,38,25,26,11,1,20,37,54.1,17,28,15,13,45,83,72,1,2020
GER-Bundesliga,2019,Düsseldorf,Kasim Nuhu,GHA,DF,24,1995,11.1,14,7,12,1,1,9,19,47.4,10,16,12,4,25,39,54,0,2020
GER-Bundesliga,2019,Düsseldorf,Kelvin Ofori,GHA,MF,18,2001,0.4,0,0,0,0,0,0,0,,0,0,0,0,0,0,0,0,2020
GER-Bundesliga,2019,Düsseldorf,Kenan Karaman,TUR,"FW,MF",25,1994,15.0,11,5,2,5,4,4,9,44.4,5,9,4,5,2,13,7,0,2020
GER-Bundesliga,2019,Düsseldorf,Kevin Stöger,AUT,MF,25,1993,14.1,21,15,10,7,4,6,24,25.0,18,24,2,22,26,47,7,1,2020
GER-Bundesliga,2019,Düsseldorf,Lewis Baker,ENG,MF,24,1995,6.1,8,5,6,2,0,2,10,20.0,8,5,2,3,2,10,5,0,2020
GER-Bundesliga,2019,Düsseldorf,Marcel Sobottka,GER,MF,25,1994,7.8,15,10,6,8,1,4,13,30.8,9,9,1,8,9,24,12,0,2020
GER-Bundesliga,2019,Düsseldorf,Markus Suttner,AUT,DF,32,1987,14.9,21,16,11,9,1,11,24,45.8,13,22,7,15,13,34,33,0,2020
GER-Bundesliga,2019,Düsseldorf,Mathias Jørgensen,DEN,DF,29,1990,5.5,4,3,3,1,0,2,4,50.0,2,7,3,4,13,17,33,0,2020
GER-Bundesliga,2019,Düsseldorf,Matthias Zimmermann,GER,"DF,MF",27,1992,32.5,62,47,26,27,9,31,64,48.4,33,41,15,26,43,105,59,0,2020
GER-Bundesliga,2019,Düsseldorf,Niko Gießelmann,GER,DF,27,1991,22.9,46,31,31,11,4,22,45,48.9,23,23,6,17,27,73,55,1,2020
GER-Bundesliga,2019,Düsseldorf,Oliver Fink,GER,"MF,FW",37,1982,7.5,21,12,7,11,3,5,16,31.3,11,12,1,11,15,36,7,0,2020
GER-Bundesliga,2019,Düsseldorf,Opoku Ampomah,GHA,"FW,MF",23,1996,5.6,9,4,3,4,2,3,12,25.0,9,3,0,3,4,13,5,0,2020
GER-Bundesliga,2019,Düsseldorf,Robin Bormuth,GER,DF,23,1995,2.0,2,1,2,0,0,2,3,66.7,1,6,5,1,0,2,12,0,2020
GER-Bundesliga,2019,Düsseldorf,Rouwen Hennings,GER,FW,31,1987,27.3,11,5,2,7,2,3,18,16.7,15,12,0,12,2,13,33,0,2020
GER-Bundesliga,2019,Düsseldorf,Steven Skrzybski,GER,"FW,MF",26,1992,5.9,4,4,2,1,1,0,16,0.0,16,10,0,10,10,14,4,0,2020
GER-Bundesliga,2019,Düsseldorf,Thomas Pledl,GER,"MF,FW",25,1994,1.0,4,2,2,2,0,0,1,0.0,1,0,0,0,0,4,1,0,2020
GER-Bundesliga,2019,Düsseldorf,Valon Berisha,KVX,MF,26,1993,10.5,14,9,3,8,3,6,21,28.6,15,4,1,3,9,23,8,0,2020
GER-Bundesliga,2019,Düsseldorf,Zack Steffen,USA,GK,24,1995,17.0,0,0,0,0,0,0,0,,0,0,0,0,0,0,5,4,2020
GER-Bundesliga,2019,Eint Frankfurt,Almamy Touré,MLI,DF,23,1996,16.6,32,19,18,11,3,11,22,50.0,11,18,7,11,23,55,54,1,2020
GER-Bundesliga,2019,Eint Frankfurt,André Silva,POR,FW,23,1995,17.5,7,2,0,5,2,2,14,14.3,12,9,0,9,8,15,4,0,2020
GER-Bundesliga,2019,Eint Frankfurt,Ante Rebić,CRO,"FW,MF",25,1993,1.0,1,0,0,1,0,0,0,,0,0,0,0,0,1,1,0,2020
GER-Bundesliga,2019,Eint Frankfurt,Bas Dost,NED,FW,30,1989,16.4,11,7,1,7,3,3,7,42.9,4,6,2,4,5,16,22,0,2020
GER-Bundesliga,2019,Eint Frankfurt,Daichi Kamada,JPN,"MF,FW",22,1996,21.9,29,20,7,17,5,8,42,19.0,34,16,1,15,10,39,6,0,2020
GER-Bundesliga,2019,Eint Frankfurt,Danny da Costa,GER,"DF,FW",26,1993,15.4,26,17,14,8,4,6,16,37.5,10,16,1,15,15,41,26,0,2020
GER-Bundesliga,2019,Eint Frankfurt,David Abraham,ARG,DF,33,1986,18.8,21,14,16,4,1,15,32,46.9,17,27,11,16,25,46,61,1,2020
GER-Bundesliga,2019,Eint Frankfurt,Dejan Joveljić,SRB,FW,19,1999,1.7,2,2,1,1,0,0,1,0.0,1,0,0,0,0,2,1,0,2020
GER-Bundesliga,2019,Eint Frankfurt,Djibril Sow,SUI,MF,22,1997,19.4,56,33,26,17,13,16,47,34.0,31,15,3,12,30,86,9,0,2020
GER-Bundesliga,2019,Eint Frankfurt,Dominik Kohr,GER,MF,25,1994,16.1,44,35,15,25,4,18,53,34.0,35,31,11,20,30,74,16,0,2020
GER-Bundesliga,2019,Eint Frankfurt,Erik Durm,GER,"DF,FW",27,1992,5.7,13,6,9,2,2,9,17,52.9,8,11,2,9,3,16,11,0,2020
GER-Bundesliga,2019,Eint Frankfurt,Felix Wiedwald,GER,GK,29,1990,3.0,0,0,0,0,0,0,0,,0,0,0,0,0,0,2,1,2020
GER-Bundesliga,2019,Eint Frankfurt,Filip Kostić,SRB,"DF,FW",26,1992,32.9,59,38,30,20,9,22,59,37.3,37,45,2,43,23,82,16,0,2020
GER-Bundesliga,2019,Eint Frankfurt,Frederik Rønnow,DEN,GK,26,1992,9.0,0,0,0,0,0,0,1,0.0,1,0,0,0,0,0,1,0,2020
GER-Bundesliga,2019,Eint Frankfurt,Gelson Fernandes,SUI,MF,32,1986,8.6,30,18,13,17,0,7,21,33.3,14,11,3,8,16,46,9,2,2020
GER-Bundesliga,2019,Eint Frankfurt,Gonçalo Paciência,POR,FW,24,1994,14.3,9,5,1,4,4,3,13,23.1,10,9,1,8,1,10,11,0,2020
GER-Bundesliga,2019,Eint Frankfurt,Jonathan de Guzmán,NED,MF,31,1987,1.0,1,1,0,1,0,1,7,14.3,6,2,0,2,1,2,0,0,2020
GER-Bundesliga,2019,Eint Frankfurt,Kevin Trapp,GER,GK,29,1990,22.0,0,0,0,0,0,0,1,0.0,1,0,0,0,3,3,5,0,2020
GER-Bundesliga,2019,Eint Frankfurt,Lucas Torró,ESP,MF,25,1994,3.7,12,7,6,6,0,8,16,50.0,8,2,1,1,8,20,3,0,2020
GER-Bundesliga,2019,Eint Frankfurt,Makoto Hasebe,JPN,"DF,MF",35,1984,21.9,28,20,16,9,3,18,39,46.2,21,38,10,28,26,54,38,0,2020
GER-Bundesliga,2019,Eint Frankfurt,Martin Hinteregger,AUT,DF,26,1992,30.2,66,51,33,30,3,28,57,49.1,29,41,21,20,36,102,96,0,2020
GER-Bundesliga,2019,Eint Frankfurt,Mijat Gaćinović,SRB,"MF,FW",24,1995,11.6,19,11,7,8,4,6,25,24.0,19,26,2,24,15,34,6,0,2020
GER-Bundesliga,2019,Eint Frankfurt,Obite N'Dicka,FRA,DF,19,1999,19.1,27,13,13,11,3,15,28,53.6,13,28,6,22,29,56,57,0,2020
GER-Bundesliga,2019,Eint Frankfurt,Sebastian Rode,GER,MF,28,1990,21.5,58,33,27,27,4,17,59,28.8,42,32,5,27,34,92,13,0,2020
GER-Bundesliga,2019,Eint Frankfurt,Simon Falette,GUI,DF,27,1992,1.0,0,0,0,0,0,0,1,0.0,1,3,3,0,3,3,5,0,2020
GER-Bundesliga,2019,Eint Frankfurt,Stefan Ilsanker,AUT,"DF,MF",30,1989,9.3,23,15,16,7,0,10,23,43.5,13,8,1,7,19,42,26,0,2020
GER-Bundesliga,2019,Eint Frankfurt,Timothy Chandler,USA,"DF,MF",29,1990,13.6,22,10,9,8,5,9,16,56.3,7,9,4,5,13,35,21,0,2020
GER-Bundesliga,2019,Freiburg,Alexander Schwolow,GER,GK,27,1992,23.2,0,0,0,0,0,0,0,,0,2,0,2,1,1,8,3,2020
GER-Bundesliga,2019,Freiburg,Amir Abrashi,ALB,MF,29,1990,7.4,16,8,7,8,1,10,19,52.6,9,18,3,15,7,23,16,2,2020
GER-Bundesliga,2019,Freiburg,Brandon Borrello,AUS,"MF,FW",24,1995,3.3,10,4,6,4,0,4,10,40.0,6,7,1,6,1,11,1,0,2020
GER-Bundesliga,2019,Freiburg,Christian Günter,GER,DF,26,1993,33.7,25,11,17,7,1,12,35,34.3,23,29,13,16,14,39,40,0,2020
GER-Bundesliga,2019,Freiburg,Dominique Heintz,GER,DF,25,1993,27.0,47,30,40,6,1,17,43,39.5,26,38,25,13,41,88,131,1,2020
GER-Bundesliga,2019,Freiburg,Gian-Luca Itter,GER,"DF,MF",20,1999,0.4,1,1,1,0,0,1,1,100.0,0,0,0,0,1,2,4,0,2020
GER-Bundesliga,2019,Freiburg,Janik Haberer,GER,"MF,FW",25,1994,19.1,26,18,8,14,4,12,45,26.7,33,25,4,21,25,51,23,0,2020
GER-Bundesliga,2019,Freiburg,Jonathan Schmid,FRA,DF,29,1990,31.5,42,27,19,19,4,19,37,51.4,18,23,8,15,35,77,84,0,2020
GER-Bundesliga,2019,Freiburg,Jérôme Gondorf,GER,MF,31,1988,1.3,9,6,7,1,1,3,6,50.0,3,3,2,1,0,9,2,0,2020
GER-Bundesliga,2019,Freiburg,Kwon Chang-hoon,KOR,"MF,FW",25,1994,7.5,7,4,2,3,2,1,10,10.0,9,5,1,4,7,14,14,0,2020
GER-Bundesliga,2019,Freiburg,Lino Tempelmann,GER,MF,20,1999,0.4,1,0,1,0,0,1,1,100.0,0,1,1,0,0,1,0,0,2020
GER-Bundesliga,2019,Freiburg,Luca Waldschmidt,GER,"FW,MF",23,1996,14.1,10,7,3,5,2,2,18,11.1,16,11,2,9,4,14,4,0,2020
GER-Bundesliga,2019,Freiburg,Lucas Höler,GER,"FW,MF",25,1994,27.6,35,15,11,16,8,11,46,23.9,35,30,9,21,12,47,38,0,2020
GER-Bundesliga,2019,Freiburg,Lukas Kübler,GER,DF,26,1992,2.3,1,1,0,1,0,1,5,20.0,4,2,0,2,1,2,6,0,2020
GER-Bundesliga,2019,Freiburg,Manuel Gulde,GER,DF,28,1991,15.2,28,16,17,9,2,15,24,62.5,9,23,13,10,22,50,80,1,2020
GER-Bundesliga,2019,Freiburg,Mark Flekken,NED,GK,26,1993,10.0,0,0,0,0,0,0,1,0.0,1,0,0,0,0,0,2,2,2020
GER-Bundesliga,2019,Freiburg,Mike Frantz,GER,MF,32,1986,3.9,4,2,1,3,0,2,9,22.2,7,5,3,2,1,5,4,0,2020
GER-Bundesliga,2019,Freiburg,Niclas Thiede,GER,GK,20,1999,0.8,0,0,0,0,0,0,0,,0,0,0,0,0,0,1,0,2020
GER-Bundesliga,2019,Freiburg,Nico Schlotterbeck,GER,DF,19,1999,4.1,6,3,4,2,0,2,5,40.0,3,7,5,2,3,9,20,1,2020
GER-Bundesliga,2019,Freiburg,Nicolas Höfler,GER,MF,29,1990,30.9,65,40,31,28,6,22,64,34.4,42,58,18,40,71,136,59,3,2020
GER-Bundesliga,2019,Freiburg,Nils Petersen,GER,"FW,MF",30,1988,27.1,19,14,7,9,3,10,28,35.7,18,32,6,26,10,29,67,0,2020
GER-Bundesliga,2019,Freiburg,Philipp Lienhart,AUT,DF,23,1996,20.2,11,4,10,1,0,6,13,46.2,7,24,17,7,28,39,86,0,2020
GER-Bundesliga,2019,Freiburg,Robin Koch,GER,"DF,MF",23,1996,30.1,34,20,20,13,1,11,26,42.3,15,30,22,8,45,79,94,4,2020
GER-Bundesliga,2019,Freiburg,Roland Sallai,HUN,"MF,FW",22,1997,12.9,17,10,4,9,4,7,20,35.0,13,12,2,10,7,24,4,0,2020
GER-Bundesliga,2019,Freiburg,Vincenzo Grifo,ITA,"MF,FW",26,1993,18.0,15,10,9,3,3,6,25,24.0,19,13,1,12,14,29,18,1,2020
GER-Bundesliga,2019,Freiburg,Yannik Keitel,GER,MF,19,2000,1.9,2,1,1,1,0,0,6,0.0,6,3,1,2,4,6,4,0,2020
GER-Bundesliga,2019,Hertha BSC,Alexander Esswein,GER,"FW,MF",29,1990,2.4,6,4,4,2,0,3,8,37.5,5,8,1,7,7,13,7,1,2020
GER-Bundesliga,2019,Hertha BSC,Arne Maier,GER,MF,20,1999,5.9,9,7,6,1,2,1,10,10.0,9,5,0,5,7,16,2,1,2020
GER-Bundesliga,2019,Hertha BSC,Daishawn Redan,NED,MF,18,2001,0.2,0,0,0,0,0,0,1,0.0,1,0,0,0,0,0,0,0,2020
GER-Bundesliga,2019,Hertha BSC,Davie Selke,GER,FW,24,1995,10.7,6,3,2,2,2,4,7,57.1,3,7,1,6,1,7,11,0,2020
GER-Bundesliga,2019,Hertha BSC,Dedryck Boyata,BEL,DF,28,1990,27.1,24,18,17,5,2,4,12,33.3,8,39,32,7,62,86,158,1,2020
GER-Bundesliga,2019,Hertha BSC,Dennis Smarsch,GER,GK,20,1999,1.7,0,0,0,0,0,0,0,,0,0,0,0,0,0,1,0,2020
GER-Bundesliga,2019,Hertha BSC,Dodi Lukebakio,BEL,"FW,MF",21,1997,22.6,25,18,13,8,4,10,28,35.7,18,22,4,18,10,35,14,0,2020
GER-Bundesliga,2019,Hertha BSC,Eduard Löwen,GER,MF,22,1997,3.5,9,6,3,6,0,5,11,45.5,6,2,1,1,7,16,2,0,2020
GER-Bundesliga,2019,Hertha BSC,Javairô Dilrosun,NED,"MF,FW",21,1998,14.5,15,8,11,1,3,5,13,38.5,8,20,0,20,18,33,10,0,2020
GER-Bundesliga,2019,Hertha BSC,Jessic Ngankam,GER,"FW,MF",19,2000,0.9,2,2,1,1,0,2,2,100.0,0,2,0,2,0,2,1,0,2020
GER-Bundesliga,2019,Hertha BSC,Jordan Torunarigha,GER,DF,21,1997,16.2,32,19,21,11,0,18,27,66.7,9,33,18,15,31,63,75,0,2020
GER-Bundesliga,2019,Hertha BSC,Karim Rekik,NED,DF,24,1994,14.0,16,10,10,6,0,3,6,50.0,3,23,15,8,18,34,44,0,2020
GER-Bundesliga,2019,Hertha BSC,Krzysztof Piątek,POL,FW,24,1995,10.1,5,4,1,1,3,0,11,0.0,11,7,0,7,5,10,3,0,2020
GER-Bundesliga,2019,Hertha BSC,Lazar Samardzic,SRB,"MF,FW",17,2002,0.4,4,4,2,2,0,1,4,25.0,3,2,1,1,0,4,0,0,2020
GER-Bundesliga,2019,Hertha BSC,Lukas Klünter,GER,DF,23,1996,20.9,44,31,26,16,2,20,30,66.7,10,16,4,12,27,71,61,1,2020
GER-Bundesliga,2019,Hertha BSC,Marius Wolf,GER,"FW,MF",24,1995,15.7,19,11,9,7,3,10,27,37.0,17,14,1,13,17,36,13,0,2020
GER-Bundesliga,2019,Hertha BSC,Marko Grujić,SRB,MF,23,1996,26.8,56,34,21,30,5,19,63,30.2,44,43,9,34,22,78,69,0,2020
GER-Bundesliga,2019,Hertha BSC,Marvin Plattenhardt,GER,DF,27,1992,15.5,18,12,13,4,1,12,17,70.6,5,18,7,11,11,29,47,0,2020
GER-Bundesliga,2019,Hertha BSC,Matheus Cunha,BRA,"FW,MF",20,1999,8.3,10,5,6,4,0,4,11,36.4,7,11,1,10,10,20,1,0,2020
GER-Bundesliga,2019,Hertha BSC,Mathew Leckie,AUS,"DF,FW",28,1991,2.2,3,1,1,2,0,2,3,66.7,1,6,0,6,2,5,2,1,2020
GER-Bundesliga,2019,Hertha BSC,Maximilian Mittelstädt,GER,"DF,FW",22,1997,21.0,61,38,31,25,5,26,54,48.1,28,38,6,32,53,114,64,0,2020
GER-Bundesliga,2019,Hertha BSC,Niklas Stark,GER,DF,24,1995,19.2,36,20,24,10,2,9,21,42.9,12,27,12,15,21,57,97,2,2020
GER-Bundesliga,2019,Hertha BSC,Ondrej Duda,SVK,MF,24,1994,5.0,6,4,1,2,3,1,10,10.0,9,3,1,2,5,11,5,0,2020
GER-Bundesliga,2019,Hertha BSC,Pascal Köpke,GER,FW,23,1995,1.3,0,0,0,0,0,0,0,,0,0,0,0,0,0,0,0,2020
GER-Bundesliga,2019,Hertha BSC,Per Ciljan Skjelbred,NOR,MF,32,1987,18.1,50,30,18,29,3,17,41,41.5,24,14,3,11,23,73,17,0,2020
GER-Bundesliga,2019,Hertha BSC,Peter Pekarík,SVK,"DF,FW",32,1986,8.5,14,7,7,3,4,8,20,40.0,12,11,4,7,7,21,31,0,2020
GER-Bundesliga,2019,Hertha BSC,Rune Jarstein,NOR,GK,34,1984,28.3,4,1,4,0,0,2,3,66.7,1,0,0,0,1,5,11,3,2020
GER-Bundesliga,2019,Hertha BSC,Salomon Kalou,CIV,"FW,MF",33,1985,1.6,1,0,1,0,0,0,2,0.0,2,2,0,2,0,1,1,0,2020
GER-Bundesliga,2019,Hertha BSC,Santiago Ascacíbar,ARG,MF,22,1997,7.0,26,13,15,11,0,11,28,39.3,17,13,2,11,16,42,13,0,2020
GER-Bundesliga,2019,Hertha BSC,Thomas Kraft,GER,GK,31,1988,4.0,0,0,0,0,0,0,0,,0,0,0,0,1,1,0,0,2020
GER-Bundesliga,2019,Hertha BSC,Vedad Ibišević,BIH,FW,34,1984,14.0,4,3,0,1,3,0,3,0.0,3,4,0,4,1,5,15,0,2020
GER-Bundesliga,2019,Hertha BSC,Vladimír Darida,CZE,MF,28,1990,25.1,50,27,14,31,5,11,48,22.9,37,44,7,37,27,77,19,2,2020
GER-Bundesliga,2019,Hoffenheim,Andrej Kramarić,CRO,"FW,MF",28,1991,15.8,2,1,1,0,1,1,7,14.3,6,6,0,6,3,5,4,0,2020
GER-Bundesliga,2019,Hoffenheim,Benjamin Hübner,GER,DF,30,1989,23.0,42,26,33,9,0,23,45,51.1,22,18,13,5,30,72,98,2,2020
GER-Bundesliga,2019,Hoffenheim,Christoph Baumgartner,AUT,"MF,FW",19,1999,16.6,32,17,15,16,1,10,37,27.0,27,25,1,24,8,40,13,0,2020
GER-Bundesliga,2019,Hoffenheim,Dennis Geiger,GER,MF,21,1998,12.6,12,5,4,6,2,2,16,12.5,14,9,2,7,6,18,4,0,2020
GER-Bundesliga,2019,Hoffenheim,Diadie Samassékou,MLI,MF,23,1996,14.6,37,18,14,17,6,12,34,35.3,22,25,8,17,40,77,27,1,2020
GER-Bundesliga,2019,Hoffenheim,Ermin Bičakčić,BIH,DF,29,1990,13.1,7,3,5,2,0,4,11,36.4,7,14,8,6,25,32,64,2,2020
GER-Bundesliga,2019,Hoffenheim,Florian Grillitsch,AUT,"MF,DF",23,1995,26.8,59,29,34,24,1,29,61,47.5,32,33,6,27,49,108,41,1,2020
GER-Bundesliga,2019,Hoffenheim,Håvard Nordtveit,NOR,DF,29,1990,7.8,4,1,3,1,0,3,7,42.9,4,17,12,5,13,17,45,0,2020
GER-Bundesliga,2019,Hoffenheim,Ihlas Bebou,TOG,"FW,MF",25,1994,23.4,27,15,9,13,5,8,23,34.8,15,25,4,21,11,38,25,0,2020
GER-Bundesliga,2019,Hoffenheim,Ilay Elmkies,ISR,MF,19,2000,0.0,1,1,1,0,0,0,0,,0,0,0,0,0,1,0,0,2020
GER-Bundesliga,2019,Hoffenheim,Ishak Belfodil,ALG,"FW,MF",27,1992,3.0,0,0,0,0,0,0,1,0.0,1,0,0,0,0,0,2,0,2020
GER-Bundesliga,2019,Hoffenheim,Jacob Bruun Larsen,DEN,"FW,MF",20,1998,4.3,3,2,3,0,0,3,8,37.5,5,3,0,3,3,6,1,0,2020
GER-Bundesliga,2019,Hoffenheim,Jürgen Locadia,NED,FW,25,1993,5.9,5,4,0,4,1,1,4,25.0,3,1,0,1,0,5,3,0,2020
GER-Bundesliga,2019,Hoffenheim,Kevin Akpoguma,NGA,DF,24,1995,12.7,24,16,20,4,0,13,24,54.2,11,21,11,10,13,37,48,0,2020
GER-Bundesliga,2019,Hoffenheim,Kevin Vogt,GER,DF,27,1991,10.7,7,5,4,3,0,3,9,33.3,6,12,6,6,8,15,52,1,2020
GER-Bundesliga,2019,Hoffenheim,Kostas Stafylidis,GRE,DF,25,1993,4.4,10,3,7,2,1,4,10,40.0,6,10,3,7,2,12,17,0,2020
GER-Bundesliga,2019,Hoffenheim,Leonardo Bittencourt,GER,MF,25,1993,0.0,1,1,0,0,1,0,0,,0,0,0,0,0,1,0,0,2020
GER-Bundesliga,2019,Hoffenheim,Lucas Ribeiro,BRA,MF,20,1999,0.7,1,0,1,0,0,0,3,0.0,3,1,0,1,1,2,1,0,2020
GER-Bundesliga,2019,Hoffenheim,Lukas Rupp,GER,MF,28,1991,3.8,9,4,3,5,1,3,6,50.0,3,5,0,5,5,14,3,0,2020
GER-Bundesliga,2019,Hoffenheim,Maximilian Beier,GER,FW,16,2002,1.2,5,2,0,1,4,1,2,50.0,1,2,0,2,0,5,0,0,2020
GER-Bundesliga,2019,Hoffenheim,Melayro Bogarde,NED,DF,17,2002,0.6,2,1,2,0,0,2,2,100.0,0,0,0,0,0,2,3,0,2020
GER-Bundesliga,2019,Hoffenheim,Moanes Dabbur,ISR,FW,27,1992,8.5,8,5,1,3,4,3,10,30.0,7,6,2,4,4,12,1,0,2020
GER-Bundesliga,2019,Hoffenheim,Oliver Baumann,GER,GK,29,1990,30.0,0,0,0,0,0,0,0,,0,1,0,1,3,3,15,0,2020
GER-Bundesliga,2019,Hoffenheim,Pavel Kadeřábek,CZE,"DF,FW",27,1992,27.5,32,22,17,13,2,13,30,43.3,17,29,7,22,27,59,55,1,2020
GER-Bundesliga,2019,Hoffenheim,Philipp Pentke,GER,GK,34,1985,4.0,0,0,0,0,0,0,0,,0,0,0,0,0,0,2,0,2020
GER-Bundesliga,2019,Hoffenheim,Robert Skov,DEN,"DF,FW",23,1996,29.0,41,28,30,9,2,26,50,52.0,24,26,6,20,20,61,40,0,2020
GER-Bundesliga,2019,Hoffenheim,Sargis Adamyan,ARM,"FW,MF",26,1993,8.3,11,7,3,6,2,3,21,14.3,18,8,1,7,2,13,4,0,2020
GER-Bundesliga,2019,Hoffenheim,Sebastian Rudy,GER,"MF,DF",29,1990,30.4,73,49,31,29,13,28,75,37.3,47,26,5,21,27,100,38,0,2020
GER-Bundesliga,2019,Hoffenheim,Stefan Posch,AUT,DF,22,1997,25.6,63,34,35,27,1,35,63,55.6,28,57,25,32,40,103,101,1,2020
GER-Bundesliga,2019,Hoffenheim,Steven Zuber,SUI,"DF,FW",27,1991,8.3,11,10,7,2,2,9,19,47.4,10,4,1,3,9,20,12,0,2020
GER-Bundesliga,2019,Hoffenheim,Vincenzo Grifo,ITA,MF,26,1993,0.2,0,0,0,0,0,0,0,,0,0,0,0,0,0,0,0,2020
GER-Bundesliga,2019,Köln,Anthony Modeste,FRA,FW,31,1988,12.6,10,5,1,5,4,1,10,10.0,9,5,3,2,0,10,19,0,2020
GER-Bundesliga,2019,Köln,Benno Schmitz,GER,DF,24,1994,12.9,28,17,13,11,4,16,36,44.4,20,11,1,10,16,44,27,0,2020
GER-Bundesliga,2019,Köln,Birger Verstraete,BEL,MF,25,1994,7.4,20,11,9,10,1,11,21,52.4,10,8,1,7,4,24,10,1,2020
GER-Bundesliga,2019,Köln,Christian Clemens,GER,FW,27,1991,0.2,0,0,0,0,0,0,0,,0,1,1,0,0,0,0,0,2020
GER-Bundesliga,2019,Köln,Darko Churlinov,MKD,MF,19,2000,0.2,1,1,1,0,0,1,2,50.0,1,0,0,0,1,2,0,0,2020
GER-Bundesliga,2019,Köln,Dominick Drexler,GER,"MF,FW",29,1990,17.6,34,25,12,19,3,8,32,25.0,24,11,5,6,26,60,11,0,2020
GER-Bundesliga,2019,Köln,Ellyes Skhiri,TUN,MF,24,1995,29.7,74,52,30,37,7,29,77,37.7,48,47,9,38,67,141,33,0,2020
GER-Bundesliga,2019,Köln,Elvis Rexhbeçaj,GER,MF,21,1997,6.9,16,12,9,5,2,5,13,38.5,8,7,0,7,3,19,4,0,2020
GER-Bundesliga,2019,Köln,Florian Kainz,AUT,"FW,MF",26,1992,17.3,21,13,12,6,3,15,33,45.5,18,26,2,24,13,34,11,0,2020
GER-Bundesliga,2019,Köln,Ismail Jakobs,SEN,"FW,DF",19,1999,18.6,34,23,18,9,7,10,23,43.5,13,25,3,22,24,58,30,0,2020
GER-Bundesliga,2019,Köln,Jan Thielmann,GER,"FW,MF",17,2002,6.2,9,6,2,6,1,5,12,41.7,7,8,0,8,8,17,6,0,2020
GER-Bundesliga,2019,Köln,Jhon Córdoba,COL,FW,26,1993,22.2,9,6,1,5,3,3,13,23.1,10,19,1,18,5,14,17,0,2020
GER-Bundesliga,2019,Köln,Jonas Hector,GER,"MF,DF",29,1990,27.0,76,49,37,34,5,24,75,32.0,51,44,10,34,46,122,38,1,2020
GER-Bundesliga,2019,Köln,Jorge Meré,ESP,DF,22,1997,6.9,6,5,2,4,0,1,2,50.0,1,13,11,2,14,20,30,0,2020
GER-Bundesliga,2019,Köln,Kingsley Ehizibue,NED,DF,24,1995,25.9,79,53,44,30,5,33,53,62.3,20,28,8,20,39,118,79,1,2020
GER-Bundesliga,2019,Köln,Kingsley Schindler,GHA,"FW,MF",26,1993,9.4,8,5,3,5,0,4,12,33.3,8,6,1,5,6,14,17,0,2020
GER-Bundesliga,2019,Köln,Lasse Sobiech,GER,DF,28,1991,1.0,1,0,0,0,1,0,0,,0,0,0,0,4,5,6,0,2020
GER-Bundesliga,2019,Köln,Louis Schaub,AUT,MF,24,1994,6.9,15,12,2,9,4,5,14,35.7,9,10,1,9,3,18,2,0,2020
GER-Bundesliga,2019,Köln,Marcel Risse,GER,"MF,FW",29,1989,1.5,3,2,3,0,0,1,1,100.0,0,1,0,1,1,4,1,0,2020
GER-Bundesliga,2019,Köln,Marco Höger,GER,MF,29,1989,7.5,10,6,4,5,1,6,16,37.5,10,14,4,10,6,16,15,0,2020
GER-Bundesliga,2019,Köln,Mark Uth,GER,"MF,FW",27,1991,12.9,19,12,4,10,5,9,32,28.1,23,15,0,15,7,26,3,0,2020
GER-Bundesliga,2019,Köln,Matthias Bader,GER,DF,22,1997,0.1,1,1,1,0,0,1,2,50.0,1,0,0,0,0,1,1,0,2020
GER-Bundesliga,2019,Köln,Noah Katterbach,GER,DF,18,2001,14.6,29,23,21,8,0,11,28,39.3,17,12,1,11,29,58,26,0,2020
GER-Bundesliga,2019,Köln,Rafael Czichos,GER,DF,29,1990,24.5,43,34,26,16,1,22,45,48.9,23,24,13,11,35,78,110,1,2020
GER-Bundesliga,2019,Köln,Sebastiaan Bornauw,BEL,DF,20,1999,27.2,37,24,24,12,1,20,39,51.3,19,32,12,20,42,79,99,0,2020
GER-Bundesliga,2019,Köln,Simon Terodde,GER,FW,31,1988,9.0,8,5,4,3,1,3,13,23.1,10,14,3,11,2,10,14,0,2020
GER-Bundesliga,2019,Köln,Tim Lemperle,GER,MF,17,2002,0.2,0,0,0,0,0,0,0,,0,0,0,0,0,0,0,0,2020
GER-Bundesliga,2019,Köln,Timo Horn,GER,GK,26,1993,34.0,0,0,0,0,0,0,5,0.0,5,0,0,0,2,2,15,1,2020
GER-Bundesliga,2019,Köln,Toni Leistner,GER,DF,28,1990,11.2,19,12,10,9,0,5,13,38.5,8,16,7,9,32,51,57,0,2020
GER-Bundesliga,2019,Leverkusen,Aleksandar Dragović,AUT,DF,28,1991,11.4,18,11,11,6,1,10,21,47.6,11,9,3,6,15,33,39,0,2020
GER-Bundesliga,2019,Leverkusen,Charles Aránguiz,CHI,MF,30,1989,23.5,56,37,19,29,8,27,74,36.5,47,27,6,21,22,78,21,1,2020
GER-Bundesliga,2019,Leverkusen,Daley Sinkgraven,NED,"DF,MF",24,1995,10.1,20,16,11,6,3,8,24,33.3,16,12,3,9,10,30,16,0,2020
GER-Bundesliga,2019,Leverkusen,Edmond Tapsoba,BFA,DF,20,1999,11.8,24,15,17,5,2,15,25,60.0,10,9,5,4,9,33,44,0,2020
GER-Bundesliga,2019,Leverkusen,Exequiel Palacios,ARG,MF,20,1998,2.0,8,7,4,4,0,2,5,40.0,3,2,0,2,1,9,0,0,2020
GER-Bundesliga,2019,Leverkusen,Florian Wirtz,GER,FW,16,2003,4.1,4,2,0,4,0,2,4,50.0,2,4,0,4,2,6,1,0,2020
GER-Bundesliga,2019,Leverkusen,Joel Pohjanpalo,FIN,MF,24,1994,0.0,0,0,0,0,0,0,0,,0,0,0,0,0,0,0,0,2020
GER-Bundesliga,2019,Leverkusen,Jonathan Tah,GER,DF,23,1996,23.2,36,26,23,11,2,18,29,62.1,11,25,13,12,27,63,98,2,2020
GER-Bundesliga,2019,Leverkusen,Julian Baumgartlinger,AUT,MF,31,1988,19.9,42,21,15,21,6,18,42,42.9,24,37,4,33,20,62,16,1,2020
GER-Bundesliga,2019,Leverkusen,Kai Havertz,GER,"MF,FW",20,1999,27.3,21,15,5,10,6,6,39,15.4,33,22,0,22,2,23,22,0,2020
GER-Bundesliga,2019,Leverkusen,Karim Bellarabi,GER,"FW,DF",29,1990,15.8,19,11,9,7,3,9,28,32.1,19,16,0,16,10,29,4,0,2020
GER-Bundesliga,2019,Leverkusen,Kerem Demirbay,GER,MF,26,1993,17.5,35,19,10,21,4,12,31,38.7,19,19,5,14,22,57,7,1,2020
GER-Bundesliga,2019,Leverkusen,Kevin Volland,GER,FW,27,1992,22.7,16,6,5,6,5,5,16,31.3,11,14,2,12,5,21,7,0,2020
GER-Bundesliga,2019,Leverkusen,Lars Bender,GER,"DF,MF",30,1989,15.3,42,26,17,20,5,19,38,50.0,19,32,6,26,24,66,30,0,2020
GER-Bundesliga,2019,Leverkusen,Leon Bailey,JAM,"FW,MF",21,1997,12.1,6,3,1,5,0,6,16,37.5,10,9,0,9,8,14,3,0,2020
GER-Bundesliga,2019,Leverkusen,Lucas Alario,ARG,FW,26,1992,13.0,6,3,0,4,2,1,8,12.5,7,12,2,10,1,7,9,0,2020
GER-Bundesliga,2019,Leverkusen,Lukáš Hrádecký,FIN,GK,29,1989,34.0,0,0,0,0,0,0,1,0.0,1,0,0,0,2,2,19,2,2020
GER-Bundesliga,2019,Leverkusen,Mitchell Weiser,GER,"DF,MF",25,1994,13.0,41,29,20,17,4,18,30,60.0,12,19,2,17,24,65,22,1,2020
GER-Bundesliga,2019,Leverkusen,Moussa Diaby,FRA,"FW,MF",20,1999,19.7,10,8,3,7,0,5,15,33.3,10,6,0,6,9,19,4,0,2020
GER-Bundesliga,2019,Leverkusen,Nadiem Amiri,GER,"MF,FW",22,1996,20.6,26,16,7,15,4,16,34,47.1,18,12,2,10,14,40,8,1,2020
GER-Bundesliga,2019,Leverkusen,Panagiotis Retsos,GRE,DF,20,1998,1.3,6,3,4,2,0,1,4,25.0,3,2,0,2,2,8,2,0,2020
GER-Bundesliga,2019,Leverkusen,Paulinho,BRA,"MF,FW",19,2000,3.4,4,3,3,1,0,1,2,50.0,1,5,1,4,1,5,0,0,2020
GER-Bundesliga,2019,Leverkusen,Sven Bender,GER,DF,30,1989,30.3,53,34,29,17,7,23,48,47.9,25,42,13,29,67,120,88,2,2020
GER-Bundesliga,2019,Leverkusen,Wendell,BRA,"DF,MF",26,1993,21.1,64,42,26,26,12,41,66,62.1,25,30,4,26,36,100,36,0,2020
GER-Bundesliga,2019,M'Gladbach,Alassane Pléa,FRA,FW,26,1993,23.8,16,7,5,6,5,8,28,28.6,20,21,2,19,9,25,7,0,2020
GER-Bundesliga,2019,M'Gladbach,Breel Embolo,SUI,"FW,MF",22,1997,17.2,22,11,2,15,5,4,15,26.7,11,12,1,11,8,30,5,0,2020
GER-Bundesliga,2019,M'Gladbach,Christoph Kramer,GER,MF,28,1991,16.3,45,29,19,21,5,19,49,38.8,30,22,3,19,14,59,19,0,2020
GER-Bundesliga,2019,M'Gladbach,Denis Zakaria,SUI,"MF,DF",22,1996,21.6,49,30,23,23,3,20,39,51.3,19,39,12,27,37,86,31,1,2020
GER-Bundesliga,2019,M'Gladbach,Fabian Johnson,USA,"MF,DF",31,1987,3.0,5,3,2,2,1,2,4,50.0,2,4,1,3,2,7,3,0,2020
GER-Bundesliga,2019,M'Gladbach,Florian Neuhaus,GER,MF,22,1997,26.2,42,23,13,22,7,12,54,22.2,42,24,4,20,27,69,8,0,2020
GER-Bundesliga,2019,M'Gladbach,Ibrahima Traoré,GUI,"FW,MF",31,1988,1.7,4,3,1,1,2,1,7,14.3,6,1,0,1,1,5,3,0,2020
GER-Bundesliga,2019,M'Gladbach,Jonas Hofmann,GER,"MF,FW",27,1992,18.1,43,27,22,12,9,22,76,28.9,54,28,3,25,18,61,14,0,2020
GER-Bundesliga,2019,M'Gladbach,Jordan Beyer,GER,DF,19,2000,1.2,3,1,3,0,0,0,1,0.0,1,4,2,2,1,4,4,0,2020
GER-Bundesliga,2019,M'Gladbach,Keanan Bennetts,ENG,MF,20,1999,0.0,0,0,0,0,0,0,1,0.0,1,0,0,0,0,0,0,0,2020
GER-Bundesliga,2019,M'Gladbach,Lars Stindl,GER,"MF,FW",30,1988,15.9,27,16,4,15,8,10,28,35.7,18,18,2,16,10,37,7,0,2020
GER-Bundesliga,2019,M'Gladbach,László Bénes,SVK,MF,21,1997,10.0,15,8,3,5,7,6,19,31.6,13,6,2,4,8,23,3,1,2020
GER-Bundesliga,2019,M'Gladbach,Mamadou Doucouré,FRA,MF,21,1998,0.0,0,0,0,0,0,0,0,,0,0,0,0,0,0,0,0,2020
GER-Bundesliga,2019,M'Gladbach,Marcus Thuram,FRA,FW,21,1997,24.5,26,18,7,8,11,11,29,37.9,18,20,1,19,12,38,18,0,2020
GER-Bundesliga,2019,M'Gladbach,Matthias Ginter,GER,DF,25,1994,30.9,34,20,19,14,1,17,31,54.8,14,27,22,5,34,68,125,3,2020
GER-Bundesliga,2019,M'Gladbach,Nico Elvedi,SUI,DF,22,1996,29.1,45,27,37,8,0,19,38,50.0,19,32,15,17,62,107,112,0,2020
GER-Bundesliga,2019,M'Gladbach,Oscar Wendt,SWE,DF,33,1985,18.7,26,14,16,8,2,12,31,38.7,19,27,6,21,20,46,45,0,2020
GER-Bundesliga,2019,M'Gladbach,Patrick Herrmann,GER,"FW,MF",28,1991,16.1,24,11,8,10,6,5,16,31.3,11,21,4,17,11,35,8,0,2020
GER-Bundesliga,2019,M'Gladbach,Raffael,BRA,"MF,FW",34,1985,0.7,0,0,0,0,0,0,2,0.0,2,2,0,2,0,0,0,0,2020
GER-Bundesliga,2019,M'Gladbach,Ramy Bensebaini,ALG,DF,24,1995,16.1,33,17,17,12,4,18,31,58.1,13,24,4,20,38,71,49,0,2020
GER-Bundesliga,2019,M'Gladbach,Stefan Lainer,AUT,DF,26,1992,30.1,51,30,25,19,7,24,54,44.4,30,38,7,31,29,80,71,0,2020
GER-Bundesliga,2019,M'Gladbach,Tobias Strobl,GER,"MF,DF",29,1990,6.8,9,6,5,4,0,3,8,37.5,5,8,4,4,11,20,5,0,2020
GER-Bundesliga,2019,M'Gladbach,Tony Jantschke,GER,DF,29,1990,11.2,33,21,23,10,0,15,24,62.5,9,20,11,9,27,60,48,0,2020
GER-Bundesliga,2019,M'Gladbach,Torben Müsel,GER,FW,20,1999,0.0,0,0,0,0,0,0,0,,0,0,0,0,1,1,0,0,2020
GER-Bundesliga,2019,M'Gladbach,Yann Sommer,SUI,GK,30,1988,34.0,0,0,0,0,0,0,1,0.0,1,0,0,0,1,1,11,6,2020
GER-Bundesliga,2019,Mainz 05,Aarón Martín,ESP,DF,22,1997,19.9,29,15,17,8,4,9,22,40.9,13,11,5,6,30,59,36,0,2020
GER-Bundesliga,2019,Mainz 05,Alexander Hack,GER,DF,25,1993,8.9,26,10,19,6,1,16,27,59.3,11,20,9,11,23,49,60,1,2020
GER-Bundesliga,2019,Mainz 05,Alexandru Maxim,ROU,"MF,DF",29,1990,1.3,4,2,1,2,1,1,3,33.3,2,0,0,0,1,5,1,0,2020
GER-Bundesliga,2019,Mainz 05,Daniel Brosinski,GER,DF,31,1988,19.0,40,27,13,23,4,15,34,44.1,19,16,2,14,14,54,58,0,2020
GER-Bundesliga,2019,Mainz 05,Danny Latza,GER,MF,29,1989,15.3,33,19,15,17,1,16,49,32.7,33,22,5,17,17,50,24,0,2020
GER-Bundesliga,2019,Mainz 05,Edimilson Fernandes,SUI,"MF,DF",23,1996,16.5,33,20,12,15,6,15,33,45.5,18,17,9,8,32,65,47,1,2020
GER-Bundesliga,2019,Mainz 05,Florian Müller,GER,GK,21,1997,12.5,0,0,0,0,0,0,0,,0,0,0,0,2,2,3,1,2020
GER-Bundesliga,2019,Mainz 05,Jean-Paul Boëtius,NED,MF,25,1994,25.2,63,33,21,31,11,20,57,35.1,37,38,1,37,26,89,6,0,2020
GER-Bundesliga,2019,Mainz 05,Jean-Philippe Mateta,FRA,FW,22,1997,11.7,2,2,0,2,0,0,6,0.0,6,3,2,1,1,3,11,0,2020
GER-Bundesliga,2019,Mainz 05,Jeffrey Bruma,NED,DF,27,1991,7.5,12,8,8,4,0,4,6,66.7,2,11,5,6,6,18,34,1,2020
GER-Bundesliga,2019,Mainz 05,Jerry St. Juste,NED,DF,22,1996,23.5,46,25,34,10,2,14,34,41.2,20,35,19,16,52,98,86,1,2020
GER-Bundesliga,2019,Mainz 05,Ji Dong-won,KOR,"FW,MF",28,1991,1.1,0,0,0,0,0,0,1,0.0,1,1,0,1,0,0,0,0,2020
GER-Bundesliga,2019,Mainz 05,Jonathan Burkardt,GER,"FW,MF",19,2000,2.8,9,4,2,5,2,3,8,37.5,5,6,1,5,0,9,1,0,2020
GER-Bundesliga,2019,Mainz 05,Karim Onisiwo,AUT,FW,27,1992,19.2,27,19,6,10,11,5,13,38.5,8,20,3,17,7,34,11,0,2020
GER-Bundesliga,2019,Mainz 05,Leandro Barreiro Martins,LUX,MF,19,2000,10.4,38,21,16,19,3,14,29,48.3,15,18,3,15,9,47,18,1,2020
GER-Bundesliga,2019,Mainz 05,Levin Öztunalı,GER,"MF,FW",23,1996,19.8,28,19,13,12,3,12,35,34.3,23,27,1,26,9,37,14,2,2020
GER-Bundesliga,2019,Mainz 05,Moussa Niakhate,SEN,DF,23,1996,33.0,35,22,29,6,0,16,29,55.2,13,40,26,14,40,75,124,4,2020
GER-Bundesliga,2019,Mainz 05,Phillipp Mwene,AUT,DF,25,1994,3.5,11,5,9,2,0,7,12,58.3,5,10,1,9,3,14,11,0,2020
GER-Bundesliga,2019,Mainz 05,Pierre Kunde,CMR,MF,24,1995,20.7,34,17,15,18,1,12,30,40.0,18,16,4,12,26,60,55,0,2020
GER-Bundesliga,2019,Mainz 05,Ridle Baku,GER,"DF,MF",21,1998,26.1,54,31,25,22,7,26,53,49.1,27,45,7,38,42,96,57,0,2020
GER-Bundesliga,2019,Mainz 05,Robin Quaison,SWE,"FW,MF",25,1993,28.9,25,17,15,7,3,11,32,34.4,21,27,5,22,11,36,8,0,2020
GER-Bundesliga,2019,Mainz 05,Robin Zentner,GER,GK,24,1994,21.5,1,1,1,0,0,1,1,100.0,0,0,0,0,0,1,11,0,2020
GER-Bundesliga,2019,Mainz 05,Ronaël Pierre-Gabriel,FRA,DF,21,1998,6.4,16,10,9,6,1,7,13,53.8,6,7,0,7,8,24,31,1,2020
GER-Bundesliga,2019,Mainz 05,Taiwo Awoniyi,NGA,"FW,MF",21,1997,5.4,2,0,0,2,0,0,4,0.0,4,4,2,2,2,4,3,0,2020
GER-Bundesliga,2019,Mainz 05,Ádám Szalai,HUN,FW,31,1987,12.7,8,4,0,6,2,1,11,9.1,10,9,0,9,2,10,14,0,2020
GER-Bundesliga,2019,Paderborn 07,Abdelhamid Sabiri,MAR,MF,22,1996,11.6,20,16,6,11,3,9,27,33.3,18,9,2,7,8,28,18,1,2020
GER-Bundesliga,2019,Paderborn 07,Antony Evans,ENG,"MF,DF",20,1998,1.7,5,4,1,3,1,1,5,20.0,4,1,1,0,2,7,4,0,2020
GER-Bundesliga,2019,Paderborn 07,Babacar Guèye,SEN,FW,24,1994,1.2,2,0,0,0,2,0,1,0.0,1,1,1,0,0,2,3,0,2020
GER-Bundesliga,2019,Paderborn 07,Ben Zolinski,GER,"FW,MF",27,1992,13.4,17,9,7,9,1,7,27,25.9,20,12,0,12,8,25,4,0,2020
GER-Bundesliga,2019,Paderborn 07,Cauly Oliveira Souza,BRA,"MF,FW",23,1995,8.0,11,7,5,5,1,3,11,27.3,8,9,0,9,6,17,1,0,2020
GER-Bundesliga,2019,Paderborn 07,Christian Strohdiek,GER,DF,31,1988,15.1,26,22,21,5,0,20,42,47.6,22,16,10,6,25,51,92,0,2020
GER-Bundesliga,2019,Paderborn 07,Christopher Antwi-Adjei,GHA,"MF,FW",25,1994,27.4,25,16,13,9,3,9,33,27.3,24,29,2,27,15,40,14,0,2020
GER-Bundesliga,2019,Paderborn 07,Dennis Jastrzembski,POL,"MF,FW",19,2000,2.0,2,0,1,1,0,0,1,0.0,1,3,0,3,3,5,0,0,2020
GER-Bundesliga,2019,Paderborn 07,Dennis Srbeny,GER,"FW,MF",25,1994,12.4,11,6,4,4,3,5,18,27.8,13,11,1,10,3,14,9,0,2020
GER-Bundesliga,2019,Paderborn 07,Gerrit Holtmann,PHI,"MF,DF",24,1995,11.8,24,14,14,6,4,15,37,40.5,22,21,1,20,6,30,8,0,2020
GER-Bundesliga,2019,Paderborn 07,Jamilu Collins,NGA,DF,24,1994,29.6,69,43,44,21,4,37,62,59.7,25,53,19,34,70,139,91,1,2020
GER-Bundesliga,2019,Paderborn 07,Jan Luca Rumpf,GER,DF,20,1999,1.0,0,0,0,0,0,0,0,,0,0,0,0,0,0,2,0,2020
GER-Bundesliga,2019,Paderborn 07,Jannik Huth,GER,GK,25,1994,6.0,0,0,0,0,0,0,1,0.0,1,0,0,0,0,0,2,0,2020
GER-Bundesliga,2019,Paderborn 07,Kai Pröger,GER,"MF,FW",27,1992,23.1,43,22,21,17,5,17,58,29.3,41,34,6,28,14,57,20,1,2020
GER-Bundesliga,2019,Paderborn 07,Khiry Shelton,USA,FW,26,1993,0.4,1,1,1,0,0,0,0,,0,0,0,0,0,1,0,0,2020
GER-Bundesliga,2019,Paderborn 07,Klaus Gjasula,ALB,MF,29,1989,25.3,69,39,30,35,4,30,61,49.2,31,33,6,27,32,101,50,2,2020
GER-Bundesliga,2019,Paderborn 07,Laurent Jans,LUX,DF,26,1992,17.5,42,25,30,8,4,22,48,45.8,26,25,10,15,19,61,49,1,2020
GER-Bundesliga,2019,Paderborn 07,Leopold Zingerle,GER,GK,25,1994,28.0,3,1,3,0,0,2,4,50.0,2,0,0,0,0,3,7,2,2020
GER-Bundesliga,2019,Paderborn 07,Luca Kilian,GER,DF,19,1999,14.0,33,24,27,6,0,22,41,53.7,19,20,9,11,12,45,67,0,2020
GER-Bundesliga,2019,Paderborn 07,Marlon Ritter,GER,MF,24,1994,4.8,7,5,5,2,0,4,9,44.4,5,7,0,7,8,15,3,0,2020
GER-Bundesliga,2019,Paderborn 07,Mohamed Dräger,TUN,DF,23,1996,16.2,32,21,22,8,2,14,33,42.4,19,17,5,12,18,50,39,0,2020
GER-Bundesliga,2019,Paderborn 07,Samúel Friðjónsson,ISL,MF,23,1996,2.1,4,1,3,1,0,1,3,33.3,2,4,1,3,4,8,4,0,2020
GER-Bundesliga,2019,Paderborn 07,Sebastian Schonlau,GER,DF,24,1994,23.0,64,43,50,14,0,41,66,62.1,25,36,15,21,40,104,138,1,2020
GER-Bundesliga,2019,Paderborn 07,Sebastian Vasiliadis,GRE,MF,21,1997,31.2,73,45,34,31,8,28,81,34.6,53,47,6,41,34,107,50,0,2020
GER-Bundesliga,2019,Paderborn 07,Streli Mamba,GER,FW,25,1994,16.9,15,9,0,9,6,1,13,7.7,12,12,2,10,6,21,2,0,2020
GER-Bundesliga,2019,Paderborn 07,Sven Michel,GER,FW,29,1990,15.3,14,12,3,5,6,3,20,15.0,17,13,2,11,7,21,7,0,2020
GER-Bundesliga,2019,Paderborn 07,Uwe Hünemeier,GER,DF,33,1986,13.4,20,15,9,11,0,10,20,50.0,10,22,12,10,24,44,63,0,2020
GER-Bundesliga,2019,RB Leipzig,Ademola Lookman,NGA,"FW,MF",21,1997,3.4,6,4,3,1,2,1,1,100.0,0,3,0,3,1,7,0,1,2020
GER-Bundesliga,2019,RB Leipzig,Amadou Haidara,MLI,MF,21,1998,8.4,26,16,7,17,2,10,24,41.7,14,14,2,12,8,34,10,1,2020
GER-Bundesliga,2019,RB Leipzig,Angeliño,ESP,"DF,FW",22,1997,12.2,15,9,7,5,3,5,15,33.3,10,14,1,13,19,34,24,0,2020
GER-Bundesliga,2019,RB Leipzig,Christopher Nkunku,FRA,"MF,FW",21,1997,21.4,21,13,4,11,6,9,33,27.3,24,25,2,23,20,41,8,0,2020
GER-Bundesliga,2019,RB Leipzig,Dani Olmo,ESP,"MF,FW",21,1998,8.3,20,14,5,10,5,1,13,7.7,12,7,1,6,4,24,6,0,2020
GER-Bundesliga,2019,RB Leipzig,Dayot Upamecano,FRA,DF,20,1998,26.2,52,31,37,15,0,23,43,53.5,20,31,17,14,43,95,88,1,2020
GER-Bundesliga,2019,RB Leipzig,Dennis Borkowski,GER,FW,17,2002,0.1,0,0,0,0,0,0,0,,0,0,0,0,0,0,0,0,2020
GER-Bundesliga,2019,RB Leipzig,Diego Demme,GER,MF,27,1991,13.5,41,18,17,19,5,17,42,40.5,25,14,2,12,15,56,14,0,2020
GER-Bundesliga,2019,RB Leipzig,Emil Forsberg,SWE,MF,27,1991,12.7,16,10,5,8,3,6,26,23.1,20,15,0,15,5,21,3,0,2020
GER-Bundesliga,2019,RB Leipzig,Ethan Ampadu,WAL,DF,18,2000,0.9,5,4,3,2,0,1,1,100.0,0,3,1,2,1,6,3,0,2020
GER-Bundesliga,2019,RB Leipzig,Hannes Wolf,AUT,"FW,MF",20,1999,0.6,3,0,0,1,2,1,4,25.0,3,0,0,0,0,3,0,0,2020
GER-Bundesliga,2019,RB Leipzig,Ibrahima Konaté,FRA,DF,20,1999,6.3,11,6,10,1,0,2,7,28.6,5,9,4,5,5,16,35,1,2020
GER-Bundesliga,2019,RB Leipzig,Kevin Kampl,SVN,MF,28,1990,7.5,17,11,7,10,0,7,23,30.4,16,7,2,5,16,33,6,0,2020
GER-Bundesliga,2019,RB Leipzig,Konrad Laimer,AUT,MF,22,1997,23.5,91,45,30,46,15,43,102,42.2,59,51,8,43,34,125,14,0,2020
GER-Bundesliga,2019,RB Leipzig,Lukas Klostermann,GER,DF,23,1996,29.4,45,26,24,16,5,18,31,58.1,13,34,16,18,26,71,101,2,2020
GER-Bundesliga,2019,RB Leipzig,Marcel Halstenberg,GER,DF,27,1991,28.0,46,31,27,17,2,28,58,48.3,30,37,11,26,46,92,72,2,2020
GER-Bundesliga,2019,RB Leipzig,Marcel Sabitzer,AUT,"MF,FW",25,1994,27.8,39,25,15,18,6,19,56,33.9,37,27,4,23,23,62,25,0,2020
GER-Bundesliga,2019,RB Leipzig,Marcelo Saracchi,URU,DF,21,1998,2.0,8,6,2,5,1,5,6,83.3,1,3,1,2,1,9,5,0,2020
GER-Bundesliga,2019,RB Leipzig,Matheus Cunha,BRA,"FW,MF",20,1999,3.1,6,2,0,1,5,0,2,0.0,2,5,1,4,1,7,0,0,2020
GER-Bundesliga,2019,RB Leipzig,Nordi Mukiele,FRA,"DF,FW",21,1997,19.8,61,39,39,12,10,25,38,65.8,13,26,4,22,47,108,57,0,2020
GER-Bundesliga,2019,RB Leipzig,Patrik Schick,CZE,FW,23,1996,14.4,7,3,1,3,3,2,9,22.2,7,8,2,6,2,9,17,0,2020
GER-Bundesliga,2019,RB Leipzig,Péter Gulácsi,HUN,GK,29,1990,32.0,0,0,0,0,0,0,0,,0,0,0,0,1,1,18,6,2020
GER-Bundesliga,2019,RB Leipzig,Stefan Ilsanker,AUT,DF,30,1989,4.6,3,1,3,0,0,3,6,50.0,3,6,3,3,7,10,21,0,2020
GER-Bundesliga,2019,RB Leipzig,Timo Werner,GER,FW,23,1996,31.1,20,9,6,7,7,3,16,18.8,13,16,0,16,5,25,2,0,2020
GER-Bundesliga,2019,RB Leipzig,Tom Krauß,GER,MF,18,2001,0.0,1,1,0,1,0,1,2,50.0,1,0,0,0,0,1,0,0,2020
GER-Bundesliga,2019,RB Leipzig,Tyler Adams,USA,"MF,DF",20,1999,10.6,22,15,13,8,1,12,25,48.0,13,16,1,15,14,36,14,0,2020
GER-Bundesliga,2019,RB Leipzig,Willi Orban,HUN,DF,26,1992,9.5,20,12,13,7,0,12,20,60.0,8,14,3,11,16,36,52,1,2020
GER-Bundesliga,2019,RB Leipzig,Yussuf Poulsen,DEN,FW,25,1994,13.6,14,10,2,10,2,4,21,19.0,17,12,0,12,4,18,15,0,2020
GER-Bundesliga,2019,RB Leipzig,Yvon Mvogo,SUI,GK,25,1994,2.0,0,0,0,0,0,0,0,,0,0,0,0,0,0,0,1,2020
GER-Bundesliga,2019,Schalke 04,Ahmed Kutucu,TUR,"FW,MF",19,2000,7.5,11,7,3,6,2,4,15,26.7,11,5,0,5,2,13,5,0,2020
GER-Bundesliga,2019,Schalke 04,Alessandro Schöpf,AUT,MF,25,1994,15.9,29,16,11,10,8,12,33,36.4,21,17,1,16,26,55,8,0,2020
GER-Bundesliga,2019,Schalke 04,Alexander Nübel,GER,GK,22,1996,25.7,0,0,0,0,0,0,0,,0,0,0,0,2,2,9,6,2020
GER-Bundesliga,2019,Schalke 04,Amine Harit,MAR,"MF,FW",22,1997,23.4,16,7,8,5,3,6,25,24.0,19,13,0,13,7,23,2,1,2020
GER-Bundesliga,2019,Schalke 04,Bastian Oczipka,GER,DF,30,1989,33.5,72,50,42,21,9,36,62,58.1,26,35,6,29,37,109,68,0,2020
GER-Bundesliga,2019,Schalke 04,Benito Raman,BEL,FW,24,1994,17.8,18,9,4,9,5,7,24,29.2,17,11,1,10,7,25,1,0,2020
GER-Bundesliga,2019,Schalke 04,Benjamin Stambouli,FRA,DF,28,1990,9.0,31,19,14,15,2,11,21,52.4,10,16,6,10,12,43,28,1,2020
GER-Bundesliga,2019,Schalke 04,Can Bozdogan,GER,MF,18,2001,2.6,8,6,5,3,0,3,12,25.0,9,2,0,2,2,10,2,0,2020
GER-Bundesliga,2019,Schalke 04,Daniel Caligiuri,ITA,"MF,FW",31,1988,25.5,58,37,18,25,15,27,74,36.5,47,67,6,61,25,83,39,0,2020
GER-Bundesliga,2019,Schalke 04,Fabian Reese,GER,FW,21,1997,1.0,1,1,1,0,0,0,0,,0,1,1,0,0,1,1,0,2020
GER-Bundesliga,2019,Schalke 04,Guido Burgstaller,AUT,FW,30,1989,13.7,7,3,0,5,2,4,15,26.7,11,12,3,9,4,11,10,0,2020
GER-Bundesliga,2019,Schalke 04,Jean-Clair Todibo,FRA,DF,19,1999,4.1,15,10,10,5,0,8,9,88.9,1,2,0,2,15,30,24,0,2020
GER-Bundesliga,2019,Schalke 04,Jonas Hofmann,GER,MF,22,1997,0.0,0,0,0,0,0,0,0,,0,0,0,0,0,0,2,0,2020
GER-Bundesliga,2019,Schalke 04,Jonjoe Kenny,ENG,DF,22,1997,30.2,49,29,24,19,6,26,51,51.0,25,45,10,35,26,75,79,0,2020
GER-Bundesliga,2019,Schalke 04,Juan Miranda,ESP,DF,19,2000,8.7,14,10,8,6,0,6,18,33.3,12,12,4,8,10,24,27,1,2020
GER-Bundesliga,2019,Schalke 04,Levent Mercan,GER,"MF,FW",18,2000,0.8,0,0,0,0,0,0,0,,0,0,0,0,0,0,2,1,2020
GER-Bundesliga,2019,Schalke 04,Malick Thiaw,GER,DF,17,2001,0.8,2,0,1,1,0,1,2,50.0,1,2,2,0,2,4,4,1,2020
GER-Bundesliga,2019,Schalke 04,Mark Uth,GER,"FW,MF",27,1991,3.9,3,2,1,1,1,0,3,0.0,3,4,0,4,1,4,0,0,2020
GER-Bundesliga,2019,Schalke 04,Markus Schubert,GER,GK,21,1998,8.2,0,0,0,0,0,0,1,0.0,1,0,0,0,0,0,9,4,2020
GER-Bundesliga,2019,Schalke 04,Matija Nastasić,SRB,DF,26,1993,15.2,26,16,17,9,0,14,17,82.4,3,28,16,12,22,48,79,0,2020
GER-Bundesliga,2019,Schalke 04,Michael Gregoritsch,AUT,FW,25,1994,9.2,8,5,0,6,2,0,9,0.0,9,9,1,8,2,10,10,0,2020
GER-Bundesliga,2019,Schalke 04,Nassim Boujellab,MAR,"MF,FW",20,1999,4.7,12,10,5,4,3,5,14,35.7,9,8,1,7,7,19,5,0,2020
GER-Bundesliga,2019,Schalke 04,Omar Mascarell,ESP,MF,26,1993,22.5,42,23,17,22,3,21,57,36.8,36,46,14,32,62,104,40,0,2020
GER-Bundesliga,2019,Schalke 04,Ozan Kabak,TUR,DF,19,2000,19.7,37,23,28,9,0,14,21,66.7,7,33,19,14,37,74,97,0,2020
GER-Bundesliga,2019,Schalke 04,Rabbi Matondo,WAL,"FW,MF",18,2000,12.9,10,3,3,2,5,3,13,23.1,10,4,0,4,5,15,1,0,2020
GER-Bundesliga,2019,Schalke 04,Salif Sané,SEN,DF,28,1990,12.5,16,9,12,4,0,11,19,57.9,8,19,7,12,21,37,50,0,2020
GER-Bundesliga,2019,Schalke 04,Suat Serdar,GER,MF,22,1997,17.8,56,37,16,33,7,18,61,29.5,43,39,7,32,24,80,7,0,2020
GER-Bundesliga,2019,Schalke 04,Timo Becker,GER,"DF,MF",22,1997,3.7,10,9,3,6,1,5,9,55.6,4,6,1,5,3,13,8,0,2020
GER-Bundesliga,2019,Schalke 04,Weston McKennie,USA,"MF,DF",20,1998,23.0,38,20,17,16,5,13,40,32.5,27,38,12,26,46,84,39,0,2020
GER-Bundesliga,2019,Union Berlin,Akaki Gogia,GER,"MF,FW",27,1992,1.3,2,1,0,0,2,0,2,0.0,2,2,2,0,0,2,0,0,2020
GER-Bundesliga,2019,Union Berlin,Anthony Ujah,NGA,"FW,MF",28,1990,10.5,8,6,4,2,2,1,6,16.7,5,0,0,0,3,11,10,0,2020
GER-Bundesliga,2019,Union Berlin,Christian Gentner,GER,MF,33,1985,27.1,53,28,16,32,5,22,73,30.1,51,46,8,38,54,107,50,0,2020
GER-Bundesliga,2019,Union Berlin,Christopher Lenz,GER,"DF,MF",24,1994,25.2,63,37,37,20,6,26,49,53.1,23,46,11,35,43,106,65,0,2020
GER-Bundesliga,2019,Union Berlin,Christopher Trimmel,AUT,"DF,MF",32,1987,31.8,71,41,35,32,4,32,54,59.3,22,31,10,21,51,122,88,1,2020
GER-Bundesliga,2019,Union Berlin,Felix Kroos,GER,"MF,DF",28,1991,4.2,17,9,9,6,2,8,15,53.3,7,6,3,3,3,20,13,1,2020
GER-Bundesliga,2019,Union Berlin,Florian Hübner,GER,DF,28,1991,9.4,16,14,12,4,0,7,17,41.2,10,11,7,4,16,32,39,0,2020
GER-Bundesliga,2019,Union Berlin,Grischa Prömel,GER,MF,24,1995,10.3,14,11,6,6,2,7,19,36.8,12,10,2,8,14,28,9,0,2020
GER-Bundesliga,2019,Union Berlin,Joshua Mees,GER,"MF,FW",23,1996,3.6,8,5,3,4,1,4,12,33.3,8,3,0,3,2,10,4,0,2020
GER-Bundesliga,2019,Union Berlin,Julian Ryerson,NOR,"DF,MF",21,1997,4.1,7,5,2,1,4,3,6,50.0,3,5,3,2,5,12,9,0,2020
GER-Bundesliga,2019,Union Berlin,Ken Reichel,GER,DF,32,1986,5.9,6,3,2,3,1,3,13,23.1,10,8,1,7,9,15,12,0,2020
GER-Bundesliga,2019,Union Berlin,Keven Schlotterbeck,GER,DF,22,1997,21.5,52,27,36,15,1,17,29,58.6,12,40,21,19,40,92,113,1,2020
GER-Bundesliga,2019,Union Berlin,Manuel Schmiedebach,GER,MF,30,1988,2.0,4,1,0,3,1,1,7,14.3,6,1,1,0,3,7,3,0,2020
GER-Bundesliga,2019,Union Berlin,Marcus Ingvartsen,DEN,"MF,FW",23,1996,19.1,20,14,5,7,8,9,28,32.1,19,16,1,15,16,36,16,0,2020
GER-Bundesliga,2019,Union Berlin,Marius Bülter,GER,"MF,FW",26,1993,25.8,38,22,19,13,6,17,54,31.5,37,37,3,34,11,49,20,1,2020
GER-Bundesliga,2019,Union Berlin,Marvin Friedrich,GER,DF,23,1995,31.0,45,31,30,14,1,12,37,32.4,25,46,24,22,42,87,110,0,2020
GER-Bundesliga,2019,Union Berlin,Michael Parensen,GER,DF,33,1986,7.0,11,6,5,6,0,5,10,50.0,5,14,8,6,12,23,17,0,2020
GER-Bundesliga,2019,Union Berlin,Moritz Nicolas,GER,GK,21,1997,1.0,0,0,0,0,0,0,0,,0,0,0,0,0,0,0,0,2020
GER-Bundesliga,2019,Union Berlin,Neven Subotić,SRB,DF,30,1988,21.8,30,18,12,16,2,8,32,25.0,24,21,8,13,34,64,89,0,2020
GER-Bundesliga,2019,Union Berlin,Rafał Gikiewicz,POL,GK,31,1987,33.0,1,0,1,0,0,1,4,25.0,3,0,0,0,2,3,26,4,2020
GER-Bundesliga,2019,Union Berlin,Robert Andrich,GER,MF,24,1994,28.6,52,27,28,18,6,19,60,31.7,41,27,7,20,47,99,36,0,2020
GER-Bundesliga,2019,Union Berlin,Sebastian Andersson,SWE,FW,28,1991,29.8,20,10,0,12,8,4,19,21.1,15,19,3,16,5,25,36,0,2020
GER-Bundesliga,2019,Union Berlin,Sebastian Polter,GER,FW,28,1991,3.7,2,2,0,1,1,1,3,33.3,2,2,0,2,1,3,1,0,2020
GER-Bundesliga,2019,Union Berlin,Sheraldo Becker,SUR,"MF,FW",24,1995,6.0,2,1,2,0,0,1,3,33.3,2,1,0,1,0,2,1,0,2020
GER-Bundesliga,2019,Union Berlin,Suleiman Abdullahi,NGA,"FW,MF",22,1996,1.7,0,0,0,0,0,0,3,0.0,3,2,1,1,1,1,1,0,2020
GER-Bundesliga,2019,Union Berlin,Yunus Mallı,TUR,"MF,FW",27,1992,7.5,8,3,1,5,2,5,10,50.0,5,2,0,2,7,15,7,0,2020
GER-Bundesliga,2019,Werder Bremen,Benjamin Goller,GER,"FW,MF",20,1999,3.2,8,3,3,4,1,3,10,30.0,7,3,0,3,1,9,1,0,2020
GER-Bundesliga,2019,Werder Bremen,Christian Groß,GER,"DF,MF",30,1989,9.7,23,17,16,5,2,9,16,56.3,7,13,7,6,14,37,50,1,2020
GER-Bundesliga,2019,Werder Bremen,Claudio Pizarro,PER,"FW,MF",40,1978,2.6,2,1,0,1,1,0,1,0.0,1,2,0,2,2,4,2,0,2020
GER-Bundesliga,2019,Werder Bremen,Davie Selke,GER,FW,24,1995,5.1,2,0,1,1,0,0,2,0.0,2,1,0,1,0,2,2,0,2020
GER-Bundesliga,2019,Werder Bremen,Davy Klaassen,NED,MF,26,1993,32.6,55,43,19,23,13,19,57,33.3,38,46,18,28,38,93,45,2,2020
GER-Bundesliga,2019,Werder Bremen,Fin Bartels,GER,"MF,FW",32,1987,3.8,9,5,4,4,1,3,12,25.0,9,3,1,2,1,10,1,0,2020
GER-Bundesliga,2019,Werder Bremen,Jiří Pavlenka,CZE,GK,27,1992,33.0,1,0,1,0,0,1,2,50.0,1,1,0,1,5,6,11,3,2020
GER-Bundesliga,2019,Werder Bremen,Johannes Eggestein,GER,"MF,FW",21,1998,5.7,8,6,2,2,4,3,12,25.0,9,6,0,6,2,10,4,0,2020
GER-Bundesliga,2019,Werder Bremen,Josh Sargent,USA,FW,19,2000,15.7,11,6,5,4,2,2,12,16.7,10,17,1,16,14,25,21,0,2020
GER-Bundesliga,2019,Werder Bremen,Kevin Möhwald,GER,MF,26,1993,0.8,2,1,1,1,0,1,2,50.0,1,0,0,0,0,2,1,0,2020
GER-Bundesliga,2019,Werder Bremen,Kevin Vogt,GER,"DF,MF",27,1991,12.3,14,10,8,6,0,8,16,50.0,8,15,12,3,25,39,37,1,2020
GER-Bundesliga,2019,Werder Bremen,Leonardo Bittencourt,GER,"FW,MF",25,1993,21.0,52,28,23,18,11,9,51,17.6,42,20,3,17,12,64,14,0,2020
GER-Bundesliga,2019,Werder Bremen,Luc Ihorst,GER,FW,19,2000,0.1,1,1,0,0,1,0,0,,0,1,0,1,0,1,0,0,2020
GER-Bundesliga,2019,Werder Bremen,Ludwig Augustinsson,SWE,"DF,MF",25,1994,10.3,29,12,15,9,5,12,23,52.2,11,19,5,14,10,39,29,0,2020
GER-Bundesliga,2019,Werder Bremen,Marco Friedl,AUT,"DF,MF",21,1998,24.3,61,39,42,15,4,29,54,53.7,25,29,9,20,34,95,78,0,2020
GER-Bundesliga,2019,Werder Bremen,Martin Harnik,AUT,"MF,FW",32,1987,0.1,0,0,0,0,0,0,0,,0,0,0,0,0,0,0,0,2020
GER-Bundesliga,2019,Werder Bremen,Maximilian Eggestein,GER,MF,22,1996,31.7,40,28,20,18,2,15,43,34.9,28,37,8,29,36,76,57,0,2020
GER-Bundesliga,2019,Werder Bremen,Michael Lang,SUI,"DF,FW",28,1991,6.0,8,5,3,5,0,6,12,50.0,6,5,1,4,7,15,22,0,2020
GER-Bundesliga,2019,Werder Bremen,Milot Rashica,KVX,FW,23,1996,25.2,21,14,13,6,2,9,33,27.3,24,15,2,13,6,27,16,1,2020
GER-Bundesliga,2019,Werder Bremen,Miloš Veljković,SRB,DF,23,1995,22.8,55,33,36,18,1,33,53,62.3,20,25,11,14,26,81,92,1,2020
GER-Bundesliga,2019,Werder Bremen,Nick Woltemade,GER,"FW,MF",17,2002,1.0,2,1,0,2,0,0,1,0.0,1,1,0,1,0,2,2,0,2020
GER-Bundesliga,2019,Werder Bremen,Niclas Füllkrug,GER,FW,26,1993,4.5,2,2,1,1,0,1,3,33.3,2,3,0,3,3,5,6,0,2020
GER-Bundesliga,2019,Werder Bremen,Niklas Moisander,FIN,DF,33,1985,22.0,27,15,19,6,2,11,26,42.3,15,37,19,18,49,76,85,0,2020
GER-Bundesliga,2019,Werder Bremen,Nuri Şahin,TUR,MF,30,1988,13.9,27,16,10,14,3,11,35,31.4,24,15,7,8,37,64,38,0,2020
GER-Bundesliga,2019,Werder Bremen,Philipp Bargfrede,GER,MF,30,1989,6.5,15,12,8,5,2,6,23,26.1,17,8,2,6,16,31,15,0,2020
GER-Bundesliga,2019,Werder Bremen,Sebastian Langkamp,GER,DF,31,1988,3.5,3,2,3,0,0,2,4,50.0,2,5,3,2,3,6,11,1,2020
GER-Bundesliga,2019,Werder Bremen,Stefanos Kapino,GRE,GK,25,1994,1.0,0,0,0,0,0,0,0,,0,0,0,0,1,1,0,0,2020
GER-Bundesliga,2019,Werder Bremen,Theodor Gebre Selassie,CZE,"DF,MF",32,1986,27.0,36,27,23,10,3,17,35,48.6,18,26,9,17,63,99,81,0,2020
GER-Bundesliga,2019,Werder Bremen,Yuya Osako,JPN,"FW,MF",29,1990,20.5,29,16,5,19,5,3,29,10.3,26,10,1,9,6,35,13,1,2020
GER-Bundesliga,2019,Werder Bremen,Ömer Toprak,TUR,DF,30,1989,7.9,7,2,4,2,1,3,6,50.0,3,6,4,2,12,19,41,0,2020
GER-Bundesliga,2019,Wolfsburg,Admir Mehmedi,SUI,"MF,FW",28,1991,13.3,14,6,2,9,3,4,15,26.7,11,10,0,10,5,19,4,0,2020
GER-Bundesliga,2019,Wolfsburg,Daniel Ginczek,GER,FW,28,1991,8.5,4,3,3,1,0,1,11,9.1,10,3,1,2,1,5,3,0,2020
GER-Bundesliga,2019,Wolfsburg,Felix Klaus,GER,"MF,FW",26,1992,7.4,24,16,4,13,7,7,19,36.8,12,10,2,8,3,27,5,0,2020
GER-Bundesliga,2019,Wolfsburg,Jeffrey Bruma,NED,DF,27,1991,9.0,9,5,4,5,0,7,13,53.8,6,6,3,3,13,22,51,1,2020
GER-Bundesliga,2019,Wolfsburg,John Brooks,USA,DF,26,1993,24.7,38,27,27,9,2,24,49,49.0,25,31,12,19,41,79,93,0,2020
GER-Bundesliga,2019,Wolfsburg,Josip Brekalo,CRO,"MF,FW",21,1998,18.6,18,8,5,6,7,5,23,21.7,18,26,0,26,16,34,4,0,2020
GER-Bundesliga,2019,Wolfsburg,Josuha Guilavogui,FRA,"MF,DF",28,1990,22.9,41,26,17,23,1,10,30,33.3,20,35,9,26,45,86,64,2,2020
GER-Bundesliga,2019,Wolfsburg,João Victor Santos Sá,BRA,"MF,FW",25,1994,18.1,35,22,12,17,6,10,38,26.3,28,31,1,30,9,44,9,0,2020
GER-Bundesliga,2019,Wolfsburg,Jérôme Roussillon,FRA,DF,26,1993,26.3,48,29,26,18,4,15,29,51.7,14,33,5,28,30,78,58,0,2020
GER-Bundesliga,2019,Wolfsburg,Kevin Mbabu,SUI,DF,24,1995,18.8,69,48,39,24,6,35,54,64.8,19,33,10,23,23,92,53,0,2020
GER-Bundesliga,2019,Wolfsburg,Koen Casteels,BEL,GK,27,1992,26.0,0,0,0,0,0,0,0,,0,0,0,0,0,0,9,1,2020
GER-Bundesliga,2019,Wolfsburg,Luca Horn,GER,DF,20,1998,0.1,0,0,0,0,0,0,0,,0,0,0,0,0,0,0,0,2020
GER-Bundesliga,2019,Wolfsburg,Lukas Nmecha,GER,"MF,FW",20,1998,1.5,0,0,0,0,0,0,0,,0,0,0,0,0,0,0,0,2020
GER-Bundesliga,2019,Wolfsburg,Mamoudou Karamoko,FRA,MF,19,1999,0.1,0,0,0,0,0,0,0,,0,0,0,0,0,0,0,0,2020
GER-Bundesliga,2019,Wolfsburg,Marcel Tisserand,COD,DF,26,1993,13.4,21,10,14,5,2,7,12,58.3,5,13,4,9,32,53,49,2,2020
GER-Bundesliga,2019,Wolfsburg,Marin Pongračić,CRO,DF,21,1997,10.3,14,9,11,2,1,9,10,90.0,1,11,7,4,19,33,21,1,2020
GER-Bundesliga,2019,Wolfsburg,Maximilian Arnold,GER,MF,25,1994,31.3,42,24,15,23,4,16,62,25.8,46,25,6,19,25,67,35,0,2020
GER-Bundesliga,2019,Wolfsburg,Omar Marmoush,EGY,"MF,FW",20,1999,0.9,1,1,1,0,0,0,0,,0,1,0,1,1,2,0,0,2020
GER-Bundesliga,2019,Wolfsburg,Paulo Otávio,BRA,DF,24,1994,4.2,21,16,11,9,1,10,13,76.9,3,12,2,10,9,30,11,0,2020
GER-Bundesliga,2019,Wolfsburg,Pavao Pervan,AUT,GK,31,1987,8.0,0,0,0,0,0,0,1,0.0,1,0,0,0,0,0,4,0,2020
GER-Bundesliga,2019,Wolfsburg,Renato Steffen,SUI,"MF,FW",27,1991,17.6,25,18,4,14,7,14,39,35.9,25,25,2,23,23,48,10,0,2020
GER-Bundesliga,2019,Wolfsburg,Robin Knoche,GER,DF,27,1992,17.7,29,14,24,5,0,17,30,56.7,13,19,11,8,27,56,77,1,2020
GER-Bundesliga,2019,Wolfsburg,William,BRA,DF,24,1995,15.2,55,26,34,14,7,27,59,45.8,32,10,3,7,24,79,38,1,2020
GER-Bundesliga,2019,Wolfsburg,Wout Weghorst,NED,FW,26,1992,30.4,15,8,4,5,6,1,17,5.9,16,17,4,13,2,17,30,0,2020
GER-Bundesliga,2019,Wolfsburg,Xaver Schlager,AUT,MF,21,1997,19.1,47,29,13,30,4,14,44,31.8,30,16,2,14,17,64,12,0,2020
GER-Bundesliga,2019,Wolfsburg,Yannick Gerhardt,GER,MF,25,1994,9.2,28,18,7,15,6,8,21,38.1,13,11,3,8,12,40,9,0,2020
GER-Bundesliga,2020,Arminia,Amos Pieper,GER,DF,22,1998,29.8,58,32,39,17,2,20,33,60.6,13,48,35,13,66,124,160,3,2021
GER-Bundesliga,2020,Arminia,Anderson Lucoqui,ANG,DF,23,1997,17.8,40,25,23,17,0,20,40,50.0,20,30,7,23,27,67,53,0,2021
GER-Bundesliga,2020,Arminia,Andreas Voglsammer,GER,"FW,MF",28,1992,11.1,12,8,6,6,0,8,17,47.1,9,11,0,11,3,15,11,0,2021
GER-Bundesliga,2020,Arminia,Arne Maier,GER,MF,21,1999,11.5,13,9,5,7,1,4,11,36.4,7,10,3,7,8,21,11,1,2021
GER-Bundesliga,2020,Arminia,Brian Behrendt,GER,DF,28,1991,0.9,0,0,0,0,0,0,1,0.0,1,0,0,0,0,0,1,0,2021
GER-Bundesliga,2020,Arminia,Cebio Soukou,BEN,"FW,MF",27,1992,5.1,12,8,5,5,2,6,11,54.5,5,3,0,3,3,15,4,0,2021
GER-Bundesliga,2020,Arminia,Christian Gebauer,AUT,"MF,FW",26,1993,7.6,9,4,2,5,2,4,11,36.4,7,4,1,3,6,15,14,0,2021
GER-Bundesliga,2020,Arminia,Cédric Brunner,SUI,DF,26,1994,29.5,42,22,24,15,3,27,40,67.5,13,30,10,20,42,84,96,0,2021
GER-Bundesliga,2020,Arminia,Fabian Klos,GER,FW,32,1987,30.1,24,13,9,11,4,7,26,26.9,19,20,6,14,4,28,29,0,2021
GER-Bundesliga,2020,Arminia,Fabian Kunze,GER,MF,22,1998,14.1,38,26,19,15,4,19,42,45.2,23,19,3,16,18,56,22,1,2021
GER-Bundesliga,2020,Arminia,Jacob Barrett Laursen,DEN,DF,25,1994,12.3,23,12,13,8,2,10,16,62.5,6,14,4,10,24,47,37,0,2021
GER-Bundesliga,2020,Arminia,Joakim Nilsson,SWE,DF,26,1994,24.0,36,24,23,12,1,14,23,60.9,9,29,22,7,39,75,111,0,2021
GER-Bundesliga,2020,Arminia,Jóan Símun Edmundsson,FRO,"FW,MF",29,1991,0.6,0,0,0,0,0,0,0,,0,1,0,1,1,1,0,0,2021
GER-Bundesliga,2020,Arminia,Manuel Prietl,AUT,MF,28,1991,28.0,65,44,33,28,4,12,73,16.4,61,34,7,27,45,110,24,0,2021
GER-Bundesliga,2020,Arminia,Marcel Hartel,GER,MF,24,1996,18.7,35,19,15,18,2,20,40,50.0,20,17,4,13,26,61,16,1,2021
GER-Bundesliga,2020,Arminia,Masaya Okugawa,JPN,MF,24,1996,10.2,17,8,5,11,1,6,14,42.9,8,17,2,15,8,25,5,0,2021
GER-Bundesliga,2020,Arminia,Michel Vlap,NED,"MF,FW",23,1997,4.1,1,1,0,1,0,0,8,0.0,8,4,0,4,5,6,3,0,2021
GER-Bundesliga,2020,Arminia,Mike van der Hoorn,NED,DF,27,1992,15.1,8,4,3,5,0,1,3,33.3,2,12,8,4,27,35,73,0,2021
GER-Bundesliga,2020,Arminia,Nathan de Medina,BEL,DF,22,1997,7.1,16,10,9,6,1,3,10,30.0,7,12,2,10,11,27,22,0,2021
GER-Bundesliga,2020,Arminia,Nils Seufert,GER,"MF,FW",23,1997,3.8,12,9,2,5,5,2,8,25.0,6,3,1,2,5,17,6,0,2021
GER-Bundesliga,2020,Arminia,Reinhold Yabo,GER,"MF,FW",28,1992,7.2,5,2,2,2,1,2,9,22.2,7,6,1,5,4,9,1,0,2021
GER-Bundesliga,2020,Arminia,Ritsu Doan,JPN,"MF,FW",22,1998,30.8,53,31,22,19,12,19,52,36.5,33,42,1,41,31,84,11,0,2021
GER-Bundesliga,2020,Arminia,Sebastian Müller,GER,"MF,DF",19,2001,0.0,0,0,0,0,0,0,0,,0,0,0,0,0,0,0,0,2021
GER-Bundesliga,2020,Arminia,Sergio Córdova,VEN,"FW,MF",22,1997,12.1,16,8,0,10,6,2,15,13.3,13,14,3,11,9,25,9,0,2021
GER-Bundesliga,2020,Arminia,Stefan Ortega,GER,GK,27,1992,34.0,2,1,2,0,0,2,6,33.3,4,0,0,0,0,2,12,3,2021
GER-Bundesliga,2020,Arminia,Sven Schipplock,GER,"FW,MF",31,1988,8.3,15,8,7,6,2,6,27,22.2,21,13,2,11,6,21,8,0,2021
GER-Bundesliga,2020,Augsburg,Alfreð Finnbogason,ISL,FW,31,1989,6.0,2,1,0,1,1,0,1,0.0,1,7,1,6,1,3,4,0,2021
GER-Bundesliga,2020,Augsburg,André Hahn,GER,"FW,MF",29,1990,22.6,31,17,14,13,4,9,44,20.5,35,35,3,32,14,45,24,0,2021
GER-Bundesliga,2020,Augsburg,Carlos Gruezo,ECU,MF,25,1995,23.2,57,32,20,32,5,20,52,38.5,32,32,5,27,35,92,29,1,2021
GER-Bundesliga,2020,Augsburg,Daniel Caligiuri,ITA,"MF,FW",32,1988,29.6,71,46,29,31,11,29,92,31.5,63,45,6,39,38,109,41,0,2021
GER-Bundesliga,2020,Augsburg,Florian Niederlechner,GER,FW,29,1990,19.3,7,5,1,4,2,0,10,0.0,10,8,3,5,10,17,18,0,2021
GER-Bundesliga,2020,Augsburg,Fredrik Jensen,FIN,"FW,MF",22,1997,4.2,3,2,1,2,0,3,6,50.0,3,4,1,3,2,5,6,0,2021
GER-Bundesliga,2020,Augsburg,Iago,BRA,DF,23,1997,17.3,37,27,21,13,3,17,29,58.6,12,17,5,12,22,59,55,0,2021
GER-Bundesliga,2020,Augsburg,Jan Morávek,CZE,MF,30,1989,3.0,5,3,4,1,0,1,8,12.5,7,3,0,3,7,12,2,0,2021
GER-Bundesliga,2020,Augsburg,Jeffrey Gouweleeuw,NED,DF,29,1991,31.5,36,20,24,11,1,16,33,48.5,17,37,18,19,69,105,149,2,2021
GER-Bundesliga,2020,Augsburg,Lukas Petkov,GER,MF,19,2000,0.0,0,0,0,0,0,0,0,,0,0,0,0,0,0,0,0,2021
GER-Bundesliga,2020,Augsburg,László Bénes,SVK,MF,22,1997,7.3,8,6,4,4,0,2,8,25.0,6,6,2,4,7,15,1,1,2021
GER-Bundesliga,2020,Augsburg,Mads Pedersen,DEN,DF,23,1996,9.9,25,16,20,3,2,10,22,45.5,12,13,3,10,15,40,32,0,2021
GER-Bundesliga,2020,Augsburg,Marco Richter,GER,"FW,MF",22,1997,15.7,17,9,3,12,2,7,23,30.4,16,10,0,10,6,23,9,0,2021
GER-Bundesliga,2020,Augsburg,Marek Suchý,CZE,DF,32,1988,3.4,4,2,1,3,0,1,2,50.0,1,3,3,0,4,8,9,0,2021
GER-Bundesliga,2020,Augsburg,Michael Gregoritsch,AUT,"FW,MF",26,1994,9.3,13,10,6,7,0,3,10,30.0,7,2,0,2,3,16,17,0,2021
GER-Bundesliga,2020,Augsburg,Noah Joel Sarenren Bazee,NGA,"FW,MF",23,1996,0.4,0,0,0,0,0,0,1,0.0,1,0,0,0,1,1,0,0,2021
GER-Bundesliga,2020,Augsburg,Ohis Felix Uduokhai,GER,DF,22,1997,29.0,33,24,19,10,4,18,27,66.7,9,48,25,23,54,87,164,2,2021
GER-Bundesliga,2020,Augsburg,Rafał Gikiewicz,POL,GK,32,1987,34.0,0,0,0,0,0,0,3,0.0,3,0,0,0,3,3,9,1,2021
GER-Bundesliga,2020,Augsburg,Rani Khedira,GER,MF,26,1994,20.2,29,10,13,15,1,10,20,50.0,10,14,5,9,31,60,47,0,2021
GER-Bundesliga,2020,Augsburg,Raphael Framberger,GER,DF,24,1995,17.1,42,23,26,11,5,19,25,76.0,6,24,2,22,36,78,62,1,2021
GER-Bundesliga,2020,Augsburg,Reece Oxford,ENG,DF,21,1998,15.1,26,18,15,11,0,10,17,58.8,7,28,22,6,29,55,89,0,2021
GER-Bundesliga,2020,Augsburg,Robert Gumny,POL,DF,22,1998,15.3,24,15,12,9,3,15,23,65.2,8,12,2,10,18,42,31,0,2021
GER-Bundesliga,2020,Augsburg,Ruben Vargas,SUI,"MF,FW",21,1998,17.9,18,12,6,9,3,1,16,6.3,15,26,2,24,18,36,27,0,2021
GER-Bundesliga,2020,Augsburg,Tim Civeja,GER,MF,18,2002,0.4,0,0,0,0,0,0,1,0.0,1,0,0,0,3,3,0,0,2021
GER-Bundesliga,2020,Augsburg,Tobias Strobl,GER,MF,30,1990,20.5,21,10,12,9,0,10,30,33.3,20,21,8,13,28,49,27,0,2021
GER-Bundesliga,2020,Bayern Munich,Alexander Nübel,GER,GK,23,1996,1.0,0,0,0,0,0,0,0,,0,0,0,0,0,0,1,0,2021
GER-Bundesliga,2020,Bayern Munich,Alphonso Davies,CAN,DF,19,2000,19.6,39,27,16,17,6,28,40,70.0,12,21,1,20,28,67,33,1,2021
GER-Bundesliga,2020,Bayern Munich,Benjamin Pavard,FRA,DF,24,1996,21.6,44,27,20,16,8,23,40,57.5,17,29,5,24,48,92,31,1,2021
GER-Bundesliga,2020,Bayern Munich,Bouna Sarr,SEN,DF,28,1992,5.0,9,8,4,3,2,3,6,50.0,3,7,0,7,10,19,7,1,2021
GER-Bundesliga,2020,Bayern Munich,Chris Richards,USA,DF,20,2000,1.0,0,0,0,0,0,0,0,,0,0,0,0,1,1,1,0,2021
GER-Bundesliga,2020,Bayern Munich,Christopher Scott,GER,"MF,FW",18,2002,0.4,2,1,0,1,1,2,2,100.0,0,0,0,0,0,2,1,0,2021
GER-Bundesliga,2020,Bayern Munich,Corentin Tolisso,FRA,MF,25,1994,8.7,19,19,4,11,4,9,29,31.0,20,15,2,13,6,25,8,0,2021
GER-Bundesliga,2020,Bayern Munich,David Alaba,AUT,"DF,MF",28,1992,29.7,37,21,14,19,4,17,32,53.1,15,29,13,16,43,80,60,0,2021
GER-Bundesliga,2020,Bayern Munich,Douglas Costa,BRA,"FW,MF",29,1990,3.6,2,1,1,1,0,1,3,33.3,2,7,0,7,2,4,1,0,2021
GER-Bundesliga,2020,Bayern Munich,Eric Maxim Choupo-Moting,CMR,"FW,MF",31,1989,9.1,8,2,0,5,3,1,4,25.0,3,6,0,6,2,10,7,0,2021
GER-Bundesliga,2020,Bayern Munich,Jamal Musiala,GER,"FW,MF",17,2003,9.8,20,12,5,7,8,7,22,31.8,15,17,2,15,14,34,3,0,2021
GER-Bundesliga,2020,Bayern Munich,Javi Martínez,ESP,"DF,MF",31,1988,5.2,10,5,4,4,2,7,9,77.8,2,8,4,4,13,23,19,0,2021
GER-Bundesliga,2020,Bayern Munich,Joshua Kimmich,GER,MF,25,1995,24.4,40,28,16,19,5,10,53,18.9,43,25,5,20,36,76,19,0,2021
GER-Bundesliga,2020,Bayern Munich,Joshua Zirkzee,NED,FW,19,2001,1.0,1,0,0,1,0,1,2,50.0,1,0,0,0,0,1,0,0,2021
GER-Bundesliga,2020,Bayern Munich,Josip Stanišić,CRO,DF,20,2000,1.0,2,2,1,1,0,1,1,100.0,0,3,0,3,2,4,2,0,2021
GER-Bundesliga,2020,Bayern Munich,Jérôme Boateng,GER,DF,31,1988,26.3,26,16,17,8,1,14,32,43.8,18,24,17,7,40,66,63,1,2021
GER-Bundesliga,2020,Bayern Munich,Kingsley Coman,FRA,"FW,MF",24,1996,19.5,14,8,6,7,1,2,21,9.5,19,22,0,22,4,18,3,0,2021
GER-Bundesliga,2020,Bayern Munich,Leon Goretzka,GER,MF,25,1995,18.9,37,23,12,21,4,16,39,41.0,23,30,2,28,44,81,11,0,2021
GER-Bundesliga,2020,Bayern Munich,Leroy Sané,GER,"FW,MF",24,1996,20.1,18,10,2,10,6,13,30,43.3,17,23,1,22,9,27,8,1,2021
GER-Bundesliga,2020,Bayern Munich,Lucas Hernández,FRA,DF,24,1996,17.7,41,31,16,17,8,17,31,54.8,14,24,6,18,19,60,38,0,2021
GER-Bundesliga,2020,Bayern Munich,Manuel Neuer,GER,GK,34,1986,33.0,0,0,0,0,0,0,1,0.0,1,0,0,0,2,2,12,3,2021
GER-Bundesliga,2020,Bayern Munich,Marc Roca,ESP,MF,23,1996,2.0,2,2,0,0,2,0,4,0.0,4,4,1,3,2,4,1,0,2021
GER-Bundesliga,2020,Bayern Munich,Mickaël Cuisance,FRA,FW,20,1999,0.2,0,0,0,0,0,0,0,,0,1,0,1,0,0,0,0,2021
GER-Bundesliga,2020,Bayern Munich,Niklas Süle,GER,DF,24,1995,16.7,32,21,15,14,3,13,21,61.9,8,24,12,12,21,53,36,1,2021
GER-Bundesliga,2020,Bayern Munich,Robert Lewandowski,POL,FW,31,1988,27.3,15,9,0,7,8,2,13,15.4,11,9,1,8,3,18,11,0,2021
GER-Bundesliga,2020,Bayern Munich,Serge Gnabry,GER,"FW,MF",25,1995,18.3,39,19,7,19,13,12,32,37.5,20,17,0,17,26,65,3,0,2021
GER-Bundesliga,2020,Bayern Munich,Tanguy Nianzou,FRA,"DF,FW",18,2002,1.3,3,1,3,0,0,1,1,100.0,0,0,0,0,3,6,1,0,2021
GER-Bundesliga,2020,Bayern Munich,Thomas Müller,GER,MF,30,1989,29.7,49,22,11,23,15,24,73,32.9,49,43,3,40,21,70,18,1,2021
GER-Bundesliga,2020,Bayern Munich,Tiago Dantas,POR,MF,19,2000,0.8,1,1,0,0,1,0,0,,0,0,0,0,0,1,0,0,2021
GER-Bundesliga,2020,Dortmund,Ansgar Knauff,GER,"MF,FW",18,2002,0.8,0,0,0,0,0,0,1,0.0,1,3,1,2,0,0,0,0,2021
GER-Bundesliga,2020,Dortmund,Axel Witsel,BEL,MF,31,1989,12.6,18,12,6,11,1,8,16,50.0,8,13,3,10,22,40,13,0,2021
GER-Bundesliga,2020,Dortmund,Dan-Axel Zagadou,FRA,DF,21,1999,3.1,2,2,2,0,0,0,0,,0,3,2,1,6,8,13,0,2021
GER-Bundesliga,2020,Dortmund,Emre Can,GER,"DF,MF",26,1994,23.7,43,34,20,20,3,20,37,54.1,17,35,10,25,48,91,52,0,2021
GER-Bundesliga,2020,Dortmund,Erling Haaland,NOR,FW,20,2000,26.7,7,2,1,3,3,1,4,25.0,3,19,4,15,4,11,16,0,2021
GER-Bundesliga,2020,Dortmund,Felix Passlack,GER,DF,22,1998,4.0,9,6,4,2,3,4,8,50.0,4,11,1,10,3,12,2,0,2021
GER-Bundesliga,2020,Dortmund,Gio Reyna,USA,"MF,FW",17,2002,22.0,24,13,9,8,7,9,25,36.0,16,14,1,13,10,34,11,0,2021
GER-Bundesliga,2020,Dortmund,Jadon Sancho,ENG,"FW,MF",20,2000,22.9,18,11,4,10,4,7,16,43.8,9,20,1,19,16,34,9,0,2021
GER-Bundesliga,2020,Dortmund,Jude Bellingham,ENG,MF,17,2003,18.9,49,31,11,29,9,19,46,41.3,27,37,5,32,24,73,13,0,2021
GER-Bundesliga,2020,Dortmund,Julian Brandt,GER,"FW,MF",24,1996,16.6,27,14,13,9,5,12,43,27.9,31,25,1,24,17,44,7,1,2021
GER-Bundesliga,2020,Dortmund,Mahmoud Dahoud,GER,MF,24,1996,14.0,30,18,9,20,1,14,38,36.8,24,23,5,18,18,48,11,1,2021
GER-Bundesliga,2020,Dortmund,Manuel Akanji,SUI,DF,25,1995,26.1,41,22,23,12,6,19,31,61.3,12,23,10,13,49,90,70,1,2021
GER-Bundesliga,2020,Dortmund,Marco Reus,GER,"MF,FW",31,1989,25.3,33,16,9,16,8,9,33,27.3,24,22,2,20,14,47,13,0,2021
GER-Bundesliga,2020,Dortmund,Marwin Hitz,SUI,GK,32,1987,15.5,1,1,1,0,0,1,1,100.0,0,0,0,0,0,1,7,1,2021
GER-Bundesliga,2020,Dortmund,Mateu Morey,ESP,DF,20,2000,9.2,13,7,4,7,2,9,12,75.0,3,6,1,5,18,31,7,1,2021
GER-Bundesliga,2020,Dortmund,Mats Hummels,GER,DF,31,1988,31.3,58,40,34,18,6,26,42,61.9,16,31,22,9,73,131,122,2,2021
GER-Bundesliga,2020,Dortmund,Nico Schulz,GER,DF,27,1993,6.8,9,6,4,3,2,2,11,18.2,9,12,4,8,6,15,10,0,2021
GER-Bundesliga,2020,Dortmund,Raphaël Guerreiro,POR,DF,26,1993,24.6,30,13,14,8,8,16,31,51.6,15,21,4,17,28,58,31,1,2021
GER-Bundesliga,2020,Dortmund,Reinier,BRA,"MF,FW",18,2002,2.9,9,4,6,1,2,2,4,50.0,2,4,1,3,2,11,0,0,2021
GER-Bundesliga,2020,Dortmund,Roman Bürki,SUI,GK,29,1990,18.5,0,0,0,0,0,0,0,,0,0,0,0,0,0,5,1,2021
GER-Bundesliga,2020,Dortmund,Steffen Tigges,GER,"FW,DF",22,1998,0.6,4,4,0,1,3,2,3,66.7,1,1,0,1,0,4,1,0,2021
GER-Bundesliga,2020,Dortmund,Thomas Delaney,DEN,MF,28,1991,14.3,40,30,15,20,5,11,31,35.5,20,28,10,18,22,62,15,1,2021
GER-Bundesliga,2020,Dortmund,Thomas Meunier,BEL,DF,28,1991,16.4,30,21,19,6,5,20,29,69.0,9,16,6,10,18,48,29,2,2021
GER-Bundesliga,2020,Dortmund,Thorgan Hazard,BEL,"MF,FW",27,1993,7.3,8,2,6,1,1,3,13,23.1,10,4,0,4,10,18,1,0,2021
GER-Bundesliga,2020,Dortmund,Youssoufa Moukoko,GER,"FW,MF",15,2004,4.7,3,2,1,1,1,0,0,,0,3,0,3,0,3,2,0,2021
GER-Bundesliga,2020,Dortmund,Łukasz Piszczek,POL,DF,35,1985,5.1,10,7,6,4,0,5,12,41.7,7,5,1,4,5,15,12,0,2021
GER-Bundesliga,2020,Eint Frankfurt,Ajdin Hrustic,AUS,"MF,DF",24,1996,3.0,6,5,2,3,1,3,10,30.0,7,2,0,2,4,10,3,0,2021
GER-Bundesliga,2020,Eint Frankfurt,Almamy Touré,MLI,DF,24,1996,7.8,18,12,8,7,3,10,14,71.4,4,5,1,4,8,26,22,0,2021
GER-Bundesliga,2020,Eint Frankfurt,Amin Younes,GER,MF,26,1993,15.5,25,14,8,10,7,6,32,18.8,26,19,1,18,13,38,4,0,2021
GER-Bundesliga,2020,Eint Frankfurt,André Silva,POR,FW,24,1995,30.7,11,2,0,7,4,6,13,46.2,7,11,1,10,3,14,15,0,2021
GER-Bundesliga,2020,Eint Frankfurt,Aymen Barkok,MAR,"MF,DF",22,1998,10.9,29,15,11,9,9,10,31,32.3,21,15,1,14,10,39,9,1,2021
GER-Bundesliga,2020,Eint Frankfurt,Bas Dost,NED,FW,31,1989,9.1,3,2,1,1,1,2,5,40.0,3,5,1,4,2,5,8,0,2021
GER-Bundesliga,2020,Eint Frankfurt,Daichi Kamada,JPN,MF,23,1996,26.2,48,28,21,16,11,16,49,32.7,33,18,1,17,14,62,22,0,2021
GER-Bundesliga,2020,Eint Frankfurt,Danny da Costa,GER,DF,27,1993,1.2,0,0,0,0,0,0,1,0.0,1,3,1,2,0,0,4,0,2021
GER-Bundesliga,2020,Eint Frankfurt,David Abraham,ARG,DF,34,1986,13.6,18,12,13,3,2,11,17,64.7,6,13,4,9,17,35,34,0,2021
GER-Bundesliga,2020,Eint Frankfurt,Djibril Sow,SUI,MF,23,1997,24.2,58,33,19,32,7,18,41,43.9,23,31,8,23,51,109,17,0,2021
GER-Bundesliga,2020,Eint Frankfurt,Dominik Kohr,GER,"MF,DF",26,1994,2.9,11,7,0,7,4,4,9,44.4,5,5,1,4,9,20,9,0,2021
GER-Bundesliga,2020,Eint Frankfurt,Elias Bördner,GER,GK,18,2002,1.0,1,0,1,0,0,1,1,100.0,0,0,0,0,2,3,1,0,2021
GER-Bundesliga,2020,Eint Frankfurt,Erik Durm,GER,DF,28,1992,16.4,17,13,7,9,1,8,21,38.1,13,19,5,14,29,46,26,0,2021
GER-Bundesliga,2020,Eint Frankfurt,Filip Kostić,SRB,DF,27,1992,28.2,54,31,22,23,9,22,54,40.7,32,43,6,37,26,80,28,2,2021
GER-Bundesliga,2020,Eint Frankfurt,Kevin Trapp,GER,GK,30,1990,33.0,0,0,0,0,0,0,1,0.0,1,1,0,1,3,3,11,3,2021
GER-Bundesliga,2020,Eint Frankfurt,Luka Jović,SRB,FW,22,1997,9.9,2,0,0,2,0,0,4,0.0,4,3,0,3,1,3,7,0,2021
GER-Bundesliga,2020,Eint Frankfurt,Makoto Hasebe,JPN,"DF,MF",36,1984,25.4,43,29,21,20,2,25,51,49.0,26,31,12,19,31,74,68,2,2021
GER-Bundesliga,2020,Eint Frankfurt,Martin Hinteregger,AUT,DF,27,1992,28.1,77,49,53,22,2,37,63,58.7,26,31,12,19,44,121,92,0,2021
GER-Bundesliga,2020,Eint Frankfurt,Obite N'Dicka,FRA,DF,20,1999,22.7,31,23,16,15,0,16,28,57.1,12,27,6,21,47,78,85,0,2021
GER-Bundesliga,2020,Eint Frankfurt,Ragnar Ache,GER,"FW,DF",22,1998,1.1,2,0,0,1,1,0,0,,0,1,0,1,1,3,1,0,2021
GER-Bundesliga,2020,Eint Frankfurt,Sebastian Rode,GER,MF,29,1990,18.1,44,25,21,16,7,14,46,30.4,32,30,3,27,47,91,18,0,2021
GER-Bundesliga,2020,Eint Frankfurt,Stefan Ilsanker,AUT,"MF,DF",31,1989,17.5,33,20,17,15,1,21,42,50.0,21,30,8,22,30,63,51,2,2021
GER-Bundesliga,2020,Eint Frankfurt,Steven Zuber,SUI,"DF,MF",28,1991,6.5,24,12,8,13,3,8,16,50.0,8,4,1,3,4,28,1,0,2021
GER-Bundesliga,2020,Eint Frankfurt,Timothy Chandler,USA,DF,30,1990,4.8,4,0,2,1,1,1,4,25.0,3,5,2,3,3,7,5,0,2021
GER-Bundesliga,2020,Eint Frankfurt,Tuta,BRA,DF,21,1999,16.2,35,20,22,13,0,24,43,55.8,19,19,2,17,29,64,53,0,2021
GER-Bundesliga,2020,Freiburg,Amir Abrashi,ALB,"MF,DF",30,1990,0.7,1,1,1,0,0,0,0,,0,1,1,0,2,3,1,0,2021
GER-Bundesliga,2020,Freiburg,Baptiste Santamaria,FRA,MF,25,1995,24.5,51,38,19,24,8,20,54,37.0,34,36,7,29,52,103,34,1,2021
GER-Bundesliga,2020,Freiburg,Christian Günter,GER,"DF,MF",27,1993,34.0,34,19,18,13,3,15,43,34.9,28,38,9,29,29,63,40,0,2021
GER-Bundesliga,2020,Freiburg,Dominique Heintz,GER,DF,26,1993,15.2,22,11,19,3,0,10,19,52.6,9,10,8,2,35,57,49,0,2021
GER-Bundesliga,2020,Freiburg,Ermedin Demirović,BIH,FW,22,1998,16.6,15,9,4,6,5,2,16,12.5,14,29,5,24,0,15,27,0,2021
GER-Bundesliga,2020,Freiburg,Florian Müller,GER,GK,22,1997,31.0,0,0,0,0,0,0,3,0.0,3,1,0,1,2,2,10,1,2021
GER-Bundesliga,2020,Freiburg,Guus Til,NED,FW,22,1997,1.4,4,3,2,1,1,2,3,66.7,1,2,0,2,2,6,2,0,2021
GER-Bundesliga,2020,Freiburg,Janik Haberer,GER,"MF,FW",26,1994,5.4,7,4,4,3,0,3,15,20.0,12,4,1,3,7,14,9,0,2021
GER-Bundesliga,2020,Freiburg,Jeong Woo-yeong,KOR,"FW,MF",20,1999,9.1,9,5,1,6,2,2,11,18.2,9,8,1,7,11,20,11,0,2021
GER-Bundesliga,2020,Freiburg,Jonathan Schmid,FRA,"MF,DF",30,1990,26.6,37,19,17,13,7,16,30,53.3,14,26,10,16,28,65,38,0,2021
GER-Bundesliga,2020,Freiburg,Keven Schlotterbeck,GER,DF,23,1997,18.4,31,10,16,15,0,10,23,43.5,13,26,18,8,36,67,89,2,2021
GER-Bundesliga,2020,Freiburg,Kwon Chang-hoon,KOR,"MF,FW",26,1994,2.4,3,1,1,0,2,1,3,33.3,2,3,1,2,7,10,2,1,2021
GER-Bundesliga,2020,Freiburg,Lino Tempelmann,GER,MF,21,1999,3.0,5,3,2,2,1,0,4,0.0,4,6,1,5,2,7,6,0,2021
GER-Bundesliga,2020,Freiburg,Lucas Höler,GER,"FW,MF",26,1994,23.2,36,24,13,19,4,12,32,37.5,20,19,2,17,16,52,14,0,2021
GER-Bundesliga,2020,Freiburg,Lukas Kübler,GER,"DF,MF",27,1992,9.8,15,8,9,5,1,9,14,64.3,5,9,3,6,21,36,31,0,2021
GER-Bundesliga,2020,Freiburg,Manuel Gulde,GER,DF,29,1991,21.7,27,15,12,12,3,5,21,23.8,16,25,15,10,37,64,64,0,2021
GER-Bundesliga,2020,Freiburg,Mark Flekken,NED,GK,27,1993,3.0,0,0,0,0,0,0,0,,0,0,0,0,0,0,1,0,2021
GER-Bundesliga,2020,Freiburg,Nicolas Höfler,GER,MF,30,1990,30.3,54,28,16,31,7,23,59,39.0,36,34,10,24,66,120,41,2,2021
GER-Bundesliga,2020,Freiburg,Nils Petersen,GER,FW,31,1988,14.5,11,7,2,6,3,3,21,14.3,18,25,1,24,9,20,28,0,2021
GER-Bundesliga,2020,Freiburg,Nishan Burkart,SUI,MF,20,2000,0.2,0,0,0,0,0,0,1,0.0,1,0,0,0,0,0,0,0,2021
GER-Bundesliga,2020,Freiburg,Philipp Lienhart,AUT,DF,24,1996,33.3,21,13,12,7,2,9,20,45.0,11,30,21,9,42,63,100,0,2021
GER-Bundesliga,2020,Freiburg,Roland Sallai,HUN,"MF,FW",23,1997,18.5,18,14,7,9,2,5,13,38.5,8,11,1,10,11,29,8,0,2021
GER-Bundesliga,2020,Freiburg,Vincenzo Grifo,ITA,"MF,FW",27,1993,25.7,18,7,6,7,5,14,34,41.2,20,13,0,13,27,45,18,1,2021
GER-Bundesliga,2020,Freiburg,Yannik Keitel,GER,MF,20,2000,5.5,12,8,7,4,1,7,9,77.8,2,9,3,6,10,22,8,0,2021
GER-Bundesliga,2020,Hertha BSC,Alexander Schwolow,GER,GK,28,1992,26.0,0,0,0,0,0,0,0,,0,1,0,1,0,0,6,0,2021
GER-Bundesliga,2020,Hertha BSC,Arne Maier,GER,MF,21,1999,0.3,1,1,0,1,0,0,1,0.0,1,0,0,0,0,1,0,0,2021
GER-Bundesliga,2020,Hertha BSC,Daishawn Redan,NED,"FW,MF",19,2001,1.1,0,0,0,0,0,0,0,,0,1,0,1,0,0,0,0,2021
GER-Bundesliga,2020,Hertha BSC,Dedryck Boyata,BEL,DF,29,1990,17.2,14,7,10,3,1,7,15,46.7,8,23,20,3,26,40,68,1,2021
GER-Bundesliga,2020,Hertha BSC,Deyovaisio Zeefuik,NED,"DF,FW",22,1998,10.1,13,9,8,3,2,8,19,42.1,11,15,3,12,12,25,36,0,2021
GER-Bundesliga,2020,Hertha BSC,Dodi Lukebakio,BEL,"FW,MF",22,1997,20.6,21,14,13,5,3,9,20,45.0,11,14,1,13,12,33,8,0,2021
GER-Bundesliga,2020,Hertha BSC,Eduard Löwen,GER,"MF,DF",23,1997,0.9,5,1,3,1,1,2,5,40.0,3,1,0,1,1,6,1,0,2021
GER-Bundesliga,2020,Hertha BSC,Javairô Dilrosun,NED,"FW,MF",22,1998,5.9,5,3,2,2,1,1,6,16.7,5,5,0,5,4,9,3,0,2021
GER-Bundesliga,2020,Hertha BSC,Jessic Ngankam,GER,FW,20,2000,3.3,5,2,1,2,2,1,3,33.3,2,6,1,5,0,5,1,0,2021
GER-Bundesliga,2020,Hertha BSC,Jhon Córdoba,COL,FW,27,1993,17.1,9,4,1,5,3,2,4,50.0,2,13,2,11,6,15,4,0,2021
GER-Bundesliga,2020,Hertha BSC,Jonas Michel Dirkner,GER,MF,18,2002,0.2,0,0,0,0,0,0,0,,0,0,0,0,0,0,0,0,2021
GER-Bundesliga,2020,Hertha BSC,Jonas Michelbrink,GER,MF,19,2001,0.4,0,0,0,0,0,0,0,,0,0,0,0,0,0,0,0,2021
GER-Bundesliga,2020,Hertha BSC,Jordan Torunarigha,GER,DF,22,1997,10.8,7,4,7,0,0,5,8,62.5,3,8,2,6,15,22,54,1,2021
GER-Bundesliga,2020,Hertha BSC,Krzysztof Piątek,POL,FW,25,1995,18.1,9,4,1,7,1,3,22,13.6,19,11,0,11,6,15,14,0,2021
GER-Bundesliga,2020,Hertha BSC,Luca Netz,GER,"DF,FW",17,2003,3.4,14,8,12,2,0,6,17,35.3,11,3,0,3,6,20,8,0,2021
GER-Bundesliga,2020,Hertha BSC,Lucas Tousart,FRA,MF,23,1997,23.2,33,18,16,15,2,13,27,48.1,14,33,6,27,40,73,52,0,2021
GER-Bundesliga,2020,Hertha BSC,Lukas Klünter,GER,DF,24,1996,11.0,10,5,6,4,0,5,10,50.0,5,3,1,2,11,21,29,1,2021
GER-Bundesliga,2020,Hertha BSC,Marten Winkler,GER,FW,17,2002,0.0,0,0,0,0,0,0,0,,0,0,0,0,0,0,0,0,2021
GER-Bundesliga,2020,Hertha BSC,Marvin Plattenhardt,GER,DF,28,1992,11.9,15,10,6,7,2,5,9,55.6,4,9,1,8,1,16,19,1,2021
GER-Bundesliga,2020,Hertha BSC,Matheus Cunha,BRA,"FW,MF",21,1999,23.9,36,16,10,19,7,13,49,26.5,36,29,2,27,31,67,9,0,2021
GER-Bundesliga,2020,Hertha BSC,Mathew Leckie,AUS,"FW,DF",29,1991,5.6,12,3,5,5,2,4,11,36.4,7,8,0,8,13,25,9,0,2021
GER-Bundesliga,2020,Hertha BSC,Mattéo Guendouzi,FRA,MF,21,1999,20.2,24,13,10,12,2,9,25,36.0,16,15,4,11,21,45,24,1,2021
GER-Bundesliga,2020,Hertha BSC,Maximilian Mittelstädt,GER,"DF,FW",23,1997,20.0,66,39,42,21,3,35,72,48.6,37,34,5,29,55,121,61,1,2021
GER-Bundesliga,2020,Hertha BSC,Márton Dárdai,GER,"DF,MF",18,2002,9.1,17,10,10,6,1,9,16,56.3,7,7,3,4,16,33,31,0,2021
GER-Bundesliga,2020,Hertha BSC,Nemanja Radonjić,SRB,"FW,MF",24,1996,6.8,5,3,2,2,1,1,5,20.0,4,1,0,1,2,7,1,0,2021
GER-Bundesliga,2020,Hertha BSC,Niklas Stark,GER,"DF,MF",25,1995,31.0,49,28,20,27,2,13,31,41.9,18,43,16,27,42,91,101,0,2021
GER-Bundesliga,2020,Hertha BSC,Omar Alderete,PAR,DF,23,1996,14.4,16,10,11,5,0,7,16,43.8,9,14,10,4,21,37,61,1,2021
GER-Bundesliga,2020,Hertha BSC,Peter Pekarík,SVK,DF,33,1986,18.8,24,18,17,7,0,17,31,54.8,14,19,8,11,27,51,41,0,2021
GER-Bundesliga,2020,Hertha BSC,Rune Jarstein,NOR,GK,35,1984,8.0,0,0,0,0,0,0,0,,0,0,0,0,0,0,7,1,2021
GER-Bundesliga,2020,Hertha BSC,Sami Khedira,GER,MF,33,1987,4.4,11,6,3,7,1,6,12,50.0,6,4,0,4,9,20,7,0,2021
GER-Bundesliga,2020,Hertha BSC,Santiago Ascacíbar,ARG,MF,23,1997,8.5,30,15,15,14,1,15,28,53.6,13,23,2,21,13,43,14,0,2021
GER-Bundesliga,2020,Hertha BSC,Vladimír Darida,CZE,MF,29,1990,21.1,34,19,11,19,4,9,31,29.0,22,34,2,32,27,61,18,0,2021
GER-Bundesliga,2020,Hoffenheim,Andrej Kramarić,CRO,"FW,MF",29,1991,26.4,7,4,4,0,3,3,8,37.5,5,8,1,7,7,14,5,1,2021
GER-Bundesliga,2020,Hoffenheim,Chris Richards,USA,DF,20,2000,10.5,19,8,12,6,1,10,16,62.5,6,13,4,9,21,40,40,1,2021
GER-Bundesliga,2020,Hoffenheim,Christoph Baumgartner,AUT,"MF,FW",20,1999,26.3,44,31,13,24,7,14,51,27.5,37,40,8,32,24,68,24,0,2021
GER-Bundesliga,2020,Hoffenheim,Dennis Geiger,GER,MF,22,1998,7.3,13,10,3,8,2,5,8,62.5,3,10,0,10,3,16,0,0,2021
GER-Bundesliga,2020,Hoffenheim,Diadie Samassékou,MLI,MF,24,1996,28.5,71,41,22,42,7,33,90,36.7,57,41,12,29,78,149,50,0,2021
GER-Bundesliga,2020,Hoffenheim,Ermin Bičakčić,BIH,DF,30,1990,1.4,1,1,0,1,0,1,1,100.0,0,1,1,0,3,4,9,0,2021
GER-Bundesliga,2020,Hoffenheim,Florian Grillitsch,AUT,"MF,DF",24,1995,20.9,37,21,21,13,3,19,52,36.5,33,38,7,31,51,88,47,1,2021
GER-Bundesliga,2020,Hoffenheim,Georginio Rutter,FRA,FW,18,2002,2.7,4,4,2,2,0,1,2,50.0,1,2,0,2,0,4,2,0,2021
GER-Bundesliga,2020,Hoffenheim,Håvard Nordtveit,NOR,DF,30,1990,7.8,6,2,5,1,0,6,8,75.0,2,4,2,2,13,19,42,0,2021
GER-Bundesliga,2020,Hoffenheim,Ihlas Bebou,TOG,"FW,MF",26,1994,24.4,24,9,5,10,9,8,14,57.1,6,18,4,14,17,41,16,0,2021
GER-Bundesliga,2020,Hoffenheim,Ishak Belfodil,ALG,"FW,MF",28,1992,6.6,3,2,0,0,3,0,2,0.0,2,1,0,1,1,4,3,0,2021
GER-Bundesliga,2020,Hoffenheim,Jacob Bruun Larsen,DEN,"MF,FW",21,1998,1.0,0,0,0,0,0,0,0,,0,0,0,0,0,0,0,0,2021
GER-Bundesliga,2020,Hoffenheim,Joshua Brenet,NED,DF,26,1994,0.0,0,0,0,0,0,0,0,,0,0,0,0,0,0,0,0,2021
GER-Bundesliga,2020,Hoffenheim,Kasim Nuhu,GHA,DF,25,1995,11.0,13,7,9,4,0,6,10,60.0,4,8,3,5,15,28,38,0,2021
GER-Bundesliga,2020,Hoffenheim,Kevin Akpoguma,NGA,DF,25,1995,13.2,18,12,11,6,1,8,14,57.1,6,28,15,13,13,31,32,2,2021
GER-Bundesliga,2020,Hoffenheim,Kevin Vogt,GER,DF,28,1991,20.5,18,12,11,6,1,12,21,57.1,9,21,12,9,16,34,71,0,2021
GER-Bundesliga,2020,Hoffenheim,Klauss,BRA,"MF,FW",23,1997,0.6,1,0,0,0,1,0,1,0.0,1,0,0,0,0,1,0,0,2021
GER-Bundesliga,2020,Hoffenheim,Marco John,GER,DF,18,2002,11.1,21,15,9,5,7,10,22,45.5,12,18,1,17,16,37,21,0,2021
GER-Bundesliga,2020,Hoffenheim,Maximilian Beier,GER,"FW,DF",17,2002,0.1,0,0,0,0,0,0,1,0.0,1,0,0,0,0,0,0,0,2021
GER-Bundesliga,2020,Hoffenheim,Melayro Bogarde,NED,"DF,MF",18,2002,3.1,7,3,3,3,1,5,9,55.6,4,0,0,0,5,12,1,0,2021
GER-Bundesliga,2020,Hoffenheim,Mijat Gaćinović,SRB,"DF,MF",25,1995,9.1,18,10,6,11,1,9,24,37.5,15,13,0,13,18,36,15,0,2021
GER-Bundesliga,2020,Hoffenheim,Moanes Dabbur,ISR,"FW,MF",28,1992,11.1,6,3,3,1,2,1,13,7.7,12,6,0,6,9,15,7,0,2021
GER-Bundesliga,2020,Hoffenheim,Oliver Baumann,GER,GK,30,1990,31.0,0,0,0,0,0,0,1,0.0,1,0,0,0,2,2,14,0,2021
GER-Bundesliga,2020,Hoffenheim,Pavel Kadeřábek,CZE,"DF,FW",28,1992,17.6,15,12,7,6,2,6,15,40.0,9,12,3,9,18,33,31,0,2021
GER-Bundesliga,2020,Hoffenheim,Philipp Pentke,GER,GK,35,1985,3.0,0,0,0,0,0,0,0,,0,0,0,0,0,0,0,0,2021
GER-Bundesliga,2020,Hoffenheim,Robert Skov,DEN,"FW,MF",24,1996,12.9,19,10,9,7,3,7,16,43.8,9,9,2,7,15,34,10,1,2021
GER-Bundesliga,2020,Hoffenheim,Ryan Sessegnon,ENG,"DF,FW",20,2000,17.5,47,25,26,13,8,15,34,44.1,19,26,3,23,30,77,46,0,2021
GER-Bundesliga,2020,Hoffenheim,Sargis Adamyan,ARM,"FW,MF",27,1993,5.3,9,4,4,3,2,7,14,50.0,7,2,0,2,6,15,1,0,2021
GER-Bundesliga,2020,Hoffenheim,Sebastian Rudy,GER,"MF,FW",30,1990,18.6,35,26,15,15,5,16,45,35.6,29,24,4,20,13,48,21,1,2021
GER-Bundesliga,2020,Hoffenheim,Stefan Posch,AUT,DF,23,1997,23.5,52,24,29,17,6,27,47,57.4,20,27,8,19,37,89,73,1,2021
GER-Bundesliga,2020,Köln,Anthony Modeste,FRA,FW,32,1988,2.5,2,0,0,2,0,0,1,0.0,1,0,0,0,0,2,2,0,2021
GER-Bundesliga,2020,Köln,Benno Schmitz,GER,DF,25,1994,4.6,14,7,6,7,1,7,13,53.8,6,8,2,6,6,20,7,0,2021
GER-Bundesliga,2020,Köln,Dimitris Limnios,GRE,"MF,FW",22,1998,4.2,9,6,3,5,1,5,6,83.3,1,5,0,5,2,11,1,0,2021
GER-Bundesliga,2020,Köln,Dominick Drexler,GER,"MF,FW",30,1990,13.7,36,26,15,18,3,12,30,40.0,18,5,1,4,14,50,15,0,2021
GER-Bundesliga,2020,Köln,Ellyes Skhiri,TUN,MF,25,1995,30.9,83,48,44,31,8,33,65,50.8,32,49,13,36,82,165,38,2,2021
GER-Bundesliga,2020,Köln,Elvis Rexhbeçaj,GER,"MF,FW",22,1997,20.4,53,32,17,27,9,19,53,35.8,34,32,7,25,26,79,18,0,2021
GER-Bundesliga,2020,Köln,Emmanuel Dennis,NGA,FW,22,1997,5.3,13,7,6,5,2,1,6,16.7,5,6,0,6,0,13,0,1,2021
GER-Bundesliga,2020,Köln,Florian Kainz,AUT,"MF,FW",27,1992,5.0,4,2,0,4,0,2,8,25.0,6,7,0,7,3,7,3,0,2021
GER-Bundesliga,2020,Köln,Frederik Sørensen,DEN,DF,28,1992,1.1,2,1,0,2,0,1,1,100.0,0,2,0,2,0,2,0,0,2021
GER-Bundesliga,2020,Köln,Ismail Jakobs,SEN,"MF,FW",20,1999,19.2,25,10,17,4,4,11,21,52.4,10,18,1,17,16,41,36,0,2021
GER-Bundesliga,2020,Köln,Jan Thielmann,GER,"FW,MF",18,2002,11.4,11,6,1,8,2,5,9,55.6,4,10,1,9,9,20,2,0,2021
GER-Bundesliga,2020,Köln,Jannes Horn,GER,DF,23,1997,19.6,35,19,23,11,1,23,31,74.2,8,19,2,17,10,45,45,0,2021
GER-Bundesliga,2020,Köln,Jonas Hector,GER,"MF,FW",30,1990,14.3,34,22,8,21,5,15,35,42.9,20,24,5,19,19,53,20,1,2021
GER-Bundesliga,2020,Köln,Jorge Meré,ESP,DF,23,1997,14.4,13,6,9,3,1,6,13,46.2,7,14,11,3,15,28,63,0,2021
GER-Bundesliga,2020,Köln,Kingsley Ehizibue,NED,DF,25,1995,12.6,32,19,22,9,1,10,17,58.8,7,19,5,14,18,50,42,0,2021
GER-Bundesliga,2020,Köln,Marco Höger,GER,"DF,MF",30,1989,0.6,1,0,0,1,0,1,2,50.0,1,2,0,2,2,3,1,0,2021
GER-Bundesliga,2020,Köln,Marius Wolf,GER,"MF,DF",25,1995,28.3,35,19,19,13,3,13,38,34.2,25,29,3,26,28,63,47,1,2021
GER-Bundesliga,2020,Köln,Max Meyer,GER,MF,24,1995,3.9,7,4,3,3,1,4,8,50.0,4,4,1,3,3,10,1,0,2021
GER-Bundesliga,2020,Köln,Noah Katterbach,GER,"DF,MF",19,2001,12.3,18,11,11,6,1,13,21,61.9,8,7,3,4,23,41,22,0,2021
GER-Bundesliga,2020,Köln,Ondrej Duda,SVK,"FW,MF",25,1994,28.2,36,14,13,18,5,8,39,20.5,31,28,2,26,19,55,20,0,2021
GER-Bundesliga,2020,Köln,Rafael Czichos,GER,DF,30,1990,25.1,48,24,33,13,2,23,42,54.8,19,25,9,16,53,101,109,0,2021
GER-Bundesliga,2020,Köln,Ron-Robert Zieler,GER,GK,31,1989,0.6,0,0,0,0,0,0,0,,0,0,0,0,0,0,0,0,2021
GER-Bundesliga,2020,Köln,Salih Özcan,TUR,MF,22,1998,15.2,21,13,11,10,0,12,33,36.4,21,11,2,9,20,41,14,1,2021
GER-Bundesliga,2020,Köln,Sava Cestic,SRB,DF,19,2001,10.0,20,9,12,6,2,8,17,47.1,9,13,4,9,18,38,40,0,2021
GER-Bundesliga,2020,Köln,Sebastiaan Bornauw,BEL,DF,21,1999,23.1,29,20,25,4,0,14,25,56.0,11,33,26,7,40,69,104,0,2021
GER-Bundesliga,2020,Köln,Sebastian Andersson,SWE,FW,29,1991,12.5,3,2,0,3,0,1,8,12.5,7,10,3,7,2,5,9,0,2021
GER-Bundesliga,2020,Köln,Timo Horn,GER,GK,27,1993,33.4,1,0,1,0,0,1,4,25.0,3,1,0,1,0,1,11,2,2021
GER-Bundesliga,2020,Köln,Toluwalase Arokodare,NGA,"FW,MF",19,2000,1.2,1,1,0,0,1,0,0,,0,1,0,1,1,2,0,0,2021
GER-Bundesliga,2020,Leverkusen,Aleksandar Dragović,AUT,DF,29,1991,12.6,11,7,5,5,1,9,13,69.2,4,17,5,12,13,24,33,0,2021
GER-Bundesliga,2020,Leverkusen,Charles Aránguiz,CHI,MF,31,1989,18.5,41,23,16,21,4,17,43,39.5,26,32,4,28,33,74,17,0,2021
GER-Bundesliga,2020,Leverkusen,Daley Sinkgraven,NED,DF,25,1995,17.4,32,17,13,16,3,18,35,51.4,17,22,5,17,23,55,23,0,2021
GER-Bundesliga,2020,Leverkusen,Demarai Gray,JAM,FW,24,1996,4.9,3,2,1,2,0,1,1,100.0,0,3,0,3,4,7,3,0,2021
GER-Bundesliga,2020,Leverkusen,Edmond Tapsoba,BFA,DF,21,1999,29.5,54,28,35,18,1,21,45,46.7,24,55,29,26,48,102,96,0,2021
GER-Bundesliga,2020,Leverkusen,Emrehan Gedikli,GER,FW,17,2003,0.3,0,0,0,0,0,0,0,,0,0,0,0,0,0,0,0,2021
GER-Bundesliga,2020,Leverkusen,Exequiel Palacios,ARG,MF,21,1998,6.4,31,17,12,16,3,17,30,56.7,13,13,0,13,12,43,7,0,2021
GER-Bundesliga,2020,Leverkusen,Florian Wirtz,GER,MF,17,2003,24.7,35,18,8,22,5,11,37,29.7,26,27,1,26,9,44,8,0,2021
GER-Bundesliga,2020,Leverkusen,Jeremie Frimpong,NED,"DF,FW",19,2000,4.8,7,4,4,3,0,4,8,50.0,4,4,0,4,1,8,7,0,2021
GER-Bundesliga,2020,Leverkusen,Joel Pohjanpalo,FIN,MF,25,1994,0.1,0,0,0,0,0,0,0,,0,0,0,0,0,0,0,0,2021
GER-Bundesliga,2020,Leverkusen,Jonathan Tah,GER,DF,24,1996,24.7,30,17,19,9,2,11,21,52.4,10,19,12,7,33,63,89,1,2021
GER-Bundesliga,2020,Leverkusen,Julian Baumgartlinger,AUT,MF,32,1988,11.9,43,20,14,26,3,16,31,51.6,15,12,0,12,12,55,10,1,2021
GER-Bundesliga,2020,Leverkusen,Karim Bellarabi,GER,"FW,MF",30,1990,8.9,12,10,3,4,5,4,17,23.5,13,12,0,12,12,24,4,0,2021
GER-Bundesliga,2020,Leverkusen,Kerem Demirbay,GER,MF,27,1993,19.4,46,31,15,26,5,19,38,50.0,19,21,4,17,8,54,6,1,2021
GER-Bundesliga,2020,Leverkusen,Lars Bender,GER,DF,31,1989,10.4,19,13,12,6,1,9,21,42.9,12,19,5,14,16,35,19,0,2021
GER-Bundesliga,2020,Leverkusen,Lennart Grill,GER,GK,21,1999,4.0,0,0,0,0,0,0,0,,0,0,0,0,0,0,2,0,2021
GER-Bundesliga,2020,Leverkusen,Leon Bailey,JAM,"FW,MF",22,1997,23.8,14,8,3,7,4,4,15,26.7,11,13,0,13,9,23,3,0,2021
GER-Bundesliga,2020,Leverkusen,Lucas Alario,ARG,FW,27,1992,13.8,8,2,2,5,1,2,4,50.0,2,9,1,8,2,10,10,0,2021
GER-Bundesliga,2020,Leverkusen,Lukáš Hrádecký,FIN,GK,30,1989,28.5,0,0,0,0,0,0,1,0.0,1,0,0,0,1,1,11,3,2021
GER-Bundesliga,2020,Leverkusen,Mitchell Weiser,GER,DF,26,1994,2.5,4,1,1,2,1,2,4,50.0,2,1,0,1,3,7,4,0,2021
GER-Bundesliga,2020,Leverkusen,Moussa Diaby,FRA,"FW,MF",21,1999,26.5,10,6,4,5,1,6,20,30.0,14,11,0,11,12,22,5,0,2021
GER-Bundesliga,2020,Leverkusen,Nadiem Amiri,GER,MF,23,1996,21.0,12,7,4,8,0,7,33,21.2,26,18,3,15,12,24,7,0,2021
GER-Bundesliga,2020,Leverkusen,Niklas Lomb,GER,GK,27,1993,1.5,0,0,0,0,0,0,0,,0,0,0,0,0,0,0,2,2021
GER-Bundesliga,2020,Leverkusen,Patrik Schick,CZE,FW,24,1996,20.7,7,2,0,5,2,1,4,25.0,3,5,2,3,3,10,20,0,2021
GER-Bundesliga,2020,Leverkusen,Paulinho,BRA,FW,20,2000,0.7,0,0,0,0,0,0,0,,0,0,0,0,0,0,0,0,2021
GER-Bundesliga,2020,Leverkusen,Santiago Arias,COL,DF,28,1992,1.0,2,1,0,1,1,1,1,100.0,0,0,0,0,1,3,4,0,2021
GER-Bundesliga,2020,Leverkusen,Sven Bender,GER,DF,31,1989,13.0,17,9,8,8,1,7,20,35.0,13,20,9,11,21,38,41,1,2021
GER-Bundesliga,2020,Leverkusen,Timothy Fosu-Mensah,NED,DF,22,1998,4.5,4,2,1,2,1,2,4,50.0,2,7,3,4,7,11,4,0,2021
GER-Bundesliga,2020,Leverkusen,Tin Jedvaj,CRO,DF,24,1995,1.7,5,2,2,3,0,1,3,33.3,2,2,1,1,2,7,9,0,2021
GER-Bundesliga,2020,Leverkusen,Wendell,BRA,DF,27,1993,16.2,53,35,27,18,8,23,49,46.9,26,26,3,23,25,78,39,1,2021
GER-Bundesliga,2020,M'Gladbach,Alassane Pléa,FRA,FW,27,1993,20.0,19,9,4,10,5,5,20,25.0,15,1,0,1,5,24,7,0,2021
GER-Bundesliga,2020,M'Gladbach,Breel Embolo,SUI,"FW,MF",23,1997,16.0,15,10,1,13,1,0,6,0.0,6,16,1,15,8,23,8,0,2021
GER-Bundesliga,2020,M'Gladbach,Christoph Kramer,GER,MF,29,1991,22.6,55,37,22,28,5,28,58,48.3,30,32,11,21,34,89,39,0,2021
GER-Bundesliga,2020,M'Gladbach,Denis Zakaria,SUI,"MF,DF",23,1996,15.8,30,15,12,15,3,11,20,55.0,9,20,7,13,23,53,29,1,2021
GER-Bundesliga,2020,M'Gladbach,Florian Neuhaus,GER,MF,23,1997,29.1,48,28,19,26,3,19,63,30.2,44,35,7,28,50,98,20,1,2021
GER-Bundesliga,2020,M'Gladbach,Hannes Wolf,AUT,"MF,FW",21,1999,15.3,26,13,8,10,8,8,36,22.2,28,18,1,17,9,35,4,0,2021
GER-Bundesliga,2020,M'Gladbach,Ibrahima Traoré,GUI,"FW,DF",32,1988,1.1,4,1,1,2,1,0,0,,0,2,0,2,0,4,0,0,2021
GER-Bundesliga,2020,M'Gladbach,Jonas Hofmann,GER,"FW,MF",28,1992,20.2,26,20,12,12,2,10,53,18.9,43,27,2,25,27,53,9,0,2021
GER-Bundesliga,2020,M'Gladbach,Jordan Beyer,GER,DF,20,2000,2.1,2,1,2,0,0,1,2,50.0,1,5,4,1,5,7,5,0,2021
GER-Bundesliga,2020,M'Gladbach,Lars Stindl,GER,"MF,FW",31,1988,21.8,24,17,3,16,5,7,32,21.9,25,26,3,23,13,37,14,0,2021
GER-Bundesliga,2020,M'Gladbach,László Bénes,SVK,MF,22,1997,1.7,6,2,5,1,0,2,4,50.0,2,0,0,0,2,8,1,0,2021
GER-Bundesliga,2020,M'Gladbach,Marcus Thuram,FRA,"FW,MF",22,1997,19.2,24,14,9,10,5,10,23,43.5,13,27,4,23,15,39,13,1,2021
GER-Bundesliga,2020,M'Gladbach,Matthias Ginter,GER,DF,26,1994,34.0,26,16,15,10,1,14,24,58.3,10,43,32,11,51,77,121,0,2021
GER-Bundesliga,2020,M'Gladbach,Nico Elvedi,SUI,DF,23,1996,28.2,49,35,36,12,1,25,37,67.6,12,38,22,16,65,114,123,0,2021
GER-Bundesliga,2020,M'Gladbach,Oscar Wendt,SWE,DF,34,1985,13.9,12,6,2,9,1,4,12,33.3,8,18,4,14,14,26,23,0,2021
GER-Bundesliga,2020,M'Gladbach,Patrick Herrmann,GER,"FW,MF",29,1991,9.7,9,6,4,3,2,2,14,14.3,12,16,0,16,10,19,8,0,2021
GER-Bundesliga,2020,M'Gladbach,Ramy Bensebaini,ALG,DF,25,1995,20.1,43,24,27,13,3,26,42,61.9,16,39,7,32,47,90,66,0,2021
GER-Bundesliga,2020,M'Gladbach,Rocco Reitz,GER,MF,18,2002,0.7,3,2,0,3,0,2,2,100.0,0,3,1,2,1,4,1,0,2021
GER-Bundesliga,2020,M'Gladbach,Stefan Lainer,AUT,DF,27,1992,30.8,62,37,30,22,10,27,60,45.0,33,34,5,29,35,97,85,1,2021
GER-Bundesliga,2020,M'Gladbach,Tobias Sippel,GER,GK,32,1988,3.8,0,0,0,0,0,0,0,,0,0,0,0,1,1,4,0,2021
GER-Bundesliga,2020,M'Gladbach,Tony Jantschke,GER,DF,30,1990,3.0,2,2,1,1,0,1,3,33.3,2,6,4,2,4,6,7,0,2021
GER-Bundesliga,2020,M'Gladbach,Valentino Lazaro,AUT,"DF,FW",24,1996,13.8,17,11,7,5,5,12,19,63.2,7,18,1,17,15,32,20,0,2021
GER-Bundesliga,2020,M'Gladbach,Yann Sommer,SUI,GK,31,1988,30.1,1,1,1,0,0,1,1,100.0,0,0,0,0,2,3,9,2,2021
GER-Bundesliga,2020,Mainz 05,Aarón Martín,ESP,"DF,FW",23,1997,2.9,3,2,2,1,0,2,4,50.0,2,1,0,1,2,5,2,0,2021
GER-Bundesliga,2020,Mainz 05,Alexander Hack,GER,DF,26,1993,15.2,32,21,23,8,1,18,31,58.1,13,26,17,9,41,73,91,2,2021
GER-Bundesliga,2020,Mainz 05,Daniel Brosinski,GER,"DF,FW",32,1988,15.9,19,14,10,7,2,12,31,38.7,19,18,1,17,14,33,33,0,2021
GER-Bundesliga,2020,Mainz 05,Danny Latza,GER,MF,30,1989,20.0,43,26,12,19,12,23,70,32.9,47,39,3,36,27,70,23,0,2021
GER-Bundesliga,2020,Mainz 05,Danny da Costa,GER,"DF,FW",27,1993,13.4,22,16,6,9,7,13,27,48.1,14,17,2,15,17,39,27,0,2021
GER-Bundesliga,2020,Mainz 05,Dominik Kohr,GER,MF,26,1994,14.1,47,31,14,26,7,20,39,51.3,19,18,5,13,27,74,15,0,2021
GER-Bundesliga,2020,Mainz 05,Edimilson Fernandes,SUI,"MF,FW",24,1996,9.3,8,4,4,4,0,4,7,57.1,3,12,4,8,29,37,25,0,2021
GER-Bundesliga,2020,Mainz 05,Finn Dahmen,GER,GK,22,1998,3.0,0,0,0,0,0,0,1,0.0,1,0,0,0,0,0,1,0,2021
GER-Bundesliga,2020,Mainz 05,Issah Abbas,GHA,"DF,FW",21,1998,0.2,0,0,0,0,0,0,0,,0,0,0,0,0,0,0,0,2021
GER-Bundesliga,2020,Mainz 05,Jean-Paul Boëtius,NED,"MF,FW",26,1994,22.9,42,28,13,15,14,17,47,36.2,30,37,3,34,33,75,14,0,2021
GER-Bundesliga,2020,Mainz 05,Jean-Philippe Mateta,FRA,FW,23,1997,11.1,6,3,1,3,2,0,3,0.0,3,3,1,2,4,10,6,0,2021
GER-Bundesliga,2020,Mainz 05,Jerry St. Juste,NED,DF,23,1996,32.0,65,38,37,26,2,20,36,55.6,16,46,27,19,64,129,82,1,2021
GER-Bundesliga,2020,Mainz 05,Ji Dong-won,KOR,FW,29,1991,0.7,1,1,1,0,0,0,0,,0,1,0,1,2,3,0,0,2021
GER-Bundesliga,2020,Mainz 05,Jonathan Burkardt,GER,"FW,MF",20,2000,15.3,27,13,15,10,2,11,19,57.9,8,20,3,17,8,35,15,0,2021
GER-Bundesliga,2020,Mainz 05,Karim Onisiwo,AUT,"FW,MF",28,1992,20.5,31,20,7,15,9,14,23,60.9,9,20,1,19,5,36,12,0,2021
GER-Bundesliga,2020,Mainz 05,Kevin Stöger,AUT,"MF,FW",26,1993,6.0,12,6,2,9,1,5,16,31.3,11,5,0,5,6,18,4,0,2021
GER-Bundesliga,2020,Mainz 05,Leandro Barreiro Martins,LUX,MF,20,2000,25.6,58,32,19,26,13,20,50,40.0,30,34,9,25,57,115,55,0,2021
GER-Bundesliga,2020,Mainz 05,Levin Öztunalı,GER,"DF,FW",24,1996,8.4,24,18,14,8,2,8,17,47.1,9,15,0,15,15,39,16,0,2021
GER-Bundesliga,2020,Mainz 05,Luca Kilian,GER,DF,20,1999,4.2,14,7,10,4,0,9,17,52.9,8,3,1,2,13,27,12,0,2021
GER-Bundesliga,2020,Mainz 05,Matondo-Merveille Papela,GER,DF,19,2001,0.0,0,0,0,0,0,0,1,0.0,1,0,0,0,0,0,0,0,2021
GER-Bundesliga,2020,Mainz 05,Moussa Niakhate,SEN,DF,24,1996,31.8,42,22,28,13,1,14,29,48.3,15,31,15,16,49,91,79,0,2021
GER-Bundesliga,2020,Mainz 05,Niklas Tauer,GER,"MF,DF",19,2001,0.8,1,1,0,1,0,1,2,50.0,1,3,1,2,3,4,1,0,2021
GER-Bundesliga,2020,Mainz 05,Paul Nebel,GER,"MF,FW",17,2002,0.6,1,1,0,1,0,0,1,0.0,1,0,0,0,2,3,0,0,2021
GER-Bundesliga,2020,Mainz 05,Phillipp Mwene,AUT,"DF,MF",26,1994,18.6,36,23,21,11,4,19,38,50.0,19,26,3,23,24,60,33,0,2021
GER-Bundesliga,2020,Mainz 05,Pierre Kunde,CMR,MF,25,1995,5.7,8,4,1,5,2,2,9,22.2,7,6,0,6,10,18,9,0,2021
GER-Bundesliga,2020,Mainz 05,Ridle Baku,GER,DF,22,1998,2.0,4,2,3,1,0,2,6,33.3,4,3,1,2,3,7,6,0,2021
GER-Bundesliga,2020,Mainz 05,Robert Glatzel,GER,FW,26,1994,4.0,1,0,1,0,0,0,2,0.0,2,2,0,2,0,1,2,0,2021
GER-Bundesliga,2020,Mainz 05,Robin Quaison,SWE,"FW,MF",26,1993,16.4,14,6,3,6,5,7,14,50.0,7,10,0,10,13,27,10,0,2021
GER-Bundesliga,2020,Mainz 05,Robin Zentner,GER,GK,25,1994,31.0,1,1,1,0,0,1,3,33.3,2,0,0,0,3,4,9,2,2021
GER-Bundesliga,2020,Mainz 05,Stefan Bell,GER,DF,28,1991,14.1,24,18,15,9,0,14,23,60.9,9,19,11,8,27,51,76,1,2021
GER-Bundesliga,2020,Mainz 05,Ádám Szalai,HUN,FW,32,1987,8.1,7,6,3,2,2,2,8,25.0,6,4,1,3,2,9,4,0,2021
GER-Bundesliga,2020,RB Leipzig,Alexander Sørloth,NOR,FW,24,1995,16.0,7,5,0,5,2,2,14,14.3,12,13,2,11,3,10,13,0,2021
GER-Bundesliga,2020,RB Leipzig,Amadou Haidara,MLI,"MF,FW",22,1998,21.2,50,28,20,21,9,11,36,30.6,25,33,1,32,30,80,24,0,2021
GER-Bundesliga,2020,RB Leipzig,Angeliño,ESP,"DF,FW",23,1997,24.0,31,19,10,18,3,13,24,54.2,11,22,1,21,30,61,40,0,2021
GER-Bundesliga,2020,RB Leipzig,Benjamin Henrichs,GER,"DF,MF",23,1997,6.0,12,7,4,5,3,2,9,22.2,7,9,1,8,8,20,8,0,2021
GER-Bundesliga,2020,RB Leipzig,Christopher Nkunku,FRA,"FW,MF",22,1997,21.0,16,11,3,7,6,8,18,44.4,10,27,1,26,9,25,14,0,2021
GER-Bundesliga,2020,RB Leipzig,Dani Olmo,ESP,MF,22,1998,24.4,23,14,6,13,4,4,23,17.4,19,15,0,15,13,36,21,0,2021
GER-Bundesliga,2020,RB Leipzig,Dayot Upamecano,FRA,DF,21,1998,25.9,37,30,18,19,0,14,20,70.0,6,25,14,11,33,70,74,2,2021
GER-Bundesliga,2020,RB Leipzig,Dennis Borkowski,GER,"MF,FW",18,2002,0.1,0,0,0,0,0,0,0,,0,1,0,1,0,0,0,0,2021
GER-Bundesliga,2020,RB Leipzig,Emil Forsberg,SWE,"FW,MF",28,1991,17.1,11,6,1,6,4,5,27,18.5,22,10,1,9,11,22,4,0,2021
GER-Bundesliga,2020,RB Leipzig,Hwang Hee-chan,KOR,"FW,MF",24,1996,5.1,3,2,1,0,2,1,7,14.3,6,4,0,4,1,4,1,0,2021
GER-Bundesliga,2020,RB Leipzig,Ibrahima Konaté,FRA,DF,21,1999,7.7,6,4,2,3,1,2,8,25.0,6,6,3,3,8,14,24,0,2021
GER-Bundesliga,2020,RB Leipzig,Joscha Wosz,GER,DF,18,2002,0.4,1,1,1,0,0,0,0,,0,1,0,1,1,2,0,0,2021
GER-Bundesliga,2020,RB Leipzig,Josep Martinez,ESP,GK,22,1998,1.0,0,0,0,0,0,0,0,,0,0,0,0,0,0,0,0,2021
GER-Bundesliga,2020,RB Leipzig,Justin Kluivert,NED,"FW,MF",21,1999,9.0,2,1,1,1,0,0,2,0.0,2,4,0,4,5,7,3,0,2021
GER-Bundesliga,2020,RB Leipzig,Kevin Kampl,SVN,MF,29,1990,21.5,38,26,9,24,5,18,35,51.4,17,20,2,18,29,67,14,0,2021
GER-Bundesliga,2020,RB Leipzig,Konrad Laimer,AUT,"DF,MF",23,1997,0.9,2,0,0,1,1,0,4,0.0,4,2,0,2,1,3,0,0,2021
GER-Bundesliga,2020,RB Leipzig,Lazar Samardzic,SRB,MF,18,2002,2.2,10,7,4,6,0,5,13,38.5,8,6,0,6,2,12,1,0,2021
GER-Bundesliga,2020,RB Leipzig,Lukas Klostermann,GER,DF,24,1996,16.1,23,19,8,12,3,11,18,61.1,7,16,6,10,18,41,44,1,2021
GER-Bundesliga,2020,RB Leipzig,Marcel Halstenberg,GER,DF,28,1991,18.3,29,18,20,8,1,19,41,46.3,22,15,3,12,16,45,35,0,2021
GER-Bundesliga,2020,RB Leipzig,Marcel Sabitzer,AUT,MF,26,1994,22.5,29,21,12,16,1,12,37,32.4,25,7,2,5,35,64,27,0,2021
GER-Bundesliga,2020,RB Leipzig,Nordi Mukiele,FRA,DF,22,1997,18.6,44,30,14,28,2,21,37,56.8,16,33,1,32,23,67,33,2,2021
GER-Bundesliga,2020,RB Leipzig,Péter Gulácsi,HUN,GK,30,1990,33.0,1,0,1,0,0,1,2,50.0,1,0,0,0,2,3,7,0,2021
GER-Bundesliga,2020,RB Leipzig,Tyler Adams,USA,"MF,DF",21,1999,20.6,35,24,12,15,8,17,31,54.8,14,22,5,17,29,64,30,0,2021
GER-Bundesliga,2020,RB Leipzig,Willi Orban,HUN,DF,27,1992,26.3,40,26,19,15,6,23,37,62.2,14,29,20,9,40,80,74,0,2021
GER-Bundesliga,2020,RB Leipzig,Yussuf Poulsen,DEN,FW,26,1994,15.0,10,6,1,6,3,1,17,5.9,16,16,0,16,6,16,13,0,2021
GER-Bundesliga,2020,Schalke 04,Ahmed Kutucu,TUR,"FW,MF",20,2000,1.2,1,0,0,0,1,1,2,50.0,1,1,0,1,0,1,0,0,2021
GER-Bundesliga,2020,Schalke 04,Alessandro Schöpf,AUT,"FW,MF",26,1994,10.5,11,9,3,7,1,1,6,16.7,5,15,1,14,6,17,6,0,2021
GER-Bundesliga,2020,Schalke 04,Amine Harit,MAR,"MF,FW",23,1997,23.3,22,13,8,11,3,10,23,43.5,13,9,1,8,17,39,7,1,2021
GER-Bundesliga,2020,Schalke 04,Bastian Oczipka,GER,"DF,FW",31,1989,21.4,33,20,22,10,1,7,21,33.3,14,22,4,18,24,57,41,0,2021
GER-Bundesliga,2020,Schalke 04,Benito Raman,BEL,"FW,MF",25,1994,13.8,19,13,11,6,2,6,29,20.7,23,11,0,11,5,24,5,0,2021
GER-Bundesliga,2020,Schalke 04,Benjamin Stambouli,FRA,"DF,MF",29,1990,21.7,45,29,24,18,3,15,37,40.5,22,42,14,28,49,94,45,1,2021
GER-Bundesliga,2020,Schalke 04,Blendi Idrizi,KVX,MF,22,1998,2.6,8,4,1,6,1,1,1,100.0,0,6,2,4,3,11,1,0,2021
GER-Bundesliga,2020,Schalke 04,Can Bozdogan,GER,"MF,FW",19,2001,7.2,13,5,6,6,1,4,15,26.7,11,10,2,8,7,20,5,0,2021
GER-Bundesliga,2020,Schalke 04,Florian Flick,GER,MF,20,2000,4.0,10,7,4,6,0,7,16,43.8,9,4,3,1,7,17,5,1,2021
GER-Bundesliga,2020,Schalke 04,Frederik Rønnow,DEN,GK,27,1992,10.5,0,0,0,0,0,0,0,,0,0,0,0,1,1,9,1,2021
GER-Bundesliga,2020,Schalke 04,Gonçalo Paciência,POR,FW,25,1994,8.3,8,3,4,1,3,4,16,25.0,12,4,1,3,1,9,3,0,2021
GER-Bundesliga,2020,Schalke 04,Hamza Mendyl,MAR,"FW,DF",22,1997,1.1,2,2,2,0,0,0,2,0.0,2,2,0,2,0,2,2,0,2021
GER-Bundesliga,2020,Schalke 04,Henning Matriciani,GER,DF,20,2000,0.3,1,1,1,0,0,1,1,100.0,0,1,0,1,0,1,1,0,2021
GER-Bundesliga,2020,Schalke 04,Jan Luca Schuler,GER,FW,21,1999,0.4,2,2,1,1,0,0,1,0.0,1,1,0,1,0,2,0,0,2021
GER-Bundesliga,2020,Schalke 04,Jimmy Kaparos,GER,MF,18,2001,0.2,0,0,0,0,0,0,1,0.0,1,0,0,0,0,0,0,0,2021
GER-Bundesliga,2020,Schalke 04,Kerim Calhanoglu,GER,DF,17,2002,3.3,3,3,1,1,1,0,3,0.0,3,4,0,4,7,10,6,0,2021
GER-Bundesliga,2020,Schalke 04,Kilian Ludewig,GER,"DF,FW",20,2000,5.8,16,6,10,5,1,8,25,32.0,17,7,0,7,3,19,14,0,2021
GER-Bundesliga,2020,Schalke 04,Klaas-Jan Huntelaar,NED,FW,36,1983,6.5,4,2,0,2,2,0,2,0.0,2,3,1,2,2,6,3,0,2021
GER-Bundesliga,2020,Schalke 04,Levent Mercan,GER,FW,19,2000,0.1,0,0,0,0,0,0,0,,0,0,0,0,0,0,0,0,2021
GER-Bundesliga,2020,Schalke 04,Malick Thiaw,GER,DF,18,2001,16.1,42,27,24,17,1,15,26,57.7,11,17,12,5,33,75,70,0,2021
GER-Bundesliga,2020,Schalke 04,Mark Uth,GER,"FW,MF",28,1991,16.6,25,13,13,10,2,5,23,21.7,18,21,0,21,5,30,10,0,2021
GER-Bundesliga,2020,Schalke 04,Matija Nastasić,SRB,DF,27,1993,13.6,11,7,9,2,0,9,16,56.3,7,22,18,4,26,37,51,1,2021
GER-Bundesliga,2020,Schalke 04,Matthew Hoppe,USA,FW,19,2001,14.5,6,6,1,3,2,2,12,16.7,10,8,2,6,4,10,15,0,2021
GER-Bundesliga,2020,Schalke 04,Mehmet Aydin,GER,DF,18,2002,5.6,15,7,9,6,0,4,10,40.0,6,6,1,5,6,21,16,0,2021
GER-Bundesliga,2020,Schalke 04,Michael Langer,AUT,GK,35,1985,2.7,0,0,0,0,0,0,0,,0,0,0,0,0,0,3,0,2021
GER-Bundesliga,2020,Schalke 04,Mikail Maden,NOR,FW,18,2002,0.1,0,0,0,0,0,0,0,,0,0,0,0,0,0,0,0,2021
GER-Bundesliga,2020,Schalke 04,Nabil Bentaleb,ALG,MF,25,1994,6.1,14,8,7,6,1,4,15,26.7,11,5,2,3,6,20,8,0,2021
GER-Bundesliga,2020,Schalke 04,Nassim Boujellab,MAR,"MF,FW",21,1999,6.7,13,9,2,10,1,2,12,16.7,10,10,3,7,7,20,9,0,2021
GER-Bundesliga,2020,Schalke 04,Omar Mascarell,ESP,MF,27,1993,19.6,41,24,15,19,7,21,54,38.9,33,40,14,26,37,78,32,1,2021
GER-Bundesliga,2020,Schalke 04,Ozan Kabak,TUR,DF,20,2000,13.8,17,9,11,5,1,6,13,46.2,7,20,11,9,13,30,57,0,2021
GER-Bundesliga,2020,Schalke 04,Rabbi Matondo,WAL,"FW,MF",19,2000,2.4,3,2,0,3,0,2,3,66.7,1,1,0,1,1,4,1,0,2021
GER-Bundesliga,2020,Schalke 04,Ralf Fährmann,GER,GK,31,1988,20.8,2,1,2,0,0,1,2,50.0,1,0,0,0,1,3,9,3,2021
GER-Bundesliga,2020,Schalke 04,Salif Sané,SEN,DF,29,1990,11.9,17,9,9,7,1,13,23,56.5,10,25,13,12,25,42,66,0,2021
GER-Bundesliga,2020,Schalke 04,Sead Kolašinac,BIH,"DF,MF",27,1993,15.8,20,17,10,7,3,8,18,44.4,10,17,5,12,20,40,17,0,2021
GER-Bundesliga,2020,Schalke 04,Sebastian Rudy,GER,DF,30,1990,2.0,4,2,2,0,2,4,7,57.1,3,6,4,2,1,5,4,0,2021
GER-Bundesliga,2020,Schalke 04,Shkodran Mustafi,GER,DF,28,1992,11.5,16,5,15,1,0,3,12,25.0,9,20,15,5,32,48,76,1,2021
GER-Bundesliga,2020,Schalke 04,Steven Skrzybski,GER,"FW,DF",27,1992,4.7,5,4,0,5,0,1,7,14.3,6,13,1,12,5,10,1,1,2021
GER-Bundesliga,2020,Schalke 04,Suat Serdar,GER,MF,23,1997,21.7,55,35,18,33,4,17,52,32.7,35,29,4,25,23,78,21,0,2021
GER-Bundesliga,2020,Schalke 04,Timo Becker,GER,DF,23,1997,18.2,34,23,28,6,0,16,25,64.0,9,18,4,14,22,56,58,0,2021
GER-Bundesliga,2020,Schalke 04,Vasileios Pavlidis,GRE,FW,17,2002,0.0,0,0,0,0,0,0,0,,0,0,0,0,0,0,0,0,2021
GER-Bundesliga,2020,Schalke 04,Vedad Ibišević,BIH,FW,35,1984,1.7,0,0,0,0,0,0,0,,0,1,0,1,1,1,1,0,2021
GER-Bundesliga,2020,Schalke 04,William,BRA,"DF,FW",25,1995,5.3,14,10,10,4,0,5,15,33.3,10,16,5,11,11,25,15,1,2021
GER-Bundesliga,2020,Stuttgart,Alkhaly Momo Cissé,GUI,"FW,DF",17,2002,0.4,1,1,1,0,0,0,0,,0,1,0,1,0,1,0,0,2021
GER-Bundesliga,2020,Stuttgart,Atakan Karazor,GER,"DF,MF",23,1996,11.5,20,12,12,7,1,13,22,59.1,9,18,8,10,21,41,50,2,2021
GER-Bundesliga,2020,Stuttgart,Borna Sosa,CRO,"DF,FW",22,1998,22.7,14,10,6,6,2,8,25,32.0,17,23,4,19,31,45,74,0,2021
GER-Bundesliga,2020,Stuttgart,Daniel Didavi,GER,"MF,FW",30,1990,10.8,16,6,2,9,5,7,12,58.3,5,10,0,10,3,19,8,0,2021
GER-Bundesliga,2020,Stuttgart,Darko Churlinov,MKD,"DF,MF",20,2000,2.4,2,2,2,0,0,1,3,33.3,2,5,1,4,0,2,2,0,2021
GER-Bundesliga,2020,Stuttgart,Erik Thommy,GER,"MF,DF",25,1994,3.5,3,1,0,3,0,0,3,0.0,3,3,0,3,3,6,4,0,2021
GER-Bundesliga,2020,Stuttgart,Fabian Bredlow,GER,GK,25,1995,1.0,0,0,0,0,0,0,0,,0,0,0,0,0,0,0,0,2021
GER-Bundesliga,2020,Stuttgart,Gonzalo Castro,GER,MF,33,1987,19.2,21,7,6,9,6,8,23,34.8,15,16,3,13,8,29,12,0,2021
GER-Bundesliga,2020,Stuttgart,Gregor Kobel,SUI,GK,22,1997,33.0,2,2,2,0,0,2,2,100.0,0,0,0,0,2,4,8,1,2021
GER-Bundesliga,2020,Stuttgart,Hamadi Al Ghaddioui,MAR,FW,29,1990,0.5,0,0,0,0,0,0,1,0.0,1,0,0,0,0,0,0,0,2021
GER-Bundesliga,2020,Stuttgart,Konstantinos Mavropanos,GRE,DF,22,1997,16.3,42,29,29,12,1,27,46,58.7,19,25,10,15,59,101,66,1,2021
GER-Bundesliga,2020,Stuttgart,Lilian Egloff,GER,MF,17,2002,0.2,0,0,0,0,0,0,0,,0,0,0,0,0,0,0,0,2021
GER-Bundesliga,2020,Stuttgart,Luca Mack,GER,MF,20,2000,0.1,0,0,0,0,0,0,0,,0,0,0,0,0,0,1,0,2021
GER-Bundesliga,2020,Stuttgart,Marc-Oliver Kempf,GER,DF,25,1995,30.3,49,26,28,18,3,29,49,59.2,20,40,25,15,68,117,103,1,2021
GER-Bundesliga,2020,Stuttgart,Marcin Kamiński,POL,DF,28,1992,2.4,1,1,0,0,1,0,0,,0,2,1,1,1,2,10,0,2021
GER-Bundesliga,2020,Stuttgart,Mateo Klimowicz,GER,"MF,FW",20,2000,13.3,20,15,6,10,4,5,18,27.8,13,5,1,4,2,22,2,0,2021
GER-Bundesliga,2020,Stuttgart,Mohamed Sankoh,NED,MF,16,2003,0.2,0,0,0,0,0,0,0,,0,1,0,1,0,0,0,0,2021
GER-Bundesliga,2020,Stuttgart,Naouirou Ahamada,FRA,MF,18,2002,2.8,4,1,3,1,0,1,1,100.0,0,2,0,2,1,5,1,0,2021
GER-Bundesliga,2020,Stuttgart,Nicolás González,ARG,"FW,MF",22,1998,10.4,5,5,1,2,2,0,6,0.0,6,10,3,7,4,9,6,0,2021
GER-Bundesliga,2020,Stuttgart,Orel Mangala,BEL,MF,22,1998,23.4,27,15,13,11,3,17,28,60.7,11,27,10,17,26,53,30,0,2021
GER-Bundesliga,2020,Stuttgart,Pascal Stenzel,GER,DF,24,1996,14.2,33,14,15,17,1,22,50,44.0,28,19,4,15,26,59,39,1,2021
GER-Bundesliga,2020,Stuttgart,Philipp Förster,GER,MF,25,1995,16.8,22,13,7,12,3,6,25,24.0,19,18,1,17,15,37,2,0,2021
GER-Bundesliga,2020,Stuttgart,Philipp Klement,GER,"MF,FW",27,1992,4.7,7,3,6,0,1,3,7,42.9,4,9,2,7,6,13,7,0,2021
GER-Bundesliga,2020,Stuttgart,Roberto Massimo,GER,"DF,FW",19,2000,8.4,21,11,13,5,3,11,24,45.8,13,5,1,4,11,32,13,0,2021
GER-Bundesliga,2020,Stuttgart,Sasa Kalajdzic,AUT,FW,23,1997,23.7,16,12,4,5,7,2,17,11.8,15,10,1,9,9,25,21,0,2021
GER-Bundesliga,2020,Stuttgart,Silas Katompa,COD,"DF,FW",21,1998,21.3,48,29,19,19,10,21,44,47.7,23,29,1,28,22,70,11,2,2021
GER-Bundesliga,2020,Stuttgart,Tanguy Coulibaly,FRA,"DF,FW",19,2001,16.7,26,15,10,7,9,11,23,47.8,12,20,0,20,10,36,11,0,2021
GER-Bundesliga,2020,Stuttgart,Waldemar Anton,GER,DF,24,1996,30.1,31,20,17,14,0,12,31,38.7,19,28,18,10,47,78,114,0,2021
GER-Bundesliga,2020,Stuttgart,Wataru Endo,JPN,MF,27,1993,32.8,65,44,25,34,6,29,71,40.8,42,53,14,39,51,116,59,0,2021
GER-Bundesliga,2020,Union Berlin,Akaki Gogia,GER,"FW,MF",28,1992,1.6,1,0,0,1,0,0,2,0.0,2,0,0,0,1,2,0,0,2021
GER-Bundesliga,2020,Union Berlin,Andreas Luthe,GER,GK,33,1987,30.8,1,1,1,0,0,1,3,33.3,2,1,0,1,0,1,8,3,2021
GER-Bundesliga,2020,Union Berlin,Cedric Teuchert,GER,"FW,MF",23,1997,8.4,7,5,2,4,1,3,16,18.8,13,12,0,12,5,12,6,0,2021
GER-Bundesliga,2020,Union Berlin,Christian Gentner,GER,MF,34,1985,11.5,17,8,9,5,3,5,18,27.8,13,13,1,12,17,34,16,0,2021
GER-Bundesliga,2020,Union Berlin,Christopher Lenz,GER,"DF,FW",25,1994,25.0,74,41,39,30,5,35,71,49.3,36,34,5,29,35,109,50,0,2021
GER-Bundesliga,2020,Union Berlin,Christopher Trimmel,AUT,"DF,FW",33,1987,28.6,50,25,28,18,4,28,54,51.9,26,32,7,25,50,100,99,0,2021
GER-Bundesliga,2020,Union Berlin,Florian Hübner,GER,DF,29,1991,5.8,10,5,7,3,0,7,15,46.7,8,7,3,4,13,23,21,0,2021
GER-Bundesliga,2020,Union Berlin,Grischa Prömel,GER,MF,25,1995,20.2,39,23,14,23,2,18,34,52.9,16,20,2,18,24,63,22,0,2021
GER-Bundesliga,2020,Union Berlin,Joel Pohjanpalo,FIN,FW,25,1994,9.5,5,1,0,3,2,1,6,16.7,5,1,0,1,1,6,12,0,2021
GER-Bundesliga,2020,Union Berlin,Joshua Mees,GER,FW,24,1996,0.1,0,0,0,0,0,0,0,,0,0,0,0,0,0,0,0,2021
GER-Bundesliga,2020,Union Berlin,Julian Ryerson,NOR,"DF,MF",22,1997,11.9,22,15,4,14,4,12,15,80.0,3,13,0,13,11,33,17,0,2021
GER-Bundesliga,2020,Union Berlin,Keita Endo,JPN,"MF,FW",22,1997,5.1,8,3,1,5,2,3,9,33.3,6,5,2,3,6,14,4,0,2021
GER-Bundesliga,2020,Union Berlin,Leon Dajaku,GER,FW,19,2001,0.4,0,0,0,0,0,0,0,,0,0,0,0,0,0,0,0,2021
GER-Bundesliga,2020,Union Berlin,Loris Karius,GER,GK,27,1993,3.2,0,0,0,0,0,0,0,,0,0,0,0,0,0,2,0,2021
GER-Bundesliga,2020,Union Berlin,Marcus Ingvartsen,DEN,"MF,FW",24,1996,21.8,17,11,5,6,6,8,26,30.8,18,22,0,22,18,35,10,0,2021
GER-Bundesliga,2020,Union Berlin,Marius Bülter,GER,"FW,MF",27,1993,10.9,15,8,6,6,3,5,17,29.4,12,17,2,15,12,27,11,0,2021
GER-Bundesliga,2020,Union Berlin,Marvin Friedrich,GER,DF,24,1995,34.0,47,29,35,11,1,18,32,56.3,14,38,18,20,52,99,109,0,2021
GER-Bundesliga,2020,Union Berlin,Max Kruse,GER,"FW,MF",32,1988,18.1,7,3,1,5,1,2,9,22.2,7,11,0,11,3,10,3,0,2021
GER-Bundesliga,2020,Union Berlin,Nico Schlotterbeck,GER,DF,20,1999,14.3,34,19,14,19,1,18,28,64.3,10,13,6,7,31,65,29,1,2021
GER-Bundesliga,2020,Union Berlin,Niko Gießelmann,GER,DF,28,1991,4.8,12,9,7,4,1,5,8,62.5,3,9,3,6,8,20,13,1,2021
GER-Bundesliga,2020,Union Berlin,Petar Musa,CRO,FW,22,1998,7.9,12,8,3,6,3,4,8,50.0,4,10,0,10,4,16,5,0,2021
GER-Bundesliga,2020,Union Berlin,Robert Andrich,GER,MF,25,1994,28.1,51,24,22,27,2,24,53,45.3,29,40,6,34,51,102,31,2,2021
GER-Bundesliga,2020,Union Berlin,Robin Knoche,GER,DF,28,1992,33.8,44,29,30,12,2,23,39,59.0,16,43,27,16,49,93,118,2,2021
GER-Bundesliga,2020,Union Berlin,Sebastian Griesbeck,GER,MF,29,1990,9.9,20,9,8,11,1,8,19,42.1,11,13,3,10,5,25,8,0,2021
GER-Bundesliga,2020,Union Berlin,Sheraldo Becker,SUR,"FW,MF",25,1995,12.3,5,4,2,2,1,3,5,60.0,2,4,0,4,6,11,7,0,2021
GER-Bundesliga,2020,Union Berlin,Taiwo Awoniyi,NGA,FW,22,1997,15.1,5,3,2,3,0,1,14,7.1,13,9,0,9,3,8,4,0,2021
GER-Bundesliga,2020,Union Berlin,Tim Maciejewski,GER,FW,19,2001,0.1,0,0,0,0,0,0,0,,0,0,0,0,0,0,0,0,2021
GER-Bundesliga,2020,Werder Bremen,Christian Groß,GER,"MF,DF",31,1989,16.3,44,28,17,25,2,15,37,40.5,22,12,2,10,24,68,37,0,2021
GER-Bundesliga,2020,Werder Bremen,Davie Selke,GER,FW,25,1995,9.0,3,2,1,1,1,0,6,0.0,6,3,2,1,1,4,7,0,2021
GER-Bundesliga,2020,Werder Bremen,Davy Klaassen,NED,MF,27,1993,2.5,3,1,0,1,2,0,5,0.0,5,5,1,4,3,6,4,0,2021
GER-Bundesliga,2020,Werder Bremen,Eren Dinkçi,GER,"MF,FW",18,2001,1.2,1,1,1,0,0,0,1,0.0,1,4,0,4,2,3,1,0,2021
GER-Bundesliga,2020,Werder Bremen,Felix Agu,GER,DF,20,1999,7.8,20,9,10,9,1,10,18,55.6,8,14,3,11,12,32,18,0,2021
GER-Bundesliga,2020,Werder Bremen,Ilia Gruev,BUL,FW,20,2000,0.0,0,0,0,0,0,0,0,,0,0,0,0,0,0,0,0,2021
GER-Bundesliga,2020,Werder Bremen,Jean-Manuel Mbom,GER,"MF,DF",20,2000,12.9,19,13,14,3,2,8,27,29.6,19,17,6,11,13,32,27,0,2021
GER-Bundesliga,2020,Werder Bremen,Jiří Pavlenka,CZE,GK,28,1992,34.0,2,0,2,0,0,2,2,100.0,0,0,0,0,1,3,17,4,2021
GER-Bundesliga,2020,Werder Bremen,Johannes Eggestein,GER,"FW,MF",22,1998,0.4,0,0,0,0,0,0,1,0.0,1,0,0,0,1,1,2,0,2021
GER-Bundesliga,2020,Werder Bremen,Josh Sargent,USA,"FW,MF",20,2000,27.8,32,19,13,13,6,13,27,48.1,14,39,4,35,17,49,36,0,2021
GER-Bundesliga,2020,Werder Bremen,Kevin Möhwald,GER,MF,27,1993,17.3,15,9,9,5,1,4,18,22.2,14,10,3,7,32,47,19,2,2021
GER-Bundesliga,2020,Werder Bremen,Leonardo Bittencourt,GER,"MF,FW",26,1993,16.8,58,32,24,28,6,16,51,31.4,35,29,2,27,13,71,10,0,2021
GER-Bundesliga,2020,Werder Bremen,Ludwig Augustinsson,SWE,"DF,FW",26,1994,21.7,37,20,19,14,4,17,29,58.6,12,21,7,14,20,57,62,0,2021
GER-Bundesliga,2020,Werder Bremen,Marco Friedl,AUT,DF,22,1998,30.9,50,34,31,17,2,30,62,48.4,32,38,17,21,55,105,118,1,2021
GER-Bundesliga,2020,Werder Bremen,Maximilian Eggestein,GER,MF,23,1996,32.7,57,42,22,29,6,21,46,45.7,25,30,5,25,43,100,36,0,2021
GER-Bundesliga,2020,Werder Bremen,Milot Rashica,KVX,"FW,MF",24,1996,16.2,24,12,11,11,2,12,23,52.2,11,7,0,7,4,28,6,0,2021
GER-Bundesliga,2020,Werder Bremen,Miloš Veljković,SRB,DF,24,1995,19.1,24,14,17,6,1,15,31,48.4,16,22,9,13,29,53,94,1,2021
GER-Bundesliga,2020,Werder Bremen,Nick Woltemade,GER,"MF,FW",18,2002,1.6,3,2,1,1,1,2,4,50.0,2,1,0,1,0,3,0,0,2021
GER-Bundesliga,2020,Werder Bremen,Niclas Füllkrug,GER,FW,27,1993,9.7,7,3,2,4,1,1,13,7.7,12,10,4,6,3,10,13,0,2021
GER-Bundesliga,2020,Werder Bremen,Niklas Moisander,FIN,DF,34,1985,13.6,14,11,11,3,0,8,14,57.1,6,15,8,7,22,36,61,0,2021
GER-Bundesliga,2020,Werder Bremen,Patrick Erras,GER,"FW,MF",25,1995,0.3,0,0,0,0,0,0,1,0.0,1,0,0,0,0,0,0,0,2021
GER-Bundesliga,2020,Werder Bremen,Philipp Bargfrede,GER,MF,31,1989,0.3,0,0,0,0,0,0,0,,0,0,0,0,0,0,3,0,2021
GER-Bundesliga,2020,Werder Bremen,Romano Schmid,AUT,"MF,FW",20,2000,13.1,22,16,8,10,4,8,35,22.9,27,21,0,21,8,30,6,0,2021
GER-Bundesliga,2020,Werder Bremen,Tahith Chong,NED,"MF,FW",20,1999,4.3,11,6,1,9,1,4,8,50.0,4,4,0,4,5,16,1,0,2021
GER-Bundesliga,2020,Werder Bremen,Theodor Gebre Selassie,CZE,DF,33,1986,33.7,61,35,39,17,5,28,64,43.8,36,33,11,22,58,119,98,1,2021
GER-Bundesliga,2020,Werder Bremen,Yuya Osako,JPN,"MF,FW",30,1990,8.5,12,8,2,5,5,2,9,22.2,7,6,1,5,5,17,7,0,2021
GER-Bundesliga,2020,Werder Bremen,Ömer Toprak,TUR,DF,31,1989,21.6,23,16,15,6,2,12,24,50.0,12,27,16,11,36,59,115,1,2021
GER-Bundesliga,2020,Wolfsburg,Admir Mehmedi,SUI,"MF,FW",29,1991,9.1,17,9,6,7,4,6,16,37.5,10,7,0,7,5,22,1,0,2021
GER-Bundesliga,2020,Wolfsburg,Bartosz Bialek,POL,"FW,MF",18,2001,3.0,6,5,1,4,1,4,4,100.0,0,5,1,4,3,9,4,0,2021
GER-Bundesliga,2020,Wolfsburg,Daniel Ginczek,GER,"FW,MF",29,1991,2.4,2,2,1,1,0,2,8,25.0,6,2,0,2,1,3,2,0,2021
GER-Bundesliga,2020,Wolfsburg,Felix Klaus,GER,"DF,MF",27,1992,1.5,7,4,3,4,0,4,5,80.0,1,4,0,4,2,9,4,0,2021
GER-Bundesliga,2020,Wolfsburg,John Brooks,USA,DF,27,1993,30.8,47,29,33,14,0,30,54,55.6,24,35,10,25,55,102,134,0,2021
GER-Bundesliga,2020,Wolfsburg,Josip Brekalo,CRO,FW,22,1998,20.2,22,10,10,7,5,8,29,27.6,21,18,0,18,17,39,3,1,2021
GER-Bundesliga,2020,Wolfsburg,Josuha Guilavogui,FRA,"MF,DF",29,1990,8.3,17,9,9,8,0,5,12,41.7,7,12,5,7,29,46,25,0,2021
GER-Bundesliga,2020,Wolfsburg,João Victor Santos Sá,BRA,FW,26,1994,5.2,9,6,2,6,1,6,11,54.5,5,11,0,11,8,17,2,0,2021
GER-Bundesliga,2020,Wolfsburg,Jérôme Roussillon,FRA,DF,27,1993,13.7,24,12,14,8,2,11,20,55.0,9,10,1,9,19,43,28,0,2021
GER-Bundesliga,2020,Wolfsburg,Kevin Mbabu,SUI,DF,25,1995,18.2,51,33,27,17,7,24,35,68.6,11,28,7,21,22,73,59,1,2021
GER-Bundesliga,2020,Wolfsburg,Koen Casteels,BEL,GK,28,1992,32.0,0,0,0,0,0,0,1,0.0,1,1,0,1,2,2,9,2,2021
GER-Bundesliga,2020,Wolfsburg,Marin Pongračić,CRO,DF,22,1997,6.4,13,9,9,3,1,6,8,75.0,2,12,5,7,11,24,27,0,2021
GER-Bundesliga,2020,Wolfsburg,Maxence Lacroix,FRA,DF,20,2000,28.8,49,29,37,12,0,24,45,53.3,21,51,21,30,65,114,140,1,2021
GER-Bundesliga,2020,Wolfsburg,Maximilian Arnold,GER,MF,26,1994,28.7,47,32,20,26,1,18,49,36.7,31,24,3,21,49,96,57,0,2021
GER-Bundesliga,2020,Wolfsburg,Maximilian Philipp,GER,MF,26,1994,12.3,15,6,3,6,6,5,21,23.8,16,17,0,17,6,21,3,0,2021
GER-Bundesliga,2020,Wolfsburg,Omar Marmoush,EGY,FW,21,1999,0.0,0,0,0,0,0,0,0,,0,0,0,0,0,0,0,0,2021
GER-Bundesliga,2020,Wolfsburg,Paulo Otávio,BRA,DF,25,1994,19.3,60,40,32,22,6,34,62,54.8,28,51,7,44,42,102,59,0,2021
GER-Bundesliga,2020,Wolfsburg,Pavao Pervan,AUT,GK,32,1987,2.0,0,0,0,0,0,0,0,,0,0,0,0,0,0,1,0,2021
GER-Bundesliga,2020,Wolfsburg,Renato Steffen,SUI,"FW,MF",28,1991,17.4,24,15,6,12,6,13,24,54.2,11,21,2,19,22,46,15,0,2021
GER-Bundesliga,2020,Wolfsburg,Ridle Baku,GER,"FW,DF",22,1998,29.8,50,31,20,20,10,22,53,41.5,31,54,4,50,40,90,33,1,2021
GER-Bundesliga,2020,Wolfsburg,Tim Siersleben,GER,DF,20,2000,0.4,2,2,2,0,0,1,1,100.0,0,1,0,1,0,2,0,0,2021
GER-Bundesliga,2020,Wolfsburg,William,BRA,"MF,FW",25,1995,0.0,0,0,0,0,0,0,0,,0,0,0,0,0,0,0,0,2021
GER-Bundesliga,2020,Wolfsburg,Wout Weghorst,NED,FW,27,1992,32.7,13,8,2,8,3,4,20,20.0,16,17,3,14,4,17,26,0,2021
GER-Bundesliga,2020,Wolfsburg,Xaver Schlager,AUT,MF,22,1997,29.2,66,40,20,38,8,22,68,32.4,46,50,6,44,54,120,38,0,2021
GER-Bundesliga,2020,Wolfsburg,Yannick Gerhardt,GER,"MF,FW",26,1994,21.5,52,32,14,32,6,21,52,40.4,31,34,4,30,21,73,30,0,2021
GER-Bundesliga,2020,Wolfsburg,Yunus Mallı,TUR,MF,28,1992,0.6,1,0,0,1,0,1,1,100.0,0,0,0,0,0,1,0,0,2021
GER-Bundesliga,2021,Arminia,Alessandro Schöpf,AUT,MF,27,1994,26.6,40,22,19,16,5,14,30,46.7,16,31,5,26,30,70,21,1,2022
GER-Bundesliga,2021,Arminia,Amos Pieper,GER,DF,23,1998,26.4,58,29,38,19,1,32,51,62.7,19,37,23,14,50,108,132,1,2022
GER-Bundesliga,2021,Arminia,Andrés Andrade Cedeño,PAN,DF,22,1998,11.6,27,16,18,8,1,17,35,48.6,18,16,7,9,19,46,44,0,2022
GER-Bundesliga,2021,Arminia,Bryan Lasme,FRA,FW,22,1998,9.7,6,6,1,2,3,0,3,0.0,3,7,0,7,1,7,9,0,2022
GER-Bundesliga,2021,Arminia,Burak İnce,TUR,FW,17,2004,1.5,1,1,1,0,0,1,2,50.0,1,1,0,1,0,1,0,0,2022
GER-Bundesliga,2021,Arminia,Cédric Brunner,SUI,DF,27,1994,24.3,51,35,29,20,2,25,49,51.0,24,27,10,17,43,94,84,0,2022
GER-Bundesliga,2021,Arminia,Edimilson Fernandes,SUI,"MF,FW",25,1996,3.1,2,0,1,1,0,1,4,25.0,3,2,2,0,2,4,6,0,2022
GER-Bundesliga,2021,Arminia,Fabian Klos,GER,FW,33,1987,15.8,7,5,0,5,2,2,10,20.0,8,17,4,13,0,7,31,0,2022
GER-Bundesliga,2021,Arminia,Fabian Kunze,GER,MF,23,1998,14.0,35,21,14,20,1,15,32,46.9,17,17,2,15,19,54,27,1,2022
GER-Bundesliga,2021,Arminia,Florian Krüger,GER,"FW,MF",22,1999,12.5,3,1,0,3,0,2,10,20.0,8,12,1,11,2,5,13,0,2022
GER-Bundesliga,2021,Arminia,George Bello,USA,DF,19,2002,4.8,7,7,7,0,0,4,4,100.0,0,5,4,1,6,13,11,0,2022
GER-Bundesliga,2021,Arminia,Gonzalo Castro,GER,"MF,FW",34,1987,4.8,8,3,4,4,0,1,5,20.0,4,3,0,3,3,11,3,0,2022
GER-Bundesliga,2021,Arminia,Guilherme Ramos,POR,DF,23,1997,10.1,25,15,17,8,0,12,19,63.2,7,21,8,13,27,52,52,0,2022
GER-Bundesliga,2021,Arminia,Jacob Barrett Laursen,DEN,DF,26,1994,18.1,16,12,10,6,0,8,21,38.1,13,19,7,12,28,44,43,0,2022
GER-Bundesliga,2021,Arminia,Janni Serra,GER,FW,23,1998,12.4,4,2,2,0,2,2,7,28.6,5,8,3,5,5,9,19,0,2022
GER-Bundesliga,2021,Arminia,Joakim Nilsson,SWE,DF,27,1994,30.4,37,19,24,13,0,20,26,76.9,6,36,23,13,56,93,143,1,2022
GER-Bundesliga,2021,Arminia,Lennart-Marten Czyborra,GER,DF,22,1999,1.5,0,0,0,0,0,0,2,0.0,2,0,0,0,3,3,3,1,2022
GER-Bundesliga,2021,Arminia,Manuel Prietl,AUT,MF,29,1991,23.6,59,26,23,31,5,23,60,38.3,37,28,3,25,39,98,33,0,2022
GER-Bundesliga,2021,Arminia,Masaya Okugawa,JPN,"MF,FW",25,1996,28.1,46,25,18,22,6,12,37,32.4,25,29,1,28,20,66,13,0,2022
GER-Bundesliga,2021,Arminia,Mike van der Hoorn,NED,DF,28,1992,0.2,1,0,1,0,0,0,0,,0,0,0,0,1,2,2,0,2022
GER-Bundesliga,2021,Arminia,Nathan de Medina,BEL,DF,23,1997,8.6,17,10,11,6,0,6,10,60.0,4,14,3,11,10,27,28,0,2022
GER-Bundesliga,2021,Arminia,Patrick Wimmer,AUT,"FW,MF",20,2001,22.8,53,31,13,31,9,22,61,36.1,39,30,1,29,27,80,13,0,2022
GER-Bundesliga,2021,Arminia,Robin Hack,GER,"FW,MF",22,1998,15.2,14,8,6,5,3,3,21,14.3,18,18,1,17,5,19,4,0,2022
GER-Bundesliga,2021,Arminia,Sebastian Vasiliadis,GRE,MF,23,1997,13.3,31,17,12,15,4,15,42,35.7,27,15,2,13,25,56,31,1,2022
GER-Bundesliga,2021,Arminia,Stefan Ortega,GER,GK,28,1992,33.0,1,0,1,0,0,1,2,50.0,1,2,0,2,0,1,5,1,2022
GER-Bundesliga,2021,Arminia,Stefanos Kapino,GRE,GK,27,1994,1.0,0,0,0,0,0,0,0,,0,0,0,0,0,0,0,0,2022
GER-Bundesliga,2021,Augsburg,Alfreð Finnbogason,ISL,FW,32,1989,3.2,3,1,0,2,1,2,4,50.0,2,5,1,4,2,5,8,0,2022
GER-Bundesliga,2021,Augsburg,Andi Zeqiri,SUI,"FW,MF",22,1999,11.3,14,7,3,5,6,3,12,25.0,9,10,1,9,2,16,12,0,2022
GER-Bundesliga,2021,Augsburg,André Hahn,GER,"MF,FW",30,1990,23.3,36,20,9,15,12,17,50,34.0,33,38,5,33,15,51,43,0,2022
GER-Bundesliga,2021,Augsburg,Arne Maier,GER,MF,22,1999,20.7,20,13,6,10,4,8,26,30.8,18,18,1,17,15,35,13,0,2022
GER-Bundesliga,2021,Augsburg,Carlos Gruezo,ECU,MF,26,1995,10.8,22,11,10,10,2,8,21,38.1,13,11,2,9,9,31,15,0,2022
GER-Bundesliga,2021,Augsburg,Daniel Caligiuri,ITA,"DF,MF",33,1988,22.3,46,30,17,26,3,27,72,37.5,45,36,5,31,18,64,33,0,2022
GER-Bundesliga,2021,Augsburg,Florian Niederlechner,GER,FW,30,1990,12.9,6,5,1,3,2,4,13,30.8,9,9,0,9,4,10,7,0,2022
GER-Bundesliga,2021,Augsburg,Frederik Winther,DEN,DF,20,2001,3.6,7,2,7,0,0,5,6,83.3,1,4,1,3,8,15,21,0,2022
GER-Bundesliga,2021,Augsburg,Fredrik Jensen,FIN,"MF,FW",23,1997,4.6,5,4,1,3,1,4,7,57.1,3,5,1,4,2,7,4,0,2022
GER-Bundesliga,2021,Augsburg,Iago,BRA,DF,24,1997,24.2,49,29,25,19,5,15,34,44.1,19,28,6,22,27,76,62,0,2022
GER-Bundesliga,2021,Augsburg,Jan Morávek,CZE,MF,31,1989,5.2,11,6,3,7,1,6,18,33.3,12,11,2,9,6,17,8,0,2022
GER-Bundesliga,2021,Augsburg,Jeffrey Gouweleeuw,NED,DF,30,1991,28.6,50,27,33,17,0,22,36,61.1,14,35,18,17,49,99,116,0,2022
GER-Bundesliga,2021,Augsburg,Lasse Günther,GER,DF,18,2003,1.8,8,5,4,3,1,5,9,55.6,4,0,0,0,2,10,2,0,2022
GER-Bundesliga,2021,Augsburg,Mads Pedersen,DEN,"MF,DF",24,1996,15.5,28,21,8,15,5,12,27,44.4,15,13,4,9,15,43,30,0,2022
GER-Bundesliga,2021,Augsburg,Michael Gregoritsch,AUT,"FW,MF",27,1994,15.5,19,8,4,10,5,2,15,13.3,13,18,2,16,6,25,29,0,2022
GER-Bundesliga,2021,Augsburg,Niklas Dorsch,GER,MF,23,1998,25.8,76,47,47,23,6,30,60,50.0,30,34,12,22,35,111,36,3,2022
GER-Bundesliga,2021,Augsburg,Noah Joel Sarenren Bazee,NGA,"MF,FW",24,1996,2.7,5,2,2,2,1,3,4,75.0,1,8,2,6,1,6,4,0,2022
GER-Bundesliga,2021,Augsburg,Ohis Felix Uduokhai,GER,DF,23,1997,8.7,9,6,6,3,0,6,11,54.5,5,13,8,5,9,18,33,0,2022
GER-Bundesliga,2021,Augsburg,Rafał Gikiewicz,POL,GK,33,1987,34.0,2,0,2,0,0,2,7,28.6,5,0,0,0,3,5,11,5,2022
GER-Bundesliga,2021,Augsburg,Raphael Framberger,GER,DF,25,1995,9.4,26,19,12,10,4,13,27,48.1,14,8,2,6,9,35,25,0,2022
GER-Bundesliga,2021,Augsburg,Reece Oxford,ENG,DF,22,1998,29.9,27,14,16,9,2,15,31,48.4,16,42,33,9,72,99,172,1,2022
GER-Bundesliga,2021,Augsburg,Ricardo Pepi,USA,"FW,MF",18,2003,5.3,4,2,1,3,0,1,8,12.5,7,7,0,7,3,7,8,0,2022
GER-Bundesliga,2021,Augsburg,Robert Gumny,POL,DF,23,1998,25.2,48,29,25,20,3,25,43,58.1,18,24,7,17,28,76,57,3,2022
GER-Bundesliga,2021,Augsburg,Ruben Vargas,SUI,"MF,FW",22,1998,22.0,28,21,7,14,7,11,30,36.7,19,9,1,8,16,44,13,0,2022
GER-Bundesliga,2021,Augsburg,Sergio Córdova,VEN,"FW,MF",23,1997,3.6,4,3,2,2,0,1,2,50.0,1,4,0,4,0,4,4,0,2022
GER-Bundesliga,2021,Augsburg,Tobias Strobl,GER,"MF,DF",31,1990,3.6,8,3,3,5,0,3,11,27.3,8,7,2,5,7,15,3,0,2022
GER-Bundesliga,2021,Bayern Munich,Alphonso Davies,CAN,DF,20,2000,19.3,34,17,17,8,9,13,31,41.9,18,27,1,26,23,57,26,1,2022
GER-Bundesliga,2021,Bayern Munich,Benjamin Pavard,FRA,DF,25,1996,23.1,35,20,21,13,1,19,29,65.5,10,28,16,12,36,71,50,1,2022
GER-Bundesliga,2021,Bayern Munich,Bouna Sarr,SEN,DF,29,1992,0.7,4,4,2,1,1,4,5,80.0,1,2,1,1,6,10,1,0,2022
GER-Bundesliga,2021,Bayern Munich,Chris Richards,USA,DF,21,2000,0.0,0,0,0,0,0,0,0,,0,1,0,1,0,0,0,0,2022
GER-Bundesliga,2021,Bayern Munich,Christian Früchtl,GER,GK,21,2000,0.1,0,0,0,0,0,0,0,,0,0,0,0,0,0,0,0,2022
GER-Bundesliga,2021,Bayern Munich,Corentin Tolisso,FRA,MF,26,1994,7.8,11,5,1,9,1,7,17,41.2,10,5,1,4,9,20,10,0,2022
GER-Bundesliga,2021,Bayern Munich,Dayot Upamecano,FRA,DF,22,1998,24.6,66,42,42,21,3,24,36,66.7,12,20,10,10,32,98,71,6,2022
GER-Bundesliga,2021,Bayern Munich,Eric Maxim Choupo-Moting,CMR,"FW,MF",32,1989,4.2,10,9,3,6,1,3,10,30.0,7,1,0,1,5,15,2,0,2022
GER-Bundesliga,2021,Bayern Munich,Gabriel Vidovic,CRO,"FW,MF",17,2003,0.4,0,0,0,0,0,0,0,,0,0,0,0,0,0,0,0,2022
GER-Bundesliga,2021,Bayern Munich,Jamal Musiala,GER,"MF,FW",18,2003,16.3,40,26,11,16,13,15,36,41.7,21,25,0,25,19,59,2,1,2022
GER-Bundesliga,2021,Bayern Munich,Joshua Kimmich,GER,MF,26,1995,27.5,39,20,14,17,8,18,58,31.0,40,34,8,26,52,91,29,1,2022
GER-Bundesliga,2021,Bayern Munich,Josip Stanišić,CRO,DF,21,2000,7.2,21,10,7,12,2,12,18,66.7,6,7,0,7,11,32,10,2,2022
GER-Bundesliga,2021,Bayern Munich,Kingsley Coman,FRA,"FW,DF",25,1996,15.1,14,8,1,9,4,5,16,31.3,11,14,0,14,8,22,5,0,2022
GER-Bundesliga,2021,Bayern Munich,Leon Goretzka,GER,MF,26,1995,15.5,25,15,12,9,4,11,26,42.3,15,11,1,10,17,42,23,2,2022
GER-Bundesliga,2021,Bayern Munich,Leroy Sané,GER,"FW,MF",25,1996,22.0,28,16,5,19,4,9,24,37.5,15,18,0,18,12,40,2,1,2022
GER-Bundesliga,2021,Bayern Munich,Lucas Copado,GER,FW,17,2004,0.2,1,0,1,0,0,1,1,100.0,0,0,0,0,0,1,0,0,2022
GER-Bundesliga,2021,Bayern Munich,Lucas Hernández,FRA,DF,25,1996,22.6,50,31,20,24,6,26,42,61.9,16,22,11,11,28,78,54,1,2022
GER-Bundesliga,2021,Bayern Munich,Malik Tillman,USA,"FW,MF",19,2002,1.2,2,1,0,1,1,0,1,0.0,1,5,1,4,2,4,1,0,2022
GER-Bundesliga,2021,Bayern Munich,Manuel Neuer,GER,GK,35,1986,27.9,2,1,2,0,0,1,2,50.0,1,0,0,0,0,2,7,1,2022
GER-Bundesliga,2021,Bayern Munich,Marc Roca,ESP,MF,24,1996,4.2,9,7,2,4,3,2,8,25.0,6,6,0,6,6,15,4,0,2022
GER-Bundesliga,2021,Bayern Munich,Marcel Sabitzer,AUT,"MF,DF",27,1994,10.1,18,7,8,8,2,9,19,47.4,10,7,0,7,9,27,10,1,2022
GER-Bundesliga,2021,Bayern Munich,Mickaël Cuisance,FRA,MF,21,1999,0.1,1,1,0,1,0,0,0,,0,0,0,0,0,1,0,0,2022
GER-Bundesliga,2021,Bayern Munich,Niklas Süle,GER,DF,25,1995,20.4,29,23,21,7,1,18,24,75.0,6,16,12,4,28,57,49,0,2022
GER-Bundesliga,2021,Bayern Munich,Omar Richards,ENG,DF,23,1998,4.9,19,12,11,5,3,11,16,68.8,5,7,1,6,4,23,7,0,2022
GER-Bundesliga,2021,Bayern Munich,Paul Wanner,GER,"FW,MF",15,2005,0.4,2,2,0,2,0,1,1,100.0,0,0,0,0,0,2,0,0,2022
GER-Bundesliga,2021,Bayern Munich,Robert Lewandowski,POL,FW,32,1988,32.7,10,3,0,6,4,5,17,29.4,12,17,2,15,6,16,8,0,2022
GER-Bundesliga,2021,Bayern Munich,Serge Gnabry,GER,"FW,DF",26,1995,24.3,47,31,16,20,11,22,57,38.6,35,26,0,26,14,61,3,0,2022
GER-Bundesliga,2021,Bayern Munich,Sven Ulreich,GER,GK,32,1988,6.0,0,0,0,0,0,0,0,,0,0,0,0,0,0,1,0,2022
GER-Bundesliga,2021,Bayern Munich,Tanguy Nianzou,FRA,DF,19,2002,6.5,11,7,7,3,1,7,11,63.6,4,7,2,5,7,18,17,0,2022
GER-Bundesliga,2021,Bayern Munich,Thomas Müller,GER,MF,31,1989,28.4,35,20,7,16,12,16,54,29.6,38,32,1,31,15,50,12,0,2022
GER-Bundesliga,2021,Bochum,Anthony Losilla,FRA,MF,35,1986,32.6,65,39,29,30,6,34,69,49.3,35,32,9,23,70,135,53,1,2022
GER-Bundesliga,2021,Bochum,Armel Bella Kotchap,GER,DF,19,2001,19.6,34,20,25,9,0,18,28,64.3,10,21,16,5,42,76,84,2,2022
GER-Bundesliga,2021,Bochum,Christopher Antwi-Adjei,GHA,"FW,MF",27,1994,12.6,21,18,7,8,6,6,26,23.1,20,12,0,12,1,22,8,0,2022
GER-Bundesliga,2021,Bochum,Cristian Gamboa,CRC,DF,31,1989,19.1,59,36,40,16,3,30,61,49.2,31,22,7,15,32,91,35,1,2022
GER-Bundesliga,2021,Bochum,Danilo Soares,BRA,DF,29,1991,28.5,109,71,61,39,9,56,84,66.7,28,63,9,54,62,171,65,2,2022
GER-Bundesliga,2021,Bochum,Danny Blum,GER,FW,30,1991,3.8,2,1,0,0,2,0,2,0.0,2,4,0,4,2,4,1,0,2022
GER-Bundesliga,2021,Bochum,Eduard Löwen,GER,MF,24,1997,15.7,28,22,12,11,5,10,43,23.3,33,17,2,15,9,37,15,1,2022
GER-Bundesliga,2021,Bochum,Elvis Rexhbeçaj,GER,MF,23,1997,28.2,41,20,17,19,5,19,40,47.5,21,41,6,35,27,68,15,0,2022
GER-Bundesliga,2021,Bochum,Erhan Mašović,SRB,DF,22,1998,17.2,35,20,21,13,1,21,33,63.6,12,28,19,9,34,69,64,1,2022
GER-Bundesliga,2021,Bochum,Gerrit Holtmann,PHI,"FW,MF",26,1995,20.4,15,9,5,3,7,6,22,27.3,16,26,2,24,8,23,6,0,2022
GER-Bundesliga,2021,Bochum,Herbert Bockhorn,GER,DF,26,1995,9.4,20,14,13,4,3,12,20,60.0,8,10,1,9,14,34,18,0,2022
GER-Bundesliga,2021,Bochum,Jürgen Locadia,NED,"FW,MF",27,1993,4.9,4,2,1,0,3,1,1,100.0,0,1,0,1,1,5,2,0,2022
GER-Bundesliga,2021,Bochum,Kostas Stafylidis,GRE,"DF,MF",27,1993,15.4,37,27,22,13,2,20,26,76.9,6,19,6,13,31,68,43,0,2022
GER-Bundesliga,2021,Bochum,Luis Hartwig,GER,FW,18,2002,0.0,0,0,0,0,0,0,0,,0,0,0,0,0,0,0,0,2022
GER-Bundesliga,2021,Bochum,Manuel Riemann,GER,GK,32,1988,31.0,1,0,1,0,0,1,4,25.0,3,0,0,0,1,2,12,3,2022
GER-Bundesliga,2021,Bochum,Maxim Leitsch,GER,DF,23,1998,17.1,18,10,9,7,2,10,15,66.7,5,31,19,12,31,49,74,1,2022
GER-Bundesliga,2021,Bochum,Michael Esser,GER,GK,33,1987,3.0,0,0,0,0,0,0,1,0.0,1,0,0,0,0,0,2,0,2022
GER-Bundesliga,2021,Bochum,Miloš Pantović,SRB,"MF,FW",25,1996,17.0,19,10,8,7,4,6,25,24.0,19,26,4,22,18,37,14,0,2022
GER-Bundesliga,2021,Bochum,Patrick Osterhage,GER,MF,21,2000,6.7,9,6,3,5,1,3,7,42.9,4,7,1,6,11,20,8,0,2022
GER-Bundesliga,2021,Bochum,Robert Tesche,GER,MF,34,1987,3.9,6,4,4,1,1,5,7,71.4,2,6,2,4,5,11,5,1,2022
GER-Bundesliga,2021,Bochum,Saulo Decarli,SUI,DF,29,1992,0.1,0,0,0,0,0,0,0,,0,0,0,0,0,0,0,0,2022
GER-Bundesliga,2021,Bochum,Sebastian Polter,GER,FW,30,1991,26.0,9,3,1,4,4,2,11,18.2,9,15,5,10,2,11,24,0,2022
GER-Bundesliga,2021,Bochum,Silvère Ganvoula M'Boussy,CGO,FW,25,1996,1.7,0,0,0,0,0,0,1,0.0,1,0,0,0,0,0,1,0,2022
GER-Bundesliga,2021,Bochum,Simon Zoller,GER,FW,30,1991,6.6,4,2,2,1,1,1,3,33.3,2,3,0,3,4,8,2,0,2022
GER-Bundesliga,2021,Bochum,Soma Novothny,HUN,"FW,MF",27,1994,0.9,1,1,1,0,0,0,1,0.0,1,1,0,1,0,1,2,0,2022
GER-Bundesliga,2021,Bochum,Takuma Asano,JPN,"FW,MF",26,1994,17.9,11,6,3,6,2,5,19,26.3,14,14,1,13,7,18,7,0,2022
GER-Bundesliga,2021,Bochum,Tarsis Bonga,GER,"MF,FW",24,1997,0.2,0,0,0,0,0,0,0,,0,0,0,0,0,0,0,0,2022
GER-Bundesliga,2021,Bochum,Vassilis Lambropoulos,GRE,DF,31,1990,13.0,18,12,13,3,2,11,25,44.0,14,21,10,11,17,35,56,0,2022
GER-Bundesliga,2021,Dortmund,Ansgar Knauff,GER,"FW,MF",19,2002,1.3,3,1,1,1,1,0,4,0.0,4,2,0,2,0,3,4,0,2022
GER-Bundesliga,2021,Dortmund,Antonios Papadopoulos,GER,"DF,MF",21,1999,0.2,0,0,0,0,0,0,0,,0,1,0,1,0,0,0,0,2022
GER-Bundesliga,2021,Dortmund,Axel Witsel,BEL,"MF,DF",32,1989,21.6,42,27,12,23,7,18,30,60.0,12,24,9,15,27,69,38,0,2022
GER-Bundesliga,2021,Dortmund,Dan-Axel Zagadou,FRA,DF,22,1999,10.6,13,7,11,1,1,7,10,70.0,3,14,4,10,15,28,38,2,2022
GER-Bundesliga,2021,Dortmund,Donyell Malen,NED,FW,22,1999,18.7,13,10,4,5,4,7,13,53.8,6,10,0,10,10,23,11,0,2022
GER-Bundesliga,2021,Dortmund,Emre Can,GER,"DF,MF",27,1994,18.8,36,22,20,16,0,15,30,50.0,15,26,10,16,36,72,40,2,2022
GER-Bundesliga,2021,Dortmund,Erling Haaland,NOR,FW,21,2000,21.2,2,1,0,1,1,0,1,0.0,1,8,1,7,1,3,31,0,2022
GER-Bundesliga,2021,Dortmund,Felix Passlack,GER,DF,23,1998,5.2,13,9,8,4,1,6,12,50.0,6,5,1,4,4,17,7,0,2022
GER-Bundesliga,2021,Dortmund,Gio Reyna,USA,MF,18,2002,4.9,7,4,2,4,1,3,9,33.3,6,6,0,6,1,8,3,0,2022
GER-Bundesliga,2021,Dortmund,Gregor Kobel,SUI,GK,23,1997,28.5,0,0,0,0,0,0,2,0.0,2,0,0,0,1,1,20,0,2022
GER-Bundesliga,2021,Dortmund,Immanuel Pherai,NED,MF,20,2001,0.0,0,0,0,0,0,0,0,,0,0,0,0,0,0,0,0,2022
GER-Bundesliga,2021,Dortmund,Jamie Bynoe-Gittens,ENG,FW,16,2004,1.5,3,2,0,2,1,2,5,40.0,3,4,1,3,1,4,1,0,2022
GER-Bundesliga,2021,Dortmund,Jude Bellingham,ENG,MF,18,2003,31.0,52,34,15,31,6,21,53,39.6,32,50,4,46,42,94,32,0,2022
GER-Bundesliga,2021,Dortmund,Julian Brandt,GER,"MF,FW",25,1996,23.1,37,19,13,20,4,17,54,31.5,37,19,2,17,24,61,14,1,2022
GER-Bundesliga,2021,Dortmund,Lennard Maloney,USA,DF,21,1999,0.1,1,0,1,0,0,1,1,100.0,0,0,0,0,0,1,0,0,2022
GER-Bundesliga,2021,Dortmund,Lion Semić,GER,DF,17,2003,0.0,0,0,0,0,0,0,0,,0,0,0,0,0,0,0,0,2022
GER-Bundesliga,2021,Dortmund,Mahmoud Dahoud,GER,MF,25,1996,18.4,42,19,10,24,8,20,46,43.5,26,18,3,15,17,59,16,0,2022
GER-Bundesliga,2021,Dortmund,Manuel Akanji,SUI,DF,26,1995,25.1,33,23,20,11,2,22,32,68.8,10,26,15,11,35,68,58,0,2022
GER-Bundesliga,2021,Dortmund,Marco Reus,GER,"MF,FW",32,1989,27.8,45,30,13,21,11,16,42,38.1,26,23,6,17,12,57,41,1,2022
GER-Bundesliga,2021,Dortmund,Marin Pongračić,CRO,DF,23,1997,9.2,17,10,13,4,0,6,10,60.0,4,11,5,6,17,34,32,2,2022
GER-Bundesliga,2021,Dortmund,Marius Wolf,GER,"DF,FW",26,1995,14.7,26,10,13,9,4,12,24,50.0,12,14,1,13,13,39,8,0,2022
GER-Bundesliga,2021,Dortmund,Marwin Hitz,SUI,GK,33,1987,4.5,0,0,0,0,0,0,0,,0,0,0,0,0,0,2,0,2022
GER-Bundesliga,2021,Dortmund,Mats Hummels,GER,DF,32,1988,19.6,34,22,20,13,1,20,36,55.6,16,18,13,5,32,66,66,1,2022
GER-Bundesliga,2021,Dortmund,Nico Schulz,GER,DF,28,1993,9.3,21,12,9,7,5,9,21,42.9,12,8,1,7,11,32,8,0,2022
GER-Bundesliga,2021,Dortmund,Raphaël Guerreiro,POR,DF,27,1993,19.9,35,19,19,12,4,16,31,51.6,15,18,2,16,25,60,14,1,2022
GER-Bundesliga,2021,Dortmund,Reinier,BRA,"FW,MF",19,2002,1.8,5,3,4,0,1,1,1,100.0,0,3,0,3,0,5,0,0,2022
GER-Bundesliga,2021,Dortmund,Roman Bürki,SUI,GK,30,1990,1.0,0,0,0,0,0,0,0,,0,0,0,0,0,0,0,0,2022
GER-Bundesliga,2021,Dortmund,Steffen Tigges,GER,"FW,MF",23,1998,1.2,4,3,1,2,1,2,3,66.7,1,3,1,2,0,4,3,0,2022
GER-Bundesliga,2021,Dortmund,Thomas Delaney,DEN,MF,29,1991,0.2,0,0,0,0,0,0,0,,0,0,0,0,0,0,0,0,2022
GER-Bundesliga,2021,Dortmund,Thomas Meunier,BEL,DF,29,1991,15.6,29,19,13,12,4,16,33,48.5,17,10,2,8,12,41,25,1,2022
GER-Bundesliga,2021,Dortmund,Thorgan Hazard,BEL,"FW,DF",28,1993,14.9,23,13,8,10,5,15,40,37.5,25,23,1,22,6,29,4,0,2022
GER-Bundesliga,2021,Dortmund,Tom Rothe,GER,DF,16,2004,1.0,4,3,2,2,0,3,6,50.0,3,2,0,2,2,6,3,0,2022
GER-Bundesliga,2021,Dortmund,Youssoufa Moukoko,GER,"FW,MF",16,2004,2.5,1,0,0,1,0,0,1,0.0,1,5,0,5,3,4,0,0,2022
GER-Bundesliga,2021,Eint Frankfurt,Ajdin Hrustic,AUS,MF,25,1996,10.7,16,11,5,7,4,11,32,34.4,21,18,1,17,10,26,7,0,2022
GER-Bundesliga,2021,Eint Frankfurt,Almamy Touré,MLI,"DF,MF",25,1996,5.6,12,9,8,3,1,4,17,23.5,13,10,3,7,5,17,19,0,2022
GER-Bundesliga,2021,Eint Frankfurt,Ansgar Knauff,GER,"DF,MF",19,2002,8.4,18,14,8,5,5,8,15,53.3,7,11,1,10,8,26,6,0,2022
GER-Bundesliga,2021,Eint Frankfurt,Aymen Barkok,MAR,"MF,DF",23,1998,1.8,6,2,2,3,1,2,7,28.6,5,4,1,3,5,11,6,0,2022
GER-Bundesliga,2021,Eint Frankfurt,Christopher Lenz,GER,DF,26,1994,7.4,29,15,22,6,1,12,21,57.1,9,9,4,5,7,36,21,0,2022
GER-Bundesliga,2021,Eint Frankfurt,Daichi Kamada,JPN,MF,24,1996,23.8,40,21,7,26,7,11,40,27.5,29,18,0,18,8,48,10,0,2022
GER-Bundesliga,2021,Eint Frankfurt,Danny da Costa,GER,"DF,MF",28,1993,8.1,15,4,6,7,2,6,18,33.3,12,14,1,13,11,26,18,1,2022
GER-Bundesliga,2021,Eint Frankfurt,Diant Ramaj,GER,GK,19,2001,1.0,0,0,0,0,0,0,0,,0,0,0,0,0,0,3,0,2022
GER-Bundesliga,2021,Eint Frankfurt,Djibril Sow,SUI,MF,24,1997,26.8,57,33,28,25,4,22,60,36.7,38,35,8,27,50,107,20,1,2022
GER-Bundesliga,2021,Eint Frankfurt,Erik Durm,GER,DF,29,1992,5.3,13,7,6,5,2,10,13,76.9,3,8,1,7,10,23,7,0,2022
GER-Bundesliga,2021,Eint Frankfurt,Filip Kostić,SRB,"DF,FW",28,1992,28.0,44,17,26,9,9,20,53,37.7,33,24,1,23,15,59,24,0,2022
GER-Bundesliga,2021,Eint Frankfurt,Gonçalo Paciência,POR,FW,26,1994,5.7,4,2,2,1,1,1,3,33.3,2,2,0,2,1,5,4,0,2022
GER-Bundesliga,2021,Eint Frankfurt,Jens Grahl,GER,GK,32,1988,1.0,0,0,0,0,0,0,0,,0,0,0,0,0,0,1,0,2022
GER-Bundesliga,2021,Eint Frankfurt,Jens Petter Hauge,NOR,"MF,FW",21,1999,11.6,14,5,6,7,1,7,23,30.4,16,7,0,7,3,17,5,0,2022
GER-Bundesliga,2021,Eint Frankfurt,Jesper Lindstrøm,DEN,"MF,FW",21,2000,22.0,28,13,6,13,9,12,36,33.3,24,30,0,30,24,52,11,1,2022
GER-Bundesliga,2021,Eint Frankfurt,Kevin Trapp,GER,GK,31,1990,32.0,0,0,0,0,0,0,1,0.0,1,0,0,0,1,1,13,2,2022
GER-Bundesliga,2021,Eint Frankfurt,Kristijan Jakić,CRO,MF,24,1997,20.9,37,22,10,21,6,15,62,24.2,47,33,3,30,21,58,25,1,2022
GER-Bundesliga,2021,Eint Frankfurt,Makoto Hasebe,JPN,DF,37,1984,13.2,27,12,15,11,1,13,29,44.8,16,24,8,16,22,49,36,0,2022
GER-Bundesliga,2021,Eint Frankfurt,Martin Hinteregger,AUT,DF,28,1992,24.7,45,28,28,16,1,28,43,65.1,15,36,16,20,42,87,78,3,2022
GER-Bundesliga,2021,Eint Frankfurt,Obite N'Dicka,FRA,DF,21,1999,31.7,60,34,29,27,4,44,59,74.6,15,46,20,26,48,108,137,0,2022
GER-Bundesliga,2021,Eint Frankfurt,Rafael Borré,COL,FW,25,1995,26.4,31,22,4,13,14,7,33,21.2,26,24,4,20,5,36,9,0,2022
GER-Bundesliga,2021,Eint Frankfurt,Ragnar Ache,GER,"MF,FW",23,1998,2.9,2,0,0,1,1,1,4,25.0,3,3,0,3,0,2,1,0,2022
GER-Bundesliga,2021,Eint Frankfurt,Sam Lammers,NED,"FW,MF",24,1997,5.7,4,4,0,2,2,2,6,33.3,4,9,2,7,2,6,4,0,2022
GER-Bundesliga,2021,Eint Frankfurt,Sebastian Rode,GER,MF,30,1990,8.4,15,7,5,8,2,5,17,29.4,12,11,1,10,13,28,8,0,2022
GER-Bundesliga,2021,Eint Frankfurt,Stefan Ilsanker,AUT,"DF,MF",32,1989,3.0,14,8,7,6,1,5,10,50.0,5,6,2,4,6,20,15,1,2022
GER-Bundesliga,2021,Eint Frankfurt,Timothy Chandler,USA,DF,31,1990,13.5,18,12,10,8,0,11,24,45.8,13,10,3,7,19,37,28,1,2022
GER-Bundesliga,2021,Eint Frankfurt,Tuta,BRA,DF,22,1999,24.3,46,28,20,22,4,26,47,55.3,21,43,15,28,41,87,76,1,2022
GER-Bundesliga,2021,Freiburg,Baptiste Santamaria,FRA,MF,26,1995,0.2,0,0,0,0,0,0,1,0.0,1,0,0,0,1,1,1,0,2022
GER-Bundesliga,2021,Freiburg,Benjamin Uphoff,GER,GK,27,1993,2.0,0,0,0,0,0,0,0,,0,0,0,0,0,0,2,2,2022
GER-Bundesliga,2021,Freiburg,Christian Günter,GER,"DF,MF",28,1993,34.0,34,20,16,15,3,18,50,36.0,32,23,6,17,17,51,49,2,2022
GER-Bundesliga,2021,Freiburg,Dominique Heintz,GER,DF,27,1993,0.3,0,0,0,0,0,0,0,,0,0,0,0,1,1,0,0,2022
GER-Bundesliga,2021,Freiburg,Ermedin Demirović,BIH,FW,23,1998,9.7,12,6,4,4,4,1,10,10.0,9,14,1,13,1,13,7,0,2022
GER-Bundesliga,2021,Freiburg,Hugo Siquet,BEL,DF,19,2002,0.2,0,0,0,0,0,0,0,,0,0,0,0,0,0,0,0,2022
GER-Bundesliga,2021,Freiburg,Janik Haberer,GER,MF,27,1994,9.1,14,8,5,6,3,7,19,36.8,12,11,4,7,16,30,11,0,2022
GER-Bundesliga,2021,Freiburg,Jeong Woo-yeong,KOR,"FW,MF",21,1999,19.8,15,9,6,7,2,5,15,33.3,10,8,1,7,7,22,11,0,2022
GER-Bundesliga,2021,Freiburg,Jonathan Schmid,FRA,DF,31,1990,6.5,12,6,6,3,3,5,7,71.4,2,7,1,6,6,18,15,0,2022
GER-Bundesliga,2021,Freiburg,Keven Schlotterbeck,GER,"DF,FW",24,1997,3.5,11,5,6,5,0,5,6,83.3,1,7,4,3,11,22,24,1,2022
GER-Bundesliga,2021,Freiburg,Kevin Schade,GER,"MF,FW",19,2001,9.2,9,7,6,2,1,3,10,30.0,7,15,3,12,3,12,16,0,2022
GER-Bundesliga,2021,Freiburg,Kiliann Sildillia,FRA,"DF,MF",19,2002,1.9,7,3,3,4,0,3,6,50.0,3,1,0,1,2,9,7,1,2022
GER-Bundesliga,2021,Freiburg,Lucas Höler,GER,FW,27,1994,28.7,41,25,10,17,14,13,28,46.4,15,25,4,21,17,58,39,2,2022
GER-Bundesliga,2021,Freiburg,Lukas Kübler,GER,"DF,MF",28,1992,25.9,62,35,38,16,8,28,49,57.1,21,24,8,16,44,106,70,0,2022
GER-Bundesliga,2021,Freiburg,Manuel Gulde,GER,DF,30,1991,13.6,18,10,14,3,1,8,11,72.7,3,16,8,8,17,35,37,0,2022
GER-Bundesliga,2021,Freiburg,Mark Flekken,NED,GK,28,1993,32.0,0,0,0,0,0,0,2,0.0,2,1,0,1,2,2,10,1,2022
GER-Bundesliga,2021,Freiburg,Maximilian Eggestein,GER,MF,24,1996,24.4,48,28,17,25,6,22,50,44.0,28,35,11,24,30,78,32,1,2022
GER-Bundesliga,2021,Freiburg,Nico Schlotterbeck,GER,DF,21,1999,30.9,72,43,36,34,2,33,48,68.8,15,41,32,9,56,128,154,1,2022
GER-Bundesliga,2021,Freiburg,Nicolas Höfler,GER,MF,31,1990,28.9,73,42,37,29,7,28,62,45.2,34,50,21,29,46,119,42,0,2022
GER-Bundesliga,2021,Freiburg,Nils Petersen,GER,FW,32,1988,6.4,5,3,2,3,0,1,13,7.7,12,7,0,7,2,7,17,0,2022
GER-Bundesliga,2021,Freiburg,Noah Weißhaupt,GER,"MF,FW",19,2001,1.1,1,1,1,0,0,1,2,50.0,1,2,0,2,1,2,1,1,2022
GER-Bundesliga,2021,Freiburg,Philipp Lienhart,AUT,DF,25,1996,31.9,24,13,17,6,1,13,24,54.2,11,33,23,10,50,74,158,1,2022
GER-Bundesliga,2021,Freiburg,Roland Sallai,HUN,"MF,FW",24,1997,17.2,22,16,8,11,3,7,23,30.4,16,12,0,12,11,33,12,0,2022
GER-Bundesliga,2021,Freiburg,Vincent Vermeij,NED,MF,26,1994,0.0,0,0,0,0,0,0,0,,0,1,0,1,0,0,0,0,2022
GER-Bundesliga,2021,Freiburg,Vincenzo Grifo,ITA,"MF,FW",28,1993,30.8,27,15,9,13,5,9,26,34.6,17,12,2,10,13,40,28,0,2022
GER-Bundesliga,2021,Freiburg,Yannik Keitel,GER,MF,21,2000,5.6,11,4,5,4,2,5,15,33.3,10,7,1,6,1,12,8,0,2022
GER-Bundesliga,2021,Greuther Fürth,Abdourahmane Barry,FRA,DF,21,2000,2.3,6,4,3,3,0,5,7,71.4,2,5,2,3,4,10,1,0,2022
GER-Bundesliga,2021,Greuther Fürth,Adrian Fein,GER,MF,22,1999,0.4,0,0,0,0,0,0,1,0.0,1,0,0,0,2,2,0,0,2022
GER-Bundesliga,2021,Greuther Fürth,Afimico Pululu,FRA,"FW,MF",22,1999,0.8,1,0,1,0,0,1,2,50.0,1,1,0,1,0,1,0,0,2022
GER-Bundesliga,2021,Greuther Fürth,Andreas Linde,SWE,GK,28,1993,12.0,0,0,0,0,0,0,0,,0,0,0,0,1,1,1,1,2022
GER-Bundesliga,2021,Greuther Fürth,Branimir Hrgota,SWE,FW,28,1993,30.9,46,29,10,31,5,21,72,29.2,51,27,1,26,11,57,3,1,2022
GER-Bundesliga,2021,Greuther Fürth,Cedric Itten,SUI,FW,24,1996,7.1,5,2,1,2,2,1,6,16.7,5,3,0,3,2,7,4,0,2022
GER-Bundesliga,2021,Greuther Fürth,Dickson Abiama,NGA,FW,22,1998,8.1,11,7,4,5,2,2,10,20.0,8,12,1,11,4,15,8,0,2022
GER-Bundesliga,2021,Greuther Fürth,Gian-Luca Itter,GER,DF,22,1999,16.2,44,26,30,11,3,21,38,55.3,17,24,9,15,13,57,51,0,2022
GER-Bundesliga,2021,Greuther Fürth,Gideon Jung,GER,DF,26,1994,1.6,3,1,1,2,0,2,4,50.0,2,1,1,0,2,5,5,0,2022
GER-Bundesliga,2021,Greuther Fürth,Hans Nunoo Sarpei,GHA,"DF,MF",22,1998,7.1,16,11,9,7,0,10,14,71.4,4,8,5,3,14,30,21,0,2022
GER-Bundesliga,2021,Greuther Fürth,Håvard Nielsen,NOR,"MF,FW",28,1993,15.2,17,12,5,11,1,8,21,38.1,13,18,1,17,7,24,22,0,2022
GER-Bundesliga,2021,Greuther Fürth,Jamie Leweling,GER,"FW,MF",20,2001,21.8,13,8,3,7,3,3,16,18.8,13,9,0,9,13,26,5,0,2022
GER-Bundesliga,2021,Greuther Fürth,Jeremy Dudziak,TUN,"MF,FW",25,1995,12.6,17,6,5,8,4,3,14,21.4,11,8,0,8,10,27,4,0,2022
GER-Bundesliga,2021,Greuther Fürth,Jessic Ngankam,GER,FW,21,2000,3.8,3,1,1,1,1,1,2,50.0,1,3,0,3,0,3,1,0,2022
GER-Bundesliga,2021,Greuther Fürth,Jetro Willems,NED,DF,27,1994,17.8,30,15,18,10,2,15,26,57.7,11,15,3,12,14,44,42,0,2022
GER-Bundesliga,2021,Greuther Fürth,Julian Green,USA,MF,26,1995,11.7,9,5,0,8,1,2,8,25.0,6,10,2,8,7,16,10,0,2022
GER-Bundesliga,2021,Greuther Fürth,Justin Hoogma,NED,DF,23,1998,3.0,6,5,4,2,0,4,6,66.7,2,5,5,0,4,10,4,0,2022
GER-Bundesliga,2021,Greuther Fürth,Marco Meyerhöfer,GER,DF,25,1995,25.3,53,35,22,22,9,24,37,64.9,13,38,19,19,47,100,64,1,2022
GER-Bundesliga,2021,Greuther Fürth,Marius Funk,GER,GK,25,1996,8.0,0,0,0,0,0,0,0,,0,0,0,0,0,0,8,1,2022
GER-Bundesliga,2021,Greuther Fürth,Max Christiansen,GER,MF,24,1996,22.8,46,25,19,22,5,18,43,41.9,25,52,16,36,68,114,56,0,2022
GER-Bundesliga,2021,Greuther Fürth,Maximilian Bauer,GER,DF,21,2000,18.8,28,15,17,10,1,11,28,39.3,17,24,14,10,29,57,99,0,2022
GER-Bundesliga,2021,Greuther Fürth,Nick Viergever,NED,DF,31,1989,23.7,32,23,25,7,0,24,34,70.6,10,31,22,9,37,69,119,1,2022
GER-Bundesliga,2021,Greuther Fürth,Nils Seufert,GER,MF,24,1997,1.1,3,2,1,1,1,0,1,0.0,1,0,0,0,0,3,0,0,2022
GER-Bundesliga,2021,Greuther Fürth,Paul Seguin,GER,MF,26,1995,23.4,50,31,15,32,3,26,56,46.4,30,27,3,24,19,69,30,1,2022
GER-Bundesliga,2021,Greuther Fürth,Sascha Burchert,GER,GK,31,1989,14.0,1,1,1,0,0,1,2,50.0,1,0,0,0,0,1,11,1,2022
GER-Bundesliga,2021,Greuther Fürth,Sebastian Griesbeck,GER,"DF,MF",30,1990,27.1,60,31,38,19,3,39,62,62.9,23,38,13,25,43,103,100,1,2022
GER-Bundesliga,2021,Greuther Fürth,Simon Asta,GER,DF,20,2001,8.7,13,6,4,5,4,4,8,50.0,4,14,2,12,8,21,16,0,2022
GER-Bundesliga,2021,Greuther Fürth,Timothy Tillman,GER,MF,22,1999,22.3,43,26,17,18,8,19,42,45.2,23,33,4,29,12,55,26,0,2022
GER-Bundesliga,2021,Greuther Fürth,Tobias Raschl,GER,MF,21,2000,6.6,12,9,4,8,0,5,7,71.4,2,10,1,9,3,15,1,0,2022
GER-Bundesliga,2021,Hertha BSC,Alexander Schwolow,GER,GK,29,1992,24.2,0,0,0,0,0,0,1,0.0,1,0,0,0,2,2,18,3,2022
GER-Bundesliga,2021,Hertha BSC,Anton Kade,GER,"FW,MF",17,2004,0.9,4,2,3,1,0,2,8,25.0,6,3,0,3,3,7,1,0,2022
GER-Bundesliga,2021,Hertha BSC,Cimo Röcker,GER,DF,27,1994,0.2,0,0,0,0,0,0,0,,0,0,0,0,2,2,0,0,2022
GER-Bundesliga,2021,Hertha BSC,Davie Selke,GER,FW,26,1995,11.2,5,4,1,3,1,1,3,33.3,2,6,1,5,1,6,11,0,2022
GER-Bundesliga,2021,Hertha BSC,Dedryck Boyata,BEL,DF,30,1990,21.1,15,13,11,3,1,8,11,72.7,3,17,13,4,17,32,134,1,2022
GER-Bundesliga,2021,Hertha BSC,Dennis Jastrzembski,POL,"DF,FW",21,2000,2.5,2,1,1,1,0,2,8,25.0,6,1,0,1,5,7,3,0,2022
GER-Bundesliga,2021,Hertha BSC,Deyovaisio Zeefuik,NED,DF,23,1998,6.3,11,10,6,4,1,6,12,50.0,6,12,4,8,11,22,21,1,2022
GER-Bundesliga,2021,Hertha BSC,Dodi Lukebakio,BEL,FW,23,1997,2.0,2,1,2,0,0,1,3,33.3,2,2,0,2,2,4,0,0,2022
GER-Bundesliga,2021,Hertha BSC,Fredrik André Bjørkan,NOR,DF,22,1998,3.9,12,10,7,4,1,7,9,77.8,2,6,2,4,6,18,8,0,2022
GER-Bundesliga,2021,Hertha BSC,Ishak Belfodil,ALG,FW,29,1992,18.2,9,6,4,4,1,4,8,50.0,4,9,1,8,5,14,16,0,2022
GER-Bundesliga,2021,Hertha BSC,Javairô Dilrosun,NED,FW,23,1998,1.5,3,1,1,2,0,1,1,100.0,0,1,0,1,0,3,0,0,2022
GER-Bundesliga,2021,Hertha BSC,Jordan Torunarigha,GER,DF,23,1997,5.4,4,1,1,3,0,4,5,80.0,1,4,2,2,17,21,30,0,2022
GER-Bundesliga,2021,Hertha BSC,Julian Eitschberger,GER,DF,17,2004,0.5,0,0,0,0,0,0,1,0.0,1,1,1,0,2,2,2,0,2022
GER-Bundesliga,2021,Hertha BSC,Jurgen Ekkelenkamp,NED,"MF,FW",21,2000,8.0,8,3,2,6,0,2,7,28.6,5,9,2,7,4,12,5,0,2022
GER-Bundesliga,2021,Hertha BSC,Kevin-Prince Boateng,GHA,"MF,FW",34,1987,7.7,6,5,1,4,1,3,9,33.3,6,7,2,5,6,12,11,0,2022
GER-Bundesliga,2021,Hertha BSC,Krzysztof Piątek,POL,FW,26,1995,3.9,2,2,0,1,1,0,1,0.0,1,0,0,0,0,2,6,0,2022
GER-Bundesliga,2021,Hertha BSC,Lee Dongjun,KOR,"MF,FW",24,1997,1.3,2,1,0,2,0,1,3,33.3,2,2,0,2,2,4,1,0,2022
GER-Bundesliga,2021,Hertha BSC,Linus Gechter,GER,DF,17,2004,8.0,15,8,13,2,0,7,14,50.0,7,12,7,5,11,26,29,0,2022
GER-Bundesliga,2021,Hertha BSC,Luca Wollschläger,GER,"FW,MF",18,2003,0.2,1,1,0,1,0,0,1,0.0,1,0,0,0,0,1,0,0,2022
GER-Bundesliga,2021,Hertha BSC,Lucas Tousart,FRA,MF,24,1997,21.8,42,25,15,22,5,10,34,29.4,24,30,6,24,35,77,55,0,2022
GER-Bundesliga,2021,Hertha BSC,Lukas Klünter,GER,DF,25,1996,2.2,1,1,1,0,0,1,5,20.0,4,1,0,1,2,3,2,0,2022
GER-Bundesliga,2021,Hertha BSC,Marc-Oliver Kempf,GER,DF,26,1995,11.7,10,9,9,1,0,5,14,35.7,9,14,7,7,25,35,49,1,2022
GER-Bundesliga,2021,Hertha BSC,Marcel Lotka,POL,GK,20,2001,9.8,1,0,1,0,0,1,1,100.0,0,0,0,0,1,2,3,3,2022
GER-Bundesliga,2021,Hertha BSC,Marco Richter,GER,"FW,MF",23,1997,18.9,30,16,14,10,6,13,36,36.1,23,30,4,26,16,46,24,0,2022
GER-Bundesliga,2021,Hertha BSC,Marten Winkler,GER,MF,18,2002,0.3,0,0,0,0,0,0,0,,0,0,0,0,0,0,0,0,2022
GER-Bundesliga,2021,Hertha BSC,Marvin Plattenhardt,GER,DF,29,1992,18.2,25,11,18,6,1,15,27,55.6,12,18,3,15,17,42,52,0,2022
GER-Bundesliga,2021,Hertha BSC,Matheus Cunha,BRA,FW,22,1999,0.7,0,0,0,0,0,0,0,,0,0,0,0,0,0,0,0,2022
GER-Bundesliga,2021,Hertha BSC,Maximilian Mittelstädt,GER,"DF,FW",24,1997,16.6,52,33,30,12,10,26,50,52.0,24,28,5,23,46,98,37,0,2022
GER-Bundesliga,2021,Hertha BSC,Myziane Maolida,FRA,"FW,MF",22,1999,8.6,7,4,5,1,1,3,9,33.3,6,5,0,5,1,8,6,0,2022
GER-Bundesliga,2021,Hertha BSC,Márton Dárdai,GER,DF,19,2002,8.4,10,4,8,2,0,8,18,44.4,10,16,6,10,20,30,33,2,2022
GER-Bundesliga,2021,Hertha BSC,Niklas Stark,GER,DF,26,1995,22.6,28,16,18,10,0,12,17,70.6,5,27,17,10,36,64,122,2,2022
GER-Bundesliga,2021,Hertha BSC,Peter Pekarík,SVK,DF,34,1986,24.8,45,29,33,11,1,32,46,69.6,14,28,10,18,29,74,58,0,2022
GER-Bundesliga,2021,Hertha BSC,Santiago Ascacíbar,ARG,MF,24,1997,26.4,93,54,50,37,6,38,89,42.7,51,31,6,25,41,134,42,0,2022
GER-Bundesliga,2021,Hertha BSC,Stevan Jovetić,MNE,"FW,MF",31,1989,11.3,5,2,0,2,3,1,6,16.7,5,3,0,3,1,6,6,0,2022
GER-Bundesliga,2021,Hertha BSC,Suat Serdar,GER,"MF,FW",24,1997,24.6,64,30,24,29,11,25,55,45.5,30,32,3,29,20,84,14,0,2022
GER-Bundesliga,2021,Hertha BSC,Vladimír Darida,CZE,MF,30,1990,19.8,32,18,15,13,4,13,32,40.6,19,22,3,19,20,52,17,2,2022
GER-Bundesliga,2021,Hoffenheim,Andrej Kramarić,CRO,"FW,MF",30,1991,30.1,8,4,1,5,2,7,17,41.2,10,10,0,10,9,17,7,1,2022
GER-Bundesliga,2021,Hoffenheim,Angelo Stiller,GER,MF,20,2001,18.8,30,17,11,15,4,9,23,39.1,14,32,6,26,9,39,16,2,2022
GER-Bundesliga,2021,Hoffenheim,Benjamin Hübner,GER,DF,32,1989,4.2,9,5,0,7,2,3,5,60.0,2,2,2,0,9,18,7,0,2022
GER-Bundesliga,2021,Hoffenheim,Chris Richards,USA,DF,21,2000,14.5,26,15,10,15,1,11,18,61.1,7,21,9,12,22,48,50,1,2022
GER-Bundesliga,2021,Hoffenheim,Christoph Baumgartner,AUT,"MF,FW",21,1999,21.0,28,15,14,7,7,13,32,40.6,19,24,3,21,8,36,16,0,2022
GER-Bundesliga,2021,Hoffenheim,David Raum,GER,"DF,FW",23,1998,30.6,52,29,30,10,12,30,64,46.9,34,38,5,33,27,79,39,1,2022
GER-Bundesliga,2021,Hoffenheim,Dennis Geiger,GER,MF,23,1998,15.3,34,23,9,20,5,17,30,56.7,13,15,1,14,14,48,7,1,2022
GER-Bundesliga,2021,Hoffenheim,Diadie Samassékou,MLI,MF,25,1996,18.4,41,26,14,21,6,21,44,47.7,23,27,11,16,28,69,26,0,2022
GER-Bundesliga,2021,Hoffenheim,Ermin Bičakčić,BIH,DF,31,1990,0.1,0,0,0,0,0,0,0,,0,0,0,0,0,0,0,0,2022
GER-Bundesliga,2021,Hoffenheim,Fisnik Asllani,KVX,"MF,FW",18,2002,0.1,0,0,0,0,0,0,1,0.0,1,0,0,0,0,0,0,0,2022
GER-Bundesliga,2021,Hoffenheim,Florian Grillitsch,AUT,"DF,MF",25,1995,16.6,37,19,15,21,1,17,31,54.8,14,18,7,11,29,66,36,1,2022
GER-Bundesliga,2021,Hoffenheim,Georginio Rutter,FRA,"FW,MF",19,2002,17.9,18,13,4,8,6,6,17,35.3,11,29,1,28,6,24,11,1,2022
GER-Bundesliga,2021,Hoffenheim,Håvard Nordtveit,NOR,DF,31,1990,3.4,7,6,2,4,1,4,4,100.0,0,2,1,1,10,17,11,0,2022
GER-Bundesliga,2021,Hoffenheim,Ihlas Bebou,TOG,"FW,DF",27,1994,23.2,22,14,5,12,5,7,21,33.3,14,20,3,17,12,34,25,0,2022
GER-Bundesliga,2021,Hoffenheim,Jacob Bruun Larsen,DEN,"FW,MF",22,1998,9.0,2,1,1,1,0,0,5,0.0,5,14,3,11,5,7,5,2,2022
GER-Bundesliga,2021,Hoffenheim,Justin Che,USA,"FW,DF",17,2003,0.5,2,0,1,0,1,1,2,50.0,1,0,0,0,1,3,0,0,2022
GER-Bundesliga,2021,Hoffenheim,Kasim Nuhu,GHA,DF,26,1995,0.1,0,0,0,0,0,0,1,0.0,1,0,0,0,0,0,1,0,2022
GER-Bundesliga,2021,Hoffenheim,Kevin Akpoguma,NGA,"DF,FW",26,1995,17.0,33,19,16,11,6,16,28,57.1,12,32,2,30,20,53,29,2,2022
GER-Bundesliga,2021,Hoffenheim,Kevin Vogt,GER,DF,29,1991,28.5,21,12,15,6,0,11,21,52.4,10,18,7,11,13,34,101,1,2022
GER-Bundesliga,2021,Hoffenheim,Marco John,GER,DF,19,2002,0.5,0,0,0,0,0,0,1,0.0,1,1,0,1,1,1,1,0,2022
GER-Bundesliga,2021,Hoffenheim,Mijat Gaćinović,SRB,"FW,MF",26,1995,1.2,3,3,1,1,1,3,3,100.0,0,1,0,1,1,4,2,0,2022
GER-Bundesliga,2021,Hoffenheim,Moanes Dabbur,ISR,"FW,MF",29,1992,14.6,18,10,3,5,10,4,17,23.5,13,10,0,10,5,23,4,0,2022
GER-Bundesliga,2021,Hoffenheim,Nick Proschwitz,GER,FW,34,1986,0.3,0,0,0,0,0,0,0,,0,0,0,0,0,0,0,0,2022
GER-Bundesliga,2021,Hoffenheim,Oliver Baumann,GER,GK,31,1990,33.0,0,0,0,0,0,0,3,0.0,3,0,0,0,0,0,19,1,2022
GER-Bundesliga,2021,Hoffenheim,Pavel Kadeřábek,CZE,"DF,MF",29,1992,13.3,11,10,6,3,2,5,16,31.3,11,18,6,12,13,24,22,0,2022
GER-Bundesliga,2021,Hoffenheim,Philipp Pentke,GER,GK,36,1985,1.0,0,0,0,0,0,0,0,,0,0,0,0,0,0,0,0,2022
GER-Bundesliga,2021,Hoffenheim,Robert Skov,DEN,"FW,DF",25,1996,4.1,3,2,1,1,1,2,9,22.2,7,2,0,2,3,6,3,0,2022
GER-Bundesliga,2021,Hoffenheim,Sargis Adamyan,ARM,"FW,MF",28,1993,3.7,8,6,3,4,1,3,11,27.3,8,4,0,4,1,9,2,0,2022
GER-Bundesliga,2021,Hoffenheim,Sebastian Rudy,GER,MF,31,1990,8.6,22,12,9,13,0,11,21,52.4,10,8,3,5,11,33,8,1,2022
GER-Bundesliga,2021,Hoffenheim,Stefan Posch,AUT,DF,24,1997,24.4,48,30,20,26,2,22,39,56.4,17,43,18,25,28,76,71,2,2022
GER-Bundesliga,2021,Hoffenheim,Tom Bischof,GER,MF,16,2005,0.2,0,0,0,0,0,0,0,,0,1,0,1,0,0,1,0,2022
GER-Bundesliga,2021,Hoffenheim,Umut Tohumcu,GER,MF,16,2004,0.1,0,0,0,0,0,0,0,,0,0,0,0,0,0,0,0,2022
GER-Bundesliga,2021,Köln,Anthony Modeste,FRA,FW,33,1988,29.0,10,6,4,5,1,3,18,16.7,15,11,2,9,4,14,29,0,2022
GER-Bundesliga,2021,Köln,Benno Schmitz,GER,DF,26,1994,26.9,57,37,21,27,9,42,86,48.8,44,44,8,36,39,96,39,0,2022
GER-Bundesliga,2021,Köln,Dejan Ljubicic,AUT,"MF,FW",23,1997,21.9,33,19,12,13,8,13,49,26.5,36,19,1,18,15,48,11,0,2022
GER-Bundesliga,2021,Köln,Ellyes Skhiri,TUN,MF,26,1995,20.2,55,33,25,26,4,22,41,53.7,19,41,7,34,37,92,35,1,2022
GER-Bundesliga,2021,Köln,Florian Kainz,AUT,"MF,FW",28,1992,25.8,41,26,9,25,7,23,51,45.1,28,27,3,24,32,73,24,0,2022
GER-Bundesliga,2021,Köln,Jan Thielmann,GER,"MF,FW",19,2002,13.2,24,16,6,12,6,8,23,34.8,15,23,2,21,10,34,11,0,2022
GER-Bundesliga,2021,Köln,Jannes Horn,GER,DF,24,1997,5.3,6,4,4,2,0,4,8,50.0,4,1,1,0,3,9,9,0,2022
GER-Bundesliga,2021,Köln,Jonas Hector,GER,DF,31,1990,28.4,76,39,36,26,14,29,74,39.2,45,59,8,51,50,126,68,1,2022
GER-Bundesliga,2021,Köln,Jorge Meré,ESP,DF,24,1997,5.4,9,6,3,6,0,4,7,57.1,3,6,4,2,10,19,19,0,2022
GER-Bundesliga,2021,Köln,Julian Chabot,GER,DF,23,1998,2.3,8,3,4,4,0,2,5,40.0,3,4,2,2,3,11,5,1,2022
GER-Bundesliga,2021,Köln,Kingsley Ehizibue,NED,DF,26,1995,7.6,32,18,27,5,0,15,24,62.5,9,13,4,9,9,41,26,0,2022
GER-Bundesliga,2021,Köln,Kingsley Schindler,GHA,"DF,FW",28,1993,3.9,1,0,0,0,1,1,5,20.0,4,5,1,4,5,6,5,0,2022
GER-Bundesliga,2021,Köln,Louis Schaub,AUT,"MF,FW",26,1994,7.3,16,10,7,7,2,11,20,55.0,9,17,3,14,3,19,3,0,2022
GER-Bundesliga,2021,Köln,Luca Kilian,GER,DF,21,1999,25.3,42,24,30,9,3,21,41,51.2,20,31,13,18,46,88,109,3,2022
GER-Bundesliga,2021,Köln,Mark Uth,GER,"MF,FW",29,1991,22.5,32,20,9,14,9,15,49,30.6,34,27,1,26,14,46,13,0,2022
GER-Bundesliga,2021,Köln,Marvin Schwäbe,GER,GK,26,1995,21.0,0,0,0,0,0,0,0,,0,0,0,0,0,0,8,1,2022
GER-Bundesliga,2021,Köln,Mathias Olesen,LUX,"MF,FW",20,2001,0.2,0,0,0,0,0,0,0,,0,0,0,0,1,1,0,0,2022
GER-Bundesliga,2021,Köln,Noah Katterbach,GER,DF,20,2001,0.2,1,1,1,0,0,1,1,100.0,0,0,0,0,0,1,1,0,2022
GER-Bundesliga,2021,Köln,Ondrej Duda,SVK,"MF,FW",26,1994,17.9,23,16,4,12,7,6,23,26.1,17,14,2,12,17,40,9,0,2022
GER-Bundesliga,2021,Köln,Rafael Czichos,GER,DF,31,1990,15.6,29,18,18,9,2,14,28,50.0,14,23,13,10,19,48,53,2,2022
GER-Bundesliga,2021,Köln,Salih Özcan,TUR,MF,23,1998,25.7,42,30,14,23,5,22,51,43.1,29,37,5,32,51,93,35,1,2022
GER-Bundesliga,2021,Köln,Sebastian Andersson,SWE,FW,30,1991,14.0,11,7,0,3,8,3,9,33.3,6,8,0,8,3,14,14,0,2022
GER-Bundesliga,2021,Köln,Tim Lemperle,GER,"FW,MF",19,2002,1.7,4,1,2,1,1,1,3,33.3,2,1,0,1,2,6,2,0,2022
GER-Bundesliga,2021,Köln,Timo Horn,GER,GK,28,1993,13.0,0,0,0,0,0,0,1,0.0,1,0,0,0,0,0,5,0,2022
GER-Bundesliga,2021,Köln,Timo Hübers,GER,DF,25,1996,19.3,45,27,28,17,0,27,45,60.0,18,31,19,12,52,97,95,0,2022
GER-Bundesliga,2021,Köln,Tomáš Ostrák,CZE,"MF,FW",21,2000,0.3,1,0,0,0,1,1,3,33.3,2,0,0,0,1,2,0,0,2022
GER-Bundesliga,2021,Leverkusen,Amine Adli,FRA,"FW,MF",21,2000,14.0,27,14,10,14,3,8,15,53.3,7,26,2,24,11,38,12,0,2022
GER-Bundesliga,2021,Leverkusen,Andrey Lunyov,RUS,GK,29,1991,1.0,0,0,0,0,0,0,0,,0,0,0,0,0,0,0,0,2022
GER-Bundesliga,2021,Leverkusen,Charles Aránguiz,CHI,MF,32,1989,17.5,45,25,18,21,6,22,52,42.3,30,24,4,20,33,78,21,0,2022
GER-Bundesliga,2021,Leverkusen,Daley Sinkgraven,NED,DF,26,1995,3.9,6,2,4,0,2,3,7,42.9,4,3,1,2,3,9,6,0,2022
GER-Bundesliga,2021,Leverkusen,Edmond Tapsoba,BFA,DF,22,1999,20.2,35,17,24,10,1,20,32,62.5,12,27,15,12,29,64,72,1,2022
GER-Bundesliga,2021,Leverkusen,Exequiel Palacios,ARG,MF,22,1998,12.2,30,19,12,14,4,15,38,39.5,23,20,1,19,28,58,11,2,2022
GER-Bundesliga,2021,Leverkusen,Florian Wirtz,GER,"MF,FW",18,2003,20.6,25,10,6,16,3,10,28,35.7,18,12,1,11,13,38,4,0,2022
GER-Bundesliga,2021,Leverkusen,Iker Bravo,ESP,FW,16,2005,0.1,1,1,0,1,0,0,0,,0,0,0,0,0,1,0,0,2022
GER-Bundesliga,2021,Leverkusen,Jeremie Frimpong,NED,DF,20,2000,22.8,32,18,19,12,1,12,23,52.2,11,24,6,18,17,49,40,2,2022
GER-Bundesliga,2021,Leverkusen,Joel Pohjanpalo,FIN,FW,26,1994,0.1,0,0,0,0,0,0,0,,0,0,0,0,0,0,0,0,2022
GER-Bundesliga,2021,Leverkusen,Jonathan Tah,GER,DF,25,1996,32.0,25,18,19,5,1,17,33,51.5,16,31,20,11,43,68,156,0,2022
GER-Bundesliga,2021,Leverkusen,Julian Baumgartlinger,AUT,"MF,FW",33,1988,1.0,3,1,2,1,0,1,2,50.0,1,1,0,1,2,5,0,0,2022
GER-Bundesliga,2021,Leverkusen,Karim Bellarabi,GER,"FW,MF",31,1990,7.6,9,4,4,4,1,3,13,23.1,10,5,0,5,9,18,4,0,2022
GER-Bundesliga,2021,Leverkusen,Kerem Demirbay,GER,MF,28,1993,22.8,52,31,19,30,3,16,41,39.0,25,32,9,23,33,85,21,0,2022
GER-Bundesliga,2021,Leverkusen,Lennart Grill,GER,GK,22,1999,1.0,0,0,0,0,0,0,0,,0,0,0,0,0,0,0,0,2022
GER-Bundesliga,2021,Leverkusen,Lucas Alario,ARG,FW,28,1992,7.3,6,5,0,2,4,2,5,40.0,3,5,0,5,1,7,6,0,2022
GER-Bundesliga,2021,Leverkusen,Lukáš Hrádecký,FIN,GK,31,1989,32.0,1,1,1,0,0,1,1,100.0,0,0,0,0,0,1,10,1,2022
GER-Bundesliga,2021,Leverkusen,Mitchel Bakker,NED,DF,21,2000,20.2,33,22,16,12,5,20,34,58.8,14,13,2,11,23,56,42,3,2022
GER-Bundesliga,2021,Leverkusen,Moussa Diaby,FRA,"FW,MF",22,1999,30.7,20,11,8,9,3,5,38,13.2,33,11,0,11,8,28,2,0,2022
GER-Bundesliga,2021,Leverkusen,Nadiem Amiri,GER,"MF,FW",24,1996,4.1,8,4,3,2,3,4,8,50.0,4,4,2,2,5,13,0,0,2022
GER-Bundesliga,2021,Leverkusen,Odilon Kossonou,CIV,DF,20,2001,19.9,23,17,16,6,1,15,25,60.0,10,36,14,22,26,49,66,0,2022
GER-Bundesliga,2021,Leverkusen,Panagiotis Retsos,GRE,"DF,FW",22,1998,0.4,0,0,0,0,0,0,0,,0,0,0,0,1,1,0,1,2022
GER-Bundesliga,2021,Leverkusen,Patrik Schick,CZE,FW,25,1996,23.1,5,2,2,2,1,1,9,11.1,8,6,1,5,3,8,28,0,2022
GER-Bundesliga,2021,Leverkusen,Paulinho,BRA,"FW,MF",21,2000,13.5,22,13,6,13,3,13,27,48.1,14,14,1,13,6,28,7,0,2022
GER-Bundesliga,2021,Leverkusen,Piero Hincapié,ECU,DF,19,2002,19.5,33,23,23,8,2,19,25,76.0,6,34,15,19,33,66,56,2,2022
GER-Bundesliga,2021,Leverkusen,Robert Andrich,GER,MF,26,1994,20.2,33,17,18,14,1,14,28,50.0,14,19,7,12,31,64,46,0,2022
GER-Bundesliga,2021,Leverkusen,Sardar Azmoun,IRN,"FW,MF",26,1995,4.0,3,1,0,2,1,0,5,0.0,5,2,0,2,0,3,8,0,2022
GER-Bundesliga,2021,Leverkusen,Timothy Fosu-Mensah,NED,DF,23,1998,1.6,5,3,3,1,1,4,4,100.0,0,1,0,1,2,7,2,0,2022
GER-Bundesliga,2021,Leverkusen,Zidan Sertdemir,DEN,"MF,FW",16,2005,0.2,2,2,2,0,0,0,0,,0,0,0,0,0,2,0,0,2022
GER-Bundesliga,2021,M'Gladbach,Alassane Pléa,FRA,"MF,FW",28,1993,23.0,18,14,6,9,3,7,20,35.0,13,9,1,8,4,22,9,0,2022
GER-Bundesliga,2021,M'Gladbach,Breel Embolo,SUI,FW,24,1997,24.1,16,11,1,12,3,3,8,37.5,5,14,2,12,6,22,7,0,2022
GER-Bundesliga,2021,M'Gladbach,Christoph Kramer,GER,MF,30,1991,8.3,28,11,15,10,3,12,28,42.9,16,18,5,13,12,40,9,0,2022
GER-Bundesliga,2021,M'Gladbach,Connor Noß,IRL,MF,20,2001,0.6,1,0,0,1,0,0,1,0.0,1,1,1,0,0,1,0,0,2022
GER-Bundesliga,2021,M'Gladbach,Denis Zakaria,SUI,"MF,DF",24,1996,15.5,23,14,9,10,4,12,35,34.3,23,25,5,20,19,42,22,1,2022
GER-Bundesliga,2021,M'Gladbach,Florian Neuhaus,GER,MF,24,1997,23.6,55,28,24,26,5,27,64,42.2,37,38,6,32,31,86,19,4,2022
GER-Bundesliga,2021,M'Gladbach,Hannes Wolf,AUT,"FW,MF",22,1999,3.4,23,12,4,13,6,10,20,50.0,10,10,0,10,2,25,1,0,2022
GER-Bundesliga,2021,M'Gladbach,Joe Scally,USA,DF,18,2002,21.2,40,30,21,14,5,17,41,41.5,24,27,4,23,22,62,38,0,2022
GER-Bundesliga,2021,M'Gladbach,Jonas Hofmann,GER,"MF,FW",29,1992,23.1,30,20,6,17,7,17,42,40.5,25,23,0,23,12,42,10,0,2022
GER-Bundesliga,2021,M'Gladbach,Jordan Beyer,GER,DF,21,2000,15.4,46,27,32,13,1,23,39,59.0,16,18,5,13,15,61,52,2,2022
GER-Bundesliga,2021,M'Gladbach,Keanan Bennetts,ENG,"FW,DF",22,1999,0.6,2,0,1,1,0,1,1,100.0,0,1,0,1,0,2,0,0,2022
GER-Bundesliga,2021,M'Gladbach,Kouadio Koné,FRA,MF,20,2001,24.3,60,37,29,28,3,25,42,59.5,17,27,4,23,34,94,12,0,2022
GER-Bundesliga,2021,M'Gladbach,Lars Stindl,GER,"MF,FW",32,1988,18.1,23,15,6,14,3,9,33,27.3,24,28,2,26,10,33,14,0,2022
GER-Bundesliga,2021,M'Gladbach,Luca Netz,GER,"DF,FW",18,2003,15.5,24,11,12,10,2,11,40,27.5,29,24,4,20,13,37,33,1,2022
GER-Bundesliga,2021,M'Gladbach,László Bénes,SVK,MF,23,1997,2.7,5,3,1,3,1,1,6,16.7,5,5,2,3,2,7,5,0,2022
GER-Bundesliga,2021,M'Gladbach,Marcus Thuram,FRA,FW,23,1997,10.9,6,5,0,5,1,1,4,25.0,3,5,0,5,5,11,5,0,2022
GER-Bundesliga,2021,M'Gladbach,Marvin Friedrich,GER,DF,25,1995,6.7,14,8,10,4,0,9,11,81.8,2,5,3,2,5,19,26,0,2022
GER-Bundesliga,2021,M'Gladbach,Matthias Ginter,GER,DF,27,1994,26.2,36,22,20,13,3,27,40,67.5,13,21,10,11,33,69,76,0,2022
GER-Bundesliga,2021,M'Gladbach,Nico Elvedi,SUI,DF,24,1996,27.0,40,24,23,17,0,22,36,61.1,14,33,22,11,34,74,83,1,2022
GER-Bundesliga,2021,M'Gladbach,Patrick Herrmann,GER,"DF,FW",30,1991,8.4,15,7,5,6,4,9,24,37.5,15,10,1,9,6,21,8,0,2022
GER-Bundesliga,2021,M'Gladbach,Ramy Bensebaini,ALG,DF,26,1995,22.4,42,30,24,15,3,27,44,61.4,17,33,7,26,39,81,77,1,2022
GER-Bundesliga,2021,M'Gladbach,Stefan Lainer,AUT,DF,28,1992,16.3,19,11,9,7,3,12,28,42.9,16,24,5,19,14,33,31,0,2022
GER-Bundesliga,2021,M'Gladbach,Tobias Sippel,GER,GK,33,1988,1.0,0,0,0,0,0,0,0,,0,0,0,0,0,0,0,0,2022
GER-Bundesliga,2021,M'Gladbach,Tony Jantschke,GER,DF,31,1990,2.5,6,5,2,4,0,3,6,50.0,3,3,2,1,5,11,8,0,2022
GER-Bundesliga,2021,M'Gladbach,Torben Müsel,GER,MF,22,1999,0.1,0,0,0,0,0,0,0,,0,0,0,0,0,0,0,0,2022
GER-Bundesliga,2021,M'Gladbach,Yann Sommer,SUI,GK,32,1988,33.0,0,0,0,0,0,0,2,0.0,2,0,0,0,3,3,8,3,2022
GER-Bundesliga,2021,Mainz 05,Aarón Martín,ESP,DF,24,1997,25.5,54,33,32,18,4,24,55,43.6,31,24,4,20,20,74,35,0,2022
GER-Bundesliga,2021,Mainz 05,Alexander Hack,GER,DF,27,1993,23.0,52,26,35,17,0,29,46,63.0,17,31,14,17,51,103,95,1,2022
GER-Bundesliga,2021,Mainz 05,Anderson Lucoqui,ANG,DF,24,1997,8.3,22,10,11,6,5,11,22,50.0,11,15,3,12,11,33,10,0,2022
GER-Bundesliga,2021,Mainz 05,Anton Stach,GER,MF,22,1998,20.7,28,19,14,13,1,15,38,39.5,23,24,5,19,51,79,25,0,2022
GER-Bundesliga,2021,Mainz 05,Daniel Brosinski,GER,DF,33,1988,4.3,2,1,1,1,0,1,1,100.0,0,6,0,6,3,5,9,0,2022
GER-Bundesliga,2021,Mainz 05,David Nemeth,AUT,DF,20,2001,3.5,3,2,2,1,0,1,3,33.3,2,5,1,4,6,9,11,1,2022
GER-Bundesliga,2021,Mainz 05,Delano Burgzorg,NED,MF,22,1998,0.3,1,1,1,0,0,0,1,0.0,1,0,0,0,0,1,0,0,2022
GER-Bundesliga,2021,Mainz 05,Dominik Kohr,GER,MF,27,1994,17.9,40,20,18,19,3,16,42,38.1,26,21,2,19,35,75,22,0,2022
GER-Bundesliga,2021,Mainz 05,Finn Dahmen,GER,GK,23,1998,2.0,0,0,0,0,0,0,0,,0,0,0,0,0,0,2,0,2022
GER-Bundesliga,2021,Mainz 05,Jean-Paul Boëtius,NED,MF,27,1994,20.0,40,23,18,17,5,22,53,41.5,31,41,3,38,25,65,11,0,2022
GER-Bundesliga,2021,Mainz 05,Jerry St. Juste,NED,DF,24,1996,6.7,13,9,7,6,0,7,8,87.5,1,7,3,4,14,27,14,0,2022
GER-Bundesliga,2021,Mainz 05,Jonathan Burkardt,GER,"FW,MF",21,2000,29.0,17,8,0,10,7,6,25,24.0,19,31,5,26,8,25,16,0,2022
GER-Bundesliga,2021,Mainz 05,Karim Onisiwo,AUT,FW,29,1992,26.2,18,10,4,6,8,7,22,31.8,15,27,2,25,7,25,8,0,2022
GER-Bundesliga,2021,Mainz 05,Kevin Stöger,AUT,MF,27,1993,4.7,10,5,5,5,0,4,10,40.0,6,6,0,6,5,15,1,1,2022
GER-Bundesliga,2021,Mainz 05,Leandro Barreiro Martins,LUX,MF,21,2000,19.9,63,32,23,27,13,29,50,58.0,21,23,6,17,32,95,23,0,2022
GER-Bundesliga,2021,Mainz 05,Lee Jae-sung,KOR,"MF,FW",28,1992,16.0,30,12,8,14,8,6,27,22.2,21,20,2,18,18,48,18,0,2022
GER-Bundesliga,2021,Mainz 05,Luca Kilian,GER,FW,21,1999,0.0,0,0,0,0,0,0,0,,0,0,0,0,0,0,0,0,2022
GER-Bundesliga,2021,Mainz 05,Marcus Ingvartsen,DEN,"FW,MF",25,1996,7.6,3,2,2,0,1,3,9,33.3,6,6,0,6,6,9,7,1,2022
GER-Bundesliga,2021,Mainz 05,Matondo-Merveille Papela,GER,MF,20,2001,0.9,3,2,2,1,0,2,3,66.7,1,2,0,2,2,5,0,0,2022
GER-Bundesliga,2021,Mainz 05,Moussa Niakhate,SEN,DF,25,1996,28.5,40,23,25,13,2,20,33,60.6,13,37,11,26,50,90,69,1,2022
GER-Bundesliga,2021,Mainz 05,Niklas Tauer,GER,"DF,MF",20,2001,5.4,16,9,9,7,0,9,14,64.3,5,6,2,4,9,25,14,0,2022
GER-Bundesliga,2021,Mainz 05,Paul Nebel,GER,"MF,FW",18,2002,2.5,5,3,3,1,1,2,3,66.7,1,0,0,0,0,5,1,0,2022
GER-Bundesliga,2021,Mainz 05,Robin Zentner,GER,GK,26,1994,32.0,2,2,2,0,0,2,2,100.0,0,0,0,0,2,4,21,1,2022
GER-Bundesliga,2021,Mainz 05,Romario Rösch,GER,MF,22,1999,0.0,0,0,0,0,0,0,0,,0,0,0,0,0,0,0,0,2022
GER-Bundesliga,2021,Mainz 05,Silvan Widmer,SUI,DF,28,1993,32.4,60,28,32,20,8,36,61,59.0,25,44,16,28,43,103,59,2,2022
GER-Bundesliga,2021,Mainz 05,Stefan Bell,GER,DF,29,1991,31.8,54,23,37,16,1,30,63,47.6,33,26,15,11,41,95,112,1,2022
GER-Bundesliga,2021,Mainz 05,Stephan Fürstner,GER,MF,33,1987,0.1,0,0,0,0,0,0,2,0.0,2,0,0,0,0,0,1,0,2022
GER-Bundesliga,2021,Mainz 05,Ádám Szalai,HUN,FW,33,1987,2.9,3,2,0,2,1,0,2,0.0,2,2,0,2,0,3,0,0,2022
GER-Bundesliga,2021,RB Leipzig,Amadou Haidara,MLI,MF,23,1998,14.7,30,14,11,19,0,17,37,45.9,20,22,6,16,16,46,8,1,2022
GER-Bundesliga,2021,RB Leipzig,André Silva,POR,FW,25,1995,23.1,13,9,2,3,8,4,13,30.8,9,20,2,18,2,15,15,0,2022
GER-Bundesliga,2021,RB Leipzig,Angeliño,ESP,DF,24,1997,25.5,28,21,14,13,1,14,30,46.7,16,24,3,21,29,57,40,0,2022
GER-Bundesliga,2021,RB Leipzig,Benjamin Henrichs,GER,DF,24,1997,12.7,30,21,18,6,6,12,22,54.5,10,16,1,15,19,49,14,0,2022
GER-Bundesliga,2021,RB Leipzig,Brian Brobbey,NED,"FW,MF",19,2002,1.5,1,0,0,1,0,1,1,100.0,0,1,0,1,0,1,0,0,2022
GER-Bundesliga,2021,RB Leipzig,Christopher Nkunku,FRA,"FW,MF",23,1997,30.3,23,10,10,11,2,9,35,25.7,26,23,2,21,15,38,15,0,2022
GER-Bundesliga,2021,RB Leipzig,Dani Olmo,ESP,"MF,FW",23,1998,8.3,14,6,5,7,2,5,18,27.8,13,5,1,4,4,18,1,0,2022
GER-Bundesliga,2021,RB Leipzig,Dominik Szoboszlai,HUN,"MF,FW",20,2000,17.1,17,12,5,9,3,8,27,29.6,19,30,3,27,10,27,15,0,2022
GER-Bundesliga,2021,RB Leipzig,Emil Forsberg,SWE,MF,29,1991,19.0,21,12,2,11,8,7,22,31.8,15,18,0,18,2,23,2,1,2022
GER-Bundesliga,2021,RB Leipzig,Hugo Novoa,ESP,"MF,FW",18,2003,1.5,4,4,2,0,2,2,7,28.6,5,2,0,2,1,5,0,0,2022
GER-Bundesliga,2021,RB Leipzig,Hwang Hee-chan,KOR,FW,25,1996,0.5,0,0,0,0,0,0,0,,0,0,0,0,1,1,0,0,2022
GER-Bundesliga,2021,RB Leipzig,Ilaix Moriba,GUI,MF,18,2003,0.4,0,0,0,0,0,0,4,0.0,4,2,0,2,1,1,0,0,2022
GER-Bundesliga,2021,RB Leipzig,Joscha Wosz,GER,DF,19,2002,0.1,0,0,0,0,0,0,0,,0,0,0,0,0,0,0,0,2022
GER-Bundesliga,2021,RB Leipzig,Josep Martinez,ESP,GK,23,1998,1.0,0,0,0,0,0,0,0,,0,0,0,0,0,0,0,0,2022
GER-Bundesliga,2021,RB Leipzig,Joško Gvardiol,CRO,DF,19,2002,26.8,47,31,28,17,2,22,39,56.4,17,30,11,19,51,98,62,2,2022
GER-Bundesliga,2021,RB Leipzig,Kevin Kampl,SVN,MF,30,1990,21.1,41,19,16,20,5,10,42,23.8,32,24,5,19,24,65,17,0,2022
GER-Bundesliga,2021,RB Leipzig,Konrad Laimer,AUT,MF,24,1997,13.8,38,24,11,22,5,24,53,45.3,29,29,3,26,4,42,9,0,2022
GER-Bundesliga,2021,RB Leipzig,Lukas Klostermann,GER,DF,25,1996,18.3,29,16,11,15,3,13,19,68.4,6,16,3,13,26,55,58,0,2022
GER-Bundesliga,2021,RB Leipzig,Marcel Halstenberg,GER,DF,29,1991,5.6,10,7,6,4,0,6,11,54.5,5,6,0,6,7,17,11,0,2022
GER-Bundesliga,2021,RB Leipzig,Marcel Sabitzer,AUT,"MF,FW",27,1994,0.5,2,1,1,1,0,1,1,100.0,0,0,0,0,1,3,0,0,2022
GER-Bundesliga,2021,RB Leipzig,Mohamed Simakan,FRA,DF,21,2000,22.3,48,27,25,21,2,27,41,65.9,14,22,11,11,40,88,46,1,2022
GER-Bundesliga,2021,RB Leipzig,Nordi Mukiele,FRA,"DF,FW",23,1997,20.5,35,22,23,9,3,14,27,51.9,13,31,5,26,31,66,44,2,2022
GER-Bundesliga,2021,RB Leipzig,Philipp Tschauner,GER,GK,35,1985,0.0,0,0,0,0,0,0,0,,0,0,0,0,0,0,0,0,2022
GER-Bundesliga,2021,RB Leipzig,Péter Gulácsi,HUN,GK,31,1990,33.0,0,0,0,0,0,0,0,,0,0,0,0,1,1,15,1,2022
GER-Bundesliga,2021,RB Leipzig,Sidney Raebiger,GER,MF,16,2005,0.0,0,0,0,0,0,0,0,,0,0,0,0,0,0,0,0,2022
GER-Bundesliga,2021,RB Leipzig,Solomon Bonnah,NED,DF,17,2003,0.1,0,0,0,0,0,0,0,,0,1,0,1,1,1,0,0,2022
GER-Bundesliga,2021,RB Leipzig,Tyler Adams,USA,MF,22,1999,15.0,23,7,5,16,2,7,25,28.0,18,24,1,23,16,39,19,2,2022
GER-Bundesliga,2021,RB Leipzig,Willi Orban,HUN,DF,28,1992,29.4,32,22,20,11,1,13,25,52.0,12,40,24,16,44,76,123,2,2022
GER-Bundesliga,2021,RB Leipzig,Yussuf Poulsen,DEN,"FW,MF",27,1994,12.0,13,4,3,6,4,3,13,23.1,10,13,0,13,3,16,9,0,2022
GER-Bundesliga,2021,Stuttgart,Alexis Tibidi,FRA,"MF,FW",17,2003,4.3,7,3,1,3,3,3,4,75.0,1,4,0,4,3,10,2,0,2022
GER-Bundesliga,2021,Stuttgart,Atakan Karazor,GER,MF,24,1996,21.1,48,24,18,27,3,18,36,50.0,18,37,14,23,34,82,47,0,2022
GER-Bundesliga,2021,Stuttgart,Borna Sosa,CRO,"DF,FW",23,1998,27.8,22,12,14,5,3,12,26,46.2,14,30,3,27,26,48,61,0,2022
GER-Bundesliga,2021,Stuttgart,Chris Führich,GER,"FW,MF",23,1998,19.0,28,16,10,10,8,18,39,46.2,21,31,2,29,8,36,9,0,2022
GER-Bundesliga,2021,Stuttgart,Clinton Mola,ENG,DF,20,2001,1.3,3,1,2,1,0,2,4,50.0,2,5,5,0,3,6,2,0,2022
GER-Bundesliga,2021,Stuttgart,Daniel Didavi,GER,"MF,FW",31,1990,3.1,6,2,0,4,2,4,7,57.1,3,4,1,3,1,7,1,0,2022
GER-Bundesliga,2021,Stuttgart,Enzo Millot,FRA,MF,19,2002,0.6,2,0,0,2,0,0,1,0.0,1,0,0,0,1,3,1,0,2022
GER-Bundesliga,2021,Stuttgart,Erik Thommy,GER,"FW,MF",26,1994,3.0,2,0,0,2,0,1,2,50.0,1,3,0,3,4,6,0,0,2022
GER-Bundesliga,2021,Stuttgart,Fabian Bredlow,GER,GK,26,1995,4.0,0,0,0,0,0,0,0,,0,0,0,0,0,0,1,0,2022
GER-Bundesliga,2021,Stuttgart,Florian Müller,GER,GK,23,1997,30.0,0,0,0,0,0,0,1,0.0,1,1,0,1,0,0,13,2,2022
GER-Bundesliga,2021,Stuttgart,Hamadi Al Ghaddioui,MAR,FW,30,1990,5.5,5,4,2,1,2,0,4,0.0,4,3,1,2,0,5,4,0,2022
GER-Bundesliga,2021,Stuttgart,Hiroki Ito,JPN,DF,22,1999,26.1,43,31,21,19,3,25,43,58.1,18,40,19,21,53,96,95,0,2022
GER-Bundesliga,2021,Stuttgart,Konstantinos Mavropanos,GRE,DF,23,1997,30.1,57,39,35,21,1,30,51,58.8,21,46,23,23,69,126,174,2,2022
GER-Bundesliga,2021,Stuttgart,Lilian Egloff,GER,"MF,DF",18,2002,0.3,1,0,0,1,0,0,0,,0,1,0,1,0,1,0,0,2022
GER-Bundesliga,2021,Stuttgart,Marc-Oliver Kempf,GER,DF,26,1995,9.3,13,8,7,4,2,3,10,30.0,7,16,14,2,16,29,26,2,2022
GER-Bundesliga,2021,Stuttgart,Matej Maglica,CRO,MF,22,1998,0.1,0,0,0,0,0,0,1,0.0,1,0,0,0,0,0,0,0,2022
GER-Bundesliga,2021,Stuttgart,Mateo Klimowicz,GER,"MF,FW",21,2000,6.7,13,6,6,7,0,5,16,31.3,11,2,0,2,4,17,3,0,2022
GER-Bundesliga,2021,Stuttgart,Mohamed Sankoh,NED,FW,17,2003,0.0,0,0,0,0,0,0,0,,0,0,0,0,0,0,0,0,2022
GER-Bundesliga,2021,Stuttgart,Naouirou Ahamada,FRA,"MF,DF",19,2002,0.7,1,0,1,0,0,1,3,33.3,2,0,0,0,0,1,0,0,2022
GER-Bundesliga,2021,Stuttgart,Nikolas Nartey,DEN,"MF,DF",21,2000,4.5,6,3,0,5,1,3,9,33.3,6,4,2,2,7,13,5,0,2022
GER-Bundesliga,2021,Stuttgart,Omar Marmoush,EGY,FW,22,1999,17.5,26,17,6,14,6,4,20,20.0,16,9,1,8,7,33,6,0,2022
GER-Bundesliga,2021,Stuttgart,Orel Mangala,BEL,MF,23,1998,20.6,17,10,5,7,5,11,22,50.0,11,11,4,7,12,29,19,1,2022
GER-Bundesliga,2021,Stuttgart,Pascal Stenzel,GER,DF,25,1996,10.0,24,11,15,5,4,17,33,51.5,16,13,3,10,11,35,25,0,2022
GER-Bundesliga,2021,Stuttgart,Philipp Förster,GER,"MF,FW",26,1995,10.7,20,13,4,12,4,11,26,42.3,15,12,1,11,3,23,2,0,2022
GER-Bundesliga,2021,Stuttgart,Philipp Klement,GER,MF,28,1992,3.8,7,3,1,4,2,3,3,100.0,0,6,1,5,1,8,0,0,2022
GER-Bundesliga,2021,Stuttgart,Roberto Massimo,GER,"DF,FW",20,2000,9.7,14,5,6,7,1,4,16,25.0,12,9,0,9,3,17,6,0,2022
GER-Bundesliga,2021,Stuttgart,Sasa Kalajdzic,AUT,FW,24,1997,13.6,10,6,2,5,3,3,11,27.3,8,5,0,5,2,12,14,0,2022
GER-Bundesliga,2021,Stuttgart,Silas Katompa,COD,"FW,MF",22,1998,3.1,5,4,4,0,1,3,7,42.9,4,5,0,5,2,7,1,0,2022
GER-Bundesliga,2021,Stuttgart,Tanguy Coulibaly,FRA,"FW,MF",20,2001,12.0,27,15,14,11,2,9,19,47.4,10,14,2,12,4,31,10,0,2022
GER-Bundesliga,2021,Stuttgart,Tiago Tomás,POR,FW,19,2002,11.9,8,4,0,7,1,0,6,0.0,6,3,0,3,4,12,1,0,2022
GER-Bundesliga,2021,Stuttgart,Wahidullah Faghir,DEN,FW,18,2003,1.4,0,0,0,0,0,0,1,0.0,1,2,0,2,0,0,0,0,2022
GER-Bundesliga,2021,Stuttgart,Waldemar Anton,GER,DF,25,1996,28.8,40,26,22,15,3,19,32,59.4,13,27,16,11,32,72,116,1,2022
GER-Bundesliga,2021,Stuttgart,Wataru Endo,JPN,MF,28,1993,32.2,73,41,34,34,5,31,72,43.1,41,43,12,31,30,103,64,0,2022
GER-Bundesliga,2021,Stuttgart,Ömer Faruk Beyaz,TUR,"DF,MF",17,2003,0.8,4,3,1,3,0,1,5,20.0,4,0,0,0,2,6,0,0,2022
GER-Bundesliga,2021,Union Berlin,Andreas Luthe,GER,GK,34,1987,27.0,0,0,0,0,0,0,1,0.0,1,0,0,0,0,0,11,4,2022
GER-Bundesliga,2021,Union Berlin,Andreas Voglsammer,GER,"FW,MF",29,1992,9.8,14,9,8,3,3,6,14,42.9,8,9,2,7,2,16,7,0,2022
GER-Bundesliga,2021,Union Berlin,András Schäfer,HUN,MF,22,1999,2.7,4,1,3,1,0,0,5,0.0,5,7,1,6,2,6,4,0,2022
GER-Bundesliga,2021,Union Berlin,Anthony Ujah,NGA,"FW,MF",30,1990,0.4,0,0,0,0,0,0,0,,0,0,0,0,0,0,0,0,2022
GER-Bundesliga,2021,Union Berlin,Bastian Oczipka,GER,DF,32,1989,10.4,24,15,15,7,2,10,13,76.9,3,10,2,8,12,36,21,0,2022
GER-Bundesliga,2021,Union Berlin,Cedric Teuchert,GER,"MF,FW",24,1997,1.2,3,2,3,0,0,2,6,33.3,4,1,0,1,0,3,0,0,2022
GER-Bundesliga,2021,Union Berlin,Christopher Trimmel,AUT,"DF,FW",34,1987,22.1,49,30,25,19,5,26,45,57.8,19,20,3,17,34,83,75,0,2022
GER-Bundesliga,2021,Union Berlin,Dominique Heintz,GER,DF,27,1993,5.2,8,5,5,3,0,3,6,50.0,3,7,4,3,7,15,14,0,2022
GER-Bundesliga,2021,Union Berlin,Frederik Rønnow,DEN,GK,28,1992,7.0,0,0,0,0,0,0,0,,0,0,0,0,0,0,1,0,2022
GER-Bundesliga,2021,Union Berlin,Genki Haraguchi,JPN,MF,30,1991,19.5,37,20,12,22,3,15,48,31.3,33,25,3,22,26,63,15,0,2022
GER-Bundesliga,2021,Union Berlin,Grischa Prömel,GER,MF,26,1995,26.9,36,22,14,17,5,22,52,42.3,30,18,3,15,23,59,22,0,2022
GER-Bundesliga,2021,Union Berlin,Julian Ryerson,NOR,DF,23,1997,15.9,27,15,11,12,4,17,25,68.0,8,12,4,8,16,43,32,0,2022
GER-Bundesliga,2021,Union Berlin,Keita Endo,JPN,MF,23,1997,0.6,1,1,1,0,0,0,0,,0,1,0,1,0,1,0,0,2022
GER-Bundesliga,2021,Union Berlin,Kevin Behrens,GER,FW,30,1991,5.5,3,2,1,1,1,0,4,0.0,4,3,0,3,3,6,7,0,2022
GER-Bundesliga,2021,Union Berlin,Kevin Möhwald,GER,MF,28,1993,3.9,7,1,3,3,1,1,7,14.3,6,3,0,3,3,10,6,0,2022
GER-Bundesliga,2021,Union Berlin,Levin Öztunalı,GER,MF,25,1996,6.4,14,11,6,5,3,7,17,41.2,10,3,0,3,4,18,12,0,2022
GER-Bundesliga,2021,Union Berlin,Marcus Ingvartsen,DEN,MF,25,1996,1.4,0,0,0,0,0,0,2,0.0,2,0,0,0,2,2,1,0,2022
GER-Bundesliga,2021,Union Berlin,Marvin Friedrich,GER,DF,25,1995,13.0,17,5,14,3,0,10,16,62.5,6,13,7,6,23,40,47,0,2022
GER-Bundesliga,2021,Union Berlin,Max Kruse,GER,"FW,MF",33,1988,14.1,4,1,0,3,1,2,16,12.5,14,12,0,12,3,7,2,0,2022
GER-Bundesliga,2021,Union Berlin,Niko Gießelmann,GER,"DF,FW",29,1991,23.1,24,17,10,11,3,15,38,39.5,23,26,4,22,18,42,29,1,2022
GER-Bundesliga,2021,Union Berlin,Paul Jaeckel,GER,DF,23,1998,22.7,51,29,27,24,0,29,51,56.9,22,34,10,24,57,108,81,0,2022
GER-Bundesliga,2021,Union Berlin,Rani Khedira,GER,MF,27,1994,30.6,75,38,25,42,8,32,66,48.5,34,21,8,13,50,125,27,1,2022
GER-Bundesliga,2021,Union Berlin,Robin Knoche,GER,DF,29,1992,33.0,50,24,38,12,0,30,53,56.6,23,45,26,19,49,99,151,1,2022
GER-Bundesliga,2021,Union Berlin,Sebastian Griesbeck,GER,MF,30,1990,0.1,1,1,0,1,0,1,1,100.0,0,0,0,0,0,1,0,0,2022
GER-Bundesliga,2021,Union Berlin,Sheraldo Becker,SUR,"FW,MF",26,1995,19.5,9,6,3,4,2,6,18,33.3,12,11,0,11,2,11,4,0,2022
GER-Bundesliga,2021,Union Berlin,Sven Michel,GER,FW,31,1990,3.8,10,6,5,3,2,2,8,25.0,6,3,0,3,1,11,1,0,2022
GER-Bundesliga,2021,Union Berlin,Taiwo Awoniyi,NGA,FW,23,1997,24.2,11,7,3,6,2,1,9,11.1,8,11,2,9,2,13,29,0,2022
GER-Bundesliga,2021,Union Berlin,Timo Baumgartl,GER,DF,25,1996,24.1,59,28,34,21,4,31,47,66.0,16,27,11,16,37,96,58,0,2022
GER-Bundesliga,2021,Wolfsburg,Admir Mehmedi,SUI,DF,30,1991,0.0,0,0,0,0,0,0,0,,0,0,0,0,0,0,0,0,2022
GER-Bundesliga,2021,Wolfsburg,Aster Vranckx,BEL,MF,18,2002,12.7,34,13,14,16,4,14,26,53.8,12,19,7,12,13,47,16,0,2022
GER-Bundesliga,2021,Wolfsburg,Bartosz Bialek,POL,"FW,DF",19,2001,2.0,0,0,0,0,0,0,1,0.0,1,1,0,1,0,0,2,0,2022
GER-Bundesliga,2021,Wolfsburg,Daniel Ginczek,GER,"MF,FW",30,1991,0.1,0,0,0,0,0,0,0,,0,0,0,0,0,0,0,0,2022
GER-Bundesliga,2021,Wolfsburg,Dodi Lukebakio,BEL,"FW,MF",23,1997,9.8,7,4,3,2,2,1,10,10.0,9,5,0,5,13,20,4,0,2022
GER-Bundesliga,2021,Wolfsburg,Felix Nmecha,GER,"MF,FW",20,2000,3.6,3,1,1,1,1,0,2,0.0,2,2,0,2,7,10,6,0,2022
GER-Bundesliga,2021,Wolfsburg,John Brooks,USA,DF,28,1993,29.1,47,25,25,18,4,36,60,60.0,24,33,19,14,41,88,125,1,2022
GER-Bundesliga,2021,Wolfsburg,Jonas Wind,DEN,"FW,MF",22,1999,13.1,10,6,1,7,2,1,4,25.0,3,8,3,5,6,16,13,0,2022
GER-Bundesliga,2021,Wolfsburg,Josip Brekalo,CRO,FW,23,1998,0.2,0,0,0,0,0,0,0,,0,0,0,0,0,0,0,0,2022
GER-Bundesliga,2021,Wolfsburg,Josuha Guilavogui,FRA,"MF,DF",30,1990,10.5,23,14,13,9,1,7,18,38.9,11,11,6,5,25,48,42,0,2022
GER-Bundesliga,2021,Wolfsburg,Jérôme Roussillon,FRA,DF,28,1993,19.7,14,9,8,6,0,10,16,62.5,6,24,5,19,14,28,34,2,2022
GER-Bundesliga,2021,Wolfsburg,Kevin Mbabu,SUI,DF,26,1995,15.5,31,20,21,5,5,12,23,52.2,11,25,8,17,35,66,35,0,2022
GER-Bundesliga,2021,Wolfsburg,Kevin Paredes,USA,"FW,DF",18,2003,0.2,1,0,0,0,1,0,0,,0,1,0,1,0,1,0,0,2022
GER-Bundesliga,2021,Wolfsburg,Koen Casteels,BEL,GK,29,1992,28.0,0,0,0,0,0,0,1,0.0,1,0,0,0,0,0,9,2,2022
GER-Bundesliga,2021,Wolfsburg,Luca Waldschmidt,GER,"MF,FW",25,1996,8.0,9,1,3,5,1,5,13,38.5,8,5,0,5,8,17,3,0,2022
GER-Bundesliga,2021,Wolfsburg,Lukas Nmecha,GER,"FW,MF",22,1998,18.1,12,5,5,5,2,5,19,26.3,14,9,1,8,4,16,10,0,2022
GER-Bundesliga,2021,Wolfsburg,Max Kruse,GER,"MF,FW",33,1988,12.5,9,3,4,4,1,5,12,41.7,7,2,0,2,3,12,4,0,2022
GER-Bundesliga,2021,Wolfsburg,Maxence Lacroix,FRA,DF,21,2000,27.7,59,33,41,16,2,29,40,72.5,11,35,16,19,60,119,144,0,2022
GER-Bundesliga,2021,Wolfsburg,Maximilian Arnold,GER,MF,27,1994,33.3,37,20,19,16,2,20,50,40.0,30,43,15,28,37,74,55,0,2022
GER-Bundesliga,2021,Wolfsburg,Maximilian Philipp,GER,MF,27,1994,10.7,15,11,6,7,2,5,21,23.8,16,12,1,11,4,19,5,0,2022
GER-Bundesliga,2021,Wolfsburg,Micky van de Ven,NED,DF,20,2001,2.1,4,4,3,1,0,0,1,0.0,1,4,1,3,2,6,8,0,2022
GER-Bundesliga,2021,Wolfsburg,Omar Marmoush,EGY,FW,22,1999,0.3,0,0,0,0,0,0,0,,0,0,0,0,0,0,0,0,2022
GER-Bundesliga,2021,Wolfsburg,Paulo Otávio,BRA,"DF,MF",26,1994,4.0,14,10,7,4,3,8,15,53.3,7,11,6,5,4,18,9,0,2022
GER-Bundesliga,2021,Wolfsburg,Pavao Pervan,AUT,GK,33,1987,6.0,0,0,0,0,0,0,0,,0,0,0,0,0,0,3,0,2022
GER-Bundesliga,2021,Wolfsburg,Renato Steffen,SUI,"FW,MF",29,1991,10.7,20,16,10,10,0,9,16,56.3,7,7,0,7,13,33,14,0,2022
GER-Bundesliga,2021,Wolfsburg,Ridle Baku,GER,"DF,FW",23,1998,27.2,62,37,30,24,8,25,65,38.5,40,43,1,42,21,83,52,1,2022
GER-Bundesliga,2021,Wolfsburg,Sebastiaan Bornauw,BEL,DF,22,1999,22.3,30,19,23,5,2,16,25,64.0,9,29,8,21,42,72,97,1,2022
GER-Bundesliga,2021,Wolfsburg,Wout Weghorst,NED,FW,28,1992,17.3,13,7,3,3,7,7,17,41.2,10,10,3,7,2,15,11,1,2022
GER-Bundesliga,2021,Wolfsburg,Xaver Schlager,AUT,MF,23,1997,11.6,43,20,20,20,3,20,49,40.8,29,25,2,23,9,52,14,0,2022
GER-Bundesliga,2021,Wolfsburg,Yannick Gerhardt,GER,"MF,DF",27,1994,17.5,42,20,18,17,7,22,36,61.1,14,24,1,23,25,67,25,1,2022
GER-Bundesliga,2022,Augsburg,Aaron Zehnter,GER,DF,17,2004,0.0,0,0,0,0,0,0,1,0.0,1,0,0,0,1,1,0,0,2023
GER-Bundesliga,2022,Augsburg,André Hahn,GER,"FW,MF",31,1990,4.3,9,5,4,4,1,8,12,66.7,4,9,2,7,4,13,14,0,2023
GER-Bundesliga,2022,Augsburg,Arne Engels,BEL,MF,18,2003,16.0,20,9,9,10,1,8,19,42.1,11,17,5,12,15,35,12,1,2023
GER-Bundesliga,2022,Augsburg,Arne Maier,GER,MF,23,1999,21.8,31,22,17,11,3,10,18,55.6,8,21,0,21,15,46,22,0,2023
GER-Bundesliga,2022,Augsburg,Carlos Gruezo,ECU,MF,27,1995,10.7,21,12,12,9,0,9,16,56.3,7,13,4,9,10,31,15,0,2023
GER-Bundesliga,2022,Augsburg,Daniel Caligiuri,ITA,"DF,MF",34,1988,3.2,8,5,5,3,0,4,5,80.0,1,3,2,1,3,11,2,0,2023
GER-Bundesliga,2022,Augsburg,David Čolina,CRO,"DF,FW",22,2000,1.8,4,1,1,1,2,2,2,100.0,0,8,0,8,4,8,3,0,2023
GER-Bundesliga,2022,Augsburg,Dion Drena Beljo,CRO,FW,20,2002,12.5,7,6,3,2,2,2,13,15.4,11,15,2,13,1,8,14,0,2023
GER-Bundesliga,2022,Augsburg,Elvis Rexhbeçaj,GER,MF,24,1997,28.0,51,30,18,24,9,29,59,49.2,30,40,13,27,17,68,40,0,2023
GER-Bundesliga,2022,Augsburg,Ermedin Demirović,BIH,"FW,MF",24,1998,26.3,31,14,9,12,10,9,22,40.9,13,31,4,27,14,45,37,0,2023
GER-Bundesliga,2022,Augsburg,Florian Niederlechner,GER,"FW,MF",31,1990,10.1,10,5,5,4,1,4,7,57.1,3,16,2,14,1,11,9,0,2023
GER-Bundesliga,2022,Augsburg,Frederik Winther,DEN,DF,21,2001,1.0,2,2,1,1,0,0,2,0.0,2,1,1,0,0,2,7,0,2023
GER-Bundesliga,2022,Augsburg,Fredrik Jensen,FIN,"FW,MF",24,1997,10.3,15,10,8,3,4,5,10,50.0,5,12,5,7,4,19,12,0,2023
GER-Bundesliga,2022,Augsburg,Iago,BRA,"DF,MF",25,1997,17.8,34,16,20,10,4,11,29,37.9,18,18,5,13,17,51,53,0,2023
GER-Bundesliga,2022,Augsburg,Irvin Cardona,FRA,"MF,FW",24,1997,3.5,1,1,1,0,0,1,5,20.0,4,3,0,3,4,5,8,0,2023
GER-Bundesliga,2022,Augsburg,Jeffrey Gouweleeuw,NED,DF,31,1991,31.1,42,27,19,17,6,24,49,49.0,25,41,23,18,50,92,141,2,2023
GER-Bundesliga,2022,Augsburg,Julian Baumgartlinger,AUT,MF,34,1988,6.2,15,4,5,6,4,6,19,31.6,13,4,2,2,4,19,15,0,2023
GER-Bundesliga,2022,Augsburg,Kelvin Yeboah,ITA,"FW,MF",22,2000,3.9,6,4,2,4,0,2,5,40.0,3,7,0,7,1,7,2,0,2023
GER-Bundesliga,2022,Augsburg,Lukas Petkov,GER,"MF,FW",21,2000,1.6,5,1,4,1,0,2,3,66.7,1,4,1,3,1,6,0,0,2023
GER-Bundesliga,2022,Augsburg,Mads Pedersen,DEN,"DF,MF",25,1996,20.4,44,23,31,11,2,22,33,66.7,11,32,9,23,20,64,41,1,2023
GER-Bundesliga,2022,Augsburg,Maximilian Bauer,GER,DF,22,2000,20.5,31,17,18,12,1,17,34,50.0,17,25,9,16,23,54,79,1,2023
GER-Bundesliga,2022,Augsburg,Mergim Berisha,GER,FW,24,1998,18.7,11,6,4,3,4,4,14,28.6,10,16,1,15,0,11,19,0,2023
GER-Bundesliga,2022,Augsburg,Nathanael Mbuku,FRA,"MF,FW",20,2002,0.4,1,0,0,1,0,0,0,,0,0,0,0,0,1,0,0,2023
GER-Bundesliga,2022,Augsburg,Niklas Dorsch,GER,MF,24,1998,5.4,21,12,8,11,2,9,16,56.3,7,9,3,6,6,27,9,0,2023
GER-Bundesliga,2022,Augsburg,Noah Joel Sarenren Bazee,NGA,"MF,FW",25,1996,0.2,0,0,0,0,0,0,1,0.0,1,1,0,1,0,0,0,0,2023
GER-Bundesliga,2022,Augsburg,Ohis Felix Uduokhai,GER,DF,24,1997,16.1,30,20,14,13,3,15,29,51.7,14,27,14,13,29,59,61,1,2023
GER-Bundesliga,2022,Augsburg,Rafał Gikiewicz,POL,GK,34,1987,23.0,2,2,2,0,0,2,3,66.7,1,0,0,0,0,2,15,5,2023
GER-Bundesliga,2022,Augsburg,Raphael Framberger,GER,"DF,FW",26,1995,2.0,10,6,6,4,0,3,5,60.0,2,2,1,1,2,12,5,0,2023
GER-Bundesliga,2022,Augsburg,Reece Oxford,ENG,DF,23,1998,1.0,1,1,1,0,0,0,0,,0,4,3,1,1,2,5,0,2023
GER-Bundesliga,2022,Augsburg,Renato Veiga,POR,DF,19,2003,7.1,9,6,4,3,2,7,9,77.8,2,20,6,14,7,16,29,1,2023
GER-Bundesliga,2022,Augsburg,Ricardo Pepi,USA,FW,19,2003,1.1,1,1,1,0,0,1,1,100.0,0,1,0,1,0,1,1,0,2023
GER-Bundesliga,2022,Augsburg,Robert Gumny,POL,DF,24,1998,22.4,34,24,13,15,6,11,27,40.7,16,21,7,14,26,60,62,1,2023
GER-Bundesliga,2022,Augsburg,Ruben Vargas,SUI,"MF,FW",23,1998,12.6,15,7,6,7,2,5,11,45.5,6,8,2,6,6,21,16,1,2023
GER-Bundesliga,2022,Augsburg,Tomáš Koubek,CZE,GK,29,1992,11.0,0,0,0,0,0,0,0,,0,0,0,0,0,0,7,0,2023
GER-Bundesliga,2022,Bayern Munich,Alphonso Davies,CAN,DF,21,2000,22.7,45,28,25,13,7,18,39,46.2,21,28,4,24,24,69,24,4,2023
GER-Bundesliga,2022,Bayern Munich,Arijon Ibrahimović,GER,MF,16,2005,0.2,1,1,1,0,0,0,0,,0,0,0,0,0,1,0,0,2023
GER-Bundesliga,2022,Bayern Munich,Benjamin Pavard,FRA,DF,26,1996,27.0,70,41,36,26,8,36,48,75.0,12,35,16,19,44,114,83,0,2023
GER-Bundesliga,2022,Bayern Munich,Bouna Sarr,SEN,FW,30,1992,0.0,0,0,0,0,0,0,0,,0,0,0,0,0,0,0,0,2023
GER-Bundesliga,2022,Bayern Munich,Daley Blind,NED,"DF,MF",32,1990,1.5,2,0,2,0,0,0,1,0.0,1,4,2,2,2,4,6,0,2023
GER-Bundesliga,2022,Bayern Munich,Dayot Upamecano,FRA,DF,23,1998,26.1,65,37,43,22,0,28,45,62.2,17,26,6,20,27,92,71,4,2023
GER-Bundesliga,2022,Bayern Munich,Eric Maxim Choupo-Moting,CMR,FW,33,1989,12.4,10,7,2,6,2,1,2,50.0,1,8,0,8,0,10,5,0,2023
GER-Bundesliga,2022,Bayern Munich,Gabriel Vidovic,CRO,FW,18,2003,0.2,0,0,0,0,0,0,0,,0,0,0,0,0,0,0,0,2023
GER-Bundesliga,2022,Bayern Munich,Jamal Musiala,GER,"MF,FW",19,2003,24.4,34,23,9,16,9,13,35,37.1,22,30,3,27,19,53,3,0,2023
GER-Bundesliga,2022,Bayern Munich,Joshua Kimmich,GER,MF,27,1995,31.2,78,49,24,46,8,38,72,52.8,34,36,7,29,41,119,39,2,2023
GER-Bundesliga,2022,Bayern Munich,Josip Stanišić,CRO,DF,22,2000,6.4,19,11,14,2,3,12,17,70.6,5,9,1,8,7,26,11,3,2023
GER-Bundesliga,2022,Bayern Munich,João Cancelo,POR,"DF,FW",28,1994,11.2,23,14,9,10,4,10,23,43.5,13,14,2,12,15,38,22,0,2023
GER-Bundesliga,2022,Bayern Munich,Kingsley Coman,FRA,"FW,MF",26,1996,15.7,11,8,3,5,3,7,17,41.2,10,19,1,18,2,13,7,0,2023
GER-Bundesliga,2022,Bayern Munich,Leon Goretzka,GER,MF,27,1995,19.2,43,24,21,16,6,27,48,56.3,21,40,3,37,30,73,32,0,2023
GER-Bundesliga,2022,Bayern Munich,Leroy Sané,GER,"MF,FW",26,1996,22.3,38,30,11,19,8,18,36,50.0,18,11,1,10,3,41,1,2,2023
GER-Bundesliga,2022,Bayern Munich,Lucas Hernández,FRA,DF,26,1996,5.3,6,4,3,3,0,5,6,83.3,1,2,1,1,5,11,7,0,2023
GER-Bundesliga,2022,Bayern Munich,Manuel Neuer,GER,GK,36,1986,12.0,0,0,0,0,0,0,0,,0,0,0,0,0,0,4,1,2023
GER-Bundesliga,2022,Bayern Munich,Marcel Sabitzer,AUT,MF,28,1994,7.0,27,14,11,10,6,10,17,58.8,7,3,0,3,10,37,9,0,2023
GER-Bundesliga,2022,Bayern Munich,Mathys Tel,FRA,FW,17,2005,4.6,2,2,0,1,1,1,1,100.0,0,5,1,4,0,2,2,0,2023
GER-Bundesliga,2022,Bayern Munich,Matthijs de Ligt,NED,DF,22,1999,26.7,32,23,15,16,1,15,24,62.5,9,31,20,11,23,55,85,0,2023
GER-Bundesliga,2022,Bayern Munich,Noussair Mazraoui,MAR,DF,24,1997,11.9,29,21,9,9,11,15,24,62.5,9,13,2,11,10,39,25,0,2023
GER-Bundesliga,2022,Bayern Munich,Paul Wanner,GER,MF,16,2005,0.3,3,1,1,2,0,1,1,100.0,0,0,0,0,0,3,1,0,2023
GER-Bundesliga,2022,Bayern Munich,Ryan Gravenberch,NED,MF,20,2002,6.4,17,8,4,10,3,7,13,53.8,6,9,1,8,9,26,10,0,2023
GER-Bundesliga,2022,Bayern Munich,Sadio Mané,SEN,"FW,MF",30,1992,15.8,11,5,3,3,5,1,9,11.1,8,15,2,13,0,11,4,0,2023
GER-Bundesliga,2022,Bayern Munich,Serge Gnabry,GER,"FW,MF",27,1995,21.6,35,23,11,14,10,17,43,39.5,26,24,1,23,11,46,5,1,2023
GER-Bundesliga,2022,Bayern Munich,Sven Ulreich,GER,GK,33,1988,3.0,1,1,1,0,0,1,1,100.0,0,0,0,0,0,1,0,1,2023
GER-Bundesliga,2022,Bayern Munich,Thomas Müller,GER,"FW,MF",32,1989,18.5,21,12,5,9,7,6,16,37.5,10,19,3,16,4,25,16,0,2023
GER-Bundesliga,2022,Bayern Munich,Yann Sommer,SUI,GK,33,1988,19.0,0,0,0,0,0,0,0,,0,0,0,0,1,1,5,1,2023
GER-Bundesliga,2022,Bochum,Anthony Losilla,FRA,MF,36,1986,30.2,76,49,32,34,10,38,77,49.4,39,39,12,27,37,113,67,0,2023
GER-Bundesliga,2022,Bochum,Christopher Antwi-Adjei,GHA,"FW,MF",28,1994,22.0,23,15,7,8,8,10,29,34.5,19,17,0,17,5,28,16,0,2023
GER-Bundesliga,2022,Bochum,Cristian Gamboa,CRC,DF,32,1989,16.4,42,24,27,14,1,21,31,67.7,10,20,7,13,16,58,34,1,2023
GER-Bundesliga,2022,Bochum,Danilo Soares,BRA,DF,30,1991,19.6,72,46,42,23,7,43,72,59.7,29,29,6,23,30,102,56,1,2023
GER-Bundesliga,2022,Bochum,Dominique Heintz,GER,DF,28,1993,8.8,13,9,5,7,1,6,17,35.3,11,11,7,4,12,25,34,0,2023
GER-Bundesliga,2022,Bochum,Erhan Mašović,SRB,"DF,MF",23,1998,24.2,50,31,28,21,1,30,51,58.8,21,30,14,16,27,77,79,0,2023
GER-Bundesliga,2022,Bochum,Gerrit Holtmann,PHI,"FW,MF",27,1995,10.5,14,7,6,7,1,12,21,57.1,9,15,1,14,2,16,4,0,2023
GER-Bundesliga,2022,Bochum,Ivan Ordets,UKR,DF,30,1992,27.2,31,19,21,9,1,16,28,57.1,12,34,17,17,57,88,139,0,2023
GER-Bundesliga,2022,Bochum,Jacek Góralski,POL,MF,29,1992,1.6,6,3,3,3,0,4,6,66.7,2,4,0,4,3,9,5,0,2023
GER-Bundesliga,2022,Bochum,Jannes Horn,GER,"DF,FW",25,1997,0.7,2,1,1,1,0,1,1,100.0,0,1,0,1,3,5,2,0,2023
GER-Bundesliga,2022,Bochum,Jordi Osei-Tutu,ENG,"DF,FW",23,1998,8.3,23,18,13,5,5,12,23,52.2,11,12,5,7,10,33,8,0,2023
GER-Bundesliga,2022,Bochum,Keven Schlotterbeck,GER,DF,25,1997,8.2,17,9,12,5,0,9,11,81.8,2,11,5,6,14,31,49,0,2023
GER-Bundesliga,2022,Bochum,Kevin Stöger,AUT,MF,28,1993,28.9,84,45,38,32,14,31,94,33.0,63,27,4,23,26,110,21,1,2023
GER-Bundesliga,2022,Bochum,Kostas Stafylidis,GRE,"DF,MF",28,1993,11.6,27,16,13,8,6,10,24,41.7,14,21,8,13,20,47,31,1,2023
GER-Bundesliga,2022,Bochum,Manuel Riemann,GER,GK,33,1988,34.0,3,2,3,0,0,3,5,60.0,2,1,0,1,5,8,23,7,2023
GER-Bundesliga,2022,Bochum,Moritz Broschinski,GER,"FW,MF",21,2000,2.4,0,0,0,0,0,0,5,0.0,5,1,0,1,0,0,6,0,2023
GER-Bundesliga,2022,Bochum,Patrick Osterhage,GER,MF,22,2000,11.4,20,17,8,10,2,11,16,68.8,5,17,6,11,12,32,25,0,2023
GER-Bundesliga,2022,Bochum,Philipp Förster,GER,MF,27,1995,14.5,31,19,11,15,5,12,40,30.0,28,22,0,22,6,37,6,0,2023
GER-Bundesliga,2022,Bochum,Philipp Hofmann,GER,FW,29,1993,29.2,18,11,0,13,5,5,12,41.7,7,20,8,12,6,24,48,0,2023
GER-Bundesliga,2022,Bochum,Pierre Kunde,CMR,"MF,FW",27,1995,4.2,12,6,3,8,1,6,14,42.9,8,7,1,6,7,19,9,0,2023
GER-Bundesliga,2022,Bochum,Saidy Janko,GAM,DF,26,1995,12.6,23,15,13,8,2,12,20,60.0,8,24,10,14,11,34,33,1,2023
GER-Bundesliga,2022,Bochum,Silvère Ganvoula M'Boussy,CGO,"FW,MF",26,1996,2.7,2,2,0,1,1,0,0,,0,0,0,0,0,2,3,0,2023
GER-Bundesliga,2022,Bochum,Simon Zoller,GER,FW,31,1991,16.2,11,4,2,8,1,4,12,33.3,8,14,1,13,6,17,21,0,2023
GER-Bundesliga,2022,Bochum,Takuma Asano,JPN,"FW,MF",27,1994,19.0,14,9,4,4,6,7,16,43.8,9,17,1,16,8,22,8,0,2023
GER-Bundesliga,2022,Bochum,Tim Oermann,GER,DF,18,2003,2.2,2,1,2,0,0,1,1,100.0,0,3,2,1,1,3,8,1,2023
GER-Bundesliga,2022,Bochum,Vassilis Lambropoulos,GRE,DF,32,1990,7.0,10,8,7,3,0,6,9,66.7,3,5,3,2,13,23,41,0,2023
GER-Bundesliga,2022,Dortmund,Alexander Meyer,GER,GK,31,1991,7.0,0,0,0,0,0,0,1,0.0,1,0,0,0,0,0,1,0,2023
GER-Bundesliga,2022,Dortmund,Anthony Modeste,FRA,FW,34,1988,9.0,4,4,2,0,2,2,5,40.0,3,7,0,7,2,6,22,0,2023
GER-Bundesliga,2022,Dortmund,Antonios Papadopoulos,GER,DF,22,1999,0.1,0,0,0,0,0,0,0,,0,0,0,0,1,1,0,0,2023
GER-Bundesliga,2022,Dortmund,Donyell Malen,NED,FW,23,1999,19.0,13,5,3,4,6,5,12,41.7,7,14,1,13,4,17,11,0,2023
GER-Bundesliga,2022,Dortmund,Emre Can,GER,MF,28,1994,21.1,57,28,25,27,5,22,43,51.2,21,16,6,10,25,82,39,1,2023
GER-Bundesliga,2022,Dortmund,Felix Passlack,GER,DF,24,1998,0.7,4,3,0,4,0,1,1,100.0,0,1,1,0,0,4,1,0,2023
GER-Bundesliga,2022,Dortmund,Gio Reyna,USA,"FW,MF",19,2002,6.9,14,7,2,5,7,5,10,50.0,5,8,2,6,3,17,5,0,2023
GER-Bundesliga,2022,Dortmund,Gregor Kobel,SUI,GK,24,1997,27.0,0,0,0,0,0,0,1,0.0,1,1,0,1,0,0,7,2,2023
GER-Bundesliga,2022,Dortmund,Jamie Bynoe-Gittens,ENG,"FW,MF",17,2004,5.9,8,4,2,5,1,2,7,28.6,5,1,0,1,1,9,2,0,2023
GER-Bundesliga,2022,Dortmund,Jude Bellingham,ENG,MF,19,2003,29.9,76,42,28,34,14,34,51,66.7,17,51,4,47,35,111,30,0,2023
GER-Bundesliga,2022,Dortmund,Julian Brandt,GER,"MF,FW",26,1996,26.6,29,20,6,14,9,12,43,27.9,31,23,0,23,15,44,9,1,2023
GER-Bundesliga,2022,Dortmund,Julian Ryerson,NOR,DF,24,1997,15.7,27,15,17,7,3,19,37,51.4,18,13,2,11,8,35,28,0,2023
GER-Bundesliga,2022,Dortmund,Julien Duranville,BEL,MF,16,2006,0.3,1,1,0,1,0,1,1,100.0,0,0,0,0,0,1,0,0,2023
GER-Bundesliga,2022,Dortmund,Justin Njinmah,GER,FW,21,2000,0.2,0,0,0,0,0,0,0,,0,0,0,0,0,0,0,0,2023
GER-Bundesliga,2022,Dortmund,Karim Adeyemi,GER,"FW,MF",20,2002,15.4,16,11,6,6,4,8,30,26.7,22,18,1,17,7,23,3,0,2023
GER-Bundesliga,2022,Dortmund,Mahmoud Dahoud,GER,MF,26,1996,3.7,11,9,3,4,4,7,7,100.0,0,6,2,4,7,18,3,0,2023
GER-Bundesliga,2022,Dortmund,Marco Pašalić,CRO,MF,21,2000,0.1,0,0,0,0,0,0,0,,0,0,0,0,0,0,0,0,2023
GER-Bundesliga,2022,Dortmund,Marco Reus,GER,"MF,FW",33,1989,15.0,30,17,12,14,4,7,24,29.2,17,12,4,8,8,38,8,0,2023
GER-Bundesliga,2022,Dortmund,Marius Wolf,GER,DF,27,1995,17.4,25,18,9,12,4,16,29,55.2,13,40,10,30,18,43,22,1,2023
GER-Bundesliga,2022,Dortmund,Mats Hummels,GER,DF,33,1988,22.4,62,34,38,22,2,32,55,58.2,23,30,16,14,33,95,100,1,2023
GER-Bundesliga,2022,Dortmund,Nico Schlotterbeck,GER,DF,22,1999,25.0,59,34,34,24,1,37,53,69.8,16,38,21,17,32,91,71,1,2023
GER-Bundesliga,2022,Dortmund,Niklas Süle,GER,DF,26,1995,23.5,25,19,18,3,4,14,23,60.9,9,28,19,9,17,42,53,0,2023
GER-Bundesliga,2022,Dortmund,Raphaël Guerreiro,POR,"DF,MF",28,1993,25.4,36,20,13,15,8,21,34,61.8,13,21,2,19,36,72,23,0,2023
GER-Bundesliga,2022,Dortmund,Salih Özcan,TUR,MF,24,1998,17.5,31,18,10,16,5,16,39,41.0,23,24,2,22,28,59,19,1,2023
GER-Bundesliga,2022,Dortmund,Soumaïla Coulibaly,FRA,DF,18,2003,0.5,0,0,0,0,0,0,0,,0,0,0,0,0,0,0,1,2023
GER-Bundesliga,2022,Dortmund,Sébastien Haller,CIV,FW,28,1994,13.6,5,4,2,1,2,0,4,0.0,4,8,0,8,1,6,10,0,2023
GER-Bundesliga,2022,Dortmund,Thomas Meunier,BEL,DF,30,1991,6.5,16,7,8,5,3,10,17,58.8,7,7,2,5,9,25,16,0,2023
GER-Bundesliga,2022,Dortmund,Thorgan Hazard,BEL,"FW,DF",29,1993,5.2,17,6,5,11,1,12,17,70.6,5,6,0,6,5,22,5,0,2023
GER-Bundesliga,2022,Dortmund,Tom Rothe,GER,DF,17,2004,0.3,1,1,0,1,0,1,1,100.0,0,0,0,0,1,2,2,0,2023
GER-Bundesliga,2022,Dortmund,Youssoufa Moukoko,GER,FW,17,2004,12.7,13,7,3,6,4,3,6,50.0,3,9,0,9,2,15,1,0,2023
GER-Bundesliga,2022,Eint Frankfurt,Almamy Touré,MLI,DF,26,1996,4.4,13,7,7,5,1,5,9,55.6,4,9,2,7,10,23,8,0,2023
GER-Bundesliga,2022,Eint Frankfurt,Ansgar Knauff,GER,DF,20,2002,14.3,36,25,22,11,3,15,34,44.1,19,19,1,18,15,51,26,0,2023
GER-Bundesliga,2022,Eint Frankfurt,Aurélio Buta,POR,DF,25,1997,14.6,33,19,15,13,5,15,27,55.6,12,18,1,17,9,42,34,0,2023
GER-Bundesliga,2022,Eint Frankfurt,Christopher Lenz,GER,DF,27,1994,14.3,29,21,17,7,5,16,37,43.2,21,16,3,13,21,50,34,0,2023
GER-Bundesliga,2022,Eint Frankfurt,Daichi Kamada,JPN,MF,25,1996,25.2,51,31,10,37,4,31,57,54.4,26,31,2,29,16,67,17,1,2023
GER-Bundesliga,2022,Eint Frankfurt,Dario Gebuhr,GER,DF,19,2003,0.2,0,0,0,0,0,0,1,0.0,1,0,0,0,0,0,0,0,2023
GER-Bundesliga,2022,Eint Frankfurt,Diant Ramaj,GER,GK,20,2001,1.0,0,0,0,0,0,0,0,,0,0,0,0,0,0,1,0,2023
GER-Bundesliga,2022,Eint Frankfurt,Djibril Sow,SUI,MF,25,1997,29.4,41,25,13,25,3,22,44,50.0,22,22,4,18,28,69,23,0,2023
GER-Bundesliga,2022,Eint Frankfurt,Faride Alidou,GER,"DF,MF",21,2001,2.0,8,5,3,4,1,3,9,33.3,6,3,0,3,1,9,3,0,2023
GER-Bundesliga,2022,Eint Frankfurt,Filip Kostić,SRB,"DF,MF",29,1992,0.8,2,0,1,1,0,0,0,,0,0,0,0,1,3,0,0,2023
GER-Bundesliga,2022,Eint Frankfurt,Hrvoje Smolčić,CRO,DF,21,2000,5.2,8,7,6,2,0,5,10,50.0,5,11,4,7,6,14,38,0,2023
GER-Bundesliga,2022,Eint Frankfurt,Jesper Lindstrøm,DEN,"MF,FW",22,2000,18.7,26,11,15,7,4,7,22,31.8,15,25,3,22,9,35,9,0,2023
GER-Bundesliga,2022,Eint Frankfurt,Junior Dina Ebimbe,FRA,"DF,MF",21,2000,11.8,30,19,16,14,0,16,33,48.5,17,18,5,13,11,41,20,0,2023
GER-Bundesliga,2022,Eint Frankfurt,Kevin Trapp,GER,GK,32,1990,33.0,1,1,1,0,0,0,2,0.0,2,2,0,2,0,1,10,0,2023
GER-Bundesliga,2022,Eint Frankfurt,Kristijan Jakić,CRO,"DF,MF",25,1997,16.2,33,21,19,12,2,22,41,53.7,19,32,10,22,14,47,49,1,2023
GER-Bundesliga,2022,Eint Frankfurt,Luca Pellegrini,ITA,DF,23,1999,6.2,13,8,10,3,0,8,8,100.0,0,8,2,6,7,20,11,1,2023
GER-Bundesliga,2022,Eint Frankfurt,Lucas Alario,ARG,"FW,MF",29,1992,3.7,3,2,1,0,2,0,1,0.0,1,0,0,0,2,5,13,0,2023
GER-Bundesliga,2022,Eint Frankfurt,Makoto Hasebe,JPN,DF,38,1984,14.5,18,12,16,2,0,7,22,31.8,15,22,9,13,17,35,45,0,2023
GER-Bundesliga,2022,Eint Frankfurt,Marcel Wenig,GER,MF,18,2004,0.0,0,0,0,0,0,0,0,,0,0,0,0,0,0,0,0,2023
GER-Bundesliga,2022,Eint Frankfurt,Mario Götze,GER,MF,30,1992,30.4,42,25,13,22,7,14,47,29.8,33,25,0,25,13,55,12,0,2023
GER-Bundesliga,2022,Eint Frankfurt,Obite N'Dicka,FRA,DF,22,1999,29.9,25,18,10,11,4,18,32,56.3,14,47,19,28,31,56,150,0,2023
GER-Bundesliga,2022,Eint Frankfurt,Paxten Aaronson,USA,"MF,DF",18,2003,1.9,6,5,2,2,2,2,3,66.7,1,2,1,1,0,6,2,0,2023
GER-Bundesliga,2022,Eint Frankfurt,Philipp Max,GER,DF,28,1993,7.7,12,9,4,7,1,5,16,31.3,11,10,2,8,3,15,11,0,2023
GER-Bundesliga,2022,Eint Frankfurt,Rafael Borré,COL,"MF,FW",26,1995,12.0,25,15,4,13,8,4,17,23.5,13,10,2,8,2,27,9,0,2023
GER-Bundesliga,2022,Eint Frankfurt,Randal Kolo Muani,FRA,FW,23,1998,29.2,14,10,3,3,8,1,9,11.1,8,19,2,17,3,17,13,0,2023
GER-Bundesliga,2022,Eint Frankfurt,Sebastian Rode,GER,MF,31,1990,15.7,38,24,7,28,3,14,45,31.1,31,18,2,16,16,54,12,0,2023
GER-Bundesliga,2022,Eint Frankfurt,Timothy Chandler,USA,DF,32,1990,1.0,2,2,2,0,0,2,2,100.0,0,1,0,1,0,2,3,0,2023
GER-Bundesliga,2022,Eint Frankfurt,Tuta,BRA,DF,23,1999,30.2,53,35,27,19,7,33,57,57.9,24,47,14,33,49,102,134,2,2023
GER-Bundesliga,2022,Freiburg,Christian Günter,GER,"DF,MF",29,1993,30.5,29,21,18,9,2,13,43,30.2,30,22,4,18,16,45,41,0,2023
GER-Bundesliga,2022,Freiburg,Daniel Kyereh,GHA,"MF,FW",26,1996,6.2,6,4,2,4,0,3,6,50.0,3,4,0,4,2,8,6,0,2023
GER-Bundesliga,2022,Freiburg,Hugo Siquet,BEL,DF,20,2002,0.2,2,2,2,0,0,2,2,100.0,0,1,0,1,0,2,0,0,2023
GER-Bundesliga,2022,Freiburg,Jeong Woo-yeong,KOR,"MF,FW",22,1999,7.3,7,3,4,2,1,2,5,40.0,3,7,1,6,1,8,7,0,2023
GER-Bundesliga,2022,Freiburg,Jonathan Schmid,FRA,DF,32,1990,0.5,1,1,1,0,0,0,0,,0,1,0,1,1,2,1,1,2023
GER-Bundesliga,2022,Freiburg,Kenneth Schmidt,GER,DF,20,2002,2.8,6,3,4,2,0,5,6,83.3,1,4,2,2,0,6,2,0,2023
GER-Bundesliga,2022,Freiburg,Keven Schlotterbeck,GER,DF,25,1997,0.2,0,0,0,0,0,0,0,,0,1,1,0,2,2,2,0,2023
GER-Bundesliga,2022,Freiburg,Kevin Schade,GER,"FW,MF",20,2001,2.0,6,4,3,2,1,3,5,60.0,2,0,0,0,0,6,2,0,2023
GER-Bundesliga,2022,Freiburg,Kiliann Sildillia,FRA,"DF,MF",20,2002,22.0,33,20,10,19,4,18,30,60.0,12,24,9,15,21,54,47,1,2023
GER-Bundesliga,2022,Freiburg,Kimberly Ezekwem,GER,DF,21,2001,0.1,0,0,0,0,0,0,0,,0,1,0,1,0,0,0,0,2023
GER-Bundesliga,2022,Freiburg,Lucas Höler,GER,"FW,MF",28,1994,16.7,19,14,5,7,7,6,22,27.3,16,22,5,17,10,29,17,0,2023
GER-Bundesliga,2022,Freiburg,Lukas Kübler,GER,DF,29,1992,18.2,37,25,24,9,4,18,30,60.0,12,25,11,14,29,66,50,0,2023
GER-Bundesliga,2022,Freiburg,Manuel Gulde,GER,DF,31,1991,7.1,14,8,10,4,0,2,4,50.0,2,5,1,4,19,33,25,0,2023
GER-Bundesliga,2022,Freiburg,Mark Flekken,NED,GK,29,1993,34.0,0,0,0,0,0,0,1,0.0,1,1,0,1,0,0,9,5,2023
GER-Bundesliga,2022,Freiburg,Matthias Ginter,GER,DF,28,1994,34.0,43,20,29,12,2,26,40,65.0,14,40,24,16,35,78,153,3,2023
GER-Bundesliga,2022,Freiburg,Maximilian Eggestein,GER,MF,25,1996,27.2,51,29,21,24,6,17,35,48.6,18,37,8,29,36,87,27,0,2023
GER-Bundesliga,2022,Freiburg,Merlin Röhl,GER,"MF,FW",20,2002,0.6,1,0,1,0,0,0,0,,0,0,0,0,0,1,1,0,2023
GER-Bundesliga,2022,Freiburg,Michael Gregoritsch,AUT,FW,28,1994,23.9,19,12,6,9,4,3,21,14.3,18,23,4,19,5,24,10,0,2023
GER-Bundesliga,2022,Freiburg,Nicolas Höfler,GER,MF,32,1990,31.3,66,35,28,35,3,27,61,44.3,34,40,13,27,58,124,49,0,2023
GER-Bundesliga,2022,Freiburg,Nils Petersen,GER,FW,33,1988,3.1,6,4,0,3,3,2,5,40.0,3,11,2,9,1,7,6,0,2023
GER-Bundesliga,2022,Freiburg,Noah Weißhaupt,GER,"MF,DF",20,2001,4.7,11,6,3,7,1,2,7,28.6,5,4,0,4,6,17,8,0,2023
GER-Bundesliga,2022,Freiburg,Philipp Lienhart,AUT,DF,26,1996,27.8,29,18,19,10,0,13,27,48.1,14,29,15,14,35,64,97,0,2023
GER-Bundesliga,2022,Freiburg,Ritsu Doan,JPN,"MF,FW",24,1998,26.9,61,29,19,29,13,25,54,46.3,29,40,1,39,14,75,12,0,2023
GER-Bundesliga,2022,Freiburg,Robert Wagner,GER,MF,19,2003,0.4,0,0,0,0,0,0,0,,0,2,0,2,0,0,2,0,2023
GER-Bundesliga,2022,Freiburg,Roland Sallai,HUN,"MF,FW",25,1997,11.1,11,8,4,3,4,4,10,40.0,6,7,1,6,2,13,11,0,2023
GER-Bundesliga,2022,Freiburg,Vincenzo Grifo,ITA,"MF,FW",29,1993,26.8,29,16,6,15,8,13,31,41.9,18,18,1,17,19,48,19,0,2023
GER-Bundesliga,2022,Freiburg,Yannik Keitel,GER,MF,22,2000,7.6,11,7,4,6,1,3,5,60.0,2,6,3,3,13,24,8,0,2023
GER-Bundesliga,2022,Hertha BSC,Agustín Rogel,URU,DF,24,1997,15.8,18,9,13,5,0,11,17,64.7,6,15,8,7,11,29,74,1,2023
GER-Bundesliga,2022,Hertha BSC,Chidera Ejuke,NGA,"FW,MF",24,1998,9.9,5,4,1,4,0,1,5,20.0,4,4,0,4,4,9,1,0,2023
GER-Bundesliga,2022,Hertha BSC,Davie Selke,GER,FW,27,1995,3.1,2,1,1,1,0,0,1,0.0,1,3,1,2,1,3,5,0,2023
GER-Bundesliga,2022,Hertha BSC,Derry Scherhant,GER,"FW,MF",19,2002,3.2,7,6,3,3,1,4,8,50.0,4,3,0,3,0,7,5,0,2023
GER-Bundesliga,2022,Hertha BSC,Dodi Lukebakio,BEL,"FW,MF",24,1997,26.6,18,11,7,8,3,6,27,22.2,21,23,5,18,13,31,17,0,2023
GER-Bundesliga,2022,Hertha BSC,Filip Uremović,CRO,DF,25,1997,19.2,38,23,29,8,1,14,22,63.6,8,18,13,5,36,74,88,2,2023
GER-Bundesliga,2022,Hertha BSC,Florian Niederlechner,GER,FW,31,1990,8.7,9,7,2,4,3,2,8,25.0,6,7,0,7,3,12,10,0,2023
GER-Bundesliga,2022,Hertha BSC,Ibrahim Maza,GER,"MF,FW",16,2005,0.8,1,1,1,0,0,0,1,0.0,1,2,0,2,0,1,1,0,2023
GER-Bundesliga,2022,Hertha BSC,Ivan Šunjić,CRO,MF,25,1996,11.0,38,20,16,21,1,16,24,66.7,8,17,5,12,13,51,19,1,2023
GER-Bundesliga,2022,Hertha BSC,Jean-Paul Boëtius,NED,MF,28,1994,11.7,30,16,19,9,2,8,25,32.0,17,25,5,20,14,44,10,0,2023
GER-Bundesliga,2022,Hertha BSC,Jessic Ngankam,GER,"FW,MF",22,2000,9.2,14,9,7,4,3,6,14,42.9,8,6,1,5,1,15,4,0,2023
GER-Bundesliga,2022,Hertha BSC,Jonjoe Kenny,ENG,DF,25,1997,24.9,46,34,27,16,3,24,42,57.1,18,38,9,29,46,92,74,0,2023
GER-Bundesliga,2022,Hertha BSC,Julian Eitschberger,GER,FW,18,2004,0.0,0,0,0,0,0,0,0,,0,0,0,0,0,0,0,0,2023
GER-Bundesliga,2022,Hertha BSC,Kevin-Prince Boateng,GHA,MF,35,1987,5.2,8,6,4,2,2,3,9,33.3,6,11,3,8,3,11,5,0,2023
GER-Bundesliga,2022,Hertha BSC,Lucas Tousart,FRA,MF,25,1997,32.7,73,38,35,28,10,27,60,45.0,33,42,6,36,48,121,75,1,2023
GER-Bundesliga,2022,Hertha BSC,Marc-Oliver Kempf,GER,DF,27,1995,30.1,44,27,29,14,1,16,22,72.7,6,42,32,10,51,95,143,0,2023
GER-Bundesliga,2022,Hertha BSC,Marco Richter,GER,"MF,FW",24,1997,20.4,43,23,18,17,8,19,48,39.6,29,29,2,27,24,67,25,0,2023
GER-Bundesliga,2022,Hertha BSC,Marvin Plattenhardt,GER,DF,30,1992,26.7,43,33,24,15,4,29,47,61.7,18,25,11,14,15,58,82,0,2023
GER-Bundesliga,2022,Hertha BSC,Maximilian Mittelstädt,GER,"DF,MF",25,1997,9.4,39,20,31,6,2,17,39,43.6,22,13,2,11,26,65,27,0,2023
GER-Bundesliga,2022,Hertha BSC,Myziane Maolida,FRA,"FW,MF",23,1999,1.1,1,1,1,0,0,1,2,50.0,1,0,0,0,0,1,1,0,2023
GER-Bundesliga,2022,Hertha BSC,Márton Dárdai,GER,"DF,MF",20,2002,10.5,17,8,9,8,0,9,18,50.0,9,14,9,5,11,28,45,1,2023
GER-Bundesliga,2022,Hertha BSC,Oliver Christensen,DEN,GK,23,1999,33.0,1,0,1,0,0,0,2,0.0,2,0,0,0,0,1,22,2,2023
GER-Bundesliga,2022,Hertha BSC,Pascal Klemens,GER,DF,17,2005,1.0,0,0,0,0,0,0,1,0.0,1,1,0,1,1,1,3,0,2023
GER-Bundesliga,2022,Hertha BSC,Peter Pekarík,SVK,DF,35,1986,2.3,4,3,4,0,0,4,6,66.7,2,6,2,4,4,8,7,0,2023
GER-Bundesliga,2022,Hertha BSC,Stevan Jovetić,MNE,"FW,MF",32,1989,9.9,3,2,2,1,0,1,11,9.1,10,2,1,1,2,5,10,0,2023
GER-Bundesliga,2022,Hertha BSC,Suat Serdar,GER,MF,25,1997,22.5,51,23,14,30,7,20,41,48.8,21,48,12,36,29,80,24,0,2023
GER-Bundesliga,2022,Hertha BSC,Tjark Ernst,GER,GK,19,2003,1.0,0,0,0,0,0,0,0,,0,0,0,0,0,0,1,0,2023
GER-Bundesliga,2022,Hertha BSC,Tolga Ciğerci,TUR,MF,30,1992,7.5,16,13,6,9,1,10,16,62.5,6,6,2,4,8,24,5,0,2023
GER-Bundesliga,2022,Hertha BSC,Tony Rölke,GER,FW,19,2003,0.2,0,0,0,0,0,0,0,,0,1,0,1,0,0,1,0,2023
GER-Bundesliga,2022,Hertha BSC,Veit Stange,GER,MF,18,2004,0.1,1,1,1,0,0,1,1,100.0,0,0,0,0,0,1,0,0,2023
GER-Bundesliga,2022,Hertha BSC,Vladimír Darida,CZE,MF,31,1990,0.3,1,1,0,1,0,0,0,,0,1,0,1,0,1,0,0,2023
GER-Bundesliga,2022,Hertha BSC,Wilfried Kanga,CIV,FW,24,1998,15.7,5,4,2,1,2,2,4,50.0,2,14,3,11,2,7,13,0,2023
GER-Bundesliga,2022,Hoffenheim,Andrej Kramarić,CRO,"MF,FW",31,1991,26.5,5,2,2,1,2,1,11,9.1,10,14,2,12,6,11,13,0,2023
GER-Bundesliga,2022,Hoffenheim,Angeliño,ESP,DF,25,1997,29.1,40,24,19,18,3,23,37,62.2,14,32,6,26,25,65,67,0,2023
GER-Bundesliga,2022,Hoffenheim,Angelo Stiller,GER,MF,21,2001,7.8,26,12,9,13,4,8,12,66.7,4,12,2,10,10,36,14,0,2023
GER-Bundesliga,2022,Hoffenheim,Christoph Baumgartner,AUT,"MF,FW",22,1999,28.5,36,19,12,17,7,9,52,17.3,43,57,5,52,15,51,19,1,2023
GER-Bundesliga,2022,Hoffenheim,Dennis Geiger,GER,MF,24,1998,21.7,45,25,15,28,2,22,35,62.9,13,27,3,24,24,69,18,2,2023
GER-Bundesliga,2022,Hoffenheim,Diadie Samassékou,MLI,"MF,FW",26,1996,0.4,1,0,0,1,0,0,1,0.0,1,0,0,0,0,1,0,0,2023
GER-Bundesliga,2022,Hoffenheim,Eduardo Quaresma,POR,DF,20,2002,1.0,5,3,3,2,0,1,3,33.3,2,3,2,1,0,5,3,0,2023
GER-Bundesliga,2022,Hoffenheim,Ermin Bičakčić,BIH,DF,32,1990,2.9,8,4,6,1,1,2,6,33.3,4,4,3,1,5,13,14,0,2023
GER-Bundesliga,2022,Hoffenheim,Finn Ole Becker,GER,MF,22,2000,5.7,10,2,4,6,0,4,7,57.1,3,4,0,4,5,15,8,0,2023
GER-Bundesliga,2022,Hoffenheim,Fisnik Asllani,KVX,FW,19,2002,1.9,0,0,0,0,0,0,4,0.0,4,2,0,2,3,3,3,0,2023
GER-Bundesliga,2022,Hoffenheim,Georginio Rutter,FRA,FW,20,2002,11.2,7,4,1,4,2,1,3,33.3,2,10,2,8,5,12,6,0,2023
GER-Bundesliga,2022,Hoffenheim,Grischa Prömel,GER,MF,27,1995,16.2,27,19,14,11,2,9,25,36.0,16,22,4,18,8,35,23,0,2023
GER-Bundesliga,2022,Hoffenheim,Ihlas Bebou,TOG,"FW,DF",28,1994,15.7,19,16,8,7,4,11,17,64.7,6,9,2,7,7,26,15,0,2023
GER-Bundesliga,2022,Hoffenheim,Jacob Bruun Larsen,DEN,FW,23,1998,3.6,4,3,0,1,3,3,4,75.0,1,3,1,2,1,5,0,0,2023
GER-Bundesliga,2022,Hoffenheim,John Brooks,USA,DF,29,1993,15.0,18,12,10,8,0,13,18,72.2,5,17,12,5,10,28,105,0,2023
GER-Bundesliga,2022,Hoffenheim,Joshua Quarshie,GER,MF,18,2004,0.0,0,0,0,0,0,0,0,,0,0,0,0,0,0,0,0,2023
GER-Bundesliga,2022,Hoffenheim,Kasper Dolberg,DEN,"FW,MF",24,1997,4.5,7,5,1,4,2,4,6,66.7,2,6,2,4,0,7,5,0,2023
GER-Bundesliga,2022,Hoffenheim,Kevin Akpoguma,NGA,DF,27,1995,21.7,75,44,45,27,3,32,45,71.1,13,45,16,29,24,99,70,1,2023
GER-Bundesliga,2022,Hoffenheim,Kevin Vogt,GER,DF,30,1991,19.7,15,10,10,5,0,9,22,40.9,13,18,11,7,26,41,67,0,2023
GER-Bundesliga,2022,Hoffenheim,Moanes Dabbur,ISR,FW,30,1992,10.4,11,8,4,5,2,3,9,33.3,6,8,0,8,5,16,0,0,2023
GER-Bundesliga,2022,Hoffenheim,Muhammed Damar,GER,MF,18,2004,1.8,6,3,1,2,3,1,2,50.0,1,3,0,3,0,6,0,0,2023
GER-Bundesliga,2022,Hoffenheim,Oliver Baumann,GER,GK,32,1990,34.0,0,0,0,0,0,0,0,,0,0,0,0,0,0,15,1,2023
GER-Bundesliga,2022,Hoffenheim,Ozan Kabak,TUR,DF,22,2000,26.5,51,34,27,21,3,17,30,56.7,13,35,23,12,45,96,83,0,2023
GER-Bundesliga,2022,Hoffenheim,Pavel Kadeřábek,CZE,DF,30,1992,18.5,26,20,10,9,7,15,23,65.2,8,12,2,10,14,40,37,1,2023
GER-Bundesliga,2022,Hoffenheim,Robert Skov,DEN,DF,26,1996,15.0,22,11,14,7,1,10,26,38.5,16,22,8,14,8,30,20,2,2023
GER-Bundesliga,2022,Hoffenheim,Sebastian Rudy,GER,MF,32,1990,8.8,26,12,10,16,0,13,27,48.1,14,27,7,20,11,37,13,0,2023
GER-Bundesliga,2022,Hoffenheim,Stanley N'Soki,FRA,DF,23,1999,14.3,22,13,14,7,1,12,22,54.5,10,22,5,17,24,46,34,0,2023
GER-Bundesliga,2022,Hoffenheim,Stefan Posch,AUT,DF,25,1997,0.2,0,0,0,0,0,0,0,,0,0,0,0,0,0,0,0,2023
GER-Bundesliga,2022,Hoffenheim,Thomas Delaney,DEN,MF,30,1991,3.3,6,3,3,2,1,3,8,37.5,5,5,0,5,1,7,4,0,2023
GER-Bundesliga,2022,Hoffenheim,Tom Bischof,GER,"MF,FW",17,2005,3.5,15,10,8,3,4,7,10,70.0,3,5,1,4,1,16,1,0,2023
GER-Bundesliga,2022,Hoffenheim,Umut Tohumcu,GER,"MF,DF",17,2004,3.0,10,5,4,5,1,3,9,33.3,6,4,0,4,2,12,8,0,2023
GER-Bundesliga,2022,Köln,Benno Schmitz,GER,DF,27,1994,26.9,64,42,31,28,5,42,82,51.2,40,34,4,30,26,90,57,0,2023
GER-Bundesliga,2022,Köln,Davie Selke,GER,FW,27,1995,9.7,0,0,0,0,0,0,4,0.0,4,4,1,3,0,0,11,0,2023
GER-Bundesliga,2022,Köln,Dejan Ljubicic,AUT,"MF,FW",24,1997,19.0,25,14,7,14,4,13,40,32.5,27,20,1,19,8,33,8,1,2023
GER-Bundesliga,2022,Köln,Denis Huseinbasic,GER,"MF,FW",21,2001,8.8,23,9,8,11,4,10,25,40.0,15,16,2,14,4,27,5,0,2023
GER-Bundesliga,2022,Köln,Dimitris Limnios,GRE,FW,24,1998,0.4,0,0,0,0,0,0,0,,0,0,0,0,1,1,0,0,2023
GER-Bundesliga,2022,Köln,Ellyes Skhiri,TUN,MF,27,1995,31.7,79,44,29,42,8,26,66,39.4,40,52,12,40,56,135,48,0,2023
GER-Bundesliga,2022,Köln,Eric Martel,GER,MF,20,2002,22.4,66,41,29,30,7,30,60,50.0,30,29,9,20,33,99,49,0,2023
GER-Bundesliga,2022,Köln,Florian Dietz,GER,FW,23,1998,4.4,2,1,0,2,0,1,4,25.0,3,4,1,3,0,2,2,0,2023
GER-Bundesliga,2022,Köln,Florian Kainz,AUT,"MF,FW",29,1992,26.0,21,10,7,12,2,8,26,30.8,18,27,6,21,32,53,30,1,2023
GER-Bundesliga,2022,Köln,Jan Thielmann,GER,FW,20,2002,9.7,9,8,3,4,2,2,11,18.2,9,16,3,13,9,18,7,0,2023
GER-Bundesliga,2022,Köln,Jonas Hector,GER,DF,32,1990,31.4,112,66,59,43,10,66,113,58.4,47,61,9,52,39,151,74,1,2023
GER-Bundesliga,2022,Köln,Julian Chabot,GER,DF,24,1998,20.0,36,23,19,14,3,20,35,57.1,15,30,18,12,41,77,105,0,2023
GER-Bundesliga,2022,Köln,Justin Diehl,GER,"MF,FW",17,2004,0.2,0,0,0,0,0,0,0,,0,0,0,0,0,0,0,0,2023
GER-Bundesliga,2022,Köln,Kingsley Ehizibue,NED,DF,27,1995,0.7,0,0,0,0,0,0,0,,0,1,0,1,2,2,1,0,2023
GER-Bundesliga,2022,Köln,Kingsley Schindler,GHA,"DF,MF",29,1993,12.1,23,12,13,8,2,18,28,64.3,10,14,2,12,15,38,24,0,2023
GER-Bundesliga,2022,Köln,Kristian Pedersen,DEN,DF,27,1994,3.1,5,4,4,1,0,0,2,0.0,2,3,0,3,6,11,17,0,2023
GER-Bundesliga,2022,Köln,Linton Maina,GER,"FW,MF",23,1999,24.9,18,12,5,11,2,7,30,23.3,23,19,0,19,5,23,9,0,2023
GER-Bundesliga,2022,Köln,Luca Kilian,GER,DF,22,1999,12.5,22,16,14,7,1,12,21,57.1,9,16,8,8,11,33,48,0,2023
GER-Bundesliga,2022,Köln,Mark Uth,GER,"MF,FW",30,1991,0.5,0,0,0,0,0,0,0,,0,0,0,0,0,0,0,0,2023
GER-Bundesliga,2022,Köln,Marvin Schwäbe,GER,GK,27,1995,34.0,1,0,1,0,0,1,1,100.0,0,0,0,0,2,3,8,2,2023
GER-Bundesliga,2022,Köln,Mathias Olesen,LUX,MF,21,2001,5.3,10,5,4,4,2,5,8,62.5,3,6,1,5,2,12,3,0,2023
GER-Bundesliga,2022,Köln,Nikola Soldo,CRO,DF,21,2001,6.6,15,9,8,7,0,7,11,63.6,4,7,6,1,7,22,28,0,2023
GER-Bundesliga,2022,Köln,Ondrej Duda,SVK,MF,27,1994,7.7,9,8,2,5,2,4,11,36.4,7,7,1,6,2,11,3,0,2023
GER-Bundesliga,2022,Köln,Sargis Adamyan,ARM,"FW,MF",29,1993,7.2,14,7,5,3,6,7,17,41.2,10,12,0,12,4,18,5,0,2023
GER-Bundesliga,2022,Köln,Steffen Tigges,GER,FW,24,1998,17.7,12,7,1,8,3,4,14,28.6,10,13,2,11,8,20,17,0,2023
GER-Bundesliga,2022,Köln,Tim Lemperle,GER,"FW,MF",20,2002,1.5,6,4,3,1,2,3,5,60.0,2,5,0,5,1,7,4,0,2023
GER-Bundesliga,2022,Köln,Timo Hübers,GER,DF,26,1996,28.4,43,28,35,8,0,24,52,46.2,28,27,13,14,58,101,153,0,2023
GER-Bundesliga,2022,Leverkusen,Adam Hložek,CZE,"FW,MF",20,2002,14.3,9,4,4,3,2,3,9,33.3,6,9,2,7,6,15,9,0,2023
GER-Bundesliga,2022,Leverkusen,Amine Adli,FRA,"FW,MF",22,2000,15.9,18,10,4,6,8,5,17,29.4,12,28,2,26,6,24,7,0,2023
GER-Bundesliga,2022,Leverkusen,Andrey Lunyov,RUS,GK,30,1991,1.0,0,0,0,0,0,0,0,,0,0,0,0,0,0,0,0,2023
GER-Bundesliga,2022,Leverkusen,Ayman Azhil,MAR,MF,21,2001,0.0,0,0,0,0,0,0,0,,0,0,0,0,0,0,0,0,2023
GER-Bundesliga,2022,Leverkusen,Callum Hudson-Odoi,ENG,"FW,MF",21,2000,6.7,5,3,4,0,1,1,1,100.0,0,0,0,0,2,7,4,0,2023
GER-Bundesliga,2022,Leverkusen,Charles Aránguiz,CHI,MF,33,1989,5.5,17,7,7,10,0,12,20,60.0,8,4,0,4,7,24,4,0,2023
GER-Bundesliga,2022,Leverkusen,Daley Sinkgraven,NED,"DF,MF",27,1995,3.8,10,7,7,3,0,7,9,77.8,2,8,4,4,5,15,7,0,2023
GER-Bundesliga,2022,Leverkusen,Edmond Tapsoba,BFA,DF,23,1999,31.9,51,30,35,12,4,30,42,71.4,12,40,17,23,36,87,109,1,2023
GER-Bundesliga,2022,Leverkusen,Exequiel Palacios,ARG,MF,23,1998,18.4,59,36,20,33,6,29,48,60.4,19,29,2,27,33,92,28,0,2023
GER-Bundesliga,2022,Leverkusen,Florian Wirtz,GER,"FW,MF",19,2003,12.1,18,10,9,7,2,8,16,50.0,8,15,1,14,1,19,6,0,2023
GER-Bundesliga,2022,Leverkusen,Jeremie Frimpong,NED,"DF,MF",21,2000,30.1,53,27,22,26,5,23,44,52.3,21,24,3,21,16,69,40,0,2023
GER-Bundesliga,2022,Leverkusen,Joel Pohjanpalo,FIN,"FW,MF",27,1994,0.0,0,0,0,0,0,0,0,,0,0,0,0,0,0,0,0,2023
GER-Bundesliga,2022,Leverkusen,Jonathan Tah,GER,DF,26,1996,27.6,25,12,21,4,0,12,18,66.7,6,30,18,12,40,65,118,0,2023
GER-Bundesliga,2022,Leverkusen,Karim Bellarabi,GER,"FW,MF",32,1990,0.9,2,0,1,1,0,2,3,66.7,1,0,0,0,0,2,0,0,2023
GER-Bundesliga,2022,Leverkusen,Kerem Demirbay,GER,MF,29,1993,17.2,36,18,16,17,3,18,34,52.9,16,26,6,20,16,52,11,0,2023
GER-Bundesliga,2022,Leverkusen,Lukáš Hrádecký,FIN,GK,32,1989,33.0,0,0,0,0,0,0,0,,0,0,0,0,0,0,3,3,2023
GER-Bundesliga,2022,Leverkusen,Mitchel Bakker,NED,"DF,MF",22,2000,18.4,16,8,9,7,0,6,15,40.0,9,20,2,18,15,31,20,2,2023
GER-Bundesliga,2022,Leverkusen,Moussa Diaby,FRA,"FW,MF",23,1999,30.0,14,8,4,8,2,7,14,50.0,7,8,0,8,5,19,3,0,2023
GER-Bundesliga,2022,Leverkusen,Nadiem Amiri,GER,"MF,FW",25,1996,10.9,15,6,5,8,2,9,20,45.0,11,12,1,11,6,21,10,2,2023
GER-Bundesliga,2022,Leverkusen,Noah Mbamba,BEL,MF,17,2005,0.0,0,0,0,0,0,0,0,,0,0,0,0,0,0,0,0,2023
GER-Bundesliga,2022,Leverkusen,Odilon Kossonou,CIV,DF,21,2001,16.9,21,14,12,7,2,8,16,50.0,8,26,11,15,24,45,58,1,2023
GER-Bundesliga,2022,Leverkusen,Patrik Schick,CZE,FW,26,1996,10.5,0,0,0,0,0,0,1,0.0,1,4,1,3,1,1,7,0,2023
GER-Bundesliga,2022,Leverkusen,Paulinho,BRA,FW,22,2000,0.9,0,0,0,0,0,0,0,,0,1,0,1,0,0,2,0,2023
GER-Bundesliga,2022,Leverkusen,Piero Hincapié,ECU,DF,20,2002,27.3,51,34,28,20,3,25,38,65.8,13,41,20,21,31,82,83,1,2023
GER-Bundesliga,2022,Leverkusen,Robert Andrich,GER,MF,27,1994,26.7,61,38,30,27,4,26,45,57.8,19,27,9,18,42,103,55,2,2023
GER-Bundesliga,2022,Leverkusen,Sardar Azmoun,IRN,"FW,MF",27,1995,10.3,6,3,1,4,1,1,7,14.3,6,4,0,4,2,8,14,0,2023
GER-Bundesliga,2022,Leverkusen,Timothy Fosu-Mensah,NED,DF,24,1998,2.1,7,5,3,3,1,4,4,100.0,0,2,0,2,0,7,1,0,2023
GER-Bundesliga,2022,M'Gladbach,Alassane Pléa,FRA,FW,29,1993,19.7,16,8,5,7,4,8,26,30.8,18,23,3,20,12,28,14,0,2023
GER-Bundesliga,2022,M'Gladbach,Christoph Kramer,GER,MF,31,1991,24.7,44,33,24,15,5,22,55,40.0,33,34,2,32,17,61,40,0,2023
GER-Bundesliga,2022,M'Gladbach,Florian Neuhaus,GER,MF,25,1997,15.6,19,9,9,5,5,8,27,29.6,19,20,3,17,12,31,5,0,2023
GER-Bundesliga,2022,M'Gladbach,Hannes Wolf,AUT,FW,23,1999,5.0,11,8,4,5,2,5,13,38.5,8,3,0,3,3,14,9,0,2023
GER-Bundesliga,2022,M'Gladbach,Jan Jakob Olschowsky,GER,GK,20,2001,4.0,0,0,0,0,0,0,1,0.0,1,1,0,1,0,0,1,0,2023
GER-Bundesliga,2022,M'Gladbach,Joe Scally,USA,DF,19,2002,24.5,31,20,25,5,1,24,31,77.4,7,17,6,11,8,39,61,0,2023
GER-Bundesliga,2022,M'Gladbach,Jonas Hofmann,GER,"FW,MF",30,1992,29.8,31,16,17,8,6,15,52,28.8,37,36,2,34,16,47,21,0,2023
GER-Bundesliga,2022,M'Gladbach,Jonas Omlin,SUI,GK,28,1994,14.3,1,1,1,0,0,1,3,33.3,2,1,0,1,0,1,9,1,2023
GER-Bundesliga,2022,M'Gladbach,Julian Weigl,GER,MF,26,1995,21.0,43,16,21,21,1,23,41,56.1,18,23,2,21,18,61,32,0,2023
GER-Bundesliga,2022,M'Gladbach,Ko Itakura,JPN,DF,25,1997,22.0,29,17,18,7,4,16,30,53.3,14,41,25,16,27,56,95,0,2023
GER-Bundesliga,2022,M'Gladbach,Kouadio Koné,FRA,MF,21,2001,29.0,74,39,37,33,4,24,47,51.1,23,44,12,32,32,106,21,0,2023
GER-Bundesliga,2022,M'Gladbach,Lars Stindl,GER,"FW,MF",33,1988,19.3,24,14,4,17,3,10,28,35.7,18,24,5,19,11,35,19,0,2023
GER-Bundesliga,2022,M'Gladbach,Luca Netz,GER,DF,19,2003,7.8,25,13,19,3,3,19,32,59.4,13,5,1,4,6,31,27,0,2023
GER-Bundesliga,2022,M'Gladbach,Marcus Thuram,FRA,FW,24,1997,27.9,14,7,3,6,5,6,13,46.2,7,20,3,17,6,20,22,0,2023
GER-Bundesliga,2022,M'Gladbach,Marvin Friedrich,GER,DF,26,1995,13.9,17,11,13,3,1,10,13,76.9,3,14,6,8,11,28,52,0,2023
GER-Bundesliga,2022,M'Gladbach,Nathan N'Goumou,FRA,FW,22,2000,7.7,11,5,5,5,1,7,13,53.8,6,9,0,9,1,12,4,0,2023
GER-Bundesliga,2022,M'Gladbach,Nico Elvedi,SUI,DF,25,1996,31.4,46,24,32,12,2,27,41,65.9,14,31,16,15,35,81,149,3,2023
GER-Bundesliga,2022,M'Gladbach,Oscar Fraulo,DEN,"FW,MF",18,2003,0.1,0,0,0,0,0,0,0,,0,0,0,0,0,0,0,0,2023
GER-Bundesliga,2022,M'Gladbach,Patrick Herrmann,GER,"FW,MF",31,1991,1.8,6,2,4,1,1,2,4,50.0,2,2,0,2,2,8,1,0,2023
GER-Bundesliga,2022,M'Gladbach,Ramy Bensebaini,ALG,DF,27,1995,27.6,34,21,21,10,3,26,39,66.7,13,44,14,30,36,70,98,1,2023
GER-Bundesliga,2022,M'Gladbach,Rocco Reitz,GER,MF,20,2002,0.0,0,0,0,0,0,0,0,,0,0,0,0,0,0,0,0,2023
GER-Bundesliga,2022,M'Gladbach,Semir Telalovic,GER,"MF,FW",22,1999,0.1,0,0,0,0,0,0,0,,0,0,0,0,0,0,0,0,2023
GER-Bundesliga,2022,M'Gladbach,Stefan Lainer,AUT,DF,29,1992,9.1,16,8,10,5,1,10,23,43.5,13,8,1,7,14,30,34,1,2023
GER-Bundesliga,2022,M'Gladbach,Tobias Sippel,GER,GK,34,1988,5.7,0,0,0,0,0,0,0,,0,0,0,0,0,0,1,1,2023
GER-Bundesliga,2022,M'Gladbach,Tony Jantschke,GER,"DF,MF",32,1990,1.1,2,1,1,1,0,1,1,100.0,0,5,3,2,0,2,5,0,2023
GER-Bundesliga,2022,M'Gladbach,Yann Sommer,SUI,GK,33,1988,10.0,1,0,1,0,0,1,1,100.0,0,0,0,0,0,1,8,0,2023
GER-Bundesliga,2022,M'Gladbach,Yvandro Borges Sanches,LUX,"FW,MF",18,2004,0.3,2,2,0,2,0,2,2,100.0,0,0,0,0,0,2,0,0,2023
GER-Bundesliga,2022,Mainz 05,Aarón Martín,ESP,DF,25,1997,20.5,42,27,25,11,6,21,40,52.5,19,22,1,21,15,57,31,0,2023
GER-Bundesliga,2022,Mainz 05,Alexander Hack,GER,DF,28,1993,12.6,30,18,21,9,0,19,33,57.6,14,18,5,13,24,54,45,1,2023
GER-Bundesliga,2022,Mainz 05,Andreas Hanche-Olsen,NOR,DF,25,1997,16.6,35,23,24,7,4,22,39,56.4,17,16,8,8,33,68,77,2,2023
GER-Bundesliga,2022,Mainz 05,Angelo Fulgini,FRA,MF,25,1996,5.8,6,5,2,3,1,5,12,41.7,7,5,0,5,5,11,7,0,2023
GER-Bundesliga,2022,Mainz 05,Anthony Caci,FRA,DF,25,1997,22.6,58,33,32,20,6,28,42,66.7,14,28,4,24,54,112,40,0,2023
GER-Bundesliga,2022,Mainz 05,Anton Stach,GER,MF,23,1998,23.0,27,21,10,15,2,16,38,42.1,22,28,2,26,41,68,25,0,2023
GER-Bundesliga,2022,Mainz 05,Aymen Barkok,MAR,MF,24,1998,6.5,18,8,10,5,3,5,10,50.0,5,7,0,7,3,21,9,0,2023
GER-Bundesliga,2022,Mainz 05,Brajan Gruda,GER,MF,18,2004,0.0,0,0,0,0,0,0,0,,0,0,0,0,0,0,0,0,2023
GER-Bundesliga,2022,Mainz 05,Danny da Costa,GER,DF,29,1993,13.7,20,16,7,8,5,12,20,60.0,8,22,3,19,9,29,26,0,2023
GER-Bundesliga,2022,Mainz 05,Delano Burgzorg,NED,"FW,MF",23,1998,2.7,3,3,1,1,1,2,3,66.7,1,2,0,2,0,3,2,0,2023
GER-Bundesliga,2022,Mainz 05,Dominik Kohr,GER,MF,28,1994,25.5,59,33,23,31,5,29,61,47.5,32,46,9,37,34,93,26,1,2023
GER-Bundesliga,2022,Mainz 05,Edimilson Fernandes,SUI,DF,26,1996,27.1,35,25,26,5,4,18,34,52.9,16,37,16,21,54,89,87,2,2023
GER-Bundesliga,2022,Mainz 05,Eniss Shabani,GER,MF,19,2003,0.1,0,0,0,0,0,0,0,,0,0,0,0,0,0,0,0,2023
GER-Bundesliga,2022,Mainz 05,Finn Dahmen,GER,GK,24,1998,8.0,0,0,0,0,0,0,0,,0,0,0,0,0,0,3,0,2023
GER-Bundesliga,2022,Mainz 05,Jonathan Burkardt,GER,"MF,FW",22,2000,5.9,3,1,0,1,2,1,4,25.0,3,6,1,5,1,4,1,0,2023
GER-Bundesliga,2022,Mainz 05,Karim Onisiwo,AUT,"FW,MF",30,1992,28.2,19,12,3,10,6,4,21,19.0,17,19,0,19,2,21,7,0,2023
GER-Bundesliga,2022,Mainz 05,Leandro Barreiro Martins,LUX,MF,22,2000,23.8,60,38,19,28,13,22,49,44.9,27,38,13,25,41,101,39,1,2023
GER-Bundesliga,2022,Mainz 05,Lee Jae-sung,KOR,MF,29,1992,21.0,38,17,9,21,8,16,36,44.4,20,29,5,24,17,55,21,0,2023
GER-Bundesliga,2022,Mainz 05,Ludovic Ajorque,FRA,"FW,MF",28,1994,13.5,6,5,1,4,1,1,9,11.1,8,8,2,6,1,7,8,0,2023
GER-Bundesliga,2022,Mainz 05,Marcus Ingvartsen,DEN,"FW,MF",26,1996,14.6,4,1,0,2,2,1,10,10.0,9,9,1,8,4,8,10,0,2023
GER-Bundesliga,2022,Mainz 05,Maxim Leitsch,GER,DF,24,1998,7.4,9,7,6,3,0,4,5,80.0,1,7,4,3,18,27,26,1,2023
GER-Bundesliga,2022,Mainz 05,Nelson Weiper,GER,"FW,DF",17,2005,1.1,2,0,0,0,2,1,3,33.3,2,2,0,2,0,2,1,0,2023
GER-Bundesliga,2022,Mainz 05,Niklas Tauer,GER,"DF,MF",21,2001,1.0,2,1,2,0,0,1,3,33.3,2,2,1,1,2,4,4,0,2023
GER-Bundesliga,2022,Mainz 05,Robin Zentner,GER,GK,27,1994,26.0,0,0,0,0,0,0,4,0.0,4,0,0,0,0,0,17,1,2023
GER-Bundesliga,2022,Mainz 05,Silvan Widmer,SUI,DF,29,1993,18.8,26,17,15,10,1,20,39,51.3,19,22,8,14,31,57,28,0,2023
GER-Bundesliga,2022,Mainz 05,Stefan Bell,GER,DF,30,1991,26.6,43,28,32,10,1,22,44,50.0,22,42,15,27,44,87,133,0,2023
GER-Bundesliga,2022,Mainz 05,Suliman Mustapha,AUT,"FW,MF",21,2001,0.8,2,2,0,2,0,0,0,,0,4,0,4,0,2,0,0,2023
GER-Bundesliga,2022,RB Leipzig,Abdou Diallo,SEN,"DF,MF",26,1996,5.3,6,5,5,1,0,1,3,33.3,2,8,5,3,8,14,22,0,2023
GER-Bundesliga,2022,RB Leipzig,Alexander Sørloth,NOR,FW,26,1995,0.1,0,0,0,0,0,0,0,,0,0,0,0,0,0,0,0,2023
GER-Bundesliga,2022,RB Leipzig,Amadou Haidara,MLI,MF,24,1998,15.9,25,11,15,10,0,13,34,38.2,21,26,6,20,26,51,20,0,2023
GER-Bundesliga,2022,RB Leipzig,André Silva,POR,FW,26,1995,19.3,12,6,2,5,5,3,8,37.5,5,11,1,10,3,15,3,0,2023
GER-Bundesliga,2022,RB Leipzig,Benjamin Henrichs,GER,"DF,MF",25,1997,24.3,73,46,41,29,3,43,66,65.2,23,48,4,44,35,108,46,0,2023
GER-Bundesliga,2022,RB Leipzig,Christopher Nkunku,FRA,"FW,MF",24,1997,21.1,6,4,2,1,3,1,6,16.7,5,8,3,5,8,14,11,0,2023
GER-Bundesliga,2022,RB Leipzig,Dani Olmo,ESP,"MF,FW",24,1998,14.2,15,9,1,10,4,6,14,42.9,8,15,0,15,6,21,6,0,2023
GER-Bundesliga,2022,RB Leipzig,David Raum,GER,"DF,MF",24,1998,18.7,39,25,23,12,4,17,29,58.6,12,24,6,18,16,55,26,1,2023
GER-Bundesliga,2022,RB Leipzig,Dominik Szoboszlai,HUN,"MF,FW",21,2000,27.2,45,28,12,20,13,17,42,40.5,25,43,2,41,17,62,27,0,2023
GER-Bundesliga,2022,RB Leipzig,Emil Forsberg,SWE,"MF,FW",30,1991,16.5,16,11,1,8,7,6,20,30.0,14,25,2,23,3,19,7,0,2023
GER-Bundesliga,2022,RB Leipzig,Hugo Novoa,ESP,"DF,FW",19,2003,2.0,8,2,1,3,4,4,7,57.1,3,4,0,4,1,9,0,0,2023
GER-Bundesliga,2022,RB Leipzig,Janis Blaswich,GER,GK,31,1991,26.0,0,0,0,0,0,0,0,,0,0,0,0,0,0,10,0,2023
GER-Bundesliga,2022,RB Leipzig,Joško Gvardiol,CRO,DF,20,2002,24.1,23,17,15,8,0,9,22,40.9,13,34,17,17,34,57,76,1,2023
GER-Bundesliga,2022,RB Leipzig,Kevin Kampl,SVN,MF,31,1990,15.2,21,11,6,14,1,6,27,22.2,21,26,9,17,22,43,11,0,2023
GER-Bundesliga,2022,RB Leipzig,Konrad Laimer,AUT,MF,25,1997,16.3,60,31,23,30,7,30,54,55.6,24,31,4,27,18,78,8,0,2023
GER-Bundesliga,2022,RB Leipzig,Lukas Klostermann,GER,DF,26,1996,10.1,16,8,7,9,0,8,15,53.3,7,6,3,3,13,29,31,0,2023
GER-Bundesliga,2022,RB Leipzig,Marcel Halstenberg,GER,DF,30,1991,17.3,40,21,20,15,5,23,41,56.1,18,22,1,21,21,61,29,0,2023
GER-Bundesliga,2022,RB Leipzig,Mohamed Simakan,FRA,DF,22,2000,16.2,21,14,12,5,4,14,21,66.7,7,21,4,17,16,37,55,0,2023
GER-Bundesliga,2022,RB Leipzig,Péter Gulácsi,HUN,GK,32,1990,6.0,0,0,0,0,0,0,0,,0,0,0,0,0,0,2,0,2023
GER-Bundesliga,2022,RB Leipzig,Sanoussy Ba,GER,DF,18,2004,0.0,0,0,0,0,0,0,0,,0,0,0,0,0,0,0,0,2023
GER-Bundesliga,2022,RB Leipzig,Timo Werner,GER,"FW,MF",26,1996,21.5,10,5,4,3,3,4,12,33.3,8,12,0,12,7,17,5,0,2023
GER-Bundesliga,2022,RB Leipzig,Willi Orban,HUN,DF,29,1992,32.8,51,30,33,18,0,26,43,60.5,17,42,24,18,39,90,129,1,2023
GER-Bundesliga,2022,RB Leipzig,Xaver Schlager,AUT,MF,24,1997,16.7,41,24,13,26,2,20,43,46.5,23,19,2,17,17,58,23,0,2023
GER-Bundesliga,2022,RB Leipzig,Yussuf Poulsen,DEN,FW,28,1994,4.6,6,4,1,4,1,2,5,40.0,3,3,1,2,0,6,5,0,2023
GER-Bundesliga,2022,RB Leipzig,Ørjan Nyland,NOR,GK,31,1990,2.0,0,0,0,0,0,0,0,,0,0,0,0,0,0,0,0,2023
GER-Bundesliga,2022,Schalke 04,Alex Král,CZE,MF,24,1998,26.2,34,24,10,22,2,17,37,45.9,20,31,6,25,17,51,53,0,2023
GER-Bundesliga,2022,Schalke 04,Alexander Schwolow,GER,GK,30,1992,22.6,0,0,0,0,0,0,2,0.0,2,0,0,0,1,1,6,3,2023
GER-Bundesliga,2022,Schalke 04,Andreas Ivan,ROU,MF,27,1995,0.5,0,0,0,0,0,0,1,0.0,1,0,0,0,0,0,1,0,2023
GER-Bundesliga,2022,Schalke 04,Cédric Brunner,SUI,DF,28,1994,25.7,39,27,26,11,2,30,45,66.7,15,24,7,17,43,82,79,0,2023
GER-Bundesliga,2022,Schalke 04,Danny Latza,GER,MF,32,1989,9.5,17,13,8,8,1,5,17,29.4,12,16,1,15,5,22,15,0,2023
GER-Bundesliga,2022,Schalke 04,Dominick Drexler,GER,"MF,FW",32,1990,15.2,25,17,12,10,3,9,22,40.9,13,18,2,16,8,33,12,0,2023
GER-Bundesliga,2022,Schalke 04,Florent Mollet,FRA,MF,30,1991,4.6,4,1,0,4,0,2,7,28.6,5,7,1,6,1,5,1,0,2023
GER-Bundesliga,2022,Schalke 04,Florian Flick,GER,MF,22,2000,5.7,12,3,7,5,0,4,14,28.6,10,9,3,6,4,16,18,0,2023
GER-Bundesliga,2022,Schalke 04,Henning Matriciani,GER,DF,22,2000,20.7,43,23,28,12,3,26,60,43.3,34,28,11,17,23,66,57,1,2023
GER-Bundesliga,2022,Schalke 04,Jere Uronen,FIN,DF,28,1994,7.5,14,10,6,6,2,6,10,60.0,4,5,2,3,8,22,13,0,2023
GER-Bundesliga,2022,Schalke 04,Jordan Larsson,SWE,"FW,MF",25,1997,5.1,8,5,1,7,0,2,9,22.2,7,9,0,9,4,12,3,0,2023
GER-Bundesliga,2022,Schalke 04,Keke Maximilian Topp,GER,FW,18,2004,0.2,0,0,0,0,0,0,0,,0,0,0,0,1,1,0,0,2023
GER-Bundesliga,2022,Schalke 04,Kenan Karaman,TUR,FW,28,1994,10.8,11,8,3,5,3,3,12,25.0,9,9,1,8,3,14,9,0,2023
GER-Bundesliga,2022,Schalke 04,Kerim Calhanoglu,GER,DF,19,2002,0.7,2,1,2,0,0,2,2,100.0,0,1,0,1,0,2,3,0,2023
GER-Bundesliga,2022,Schalke 04,Leo Greiml,AUT,DF,21,2001,4.0,10,5,4,5,1,5,12,41.7,7,7,3,4,3,13,16,0,2023
GER-Bundesliga,2022,Schalke 04,Malick Thiaw,GER,DF,20,2001,3.0,3,1,2,1,0,1,2,50.0,1,4,3,1,9,12,24,1,2023
GER-Bundesliga,2022,Schalke 04,Marcin Kamiński,POL,DF,30,1992,7.0,6,4,4,0,2,2,4,50.0,2,8,7,1,9,15,28,0,2023
GER-Bundesliga,2022,Schalke 04,Marius Bülter,GER,"FW,MF",29,1993,28.9,22,11,8,7,7,12,32,37.5,20,34,1,33,10,32,20,0,2023
GER-Bundesliga,2022,Schalke 04,Maya Yoshida,JPN,DF,33,1988,28.4,34,22,19,13,2,18,29,62.1,11,40,29,11,46,80,132,2,2023
GER-Bundesliga,2022,Schalke 04,Mehmet Aydin,GER,"DF,FW",20,2002,6.3,25,18,14,9,2,11,24,45.8,13,11,0,11,10,35,15,0,2023
GER-Bundesliga,2022,Schalke 04,Michael Frey,SUI,FW,28,1994,9.6,13,5,2,8,3,4,13,30.8,9,6,0,6,2,15,1,0,2023
GER-Bundesliga,2022,Schalke 04,Moritz Jenz,GER,DF,23,1999,10.5,14,11,8,5,1,5,8,62.5,3,16,10,6,8,22,53,1,2023
GER-Bundesliga,2022,Schalke 04,Ralf Fährmann,GER,GK,33,1988,11.4,1,0,1,0,0,1,1,100.0,0,0,0,0,0,1,10,2,2023
GER-Bundesliga,2022,Schalke 04,Rodrigo Zalazar,URU,"MF,FW",22,1999,14.7,16,8,5,9,2,9,24,37.5,15,16,1,15,7,23,13,0,2023
GER-Bundesliga,2022,Schalke 04,Sebastian Polter,GER,FW,31,1991,7.0,4,3,0,4,0,1,4,25.0,3,4,0,4,1,5,6,0,2023
GER-Bundesliga,2022,Schalke 04,Sepp van den Berg,NED,DF,20,2001,7.7,5,4,2,2,1,1,4,25.0,3,8,5,3,13,18,33,2,2023
GER-Bundesliga,2022,Schalke 04,Sidi Sané,GER,FW,19,2003,0.3,1,1,1,0,0,1,1,100.0,0,0,0,0,0,1,0,0,2023
GER-Bundesliga,2022,Schalke 04,Simon Terodde,GER,FW,34,1988,20.3,15,8,4,7,4,3,14,21.4,11,6,2,4,6,21,9,0,2023
GER-Bundesliga,2022,Schalke 04,Soichiro Kozuki,JPN,"FW,MF",21,2000,4.2,6,4,3,3,0,4,6,66.7,2,5,0,5,3,9,3,0,2023
GER-Bundesliga,2022,Schalke 04,Thomas Ouwejan,NED,DF,25,1996,10.0,20,8,13,5,2,6,10,60.0,4,17,4,13,13,33,27,0,2023
GER-Bundesliga,2022,Schalke 04,Tim Skarke,GER,"FW,MF",25,1996,4.9,13,7,3,8,2,8,11,72.7,3,5,0,5,0,13,4,0,2023
GER-Bundesliga,2022,Schalke 04,Timothée Kolodziejczak,FRA,DF,30,1991,0.3,0,0,0,0,0,0,1,0.0,1,0,0,0,1,1,1,0,2023
GER-Bundesliga,2022,Schalke 04,Tobias Mohr,GER,"DF,MF",26,1995,9.3,8,5,3,5,0,2,7,28.6,5,14,5,9,8,16,19,0,2023
GER-Bundesliga,2022,Schalke 04,Tom Krauß,GER,MF,21,2001,27.9,112,68,39,62,11,51,100,51.0,49,39,6,33,36,148,35,0,2023
GER-Bundesliga,2022,Schalke 04,Éder Álvarez Balanta,COL,"MF,FW",29,1993,2.6,5,4,2,3,0,2,6,33.3,4,0,0,0,3,8,4,0,2023
GER-Bundesliga,2022,Stuttgart,Alou Kuol,AUS,FW,21,2000,0.1,0,0,0,0,0,0,0,,0,0,0,0,0,0,0,0,2023
GER-Bundesliga,2022,Stuttgart,Atakan Karazor,GER,MF,25,1996,21.8,49,30,18,25,6,24,47,51.1,23,39,11,28,31,80,44,0,2023
GER-Bundesliga,2022,Stuttgart,Borna Sosa,CRO,DF,24,1998,21.7,27,21,18,8,1,21,32,65.6,11,20,5,15,19,46,37,0,2023
GER-Bundesliga,2022,Stuttgart,Chris Führich,GER,"FW,MF",24,1998,20.9,36,14,15,14,7,24,44,54.5,20,29,2,27,7,43,13,0,2023
GER-Bundesliga,2022,Stuttgart,Clinton Mola,ENG,DF,21,2001,0.2,3,1,2,1,0,1,1,100.0,0,1,1,0,1,4,2,0,2023
GER-Bundesliga,2022,Stuttgart,Dan-Axel Zagadou,FRA,DF,23,1999,14.1,14,9,10,4,0,5,14,35.7,9,19,16,3,21,35,81,1,2023
GER-Bundesliga,2022,Stuttgart,Darko Churlinov,MKD,FW,22,2000,0.3,3,2,2,1,0,2,3,66.7,1,1,0,1,0,3,0,0,2023
GER-Bundesliga,2022,Stuttgart,Enzo Millot,FRA,MF,20,2002,9.9,23,16,9,10,4,12,19,63.2,7,20,3,17,12,35,7,0,2023
GER-Bundesliga,2022,Stuttgart,Fabian Bredlow,GER,GK,27,1995,15.0,1,1,1,0,0,1,1,100.0,0,0,0,0,0,1,4,2,2023
GER-Bundesliga,2022,Stuttgart,Florian Müller,GER,GK,24,1997,19.0,0,0,0,0,0,0,0,,0,0,0,0,0,0,7,4,2023
GER-Bundesliga,2022,Stuttgart,Genki Haraguchi,JPN,MF,31,1991,8.3,16,7,7,7,2,4,16,25.0,12,13,2,11,8,24,6,0,2023
GER-Bundesliga,2022,Stuttgart,Gil Bastião Dias,POR,FW,25,1996,4.4,8,6,3,4,1,3,12,25.0,9,7,0,7,2,10,3,0,2023
GER-Bundesliga,2022,Stuttgart,Hiroki Ito,JPN,DF,23,1999,28.5,40,29,24,14,2,18,35,51.4,17,38,17,21,40,80,94,0,2023
GER-Bundesliga,2022,Stuttgart,Josha Vagnoman,GER,DF,21,2000,16.4,26,15,12,11,3,15,27,55.6,12,20,2,18,8,34,29,1,2023
GER-Bundesliga,2022,Stuttgart,Juan Perea,COL,FW,22,2000,4.6,5,4,0,2,3,2,4,50.0,2,2,1,1,1,6,3,0,2023
GER-Bundesliga,2022,Stuttgart,Konstantinos Mavropanos,GRE,DF,24,1997,25.4,50,27,32,15,3,28,38,73.7,10,39,18,21,63,113,99,0,2023
GER-Bundesliga,2022,Stuttgart,Lauren Ulrich,GER,MF,17,2005,0.1,1,1,0,0,1,0,0,,0,0,0,0,0,1,0,0,2023
GER-Bundesliga,2022,Stuttgart,Lilian Egloff,GER,"MF,FW",19,2002,2.7,12,10,4,5,3,4,6,66.7,2,2,0,2,1,13,1,0,2023
GER-Bundesliga,2022,Stuttgart,Luca Pfeiffer,GER,FW,25,1996,7.8,1,1,1,0,0,0,1,0.0,1,4,0,4,1,2,5,0,2023
GER-Bundesliga,2022,Stuttgart,Naouirou Ahamada,FRA,MF,20,2002,15.5,17,11,7,7,3,8,20,40.0,12,16,5,11,8,25,7,0,2023
GER-Bundesliga,2022,Stuttgart,Nikolas Nartey,DEN,"DF,MF",22,2000,5.3,11,6,7,3,1,5,9,55.6,4,9,0,9,4,15,12,0,2023
GER-Bundesliga,2022,Stuttgart,Pascal Stenzel,GER,DF,26,1996,3.7,12,8,8,4,0,5,9,55.6,4,9,2,7,5,17,6,0,2023
GER-Bundesliga,2022,Stuttgart,Sasa Kalajdzic,AUT,FW,25,1997,2.6,3,2,0,1,2,1,3,33.3,2,1,0,1,0,3,0,0,2023
GER-Bundesliga,2022,Stuttgart,Sehrou Guirassy,GUI,FW,26,1996,18.3,4,1,2,2,0,1,2,50.0,1,7,2,5,0,4,14,0,2023
GER-Bundesliga,2022,Stuttgart,Silas Katompa,COD,"FW,MF",23,1998,22.1,25,17,5,14,6,6,20,30.0,14,17,2,15,8,33,1,0,2023
GER-Bundesliga,2022,Stuttgart,Tanguy Coulibaly,FRA,"FW,DF",21,2001,3.6,12,9,9,1,2,5,12,41.7,7,10,0,10,3,15,0,0,2023
GER-Bundesliga,2022,Stuttgart,Thomas Kastanaras,GRE,"FW,DF",19,2003,0.8,0,0,0,0,0,0,0,,0,1,0,1,0,0,0,0,2023
GER-Bundesliga,2022,Stuttgart,Tiago Tomás,POR,"FW,MF",20,2002,14.3,10,4,2,4,4,8,13,61.5,5,9,2,7,1,11,5,0,2023
GER-Bundesliga,2022,Stuttgart,Waldemar Anton,GER,DF,26,1996,32.6,49,27,27,19,3,27,51,52.9,24,44,16,28,38,87,123,2,2023
GER-Bundesliga,2022,Stuttgart,Wataru Endo,JPN,MF,29,1993,32.5,70,37,30,31,9,38,85,44.7,47,44,6,38,26,96,63,0,2023
GER-Bundesliga,2022,Union Berlin,András Schäfer,HUN,MF,23,1999,9.6,21,9,7,12,2,6,14,42.9,8,12,2,10,4,25,11,0,2023
GER-Bundesliga,2022,Union Berlin,Aïssa Laïdouni,TUN,MF,25,1996,9.7,14,7,6,8,0,5,17,29.4,12,22,4,18,9,23,3,0,2023
GER-Bundesliga,2022,Union Berlin,Christopher Trimmel,AUT,DF,35,1987,20.1,31,16,16,12,3,20,31,64.5,11,14,1,13,25,56,48,0,2023
GER-Bundesliga,2022,Union Berlin,Danilho Doekhi,NED,DF,24,1998,24.6,38,23,21,17,0,14,26,53.8,12,27,12,15,29,67,93,0,2023
GER-Bundesliga,2022,Union Berlin,Diogo Leite,POR,DF,23,1999,25.0,35,20,21,14,0,21,34,61.8,13,23,14,9,26,61,99,1,2023
GER-Bundesliga,2022,Union Berlin,Frederik Rønnow,DEN,GK,29,1992,29.0,0,0,0,0,0,0,5,0.0,5,0,0,0,0,0,9,1,2023
GER-Bundesliga,2022,Union Berlin,Genki Haraguchi,JPN,MF,31,1991,5.5,12,8,1,10,1,3,9,33.3,6,7,1,6,3,15,9,0,2023
GER-Bundesliga,2022,Union Berlin,Jamie Leweling,GER,"FW,MF",21,2001,2.9,5,3,2,2,1,3,5,60.0,2,3,0,3,1,6,0,0,2023
GER-Bundesliga,2022,Union Berlin,Janik Haberer,GER,MF,28,1994,24.3,29,17,8,18,3,17,48,35.4,31,35,2,33,14,43,25,0,2023
GER-Bundesliga,2022,Union Berlin,Jordan Pefok,USA,FW,26,1996,15.1,15,7,3,4,8,2,17,11.8,15,17,5,12,4,19,15,0,2023
GER-Bundesliga,2022,Union Berlin,Josip Juranović,CRO,DF,26,1995,10.4,9,7,5,2,2,7,18,38.9,11,9,3,6,6,15,22,1,2023
GER-Bundesliga,2022,Union Berlin,Julian Ryerson,NOR,DF,24,1997,11.5,28,17,17,10,1,15,25,60.0,10,15,3,12,12,40,19,0,2023
GER-Bundesliga,2022,Union Berlin,Jérôme Roussillon,FRA,DF,29,1993,10.6,16,9,6,8,2,8,12,66.7,4,7,2,5,4,20,22,0,2023
GER-Bundesliga,2022,Union Berlin,Kevin Behrens,GER,FW,31,1991,17.1,11,7,4,4,3,4,18,22.2,14,18,3,15,5,16,25,0,2023
GER-Bundesliga,2022,Union Berlin,Lennart Grill,GER,GK,23,1999,5.0,0,0,0,0,0,0,1,0.0,1,0,0,0,0,0,1,1,2023
GER-Bundesliga,2022,Union Berlin,Levin Öztunalı,GER,MF,26,1996,0.1,0,0,0,0,0,0,1,0.0,1,0,0,0,0,0,0,0,2023
GER-Bundesliga,2022,Union Berlin,Miloš Pantović,SRB,MF,26,1996,2.3,4,2,4,0,0,3,5,60.0,2,3,0,3,0,4,5,0,2023
GER-Bundesliga,2022,Union Berlin,Morten Thorsby,NOR,MF,26,1996,9.3,22,10,9,11,2,13,21,61.9,8,11,5,6,3,25,20,0,2023
GER-Bundesliga,2022,Union Berlin,Niko Gießelmann,GER,DF,30,1991,14.5,21,11,9,9,3,13,31,41.9,18,17,5,12,9,30,28,0,2023
GER-Bundesliga,2022,Union Berlin,Paul Jaeckel,GER,DF,24,1998,13.3,24,18,11,11,2,17,35,48.6,18,11,5,6,19,43,44,1,2023
GER-Bundesliga,2022,Union Berlin,Paul Seguin,GER,MF,27,1995,7.7,17,8,9,4,4,8,18,44.4,10,6,0,6,6,23,7,0,2023
GER-Bundesliga,2022,Union Berlin,Rani Khedira,GER,MF,28,1994,32.0,60,33,21,32,7,25,50,50.0,25,33,10,23,40,100,33,0,2023
GER-Bundesliga,2022,Union Berlin,Robin Knoche,GER,DF,30,1992,31.9,45,29,29,12,4,24,47,51.1,23,35,18,17,38,83,140,0,2023
GER-Bundesliga,2022,Union Berlin,Sheraldo Becker,SUR,FW,27,1995,28.4,15,5,1,7,7,2,11,18.2,9,13,1,12,3,18,7,1,2023
GER-Bundesliga,2022,Union Berlin,Sven Michel,GER,"FW,MF",32,1990,5.5,9,5,1,5,3,4,8,50.0,4,5,1,4,0,9,4,0,2023
GER-Bundesliga,2022,Union Berlin,Tim Skarke,GER,"DF,MF",25,1996,0.6,1,1,0,0,1,0,0,,0,1,0,1,0,1,0,0,2023
GER-Bundesliga,2022,Union Berlin,Timo Baumgartl,GER,DF,26,1996,6.2,11,6,5,4,2,5,18,27.8,13,12,4,8,2,13,14,0,2023
GER-Bundesliga,2022,Union Berlin,Tymoteusz Puchacz,POL,DF,23,1999,0.6,1,0,1,0,0,0,0,,0,0,0,0,0,1,1,0,2023
GER-Bundesliga,2022,Werder Bremen,Amos Pieper,GER,DF,24,1998,21.7,46,28,25,19,2,24,40,60.0,16,23,11,12,30,76,94,1,2023
GER-Bundesliga,2022,Werder Bremen,Anthony Jung,GER,"DF,FW",30,1991,29.1,46,27,19,20,7,31,58,53.4,27,30,6,24,22,68,63,0,2023
GER-Bundesliga,2022,Werder Bremen,Christian Groß,GER,MF,33,1989,21.0,56,25,20,34,2,29,60,48.3,31,20,5,15,23,79,38,1,2023
GER-Bundesliga,2022,Werder Bremen,Dikeni Salifou,TOG,MF,19,2003,0.0,0,0,0,0,0,0,0,,0,0,0,0,0,0,0,0,2023
GER-Bundesliga,2022,Werder Bremen,Eren Dinkçi,GER,"FW,MF",20,2001,2.6,5,5,2,1,2,2,6,33.3,4,2,0,2,0,5,2,0,2023
GER-Bundesliga,2022,Werder Bremen,Fabio Chiarodia,ITA,DF,17,2005,0.7,0,0,0,0,0,0,0,,0,1,0,1,2,2,4,0,2023
GER-Bundesliga,2022,Werder Bremen,Felix Agu,GER,"DF,FW",22,1999,0.5,1,0,0,1,0,0,0,,0,1,1,0,0,1,0,0,2023
GER-Bundesliga,2022,Werder Bremen,Ilia Gruev,BUL,MF,22,2000,17.6,44,27,16,25,3,18,31,58.1,13,23,6,17,22,66,21,1,2023
GER-Bundesliga,2022,Werder Bremen,Jean-Manuel Mbom,GER,MF,22,2000,0.1,0,0,0,0,0,0,1,0.0,1,0,0,0,0,0,0,0,2023
GER-Bundesliga,2022,Werder Bremen,Jens Stage,DEN,MF,25,1996,20.6,34,17,15,18,1,10,37,27.0,27,34,11,23,16,50,37,0,2023
GER-Bundesliga,2022,Werder Bremen,Jiří Pavlenka,CZE,GK,30,1992,32.3,1,0,1,0,0,1,5,20.0,4,1,0,1,3,4,21,1,2023
GER-Bundesliga,2022,Werder Bremen,Lee Buchanan,ENG,"DF,FW",21,2001,5.2,14,10,2,11,1,6,12,50.0,6,5,0,5,12,26,21,0,2023
GER-Bundesliga,2022,Werder Bremen,Leonardo Bittencourt,GER,"MF,DF",28,1993,18.1,53,28,20,25,8,25,62,40.3,37,13,0,13,10,63,15,0,2023
GER-Bundesliga,2022,Werder Bremen,Marco Friedl,AUT,DF,24,1998,28.8,62,46,40,22,0,41,68,60.3,27,46,17,29,58,120,127,1,2023
GER-Bundesliga,2022,Werder Bremen,Marvin Ducksch,GER,FW,28,1994,31.7,8,3,2,4,2,3,16,18.8,13,13,2,11,9,17,41,1,2023
GER-Bundesliga,2022,Werder Bremen,Maximilian Philipp,GER,"FW,MF",28,1994,4.9,6,5,3,2,1,1,9,11.1,8,7,1,6,3,9,4,0,2023
GER-Bundesliga,2022,Werder Bremen,Michael Zetterer,GER,GK,27,1995,1.7,0,0,0,0,0,0,0,,0,0,0,0,0,0,1,0,2023
GER-Bundesliga,2022,Werder Bremen,Miloš Veljković,SRB,DF,26,1995,25.2,30,19,17,13,0,18,29,62.1,11,32,16,16,33,63,103,0,2023
GER-Bundesliga,2022,Werder Bremen,Mitchell Weiser,GER,"DF,FW",28,1994,28.0,71,43,38,24,9,38,75,50.7,37,50,7,43,28,99,38,1,2023
GER-Bundesliga,2022,Werder Bremen,Niclas Füllkrug,GER,FW,29,1993,27.5,9,4,0,6,3,3,13,23.1,10,13,4,9,1,10,24,0,2023
GER-Bundesliga,2022,Werder Bremen,Nicolai Rapp,GER,"MF,DF",25,1996,0.8,3,1,3,0,0,0,3,0.0,3,0,0,0,0,3,1,0,2023
GER-Bundesliga,2022,Werder Bremen,Niklas Schmidt,GER,MF,24,1998,12.1,25,10,12,11,2,13,28,46.4,15,10,0,10,5,30,12,0,2023
GER-Bundesliga,2022,Werder Bremen,Niklas Stark,GER,DF,27,1995,23.1,56,36,29,24,3,27,42,64.3,15,24,13,11,37,93,110,0,2023
GER-Bundesliga,2022,Werder Bremen,Oliver Burke,SCO,"FW,MF",25,1997,3.0,1,0,0,0,1,0,0,,0,2,0,2,0,1,0,0,2023
GER-Bundesliga,2022,Werder Bremen,Romano Schmid,AUT,"MF,FW",22,2000,16.9,24,15,5,13,6,10,22,45.5,12,21,3,18,7,31,12,0,2023
GER-Bundesliga,2022,Wolfsburg,Aster Vranckx,BEL,MF,19,2002,0.1,0,0,0,0,0,0,0,,0,0,0,0,0,0,1,0,2023
GER-Bundesliga,2022,Wolfsburg,Bartol Franjić,CRO,MF,22,2000,2.5,4,2,2,2,0,0,2,0.0,2,4,1,3,5,9,4,0,2023
GER-Bundesliga,2022,Wolfsburg,Dženan Pejčinović,GER,FW,17,2005,0.1,0,0,0,0,0,0,0,,0,0,0,0,0,0,0,0,2023
GER-Bundesliga,2022,Wolfsburg,Felix Nmecha,GER,MF,21,2000,20.4,41,24,11,23,7,16,34,47.1,18,26,10,16,25,66,31,0,2023
GER-Bundesliga,2022,Wolfsburg,Jakub Kamiński,POL,"FW,DF",20,2002,22.9,36,25,15,13,8,20,40,50.0,20,37,2,35,8,44,15,0,2023
GER-Bundesliga,2022,Wolfsburg,Jonas Wind,DEN,FW,23,1999,14.3,14,6,2,7,5,5,10,50.0,5,14,4,10,1,15,10,0,2023
GER-Bundesliga,2022,Wolfsburg,Josip Brekalo,CRO,"MF,FW",24,1998,3.0,2,1,2,0,0,0,4,0.0,4,0,0,0,2,4,2,0,2023
GER-Bundesliga,2022,Wolfsburg,Josuha Guilavogui,FRA,"DF,MF",31,1990,13.1,18,11,7,10,1,6,17,35.3,11,19,13,6,23,41,52,0,2023
GER-Bundesliga,2022,Wolfsburg,Jérôme Roussillon,FRA,"MF,DF",29,1993,0.2,0,0,0,0,0,0,0,,0,0,0,0,0,0,0,0,2023
GER-Bundesliga,2022,Wolfsburg,Kevin Paredes,USA,"FW,MF",19,2003,5.9,13,9,6,3,4,9,12,75.0,3,7,0,7,6,19,8,0,2023
GER-Bundesliga,2022,Wolfsburg,Kilian Fischer,GER,"DF,FW",21,2000,5.6,9,6,3,4,2,6,11,54.5,5,6,0,6,5,14,18,0,2023
GER-Bundesliga,2022,Wolfsburg,Koen Casteels,BEL,GK,30,1992,34.0,0,0,0,0,0,0,0,,0,0,0,0,1,1,10,1,2023
GER-Bundesliga,2022,Wolfsburg,Luca Waldschmidt,GER,"FW,MF",26,1996,5.8,5,2,2,1,2,2,10,20.0,8,6,0,6,3,8,5,0,2023
GER-Bundesliga,2022,Wolfsburg,Lukas Nmecha,GER,FW,23,1998,10.0,5,3,0,2,3,3,3,100.0,0,5,1,4,3,8,4,0,2023
GER-Bundesliga,2022,Wolfsburg,Lukáš Ambros,CZE,MF,18,2004,0.2,1,0,1,0,0,1,4,25.0,3,1,0,1,0,1,2,1,2023
GER-Bundesliga,2022,Wolfsburg,Mattias Svanberg,SWE,"MF,FW",23,1999,20.4,25,16,8,16,1,10,30,33.3,20,27,5,22,21,46,25,1,2023
GER-Bundesliga,2022,Wolfsburg,Max Kruse,GER,"MF,FW",34,1988,3.0,1,1,0,1,0,0,1,0.0,1,2,1,1,0,1,1,0,2023
GER-Bundesliga,2022,Wolfsburg,Maxence Lacroix,FRA,DF,22,2000,18.1,22,13,15,7,0,8,16,50.0,8,22,11,11,26,48,85,0,2023
GER-Bundesliga,2022,Wolfsburg,Maximilian Arnold,GER,MF,28,1994,30.7,62,31,25,28,9,28,54,51.9,26,34,11,23,26,88,65,2,2023
GER-Bundesliga,2022,Wolfsburg,Maximilian Philipp,GER,FW,28,1994,1.3,2,1,1,1,0,1,1,100.0,0,1,0,1,0,2,0,0,2023
GER-Bundesliga,2022,Wolfsburg,Micky van de Ven,NED,DF,21,2001,33.0,45,30,26,18,1,28,39,71.8,11,42,24,18,26,71,108,2,2023
GER-Bundesliga,2022,Wolfsburg,Nicolas Cozza,FRA,DF,23,1999,1.1,3,3,1,2,0,2,3,66.7,1,3,1,2,0,3,0,0,2023
GER-Bundesliga,2022,Wolfsburg,Omar Marmoush,EGY,FW,23,1999,16.4,16,10,8,2,6,4,16,25.0,12,21,1,20,7,23,4,0,2023
GER-Bundesliga,2022,Wolfsburg,Patrick Wimmer,AUT,"FW,MF",21,2001,18.3,39,26,18,11,10,12,38,31.6,26,27,2,25,15,54,15,0,2023
GER-Bundesliga,2022,Wolfsburg,Paulo Otávio,BRA,DF,27,1994,22.7,72,46,46,17,9,44,66,66.7,22,42,6,36,30,102,70,1,2023
GER-Bundesliga,2022,Wolfsburg,Ridle Baku,GER,"DF,FW",24,1998,28.7,50,26,29,17,4,32,58,55.2,26,44,6,38,21,71,59,0,2023
GER-Bundesliga,2022,Wolfsburg,Sebastiaan Bornauw,BEL,DF,23,1999,21.4,29,17,17,10,2,16,22,72.7,6,27,12,15,31,60,83,1,2023
GER-Bundesliga,2022,Wolfsburg,Yannick Gerhardt,GER,MF,28,1994,20.7,29,15,10,11,8,12,30,40.0,18,26,5,21,7,36,24,0,2023
ITA-Serie A,2017,Atalanta,Alessandro Bastoni,ITA,DF,18,1999,1.0,2,2,2,0,0,1,1,100.0,0,0,0,0,1,3,3,0,2018
ITA-Serie A,2017,Atalanta,Andrea Masiello,ITA,DF,31,1986,30.1,58,38,34,20,4,30,54,55.6,24,24,6,18,72,130,137,0,2018
ITA-Serie A,2017,Atalanta,Andrea Petagna,ITA,FW,22,1995,18.0,8,3,2,4,2,1,11,9.1,10,14,3,11,4,12,5,0,2018
ITA-Serie A,2017,Atalanta,Andreas Cornelius,DEN,FW,24,1993,10.4,9,5,3,3,3,1,7,14.3,6,7,0,7,2,11,7,0,2018
ITA-Serie A,2017,Atalanta,Bryan Cristante,ITA,MF,22,1995,31.4,66,50,21,32,13,18,59,30.5,41,43,6,37,23,89,27,0,2018
ITA-Serie A,2017,Atalanta,Etrit Berisha,ALB,GK,28,1989,31.0,1,1,1,0,0,1,1,100.0,0,0,0,0,1,2,5,3,2018
ITA-Serie A,2017,Atalanta,Francesco Rossi,ITA,GK,26,1991,0.1,0,0,0,0,0,0,0,,0,0,0,0,0,0,0,0,2018
ITA-Serie A,2017,Atalanta,Gianluca Mancini,ITA,DF,21,1996,7.6,20,14,11,8,1,10,17,58.8,7,8,2,6,15,35,22,0,2018
ITA-Serie A,2017,Atalanta,Hans Hateboer,NED,DF,23,1994,26.6,31,25,13,13,5,15,26,57.7,11,32,5,27,30,61,46,1,2018
ITA-Serie A,2017,Atalanta,Jasmin Kurtić,SVN,MF,28,1989,7.4,12,7,6,3,3,3,7,42.9,4,7,0,7,5,17,4,0,2018
ITA-Serie A,2017,Atalanta,Josip Iličić,SVN,"MF,FW",29,1988,22.2,24,19,5,13,6,8,29,27.6,21,19,0,19,16,40,2,0,2018
ITA-Serie A,2017,Atalanta,José Luis Palomino,ARG,DF,27,1990,22.0,60,39,36,19,5,24,51,47.1,27,36,21,15,39,99,111,1,2018
ITA-Serie A,2017,Atalanta,Leonardo Spinazzola,ITA,DF,24,1993,16.7,14,5,9,4,1,7,15,46.7,8,25,6,19,18,32,44,1,2018
ITA-Serie A,2017,Atalanta,Luca Vido,ITA,"FW,MF",20,1997,0.8,5,5,2,3,0,1,1,100.0,0,1,0,1,0,5,0,0,2018
ITA-Serie A,2017,Atalanta,Marten de Roon,NED,MF,26,1991,28.6,77,50,27,44,6,29,82,35.4,53,40,5,35,46,123,36,0,2018
ITA-Serie A,2017,Atalanta,Mattia Caldara,ITA,DF,23,1994,24.0,39,26,15,24,0,13,33,39.4,20,31,18,13,41,80,113,1,2018
ITA-Serie A,2017,Atalanta,Musa Barrow,GAM,FW,18,1998,4.9,5,2,1,3,1,2,4,50.0,2,2,0,2,1,6,2,0,2018
ITA-Serie A,2017,Atalanta,Nicolas Haas,SUI,MF,21,1996,1.9,1,1,1,0,0,0,2,0.0,2,1,1,0,1,2,4,1,2018
ITA-Serie A,2017,Atalanta,Papu Gómez,ARG,"MF,FW",29,1988,30.6,14,9,6,5,3,5,26,19.2,21,16,1,15,22,36,7,0,2018
ITA-Serie A,2017,Atalanta,Pierluigi Gollini,ITA,GK,22,1995,6.9,0,0,0,0,0,0,0,,0,0,0,0,0,0,1,0,2018
ITA-Serie A,2017,Atalanta,Rafael Tolói,ITA,DF,26,1990,27.2,72,40,34,38,0,35,68,51.5,33,35,14,21,63,135,119,1,2018
ITA-Serie A,2017,Atalanta,Remo Freuler,SUI,MF,25,1992,33.4,89,62,35,41,13,27,82,32.9,55,46,13,33,28,117,37,2,2018
ITA-Serie A,2017,Atalanta,Riccardo Orsolini,ITA,"MF,FW",20,1997,1.4,3,2,3,0,0,1,1,100.0,0,1,0,1,0,3,0,0,2018
ITA-Serie A,2017,Atalanta,Robin Gosens,GER,DF,23,1994,16.1,61,46,35,22,4,27,46,58.7,19,17,2,15,22,83,40,0,2018
ITA-Serie A,2017,Atalanta,Timothy Castagne,BEL,DF,21,1995,16.7,54,37,32,14,8,13,27,48.1,14,25,4,21,26,80,48,0,2018
ITA-Serie A,2017,Benevento,Achraf Lazaar,MAR,"MF,DF",25,1992,5.3,12,8,9,2,1,5,11,45.5,6,5,1,4,6,18,10,0,2018
ITA-Serie A,2017,Benevento,Alberto Brignoli,ITA,GK,25,1991,12.5,0,0,0,0,0,0,0,,0,0,0,0,0,0,15,3,2018
ITA-Serie A,2017,Benevento,Alin Toșca,ROU,DF,25,1992,13.0,11,8,7,4,0,6,12,50.0,6,9,4,5,13,24,69,0,2018
ITA-Serie A,2017,Benevento,Amato Ciciretti,ITA,"MF,FW",23,1993,9.0,14,8,5,6,3,2,11,18.2,9,9,0,9,6,20,4,0,2018
ITA-Serie A,2017,Benevento,Andrea Costa,ITA,DF,31,1986,15.3,19,14,13,6,0,9,19,47.4,10,21,15,6,37,56,78,2,2018
ITA-Serie A,2017,Benevento,Andrew Gravillon,GLP,DF,19,1998,0.9,2,1,2,0,0,0,1,0.0,1,1,1,0,3,5,10,0,2018
ITA-Serie A,2017,Benevento,Bacary Sagna,FRA,DF,34,1983,10.6,9,7,5,3,1,1,7,14.3,6,9,2,7,20,29,28,0,2018
ITA-Serie A,2017,Benevento,Berat Djimsiti,ALB,DF,24,1993,30.0,32,17,28,4,0,12,30,40.0,18,37,23,14,62,94,178,1,2018
ITA-Serie A,2017,Benevento,Bright Gyamfi,GHA,DF,21,1996,3.6,2,2,1,1,0,1,2,50.0,1,3,1,2,7,9,8,0,2018
ITA-Serie A,2017,Benevento,Cheick Diabaté,MLI,FW,29,1988,7.4,1,1,0,1,0,1,3,33.3,2,2,0,2,0,1,6,0,2018
ITA-Serie A,2017,Benevento,Christian Puggioni,ITA,GK,36,1981,13.1,0,0,0,0,0,0,0,,0,0,0,0,0,0,5,1,2018
ITA-Serie A,2017,Benevento,Christian Rutjens,,,,,0.0,,,,,,,,,,,,,,,,,2018
ITA-Serie A,2017,Benevento,Cristiano Lombardi,ITA,"MF,DF",21,1995,12.4,25,19,16,7,2,6,27,22.2,21,12,2,10,13,38,22,0,2018
ITA-Serie A,2017,Benevento,Danilo Cataldi,ITA,MF,22,1994,25.4,33,25,12,19,2,5,28,17.9,23,18,5,13,37,70,20,1,2018
ITA-Serie A,2017,Benevento,Enrico Brignola,ITA,"MF,FW",18,1999,15.0,28,21,17,10,1,12,38,31.6,26,13,0,13,6,34,7,0,2018
ITA-Serie A,2017,Benevento,Fabio Ceravolo,ITA,FW,30,1987,0.6,0,0,0,0,0,0,1,0.0,1,1,0,1,0,0,0,0,2018
ITA-Serie A,2017,Benevento,Fabio Lucioni,ITA,DF,29,1987,8.0,11,9,7,4,0,7,11,63.6,4,14,11,3,7,18,61,0,2018
ITA-Serie A,2017,Benevento,Filip Đuričić,SRB,"MF,FW",25,1992,10.8,22,14,11,8,3,5,9,55.6,4,7,1,6,9,31,5,0,2018
ITA-Serie A,2017,Benevento,Gaetano Letizia,ITA,DF,27,1990,23.8,36,26,21,14,1,19,49,38.8,30,24,3,21,33,69,47,3,2018
ITA-Serie A,2017,Benevento,George Pușcaș,ROU,"FW,MF",21,1996,7.8,0,0,0,0,0,0,3,0.0,3,0,0,0,1,1,13,0,2018
ITA-Serie A,2017,Benevento,Gianluca Di Chiara,ITA,DF,23,1993,11.2,26,19,18,6,2,7,21,33.3,14,10,3,7,11,37,37,1,2018
ITA-Serie A,2017,Benevento,Giovanni Volpicelli,ITA,MF,17,1999,0.0,0,0,0,0,0,0,1,0.0,1,0,0,0,0,0,0,0,2018
ITA-Serie A,2017,Benevento,Guilherme,BRA,"MF,FW",26,1991,10.5,20,11,7,7,6,3,19,15.8,16,14,1,13,8,28,4,0,2018
ITA-Serie A,2017,Benevento,Jean-Claude Billong,CMR,DF,23,1993,3.3,9,7,5,4,0,5,8,62.5,3,4,3,1,6,15,17,0,2018
ITA-Serie A,2017,Benevento,Karamoko Cissé,GUI,"FW,MF",28,1988,0.2,1,1,1,0,0,0,0,,0,0,0,0,0,1,0,0,2018
ITA-Serie A,2017,Benevento,Ledian Memushaj,ALB,MF,30,1986,14.0,28,18,11,13,4,7,30,23.3,23,24,5,19,10,38,10,1,2018
ITA-Serie A,2017,Benevento,Lorenzo Del Pinto,ITA,MF,27,1990,8.4,23,17,10,10,3,7,25,28.0,18,13,4,9,16,39,7,2,2018
ITA-Serie A,2017,Benevento,Lorenzo Venuti,ITA,DF,22,1995,26.6,44,34,26,12,6,16,37,43.2,21,40,16,24,40,84,105,3,2018
ITA-Serie A,2017,Benevento,Luca Antei,ITA,DF,25,1992,6.6,19,14,12,7,0,6,11,54.5,5,10,8,2,26,45,35,0,2018
ITA-Serie A,2017,Benevento,Luca Sparandeo,ITA,DF,17,1999,0.4,0,0,0,0,0,0,1,0.0,1,1,0,1,0,0,0,0,2018
ITA-Serie A,2017,Benevento,Mamadou Kanouté,SEN,"FW,MF",23,1993,0.4,0,0,0,0,0,0,0,,0,0,0,0,1,1,1,0,2018
ITA-Serie A,2017,Benevento,Marco D'Alessandro,ITA,"MF,FW",26,1991,11.6,31,22,15,9,7,8,24,33.3,16,12,1,11,10,41,8,1,2018
ITA-Serie A,2017,Benevento,Massimo Coda,ITA,FW,28,1988,15.7,12,9,3,4,5,2,13,15.4,11,7,2,5,6,18,11,0,2018
ITA-Serie A,2017,Benevento,Nicolas Viola,ITA,MF,27,1989,20.6,37,27,20,14,3,15,39,38.5,24,29,8,21,24,61,23,2,2018
ITA-Serie A,2017,Benevento,Pietro Iemmello,ITA,FW,25,1992,9.8,2,2,1,1,0,2,8,25.0,6,4,0,4,1,3,11,2,2018
ITA-Serie A,2017,Benevento,Raman Chibsah,GHA,MF,24,1993,11.6,20,13,10,7,3,4,14,28.6,10,13,2,11,4,24,16,0,2018
ITA-Serie A,2017,Benevento,Samuel Armenteros,SWE,FW,27,1990,4.8,4,2,1,3,0,0,3,0.0,3,1,1,0,1,5,3,0,2018
ITA-Serie A,2017,Benevento,Sandro,BRA,MF,28,1989,12.8,29,21,15,13,1,12,18,66.7,6,23,16,7,18,47,43,1,2018
ITA-Serie A,2017,Benevento,Siriki Sanogo,CIV,MF,15,2001,0.4,1,1,0,1,0,0,0,,0,0,0,0,1,2,1,0,2018
ITA-Serie A,2017,Benevento,Vid Belec,SVN,GK,27,1990,12.4,0,0,0,0,0,0,0,,0,0,0,0,1,1,6,1,2018
ITA-Serie A,2017,Benevento,Vittorio Parigini,ITA,"MF,FW",21,1996,9.5,18,11,11,6,1,6,17,35.3,11,8,1,7,5,23,1,0,2018
ITA-Serie A,2017,Bologna,Adam Masina,MAR,DF,23,1994,31.4,82,57,49,26,7,36,84,42.9,48,46,7,39,51,133,127,0,2018
ITA-Serie A,2017,Bologna,Andrea Poli,ITA,MF,27,1989,28.3,66,53,33,27,6,18,64,28.1,46,55,3,52,43,109,27,0,2018
ITA-Serie A,2017,Bologna,Angelo da Costa Júnior,BRA,GK,33,1983,4.0,0,0,0,0,0,0,0,,0,0,0,0,0,0,2,0,2018
ITA-Serie A,2017,Bologna,Antonio Mirante,ITA,GK,34,1983,33.0,0,0,0,0,0,0,3,0.0,3,1,0,1,0,0,11,5,2018
ITA-Serie A,2017,Bologna,Antonio Santurro,DOM,GK,25,1992,1.0,0,0,0,0,0,0,0,,0,0,0,0,0,0,1,0,2018
ITA-Serie A,2017,Bologna,Blerim Džemaili,SUI,"MF,FW",31,1986,13.3,27,19,11,15,1,9,27,33.3,18,15,4,11,18,45,11,0,2018
ITA-Serie A,2017,Bologna,Bruno Petković,CRO,"FW,MF",22,1994,3.7,7,6,0,5,2,1,1,100.0,0,3,0,3,4,11,5,0,2018
ITA-Serie A,2017,Bologna,Cesar Falletti,URU,"MF,FW",24,1992,3.6,11,7,4,6,1,4,8,50.0,4,10,0,10,0,11,5,0,2018
ITA-Serie A,2017,Bologna,Cheick Keita,MLI,DF,21,1996,1.4,2,2,1,1,0,1,3,33.3,2,5,0,5,2,4,1,0,2018
ITA-Serie A,2017,Bologna,Domenico Maietta,ITA,DF,34,1982,5.2,5,4,4,1,0,3,9,33.3,6,8,6,2,7,12,13,1,2018
ITA-Serie A,2017,Bologna,Emil Krafth,SWE,DF,22,1994,10.5,23,16,14,8,1,10,19,52.6,9,12,4,8,16,39,39,1,2018
ITA-Serie A,2017,Bologna,Erick Pulgar,CHI,MF,23,1994,30.8,70,48,41,29,0,24,75,32.0,51,49,13,36,46,116,83,1,2018
ITA-Serie A,2017,Bologna,Federico Di Francesco,ITA,"FW,DF",23,1994,17.7,26,13,14,8,4,5,20,25.0,15,24,2,22,16,42,25,0,2018
ITA-Serie A,2017,Bologna,Felipe Avenatti,URU,FW,24,1993,5.2,6,4,1,5,0,1,2,50.0,1,7,1,6,1,7,6,0,2018
ITA-Serie A,2017,Bologna,Filip Helander,SWE,DF,24,1993,27.8,48,32,33,15,0,15,29,51.7,14,47,25,22,37,85,160,2,2018
ITA-Serie A,2017,Bologna,Giancarlo González,CRC,DF,29,1988,20.6,20,15,14,5,1,9,13,69.2,4,26,18,8,33,53,152,1,2018
ITA-Serie A,2017,Bologna,Godfred Donsah,GHA,MF,21,1996,19.9,29,20,11,14,4,10,17,58.8,7,25,0,25,22,51,43,0,2018
ITA-Serie A,2017,Bologna,Ibrahima Mbaye,SEN,DF,22,1994,19.6,59,34,40,17,2,25,36,69.4,11,25,6,19,28,87,95,0,2018
ITA-Serie A,2017,Bologna,Ladislav Krejčí,CZE,"MF,FW",25,1992,4.4,7,5,1,3,3,1,5,20.0,4,3,0,3,2,9,3,0,2018
ITA-Serie A,2017,Bologna,Lorenzo Crisetig,ITA,MF,24,1993,6.2,18,14,8,9,1,7,24,29.2,17,8,2,6,13,31,16,1,2018
ITA-Serie A,2017,Bologna,Mattia Destro,ITA,FW,26,1991,18.0,15,13,4,9,2,3,11,27.3,8,10,1,9,5,20,26,0,2018
ITA-Serie A,2017,Bologna,Orji Okwonkwo,NGA,"FW,MF",19,1998,2.9,9,3,6,3,0,1,4,25.0,3,2,0,2,1,10,1,0,2018
ITA-Serie A,2017,Bologna,Riccardo Orsolini,ITA,"FW,DF",20,1997,3.8,5,5,4,1,0,1,5,20.0,4,2,1,1,3,8,4,0,2018
ITA-Serie A,2017,Bologna,Rodrigo Palacio,ARG,"FW,MF",35,1982,22.9,25,18,6,12,7,10,28,35.7,18,16,2,14,12,37,14,0,2018
ITA-Serie A,2017,Bologna,Saphir Taïder,ALG,MF,25,1992,4.3,6,2,4,2,0,1,2,50.0,1,3,2,1,1,7,4,0,2018
ITA-Serie A,2017,Bologna,Sebastien De Maio,FRA,DF,30,1987,22.8,26,17,15,11,0,10,25,40.0,15,35,18,17,36,62,147,0,2018
ITA-Serie A,2017,Bologna,Simone Romagnoli,ITA,DF,27,1990,6.2,12,9,10,2,0,4,9,44.4,5,12,8,4,7,19,41,2,2018
ITA-Serie A,2017,Bologna,Simone Verdi,ITA,"FW,MF",25,1992,31.4,33,24,17,13,3,11,43,25.6,32,20,1,19,36,69,12,0,2018
ITA-Serie A,2017,Bologna,Vasilis Torosidis,GRE,DF,32,1985,9.1,8,7,5,2,1,4,9,44.4,5,8,3,5,15,23,42,0,2018
ITA-Serie A,2017,Bologna,Ádám Nagy,HUN,MF,22,1995,7.9,16,9,6,8,2,7,13,53.8,6,11,0,11,7,23,5,0,2018
ITA-Serie A,2017,Cagliari,Alessandro Deiola,ITA,MF,21,1995,5.0,9,7,5,3,1,6,13,46.2,7,8,0,8,4,13,12,0,2018
ITA-Serie A,2017,Cagliari,Alessio Cragno,ITA,GK,23,1994,28.2,0,0,0,0,0,0,0,,0,1,0,1,0,0,12,0,2018
ITA-Serie A,2017,Cagliari,Andrea Cossu,ITA,"MF,FW",37,1980,2.7,1,0,0,0,1,0,2,0.0,2,2,0,2,3,4,2,0,2018
ITA-Serie A,2017,Cagliari,Artur Ioniță,MDA,MF,26,1990,29.7,63,45,30,24,9,17,38,44.7,21,39,7,32,28,91,29,0,2018
ITA-Serie A,2017,Cagliari,Charalambos Lykogiannis,GRE,DF,23,1993,7.6,16,12,9,5,2,11,18,61.1,7,12,3,9,15,31,28,0,2018
ITA-Serie A,2017,Cagliari,Damir Ceter,COL,FW,19,1997,2.2,2,1,0,2,0,0,0,,0,3,0,3,0,2,1,0,2018
ITA-Serie A,2017,Cagliari,Daniele Dessena,ITA,"MF,DF",30,1987,6.4,18,10,12,5,1,6,12,50.0,6,7,1,6,6,24,17,0,2018
ITA-Serie A,2017,Cagliari,Diego Farias,BRA,"FW,MF",27,1990,17.9,21,15,3,9,9,6,24,25.0,18,17,0,17,8,29,6,0,2018
ITA-Serie A,2017,Cagliari,Duje Čop,CRO,"FW,MF",27,1990,1.1,1,1,0,0,1,0,1,0.0,1,1,0,1,0,1,0,0,2018
ITA-Serie A,2017,Cagliari,Fabio Pisacane,ITA,DF,31,1986,21.4,52,39,36,13,3,15,41,36.6,26,29,16,13,38,90,105,1,2018
ITA-Serie A,2017,Cagliari,Fabrizio Caligara,ITA,MF,17,2000,0.2,0,0,0,0,0,0,0,,0,1,1,0,1,1,1,0,2018
ITA-Serie A,2017,Cagliari,Filippo Romagna,ITA,DF,20,1997,21.0,33,18,20,12,1,16,26,61.5,10,20,11,9,33,66,96,0,2018
ITA-Serie A,2017,Cagliari,Gregory van der Wiel,NED,DF,29,1988,3.2,5,3,4,1,0,3,5,60.0,2,1,0,1,10,15,12,0,2018
ITA-Serie A,2017,Cagliari,Han Kwang-song,PRK,FW,18,1998,3.1,1,1,0,0,1,0,4,0.0,4,4,0,4,0,1,0,0,2018
ITA-Serie A,2017,Cagliari,João Pedro,ITA,"MF,FW",25,1992,18.4,15,9,4,9,2,0,12,0.0,12,9,1,8,11,26,24,0,2018
ITA-Serie A,2017,Cagliari,Leandro Castán,BRA,DF,30,1986,12.7,24,15,16,8,0,15,20,75.0,5,16,10,6,23,47,48,1,2018
ITA-Serie A,2017,Cagliari,Leonardo Pavoletti,ITA,FW,28,1988,30.2,27,13,5,14,8,2,21,9.5,19,13,5,8,13,40,28,0,2018
ITA-Serie A,2017,Cagliari,Luca Ceppitelli,ITA,DF,27,1989,24.7,45,33,31,12,2,16,34,47.1,18,33,21,12,50,95,156,0,2018
ITA-Serie A,2017,Cagliari,Luca Cigarini,ITA,MF,31,1986,22.5,42,30,16,25,1,18,64,28.1,46,32,5,27,42,84,27,1,2018
ITA-Serie A,2017,Cagliari,Luca Crosta,ITA,GK,19,1998,1.0,0,0,0,0,0,0,0,,0,0,0,0,0,0,1,0,2018
ITA-Serie A,2017,Cagliari,Marco Andreolli,ITA,DF,31,1986,20.3,25,17,20,4,1,12,20,60.0,8,24,17,7,30,55,139,0,2018
ITA-Serie A,2017,Cagliari,Marco Capuano,ITA,DF,25,1991,7.7,13,9,6,7,0,4,8,50.0,4,7,2,5,6,19,23,1,2018
ITA-Serie A,2017,Cagliari,Marco Sau,ITA,"FW,MF",29,1987,14.6,9,6,2,4,3,1,17,5.9,16,10,0,10,9,18,1,0,2018
ITA-Serie A,2017,Cagliari,Niccolò Giannetti,ITA,"FW,DF",26,1991,3.3,5,4,2,3,0,2,6,33.3,4,1,0,1,1,6,3,0,2018
ITA-Serie A,2017,Cagliari,Nicolò Barella,ITA,MF,20,1997,32.8,92,69,37,43,12,25,78,32.1,53,48,6,42,45,137,53,0,2018
ITA-Serie A,2017,Cagliari,Paolo Faragò,ITA,DF,24,1993,27.3,92,67,53,24,15,24,60,40.0,36,41,5,36,23,115,76,0,2018
ITA-Serie A,2017,Cagliari,Rafael,BRA,GK,35,1982,8.8,0,0,0,0,0,0,0,,0,0,0,0,1,1,9,0,2018
ITA-Serie A,2017,Cagliari,Senna Miangue,BEL,"DF,FW",20,1997,8.9,7,5,4,2,1,3,7,42.9,4,8,1,7,7,14,35,0,2018
ITA-Serie A,2017,Cagliari,Simone Padoin,ITA,"DF,MF",33,1984,34.5,22,18,8,10,4,12,28,42.9,16,38,14,24,24,46,74,0,2018
ITA-Serie A,2017,Chievo,Alessandro Gamberini,ITA,DF,35,1981,20.2,13,8,11,2,0,8,12,66.7,4,32,25,7,16,29,117,1,2018
ITA-Serie A,2017,Chievo,Boštjan Cesar,SVN,DF,35,1982,6.1,4,3,3,1,0,3,4,75.0,1,6,4,2,3,7,40,0,2018
ITA-Serie A,2017,Chievo,Dario Dainelli,ITA,DF,38,1979,16.7,19,14,14,4,1,10,21,47.6,11,27,22,5,46,65,126,0,2018
ITA-Serie A,2017,Chievo,Emanuele Giaccherini,ITA,"MF,FW",32,1985,10.0,7,4,4,2,1,5,25,20.0,20,9,3,6,5,12,6,0,2018
ITA-Serie A,2017,Chievo,Fabio Depaoli,ITA,"DF,MF",20,1997,13.2,31,22,21,7,3,21,40,52.5,19,27,10,17,15,46,42,0,2018
ITA-Serie A,2017,Chievo,Fabrizio Cacciatore,ITA,DF,30,1986,31.9,34,27,20,9,5,15,30,50.0,15,33,11,22,38,72,99,3,2018
ITA-Serie A,2017,Chievo,Gianluca Gaudino,GER,MF,20,1996,0.2,0,0,0,0,0,0,0,,0,1,0,1,0,0,1,0,2018
ITA-Serie A,2017,Chievo,Ivan Radovanović,SRB,MF,28,1988,34.9,55,35,30,22,3,18,48,37.5,30,39,16,23,47,102,107,1,2018
ITA-Serie A,2017,Chievo,Luca Garritano,ITA,"MF,FW",23,1994,2.1,4,3,2,1,1,0,4,0.0,4,3,1,2,1,5,6,0,2018
ITA-Serie A,2017,Chievo,Lucas Castro,ARG,MF,28,1989,22.1,54,40,14,29,11,16,43,37.2,27,39,7,32,38,92,35,0,2018
ITA-Serie A,2017,Chievo,Manuel Pucciarelli,ITA,"FW,MF",26,1991,15.3,23,14,3,11,9,8,21,38.1,13,15,0,15,7,30,4,0,2018
ITA-Serie A,2017,Chievo,Mariusz Stępiński,POL,FW,22,1995,7.9,9,5,4,4,1,2,10,20.0,8,5,1,4,4,13,5,0,2018
ITA-Serie A,2017,Chievo,Massimo Gobbi,ITA,DF,36,1980,22.8,24,18,13,9,2,11,26,42.3,15,20,5,15,22,46,90,1,2018
ITA-Serie A,2017,Chievo,Mattia Bani,ITA,DF,23,1993,14.6,28,20,22,6,0,11,26,42.3,15,19,10,9,27,55,111,0,2018
ITA-Serie A,2017,Chievo,Mehdi Léris,ALG,"MF,FW",19,1998,0.5,1,1,1,0,0,0,1,0.0,1,0,0,0,1,2,0,0,2018
ITA-Serie A,2017,Chievo,Nenad Tomović,SRB,DF,29,1987,25.6,23,17,17,6,0,10,17,58.8,7,29,21,8,50,73,146,0,2018
ITA-Serie A,2017,Chievo,Nicola Rigoni,ITA,MF,26,1990,10.4,29,20,15,12,2,9,26,34.6,17,8,3,5,11,40,22,1,2018
ITA-Serie A,2017,Chievo,Paweł Jaroszyński,POL,DF,22,1994,9.0,20,12,14,5,1,9,18,50.0,9,11,4,7,21,41,40,1,2018
ITA-Serie A,2017,Chievo,Përparim Hetemaj,FIN,MF,30,1986,26.8,74,48,34,25,15,29,78,37.2,49,39,6,33,39,113,47,1,2018
ITA-Serie A,2017,Chievo,Riccardo Meggiorini,ITA,FW,31,1985,8.7,9,6,3,6,0,1,6,16.7,5,12,3,9,2,11,9,0,2018
ITA-Serie A,2017,Chievo,Roberto Inglese,ITA,FW,25,1991,30.9,31,21,13,9,9,7,30,23.3,23,21,2,19,8,39,17,1,2018
ITA-Serie A,2017,Chievo,Samuel Bastien,COD,MF,20,1996,15.1,17,13,7,8,2,7,23,30.4,16,23,2,21,18,35,25,0,2018
ITA-Serie A,2017,Chievo,Sergio Pellissier,ITA,FW,38,1979,6.2,6,2,1,3,2,1,3,33.3,2,3,0,3,1,7,2,0,2018
ITA-Serie A,2017,Chievo,Stefano Sorrentino,ITA,GK,38,1979,38.0,0,0,0,0,0,0,0,,0,0,0,0,0,0,23,3,2018
ITA-Serie A,2017,Chievo,Valter Birsa,SVN,"MF,FW",30,1986,27.8,28,14,7,18,3,7,54,13.0,47,22,2,20,24,52,20,1,2018
ITA-Serie A,2017,Crotone,Adrian Stoian,ROU,"MF,FW",26,1991,23.7,23,19,12,10,1,11,44,25.0,33,29,0,29,25,48,26,0,2018
ITA-Serie A,2017,Crotone,Ahmad Benali,LBY,MF,25,1992,9.0,19,10,8,10,1,5,27,18.5,22,14,1,13,8,27,15,0,2018
ITA-Serie A,2017,Crotone,Aleksandar Tonev,BUL,"FW,MF",27,1990,4.5,5,3,1,2,2,0,1,0.0,1,4,1,3,1,6,6,0,2018
ITA-Serie A,2017,Crotone,Alex Cordaz,ITA,GK,34,1983,38.0,0,0,0,0,0,0,0,,0,0,0,0,2,2,16,4,2018
ITA-Serie A,2017,Crotone,Andrea Barberis,ITA,MF,23,1993,33.7,80,44,33,42,5,16,68,23.5,52,52,5,47,58,138,67,1,2018
ITA-Serie A,2017,Crotone,Andrea Nalini,ITA,"FW,MF",27,1990,18.2,43,32,22,16,5,16,25,64.0,9,25,2,23,15,58,19,1,2018
ITA-Serie A,2017,Crotone,Ante Budimir,CRO,FW,26,1991,17.6,28,20,4,16,8,2,20,10.0,18,20,3,17,7,35,27,0,2018
ITA-Serie A,2017,Crotone,Aristóteles Romero,VEN,"MF,FW",21,1995,1.0,11,7,7,4,0,3,5,60.0,2,3,0,3,5,16,0,0,2018
ITA-Serie A,2017,Crotone,Arlind Ajeti,ALB,DF,23,1993,14.1,42,23,25,14,3,18,30,60.0,12,27,15,12,34,76,82,0,2018
ITA-Serie A,2017,Crotone,Bruno Martella,ITA,DF,24,1992,29.1,30,21,19,7,4,12,30,40.0,18,22,9,13,48,78,151,1,2018
ITA-Serie A,2017,Crotone,Daniel Pavlović,BIH,DF,29,1988,8.4,10,5,9,0,1,5,10,50.0,5,4,3,1,5,15,22,0,2018
ITA-Serie A,2017,Crotone,Davide Faraoni,ITA,"DF,MF",25,1991,19.5,62,39,36,20,6,28,47,59.6,19,30,8,22,58,120,76,0,2018
ITA-Serie A,2017,Crotone,Federico Ceccherini,ITA,DF,25,1992,35.9,35,21,28,4,3,13,25,52.0,12,39,21,18,83,118,276,1,2018
ITA-Serie A,2017,Crotone,Federico Ricci,ITA,FW,23,1994,10.2,25,18,9,10,6,9,28,32.1,19,14,0,14,11,36,5,0,2018
ITA-Serie A,2017,Crotone,Giovanni Crociata,ITA,"MF,FW",19,1997,3.2,9,6,3,4,2,1,4,25.0,3,7,0,7,4,13,3,0,2018
ITA-Serie A,2017,Crotone,Leandro Cabrera,URU,DF,26,1991,4.1,8,5,8,0,0,0,3,0.0,3,5,2,3,6,14,33,0,2018
ITA-Serie A,2017,Crotone,Marcello Trotta,ITA,FW,24,1992,25.1,39,21,12,18,9,10,55,18.2,45,22,2,20,14,53,20,0,2018
ITA-Serie A,2017,Crotone,Marco Capuano,ITA,DF,25,1991,15.6,20,10,14,6,0,5,15,33.3,10,19,13,6,28,48,93,0,2018
ITA-Serie A,2017,Crotone,Marco Tumminello,ITA,FW,18,1998,2.3,2,2,0,1,1,0,2,0.0,2,2,0,2,0,2,0,0,2018
ITA-Serie A,2017,Crotone,Marcus Rohdén,SWE,MF,26,1991,18.1,33,19,21,10,2,14,50,28.0,36,14,1,13,18,51,30,0,2018
ITA-Serie A,2017,Crotone,Mariano Julio Izco,ARG,MF,34,1983,2.0,6,4,2,4,0,2,4,50.0,2,2,0,2,4,10,1,0,2018
ITA-Serie A,2017,Crotone,Mario Sampirisi,ITA,DF,24,1992,24.4,44,32,29,12,3,13,22,59.1,9,27,14,13,43,87,116,2,2018
ITA-Serie A,2017,Crotone,Moussa Diaby,FRA,MF,18,1999,0.8,1,0,1,0,0,1,4,25.0,3,1,0,1,1,2,0,0,2018
ITA-Serie A,2017,Crotone,Niccolò Zanellato,ITA,MF,19,1998,0.8,3,2,0,3,0,1,2,50.0,1,3,0,3,0,3,0,0,2018
ITA-Serie A,2017,Crotone,Noë Dussenne,BEL,FW,25,1992,0.9,2,0,2,0,0,0,0,,0,0,0,0,1,3,8,0,2018
ITA-Serie A,2017,Crotone,Oliver Kragl,GER,MF,27,1990,1.1,1,0,0,1,0,0,0,,0,1,0,1,2,3,2,0,2018
ITA-Serie A,2017,Crotone,Rolando Mandragora,ITA,MF,20,1997,36.0,91,60,48,34,9,26,69,37.7,43,41,13,28,86,177,75,0,2018
ITA-Serie A,2017,Crotone,Simeon Nwankwo,NGA,FW,25,1992,13.5,12,9,1,5,6,1,12,8.3,11,16,3,13,1,13,20,0,2018
ITA-Serie A,2017,Crotone,Stefan Simić,CZE,DF,22,1995,6.2,13,8,11,2,0,10,11,90.9,1,6,3,3,10,23,44,0,2018
ITA-Serie A,2017,Fiorentina,Bartłomiej Drągowski,POL,GK,19,1997,2.4,0,0,0,0,0,0,0,,0,0,0,0,0,0,0,1,2018
ITA-Serie A,2017,Fiorentina,Bruno Gaspar,ANG,DF,24,1993,8.7,20,11,13,6,1,9,15,60.0,6,8,1,7,9,29,25,0,2018
ITA-Serie A,2017,Fiorentina,Bryan Dabo,BFA,MF,25,1992,6.6,17,11,6,10,1,6,15,40.0,9,13,1,12,15,32,24,1,2018
ITA-Serie A,2017,Fiorentina,Carlos Sánchez,COL,"MF,DF",31,1986,4.1,7,6,2,5,0,4,6,66.7,2,3,1,2,8,15,10,0,2018
ITA-Serie A,2017,Fiorentina,Cristiano Biraghi,ITA,DF,24,1992,33.1,74,48,33,32,9,36,58,62.1,22,42,5,37,43,117,103,2,2018
ITA-Serie A,2017,Fiorentina,Cyril Théréau,FRA,"FW,MF",34,1983,12.4,11,6,3,6,2,7,19,36.8,12,13,0,13,8,19,9,0,2018
ITA-Serie A,2017,Fiorentina,Davide Astori,ITA,DF,30,1987,25.0,47,31,33,13,1,18,29,62.1,11,29,17,12,51,98,131,2,2018
ITA-Serie A,2017,Fiorentina,Diego Falcinelli,ITA,FW,26,1991,4.9,1,1,1,0,0,0,5,0.0,5,5,1,4,1,2,4,0,2018
ITA-Serie A,2017,Fiorentina,Federico Chiesa,ITA,"FW,MF",19,1997,33.5,62,41,22,22,18,16,54,29.6,38,34,1,33,18,80,16,0,2018
ITA-Serie A,2017,Fiorentina,Germán Pezzella,ARG,DF,26,1991,33.1,63,47,42,19,2,19,41,46.3,22,33,16,17,63,126,185,1,2018
ITA-Serie A,2017,Fiorentina,Gil Bastião Dias,POR,"FW,MF",20,1996,13.2,49,31,28,15,6,19,48,39.6,29,23,0,23,19,68,12,1,2018
ITA-Serie A,2017,Fiorentina,Giovanni Simeone,ARG,FW,22,1995,33.3,32,23,9,17,6,8,40,20.0,32,27,1,26,12,44,32,0,2018
ITA-Serie A,2017,Fiorentina,Jordan Veretout,FRA,MF,24,1993,35.7,65,45,34,23,8,20,69,29.0,49,39,4,35,37,102,59,0,2018
ITA-Serie A,2017,Fiorentina,Khouma Babacar,SEN,FW,24,1993,5.0,4,4,3,0,1,2,4,50.0,2,0,0,0,2,6,5,0,2018
ITA-Serie A,2017,Fiorentina,Marco Benassi,ITA,"MF,FW",22,1994,30.9,54,38,18,22,14,17,52,32.7,35,52,2,50,28,82,36,0,2018
ITA-Serie A,2017,Fiorentina,Marco Sportiello,ITA,GK,25,1992,35.6,0,0,0,0,0,0,1,0.0,1,0,0,0,1,1,13,4,2018
ITA-Serie A,2017,Fiorentina,Maximiliano Olivera,URU,DF,25,1992,4.6,12,9,5,4,3,3,8,37.5,5,4,1,3,11,23,11,0,2018
ITA-Serie A,2017,Fiorentina,Milan Badelj,CRO,MF,28,1989,26.1,71,41,26,38,7,28,71,39.4,43,48,2,46,71,142,52,3,2018
ITA-Serie A,2017,Fiorentina,Nenad Tomović,SRB,DF,29,1987,1.5,2,1,1,1,0,0,2,0.0,2,0,0,0,3,5,5,1,2018
ITA-Serie A,2017,Fiorentina,Nikola Milenković,SRB,DF,19,1997,13.9,39,25,20,16,3,16,29,55.2,13,18,8,10,23,62,70,0,2018
ITA-Serie A,2017,Fiorentina,Rafik Zekhnini,NOR,FW,19,1998,0.1,0,0,0,0,0,0,0,,0,0,0,0,0,0,0,0,2018
ITA-Serie A,2017,Fiorentina,Riccardo Saponara,ITA,"MF,FW",25,1991,10.0,12,8,2,8,2,2,11,18.2,9,3,1,2,1,13,5,0,2018
ITA-Serie A,2017,Fiorentina,Sebastián Cristóforo,URU,MF,23,1993,3.0,16,12,6,8,2,9,19,47.4,10,4,0,4,4,20,6,0,2018
ITA-Serie A,2017,Fiorentina,Simone Lo Faso,ITA,FW,19,1998,0.4,1,1,1,0,0,0,1,0.0,1,0,0,0,1,2,0,0,2018
ITA-Serie A,2017,Fiorentina,Valentin Eysseric,FRA,"FW,MF",25,1992,7.8,17,13,7,4,6,6,20,30.0,14,10,2,8,6,23,6,0,2018
ITA-Serie A,2017,Fiorentina,Vincent Laurini,FRA,DF,28,1989,17.9,34,23,21,9,4,12,22,54.5,10,20,5,15,11,45,72,1,2018
ITA-Serie A,2017,Fiorentina,Vitor Hugo,BRA,DF,26,1991,13.4,32,21,26,6,0,10,17,58.8,7,10,6,4,43,75,92,0,2018
ITA-Serie A,2017,Genoa,Adel Taarabt,MAR,"FW,MF",28,1989,17.9,18,11,5,11,2,7,16,43.8,9,13,3,10,12,30,7,0,2018
ITA-Serie A,2017,Genoa,Aleandro Rosi,ITA,DF,30,1987,18.9,24,17,7,13,4,5,19,26.3,14,24,5,19,20,44,61,1,2018
ITA-Serie A,2017,Genoa,Andrea Bertolacci,ITA,MF,26,1991,32.2,85,53,40,38,7,21,63,33.3,42,46,12,34,46,131,37,1,2018
ITA-Serie A,2017,Genoa,Andrey Galabinov,BUL,FW,28,1988,12.5,7,5,0,5,2,0,5,0.0,5,17,1,16,2,9,11,0,2018
ITA-Serie A,2017,Genoa,Armando Izzo,ITA,DF,25,1992,15.4,30,23,14,10,6,12,18,66.7,6,15,6,9,34,64,70,0,2018
ITA-Serie A,2017,Genoa,Daniel Bessa,ITA,MF,24,1993,4.9,6,6,2,2,2,0,1,0.0,1,7,0,7,3,9,6,0,2018
ITA-Serie A,2017,Genoa,Darko Lazović,SRB,"DF,MF",26,1990,13.8,19,12,16,2,1,9,18,50.0,9,8,0,8,13,32,12,0,2018
ITA-Serie A,2017,Genoa,Davide Biraschi,ITA,DF,23,1994,20.0,33,25,13,19,1,18,25,72.0,7,19,10,9,38,71,78,0,2018
ITA-Serie A,2017,Genoa,Diego Laxalt,URU,DF,24,1993,31.2,54,43,31,17,6,22,59,37.3,37,38,3,35,25,79,55,1,2018
ITA-Serie A,2017,Genoa,Eddie Salcedo,ITA,FW,15,2001,0.4,0,0,0,0,0,0,0,,0,0,0,0,0,0,0,0,2018
ITA-Serie A,2017,Genoa,Ervin Zukanović,BIH,DF,30,1987,31.9,50,41,33,16,1,20,51,39.2,31,32,19,13,48,98,175,0,2018
ITA-Serie A,2017,Genoa,Eugenio Lamanna,ITA,GK,27,1989,1.0,0,0,0,0,0,0,0,,0,0,0,0,0,0,1,0,2018
ITA-Serie A,2017,Genoa,Federico Ricci,ITA,MF,23,1994,2.4,2,2,2,0,0,1,3,33.3,2,2,0,2,1,3,1,0,2018
ITA-Serie A,2017,Genoa,Francesco Migliore,ITA,DF,29,1988,3.7,5,5,4,1,0,2,6,33.3,4,1,0,1,3,8,9,1,2018
ITA-Serie A,2017,Genoa,Gianluca Lapadula,PER,FW,27,1990,16.6,8,5,4,4,0,1,11,9.1,10,7,1,6,3,11,8,0,2018
ITA-Serie A,2017,Genoa,Giuseppe Rossi,ITA,"FW,MF",30,1987,2.9,1,1,0,1,0,0,3,0.0,3,2,0,2,1,2,1,0,2018
ITA-Serie A,2017,Genoa,Goran Pandev,MKD,"FW,MF",34,1983,20.0,10,9,3,6,1,2,13,15.4,11,8,0,8,4,14,5,0,2018
ITA-Serie A,2017,Genoa,Isaac Cofie,GHA,MF,25,1991,6.6,13,10,3,9,1,7,15,46.7,8,9,3,6,10,23,7,0,2018
ITA-Serie A,2017,Genoa,Iuri Medeiros,POR,"FW,MF",23,1994,7.1,6,4,3,2,1,4,8,50.0,4,3,1,2,2,8,3,0,2018
ITA-Serie A,2017,Genoa,Jawad El Yamiq,MAR,DF,25,1992,4.0,8,5,7,1,0,6,8,75.0,2,11,5,6,5,13,22,1,2018
ITA-Serie A,2017,Genoa,Luca Rigoni,ITA,MF,32,1984,17.5,32,22,11,20,1,7,35,20.0,28,24,2,22,19,51,13,0,2018
ITA-Serie A,2017,Genoa,Luca Rossettini,ITA,DF,32,1985,22.5,16,8,12,3,1,6,17,35.3,11,31,21,10,29,45,151,1,2018
ITA-Serie A,2017,Genoa,Mattia Perin,ITA,GK,24,1992,37.0,0,0,0,0,0,0,1,0.0,1,0,0,0,1,1,14,2,2018
ITA-Serie A,2017,Genoa,Miguel Veloso,POR,MF,31,1986,19.3,40,29,18,19,3,11,41,26.8,30,26,3,23,13,53,35,0,2018
ITA-Serie A,2017,Genoa,Nicolás Spolli,ARG,DF,34,1983,20.0,27,21,24,2,1,13,22,59.1,9,26,17,9,36,63,120,2,2018
ITA-Serie A,2017,Genoa,Oscar Hiljemark,SWE,MF,25,1992,14.2,12,8,2,8,2,3,24,12.5,21,14,4,10,9,21,12,0,2018
ITA-Serie A,2017,Genoa,Pedro Pereira,POR,DF,19,1998,4.2,5,4,2,1,2,3,5,60.0,2,5,2,3,5,10,15,0,2018
ITA-Serie A,2017,Genoa,Petar Brlek,CRO,MF,23,1994,2.6,9,7,4,5,0,3,7,42.9,4,0,0,0,1,10,3,0,2018
ITA-Serie A,2017,Genoa,Pietro Pellegri,ITA,FW,16,2001,3.1,1,0,0,0,1,0,5,0.0,5,3,0,3,2,3,1,0,2018
ITA-Serie A,2017,Genoa,Raffaele Palladino,ITA,"MF,FW",33,1984,2.6,1,1,1,0,0,0,1,0.0,1,0,0,0,1,2,0,0,2018
ITA-Serie A,2017,Genoa,Ricardo Centurión,ARG,"MF,FW",24,1993,0.6,0,0,0,0,0,0,0,,0,0,0,0,0,0,0,0,2018
ITA-Serie A,2017,Genoa,Santiago Gentiletti,ARG,DF,32,1985,3.2,4,3,4,0,0,1,6,16.7,5,1,0,1,3,7,11,1,2018
ITA-Serie A,2017,Genoa,Stephane Omeonga,BEL,"MF,DF",21,1996,8.9,25,15,16,8,1,7,18,38.9,11,20,1,19,5,30,6,0,2018
ITA-Serie A,2017,Hellas Verona,Alessio Cerci,ITA,FW,30,1987,18.2,15,10,7,3,5,4,16,25.0,12,4,0,4,4,19,8,0,2018
ITA-Serie A,2017,Hellas Verona,Alex Ferrari,ITA,DF,23,1994,23.7,73,54,42,23,8,36,67,53.7,31,41,15,26,47,120,117,4,2018
ITA-Serie A,2017,Hellas Verona,Andrea Danzi,ITA,MF,18,1999,4.4,11,6,7,4,0,5,13,38.5,8,3,0,3,5,16,5,1,2018
ITA-Serie A,2017,Hellas Verona,Antonio Caracciolo,ITA,DF,27,1990,31.7,52,34,41,8,3,17,30,56.7,13,64,44,20,39,91,203,0,2018
ITA-Serie A,2017,Hellas Verona,Bruno Petković,CRO,FW,22,1994,10.2,14,12,3,8,3,6,13,46.2,7,11,1,10,7,21,12,0,2018
ITA-Serie A,2017,Hellas Verona,Bruno Zuculini,ARG,MF,24,1993,13.5,68,49,37,28,3,20,48,41.7,28,35,8,27,38,106,31,0,2018
ITA-Serie A,2017,Hellas Verona,Daniel Bessa,ITA,"MF,FW",24,1993,15.4,26,19,9,15,2,8,29,27.6,21,12,2,10,14,40,8,1,2018
ITA-Serie A,2017,Hellas Verona,Daniele Verde,ITA,"FW,MF",21,1996,21.7,10,9,8,1,1,6,20,30.0,14,8,0,8,30,40,19,0,2018
ITA-Serie A,2017,Hellas Verona,Deian Boldor,ROU,DF,22,1995,1.0,3,2,3,0,0,2,3,66.7,1,5,2,3,3,6,11,0,2018
ITA-Serie A,2017,Hellas Verona,Enrico Bearzotti,ITA,"DF,FW",20,1996,4.6,3,2,2,0,1,1,4,25.0,3,3,1,2,4,7,18,0,2018
ITA-Serie A,2017,Hellas Verona,Franco Zuculini,ARG,"MF,FW",26,1990,3.7,11,8,5,5,1,5,14,35.7,9,4,0,4,5,16,6,1,2018
ITA-Serie A,2017,Hellas Verona,Giampaolo Pazzini,ITA,FW,32,1984,11.0,0,0,0,0,0,0,4,0.0,4,2,0,2,1,1,13,0,2018
ITA-Serie A,2017,Hellas Verona,Gian Filippo Felicioli,ITA,"MF,DF",19,1997,3.1,13,8,5,5,3,0,4,0.0,4,0,0,0,5,18,6,0,2018
ITA-Serie A,2017,Hellas Verona,Jagoš Vuković,SRB,DF,29,1988,14.8,5,4,3,1,1,3,6,50.0,3,19,14,5,20,25,113,0,2018
ITA-Serie A,2017,Hellas Verona,Lee Seung-woo,KOR,"MF,FW",19,1998,4.0,3,2,0,1,2,0,6,0.0,6,1,0,1,2,5,0,0,2018
ITA-Serie A,2017,Hellas Verona,Marcel Büchel,LIE,MF,26,1991,18.8,37,21,15,21,1,13,48,27.1,35,35,6,29,45,82,46,1,2018
ITA-Serie A,2017,Hellas Verona,Marco Fossati,ITA,MF,24,1992,12.2,27,13,11,14,2,11,33,33.3,22,19,6,13,23,50,31,1,2018
ITA-Serie A,2017,Hellas Verona,Marco Silvestri,ITA,GK,26,1991,2.0,0,0,0,0,0,0,0,,0,0,0,0,1,1,0,0,2018
ITA-Serie A,2017,Hellas Verona,Martín Cáceres,URU,DF,30,1987,12.9,16,11,14,1,1,7,18,38.9,11,9,5,4,19,35,41,1,2018
ITA-Serie A,2017,Hellas Verona,Matteo Bianchetti,ITA,DF,24,1993,1.4,3,1,3,0,0,1,3,33.3,2,3,2,1,2,5,8,0,2018
ITA-Serie A,2017,Hellas Verona,Mattia Valoti,ITA,"MF,FW",23,1993,17.5,62,41,21,35,6,11,53,20.8,42,25,3,22,41,103,37,1,2018
ITA-Serie A,2017,Hellas Verona,Mattia Zaccagni,ITA,"MF,FW",22,1995,1.7,7,5,4,0,3,2,3,66.7,1,0,0,0,5,12,0,0,2018
ITA-Serie A,2017,Hellas Verona,Mohamed Fares,ALG,"DF,MF",21,1996,28.9,50,33,29,17,4,16,42,38.1,26,24,5,19,50,100,132,2,2018
ITA-Serie A,2017,Hellas Verona,Moise Kean,ITA,FW,17,2000,12.6,8,5,1,3,4,1,6,16.7,5,6,0,6,7,15,4,0,2018
ITA-Serie A,2017,Hellas Verona,Nícolas Andrade,BRA,GK,29,1988,36.0,2,1,2,0,0,1,4,25.0,3,2,0,2,2,4,16,7,2018
ITA-Serie A,2017,Hellas Verona,Rolando Aarons,ENG,"MF,FW",21,1995,5.7,13,8,4,4,5,1,7,14.3,6,3,1,2,2,15,0,0,2018
ITA-Serie A,2017,Hellas Verona,Ryder Matos,BRA,"FW,MF",24,1993,10.9,18,15,11,5,2,4,9,44.4,5,5,0,5,3,21,9,1,2018
ITA-Serie A,2017,Hellas Verona,Rômulo,ITA,"MF,DF",30,1987,35.2,58,44,23,29,6,13,54,24.1,41,29,2,27,43,101,41,0,2018
ITA-Serie A,2017,Hellas Verona,Samuel Souprayen,FRA,DF,28,1989,17.6,29,19,25,3,1,12,19,63.2,7,18,9,9,22,51,67,1,2018
ITA-Serie A,2017,Hellas Verona,Simone Calvano,ITA,MF,24,1993,7.2,13,12,4,9,0,3,16,18.8,13,10,4,6,15,28,14,1,2018
ITA-Serie A,2017,Hellas Verona,Thomas Heurtaux,FRA,DF,29,1988,15.5,14,11,12,2,0,4,8,50.0,4,25,16,9,37,51,97,1,2018
ITA-Serie A,2017,Hellas Verona,Ľubomír Tupta,SVK,"MF,FW",19,1998,0.4,0,0,0,0,0,0,3,0.0,3,0,0,0,0,0,0,0,2018
ITA-Serie A,2017,Inter,Andrea Pinamonti,ITA,FW,18,1999,0.2,0,0,0,0,0,0,0,,0,0,0,0,0,0,0,0,2018
ITA-Serie A,2017,Inter,Andrea Ranocchia,ITA,DF,29,1988,7.0,8,4,6,2,0,3,6,50.0,3,6,5,1,12,20,35,0,2018
ITA-Serie A,2017,Inter,Antonio Candreva,ITA,FW,30,1987,28.2,12,7,7,5,0,8,39,20.5,31,20,2,18,22,34,24,0,2018
ITA-Serie A,2017,Inter,Borja Valero,ESP,MF,32,1985,28.5,46,31,17,25,4,20,58,34.5,38,15,4,11,18,64,41,1,2018
ITA-Serie A,2017,Inter,Dalbert Henrique,BRA,DF,23,1993,5.9,15,10,11,3,1,7,13,53.8,6,7,4,3,13,28,19,0,2018
ITA-Serie A,2017,Inter,Danilo D'Ambrosio,ITA,DF,28,1988,33.1,82,64,38,35,9,30,59,50.8,29,31,7,24,45,127,68,1,2018
ITA-Serie A,2017,Inter,Davide Santon,ITA,DF,26,1991,9.3,19,14,13,6,0,9,17,52.9,8,10,3,7,20,39,32,2,2018
ITA-Serie A,2017,Inter,Ivan Perišić,CRO,FW,28,1989,36.8,47,31,15,23,9,8,56,14.3,48,47,6,41,45,92,62,0,2018
ITA-Serie A,2017,Inter,João Cancelo,POR,DF,23,1994,20.6,42,29,27,11,4,17,42,40.5,25,15,2,13,35,77,51,0,2018
ITA-Serie A,2017,Inter,João Mário,POR,"MF,FW",24,1993,6.2,8,4,3,3,2,2,8,25.0,6,6,1,5,4,12,5,0,2018
ITA-Serie A,2017,Inter,Lisandro López,ARG,DF,27,1989,0.5,2,2,1,1,0,0,2,0.0,2,0,0,0,1,3,3,0,2018
ITA-Serie A,2017,Inter,Marcelo Brozović,CRO,MF,24,1992,21.4,60,43,21,31,8,19,63,30.2,44,30,7,23,18,78,18,0,2018
ITA-Serie A,2017,Inter,Matías Vecino,URU,MF,25,1991,23.7,54,34,15,30,9,19,49,38.8,30,28,6,22,20,74,31,0,2018
ITA-Serie A,2017,Inter,Mauro Icardi,ARG,FW,24,1993,32.9,3,2,1,2,0,1,8,12.5,7,14,6,8,5,8,23,1,2018
ITA-Serie A,2017,Inter,Milan Škriniar,SVK,DF,22,1995,38.0,86,55,69,16,1,44,70,62.9,26,38,26,12,35,121,180,0,2018
ITA-Serie A,2017,Inter,Miranda,BRA,DF,32,1984,30.3,48,37,38,10,0,22,25,88.0,3,30,23,7,38,86,131,2,2018
ITA-Serie A,2017,Inter,Rafinha,BRA,MF,24,1993,11.6,14,9,1,10,3,3,16,18.8,13,15,0,15,7,21,9,0,2018
ITA-Serie A,2017,Inter,Roberto Gagliardini,ITA,MF,23,1994,22.1,63,45,28,29,6,20,54,37.0,34,18,3,15,45,108,32,2,2018
ITA-Serie A,2017,Inter,Samir Handanović,SVN,GK,33,1984,38.0,0,0,0,0,0,0,0,,0,1,0,1,0,0,7,1,2018
ITA-Serie A,2017,Inter,Yann Karamoh,FRA,"FW,MF",19,1998,5.4,3,1,1,1,1,0,3,0.0,3,4,0,4,4,7,1,1,2018
ITA-Serie A,2017,Inter,Yuto Nagatomo,JPN,DF,30,1986,8.8,10,6,4,5,1,5,14,35.7,9,8,3,5,10,20,28,0,2018
ITA-Serie A,2017,Inter,Éder,ITA,"FW,MF",30,1986,8.9,10,7,2,4,4,0,10,0.0,10,6,1,5,5,15,4,0,2018
ITA-Serie A,2017,Juventus,Alex Sandro,BRA,DF,26,1991,23.5,57,31,33,17,7,20,39,51.3,19,21,1,20,30,87,45,0,2018
ITA-Serie A,2017,Juventus,Andrea Barzagli,ITA,DF,36,1981,16.1,26,15,14,11,1,9,16,56.3,7,14,7,7,17,43,46,0,2018
ITA-Serie A,2017,Juventus,Benedikt Höwedes,GER,DF,29,1988,2.7,1,1,1,0,0,0,0,,0,0,0,0,8,9,10,1,2018
ITA-Serie A,2017,Juventus,Blaise Matuidi,FRA,MF,30,1987,26.2,49,35,14,25,10,10,35,28.6,25,28,4,24,32,81,22,1,2018
ITA-Serie A,2017,Juventus,Carlo Pinsoglio,ITA,GK,27,1990,0.3,0,0,0,0,0,0,0,,0,0,0,0,0,0,0,0,2018
ITA-Serie A,2017,Juventus,Claudio Marchisio,ITA,MF,31,1986,9.1,17,10,9,5,3,6,21,28.6,15,7,2,5,4,21,7,0,2018
ITA-Serie A,2017,Juventus,Daniele Rugani,ITA,DF,23,1994,21.5,18,12,11,5,2,7,13,53.8,6,18,14,4,20,38,87,1,2018
ITA-Serie A,2017,Juventus,Douglas Costa,BRA,"FW,MF",26,1990,19.9,17,14,10,5,2,8,25,32.0,17,15,0,15,7,24,7,0,2018
ITA-Serie A,2017,Juventus,Federico Bernardeschi,ITA,"FW,MF",23,1994,9.4,8,5,4,3,1,1,7,14.3,6,9,0,9,11,19,18,1,2018
ITA-Serie A,2017,Juventus,Gianluigi Buffon,ITA,GK,39,1978,20.7,0,0,0,0,0,0,0,,0,0,0,0,0,0,11,2,2018
ITA-Serie A,2017,Juventus,Giorgio Chiellini,ITA,DF,32,1984,24.0,28,19,17,10,1,7,15,46.7,8,21,14,7,47,75,142,3,2018
ITA-Serie A,2017,Juventus,Gonzalo Higuaín,ARG,FW,29,1987,31.3,19,17,3,7,9,2,19,10.5,17,19,4,15,7,26,20,0,2018
ITA-Serie A,2017,Juventus,Juan Cuadrado,COL,"FW,MF",29,1988,15.0,28,19,17,9,2,11,27,40.7,16,14,0,14,19,47,14,1,2018
ITA-Serie A,2017,Juventus,Kwadwo Asamoah,GHA,DF,28,1988,17.4,28,21,12,14,2,15,23,65.2,8,11,0,11,18,46,30,0,2018
ITA-Serie A,2017,Juventus,Mario Mandžukić,CRO,FW,31,1986,25.8,36,23,13,11,12,8,29,27.6,21,20,3,17,25,61,42,2,2018
ITA-Serie A,2017,Juventus,Mattia De Sciglio,ITA,DF,24,1992,10.8,22,17,7,13,2,9,13,69.2,4,12,2,10,14,36,32,0,2018
ITA-Serie A,2017,Juventus,Medhi Benatia,MAR,DF,30,1987,19.5,28,21,20,6,2,8,15,53.3,7,18,13,5,43,71,89,1,2018
ITA-Serie A,2017,Juventus,Miralem Pjanić,BIH,MF,27,1990,27.6,36,30,13,18,5,13,51,25.5,38,25,5,20,64,100,27,2,2018
ITA-Serie A,2017,Juventus,Paulo Dybala,ARG,"MF,FW",23,1993,26.1,19,11,4,10,5,4,32,12.5,28,22,0,22,12,31,4,0,2018
ITA-Serie A,2017,Juventus,Rodrigo Bentancur,URU,MF,20,1997,6.5,18,11,10,7,1,2,16,12.5,14,5,1,4,3,21,14,0,2018
ITA-Serie A,2017,Juventus,Sami Khedira,GER,MF,30,1987,21.2,14,9,1,9,4,2,23,8.7,21,13,3,10,20,34,20,0,2018
ITA-Serie A,2017,Juventus,Stefano Sturaro,ITA,"MF,DF",24,1993,6.8,17,11,5,9,3,4,11,36.4,7,9,2,7,5,22,18,1,2018
ITA-Serie A,2017,Juventus,Stephan Lichtsteiner,SUI,DF,33,1984,18.9,31,27,16,10,5,9,17,52.9,8,11,2,9,15,46,38,1,2018
ITA-Serie A,2017,Juventus,Wojciech Szczęsny,POL,GK,27,1990,17.0,0,0,0,0,0,0,0,,0,0,0,0,0,0,4,0,2018
ITA-Serie A,2017,Lazio,Adam Marušić,MNE,DF,24,1992,28.0,28,21,17,8,3,12,28,42.9,16,22,2,20,31,59,33,0,2018
ITA-Serie A,2017,Lazio,Alessandro Murgia,ITA,MF,20,1996,8.6,19,12,9,9,1,5,19,26.3,14,14,3,11,17,36,13,0,2018
ITA-Serie A,2017,Lazio,Bastos,ANG,DF,26,1991,15.6,33,24,19,13,1,19,30,63.3,11,13,8,5,24,57,67,0,2018
ITA-Serie A,2017,Lazio,Ciro Immobile,ITA,FW,27,1990,29.8,4,2,0,3,1,0,17,0.0,17,14,1,13,0,4,9,0,2018
ITA-Serie A,2017,Lazio,Davide Di Gennaro,ITA,MF,29,1988,0.1,1,0,1,0,0,1,1,100.0,0,0,0,0,0,1,0,0,2018
ITA-Serie A,2017,Lazio,Dušan Basta,SRB,DF,32,1984,8.6,9,7,4,3,2,6,14,42.9,8,10,3,7,13,22,15,0,2018
ITA-Serie A,2017,Lazio,Felipe Anderson,BRA,"FW,MF",24,1993,12.9,34,21,7,11,16,6,35,17.1,29,17,0,17,11,45,8,1,2018
ITA-Serie A,2017,Lazio,Felipe Caicedo,ECU,"FW,MF",28,1988,8.0,11,10,3,5,3,2,7,28.6,5,6,0,6,1,12,4,0,2018
ITA-Serie A,2017,Lazio,Jordan Lukaku,BEL,DF,23,1994,15.1,28,15,14,11,3,10,16,62.5,6,14,2,12,15,43,23,0,2018
ITA-Serie A,2017,Lazio,Lucas Leiva,BRA,MF,30,1987,32.0,107,80,43,59,5,29,100,29.0,71,33,7,26,70,177,59,0,2018
ITA-Serie A,2017,Lazio,Luis Alberto,ESP,"FW,MF",24,1992,29.7,39,28,8,23,8,10,44,22.7,34,30,2,28,16,55,7,0,2018
ITA-Serie A,2017,Lazio,Luiz Felipe,ITA,DF,20,1997,13.0,40,28,24,16,0,15,25,60.0,10,26,14,12,18,58,50,1,2018
ITA-Serie A,2017,Lazio,Marco Parolo,ITA,MF,32,1985,29.0,70,37,27,36,7,14,58,24.1,44,49,8,41,43,113,64,0,2018
ITA-Serie A,2017,Lazio,Martín Cáceres,URU,DF,30,1987,4.9,12,7,9,2,1,10,14,71.4,4,4,4,0,4,16,13,0,2018
ITA-Serie A,2017,Lazio,Maurício,BRA,DF,28,1988,0.1,0,0,0,0,0,0,0,,0,0,0,0,0,0,0,0,2018
ITA-Serie A,2017,Lazio,Nani,POR,"FW,MF",30,1986,4.3,9,6,2,2,5,3,9,33.3,6,8,0,8,2,11,0,0,2018
ITA-Serie A,2017,Lazio,Patric,ESP,DF,24,1993,6.6,11,6,8,2,1,4,6,66.7,2,3,0,3,3,14,32,0,2018
ITA-Serie A,2017,Lazio,Senad Lulić,BIH,"DF,MF",31,1986,27.0,66,40,32,22,12,21,80,26.3,59,32,4,28,36,102,39,0,2018
ITA-Serie A,2017,Lazio,Sergej Milinković-Savić,SRB,MF,22,1995,31.6,55,39,11,34,10,13,52,25.0,39,29,6,23,33,88,36,1,2018
ITA-Serie A,2017,Lazio,Simone Palombi,ITA,FW,21,1996,0.7,0,0,0,0,0,0,0,,0,0,0,0,0,0,0,0,2018
ITA-Serie A,2017,Lazio,Stefan de Vrij,NED,DF,25,1992,33.7,31,22,14,17,0,14,23,60.9,9,43,24,19,71,102,156,1,2018
ITA-Serie A,2017,Lazio,Thomas Strakosha,ALB,GK,22,1995,38.0,0,0,0,0,0,0,0,,0,0,0,0,2,2,13,4,2018
ITA-Serie A,2017,Lazio,Wallace,BRA,DF,22,1994,11.1,17,7,11,6,0,4,13,30.8,9,13,5,8,29,46,43,3,2018
ITA-Serie A,2017,Lazio,Ștefan Radu,ROU,DF,30,1986,28.8,53,38,36,16,1,25,41,61.0,16,30,14,16,55,108,105,1,2018
ITA-Serie A,2017,Milan,Alessio Romagnoli,ITA,DF,22,1995,26.1,20,14,17,2,1,9,14,64.3,5,24,14,10,23,43,154,1,2018
ITA-Serie A,2017,Milan,Andrea Conti,ITA,DF,23,1994,1.7,4,2,1,3,0,2,3,66.7,1,3,0,3,1,5,5,0,2018
ITA-Serie A,2017,Milan,André Silva,POR,FW,21,1995,10.4,5,4,1,0,4,2,7,28.6,5,10,1,9,4,9,6,0,2018
ITA-Serie A,2017,Milan,Cristián Zapata,COL,DF,30,1986,11.0,25,20,21,4,0,15,16,93.8,1,12,6,6,15,40,50,1,2018
ITA-Serie A,2017,Milan,Davide Calabria,ITA,DF,20,1996,17.4,64,50,33,24,7,21,41,51.2,20,19,4,15,33,97,82,1,2018
ITA-Serie A,2017,Milan,Emanuele Torrasi,ITA,MF,18,1999,0.1,,,,,,,,,,,,,,,,,2018
ITA-Serie A,2017,Milan,Fabio Borini,ITA,"DF,FW",26,1991,17.9,38,23,12,18,8,16,37,43.2,21,32,6,26,13,51,43,0,2018
ITA-Serie A,2017,Milan,Franck Kessié,CIV,MF,20,1996,36.3,48,34,20,19,9,17,44,38.6,27,47,11,36,26,74,45,3,2018
ITA-Serie A,2017,Milan,Giacomo Bonaventura,ITA,MF,27,1989,28.2,31,20,7,19,5,9,45,20.0,36,31,6,25,33,64,17,0,2018
ITA-Serie A,2017,Milan,Gianluigi Donnarumma,ITA,GK,18,1999,38.0,1,0,1,0,0,1,1,100.0,0,0,0,0,1,2,13,8,2018
ITA-Serie A,2017,Milan,Hakan Çalhanoğlu,TUR,"FW,MF",23,1994,24.1,37,27,11,18,8,8,31,25.8,23,29,2,27,22,59,15,0,2018
ITA-Serie A,2017,Milan,Ignazio Abate,ITA,DF,30,1986,11.7,20,17,10,9,1,6,11,54.5,5,22,2,20,8,28,29,0,2018
ITA-Serie A,2017,Milan,José Mauri,ITA,MF,21,1996,0.1,0,0,0,0,0,0,0,,0,0,0,0,0,0,0,0,2018
ITA-Serie A,2017,Milan,Leonardo Bonucci,ITA,DF,30,1987,34.3,30,21,22,7,1,11,18,61.1,7,31,22,9,51,81,132,0,2018
ITA-Serie A,2017,Milan,Luca Antonelli,ITA,"DF,FW",30,1987,1.6,1,1,0,0,1,0,2,0.0,2,1,0,1,1,2,8,0,2018
ITA-Serie A,2017,Milan,Lucas Biglia,ARG,MF,31,1986,22.7,59,36,28,26,5,22,61,36.1,39,49,12,37,28,87,51,1,2018
ITA-Serie A,2017,Milan,Manuel Locatelli,ITA,MF,19,1998,7.6,16,13,6,9,1,4,18,22.2,14,10,2,8,9,25,13,0,2018
ITA-Serie A,2017,Milan,Mateo Musacchio,ARG,DF,26,1990,13.4,22,15,13,7,2,8,16,50.0,8,9,3,6,12,34,58,1,2018
ITA-Serie A,2017,Milan,Nikola Kalinić,CRO,FW,29,1988,20.1,6,5,1,4,1,0,8,0.0,8,4,1,3,3,9,12,0,2018
ITA-Serie A,2017,Milan,Patrick Cutrone,ITA,FW,19,1998,16.7,11,10,2,7,2,1,10,10.0,9,11,1,10,3,14,12,0,2018
ITA-Serie A,2017,Milan,Ricardo Rodríguez,SUI,DF,24,1992,33.4,48,29,24,18,6,18,28,64.3,10,36,6,30,33,81,93,3,2018
ITA-Serie A,2017,Milan,Riccardo Montolivo,ITA,MF,32,1985,12.1,29,21,11,15,3,7,24,29.2,17,17,4,13,19,48,15,0,2018
ITA-Serie A,2017,Milan,Suso,ESP,"FW,MF",23,1993,31.4,18,14,3,5,10,4,31,12.9,27,25,0,25,16,34,2,1,2018
ITA-Serie A,2017,Napoli,Adam Ounas,ALG,FW,20,1996,1.1,4,3,0,2,2,1,4,25.0,3,2,0,2,0,4,2,0,2018
ITA-Serie A,2017,Napoli,Allan,BRA,MF,26,1991,31.7,107,68,24,65,18,36,104,34.6,68,52,3,49,28,135,16,0,2018
ITA-Serie A,2017,Napoli,Amadou Diawara,GUI,MF,20,1997,7.3,11,9,3,7,1,1,7,14.3,6,12,2,10,9,20,5,0,2018
ITA-Serie A,2017,Napoli,Arkadiusz Milik,POL,"FW,MF",23,1994,5.0,2,1,0,1,1,0,1,0.0,1,5,0,5,1,3,4,0,2018
ITA-Serie A,2017,Napoli,Christian Maggio,ITA,DF,35,1982,7.1,17,10,9,6,2,7,19,36.8,12,15,4,11,13,30,21,0,2018
ITA-Serie A,2017,Napoli,Dries Mertens,BEL,FW,30,1987,33.4,28,22,5,13,10,5,36,13.9,31,18,2,16,5,33,8,1,2018
ITA-Serie A,2017,Napoli,Elseid Hysaj,ALB,DF,23,1994,34.7,64,45,28,30,6,32,56,57.1,24,35,4,31,43,107,68,4,2018
ITA-Serie A,2017,Napoli,Emanuele Giaccherini,ITA,"FW,MF",32,1985,0.7,1,1,0,1,0,0,0,,0,0,0,0,0,1,0,0,2018
ITA-Serie A,2017,Napoli,Faouzi Ghoulam,ALG,DF,26,1991,10.9,8,4,3,5,0,4,6,66.7,2,10,2,8,15,23,19,0,2018
ITA-Serie A,2017,Napoli,Jorginho,ITA,MF,25,1991,29.4,62,46,14,39,9,15,68,22.1,53,32,3,29,50,112,12,2,2018
ITA-Serie A,2017,Napoli,José Callejón,ESP,FW,30,1987,36.0,33,27,15,14,4,10,47,21.3,37,42,5,37,22,55,31,0,2018
ITA-Serie A,2017,Napoli,Kalidou Koulibaly,SEN,DF,26,1991,34.1,54,42,31,19,4,20,40,50.0,20,36,16,20,40,94,119,3,2018
ITA-Serie A,2017,Napoli,Lorenzo Insigne,ITA,FW,26,1991,34.3,29,17,11,13,5,13,33,39.4,20,20,0,20,17,46,4,0,2018
ITA-Serie A,2017,Napoli,Lorenzo Tonelli,ITA,DF,27,1990,3.9,7,1,4,3,0,5,9,55.6,4,2,1,1,7,14,10,0,2018
ITA-Serie A,2017,Napoli,Luigi Sepe,ITA,GK,26,1991,1.0,0,0,0,0,0,0,0,,0,0,0,0,0,0,1,0,2018
ITA-Serie A,2017,Napoli,Marek Hamšík,SVK,MF,30,1987,26.3,36,22,10,15,11,15,37,40.5,22,35,2,33,14,50,16,0,2018
ITA-Serie A,2017,Napoli,Marko Rog,CRO,"MF,FW",22,1995,3.2,11,7,3,6,2,1,11,9.1,10,4,1,3,2,13,1,0,2018
ITA-Serie A,2017,Napoli,Mário Rui,POR,DF,26,1991,23.2,55,39,18,32,5,30,52,57.7,22,30,5,25,14,69,43,1,2018
ITA-Serie A,2017,Napoli,Nikola Maksimović,SRB,DF,25,1991,1.1,1,1,0,1,0,1,1,100.0,0,1,0,1,0,1,5,0,2018
ITA-Serie A,2017,Napoli,Pepe Reina,ESP,GK,34,1982,37.0,1,0,1,0,0,1,2,50.0,1,0,0,0,0,1,13,2,2018
ITA-Serie A,2017,Napoli,Piotr Zieliński,POL,"MF,FW",23,1994,18.5,31,19,7,21,3,9,24,37.5,15,32,3,29,13,44,19,1,2018
ITA-Serie A,2017,Napoli,Raúl Albiol,ESP,DF,31,1985,30.5,29,19,15,14,0,13,19,68.4,6,18,13,5,32,61,129,1,2018
ITA-Serie A,2017,Napoli,Vlad Chiricheș,ROU,DF,27,1989,6.5,8,4,7,1,0,2,5,40.0,3,2,1,1,16,24,19,1,2018
ITA-Serie A,2017,Roma,Aleksandar Kolarov,SRB,DF,31,1985,34.0,58,47,34,16,8,27,49,55.1,22,24,7,17,53,111,100,2,2018
ITA-Serie A,2017,Roma,Alessandro Florenzi,ITA,DF,26,1991,26.5,38,28,20,13,5,18,47,38.3,29,19,8,11,44,82,62,1,2018
ITA-Serie A,2017,Roma,Alisson,BRA,GK,24,1992,37.0,1,0,1,0,0,0,1,0.0,1,0,0,0,2,3,22,4,2018
ITA-Serie A,2017,Roma,Bruno Peres,BRA,DF,27,1990,12.8,26,17,16,7,3,10,23,43.5,13,9,2,7,22,48,28,1,2018
ITA-Serie A,2017,Roma,Cengiz Ünder,TUR,FW,20,1997,13.9,10,6,4,6,0,3,18,16.7,15,8,1,7,9,19,10,0,2018
ITA-Serie A,2017,Roma,Daniele De Rossi,ITA,MF,34,1983,20.3,23,13,12,9,2,9,33,27.3,24,18,13,5,43,66,45,2,2018
ITA-Serie A,2017,Roma,Diego Perotti,ARG,"FW,MF",29,1988,17.9,25,17,6,14,5,8,20,40.0,12,19,0,19,11,36,13,0,2018
ITA-Serie A,2017,Roma,Edin Džeko,BIH,FW,31,1986,33.5,15,10,1,9,5,3,15,20.0,12,9,1,8,4,19,36,0,2018
ITA-Serie A,2017,Roma,Elio Capradossi,ITA,DF,21,1996,0.9,1,0,1,0,0,0,0,,0,2,2,0,2,3,13,0,2018
ITA-Serie A,2017,Roma,Emerson Palmieri,ITA,DF,22,1994,0.2,0,0,0,0,0,0,0,,0,0,0,0,0,0,0,0,2018
ITA-Serie A,2017,Roma,Federico Fazio,ARG,DF,30,1987,32.5,56,43,38,18,0,25,31,80.6,6,30,22,8,46,102,161,3,2018
ITA-Serie A,2017,Roma,Gerson,BRA,"MF,FW",20,1997,10.1,20,12,10,8,2,2,7,28.6,5,15,2,13,11,31,11,1,2018
ITA-Serie A,2017,Roma,Grégoire Defrel,MTQ,"FW,MF",26,1991,5.4,8,3,1,1,6,2,8,25.0,6,5,0,5,3,11,6,0,2018
ITA-Serie A,2017,Roma,Héctor Moreno,MEX,DF,29,1988,2.6,2,2,1,1,0,0,1,0.0,1,1,1,0,3,5,5,0,2018
ITA-Serie A,2017,Roma,Jonathan Silva,ARG,DF,23,1994,1.2,0,0,0,0,0,0,1,0.0,1,1,1,0,3,3,1,0,2018
ITA-Serie A,2017,Roma,Juan Jesus,BRA,DF,26,1991,18.4,42,30,25,15,2,18,34,52.9,16,18,9,9,39,81,63,0,2018
ITA-Serie A,2017,Roma,Kevin Strootman,NED,MF,27,1990,25.1,57,38,19,24,14,15,46,32.6,31,27,3,24,27,84,21,0,2018
ITA-Serie A,2017,Roma,Kostas Manolas,GRE,DF,26,1991,26.0,23,20,14,7,2,9,15,60.0,6,31,24,7,46,69,133,2,2018
ITA-Serie A,2017,Roma,Lorenzo Pellegrini,ITA,MF,21,1996,20.0,36,20,16,11,9,10,35,28.6,25,21,2,19,41,77,21,1,2018
ITA-Serie A,2017,Roma,Marco Tumminello,ITA,FW,18,1998,0.0,0,0,0,0,0,0,0,,0,0,0,0,0,0,0,0,2018
ITA-Serie A,2017,Roma,Maxime Gonalons,FRA,MF,28,1989,12.2,26,18,7,12,7,9,23,39.1,14,15,4,11,23,49,19,1,2018
ITA-Serie A,2017,Roma,Mirko Antonucci,ITA,FW,18,1999,0.3,0,0,0,0,0,0,0,,0,0,0,0,0,0,0,0,2018
ITA-Serie A,2017,Roma,Patrik Schick,CZE,"FW,MF",21,1996,11.0,9,7,1,5,3,1,9,11.1,8,14,0,14,2,11,11,0,2018
ITA-Serie A,2017,Roma,Radja Nainggolan,BEL,MF,29,1988,29.0,49,36,14,28,7,9,33,27.3,24,18,1,17,18,67,31,1,2018
ITA-Serie A,2017,Roma,Rick Karsdorp,NED,DF,22,1995,0.9,1,1,1,0,0,0,0,,0,0,0,0,1,2,0,0,2018
ITA-Serie A,2017,Roma,Stephan El Shaarawy,ITA,FW,24,1992,23.9,22,16,9,8,5,5,21,23.8,16,16,1,15,24,46,8,0,2018
ITA-Serie A,2017,Roma,Łukasz Skorupski,POL,GK,26,1991,1.0,0,0,0,0,0,0,0,,0,0,0,0,0,0,1,0,2018
ITA-Serie A,2017,SPAL,Alberto Grassi,ITA,MF,22,1995,25.0,44,33,22,12,10,16,35,45.7,19,27,8,19,47,91,55,0,2018
ITA-Serie A,2017,SPAL,Alberto Paloschi,ITA,FW,27,1990,24.3,10,7,0,9,1,0,10,0.0,10,2,1,1,4,14,11,0,2018
ITA-Serie A,2017,SPAL,Alex Meret,ITA,GK,20,1997,12.9,0,0,0,0,0,0,1,0.0,1,0,0,0,0,0,5,0,2018
ITA-Serie A,2017,SPAL,Alfred Gomis,SEN,GK,23,1993,25.1,0,0,0,0,0,0,1,0.0,1,0,0,0,1,1,10,3,2018
ITA-Serie A,2017,SPAL,Bartosz Salamon,POL,DF,26,1991,19.2,28,22,21,7,0,12,21,57.1,9,24,18,6,58,86,148,0,2018
ITA-Serie A,2017,SPAL,Boukary Dramé,SEN,"DF,MF",32,1985,1.1,1,1,1,0,0,0,0,,0,0,0,0,2,3,4,0,2018
ITA-Serie A,2017,SPAL,Eros Schiavon,ITA,"MF,DF",34,1983,4.3,6,5,2,3,1,1,7,14.3,6,6,2,4,2,8,4,0,2018
ITA-Serie A,2017,SPAL,Everton Luiz,BRA,MF,29,1988,7.1,22,16,10,10,2,6,29,20.7,23,8,1,7,10,32,8,1,2018
ITA-Serie A,2017,SPAL,Federico Bonazzoli,ITA,"FW,DF",20,1997,2.0,1,0,0,1,0,0,0,,0,3,0,3,0,1,0,0,2018
ITA-Serie A,2017,SPAL,Federico Mattiello,ITA,DF,22,1995,24.5,59,40,31,22,6,21,44,47.7,23,53,15,38,64,123,66,0,2018
ITA-Serie A,2017,SPAL,Federico Viviani,ITA,MF,25,1992,27.6,52,36,23,26,3,18,55,32.7,37,39,9,30,58,110,26,2,2018
ITA-Serie A,2017,SPAL,Felipe dal Belo,BRA,DF,33,1984,28.6,51,34,32,16,3,25,49,51.0,24,42,24,18,48,99,157,1,2018
ITA-Serie A,2017,SPAL,Filippo Costa,ITA,DF,22,1995,16.4,19,12,7,7,5,7,17,41.2,10,23,6,17,22,41,50,0,2018
ITA-Serie A,2017,SPAL,Francesco Vicari,ITA,DF,22,1994,31.7,38,22,25,13,0,21,39,53.8,18,33,27,6,45,83,210,1,2018
ITA-Serie A,2017,SPAL,Gabriele Marchegiani,ITA,GK,21,1996,0.0,0,0,0,0,0,0,0,,0,0,0,0,0,0,0,0,2018
ITA-Serie A,2017,SPAL,Jasmin Kurtić,SVN,"MF,FW",28,1989,16.0,28,18,13,11,4,5,21,23.8,16,13,1,12,17,45,25,0,2018
ITA-Serie A,2017,SPAL,Lorenco Šimić,CRO,DF,21,1996,3.5,5,3,5,0,0,3,4,75.0,1,7,4,3,11,16,15,0,2018
ITA-Serie A,2017,SPAL,Luca Mora,ITA,MF,29,1988,10.4,19,17,6,8,5,5,17,29.4,12,9,3,6,4,23,20,0,2018
ITA-Serie A,2017,SPAL,Luca Rizzo,ITA,MF,25,1992,5.4,18,10,7,10,1,5,17,29.4,12,10,0,10,3,21,5,1,2018
ITA-Serie A,2017,SPAL,Manuel Lazzari,ITA,DF,23,1993,34.6,61,47,33,21,7,27,62,43.5,35,32,7,25,31,92,73,2,2018
ITA-Serie A,2017,SPAL,Marco Borriello,ITA,FW,35,1982,8.6,4,2,2,1,1,0,1,0.0,1,1,0,1,1,5,6,0,2018
ITA-Serie A,2017,SPAL,Marios Oikonomou,GRE,DF,24,1992,1.9,5,3,4,1,0,0,2,0.0,2,0,0,0,4,9,12,0,2018
ITA-Serie A,2017,SPAL,Mattia Vitale,ITA,"MF,FW",19,1997,1.1,2,1,2,0,0,0,0,,0,1,0,1,3,5,1,0,2018
ITA-Serie A,2017,SPAL,Michele Cremonesi,ITA,DF,29,1988,4.3,4,2,2,2,0,1,4,25.0,3,5,3,2,7,11,28,0,2018
ITA-Serie A,2017,SPAL,Mirco Antenucci,ITA,FW,32,1984,28.6,16,13,6,8,2,0,21,0.0,21,14,0,14,11,27,15,0,2018
ITA-Serie A,2017,SPAL,Pasquale Schiattarella,ITA,MF,30,1987,22.1,40,31,20,15,5,13,43,30.2,30,7,2,5,24,64,26,0,2018
ITA-Serie A,2017,SPAL,Sauli Väisänen,FIN,DF,23,1994,6.0,12,9,9,3,0,6,8,75.0,2,5,4,1,13,25,26,0,2018
ITA-Serie A,2017,SPAL,Sergio Floccari,ITA,FW,35,1981,9.8,13,9,7,5,1,6,11,54.5,5,6,1,5,2,15,6,0,2018
ITA-Serie A,2017,SPAL,Thiago Cionek,POL,DF,31,1986,15.0,28,21,18,6,4,11,20,55.0,9,19,9,10,35,63,99,0,2018
ITA-Serie A,2017,Sampdoria,Bartosz Bereszyński,POL,DF,25,1992,27.6,63,47,30,28,5,31,53,58.5,22,33,8,25,30,93,98,2,2018
ITA-Serie A,2017,Sampdoria,Christian Puggioni,ITA,GK,36,1981,9.0,0,0,0,0,0,0,0,,0,0,0,0,0,0,6,1,2018
ITA-Serie A,2017,Sampdoria,Daniel Pavlović,BIH,DF,29,1988,1.0,3,1,1,1,1,1,1,100.0,0,0,0,0,0,3,5,0,2018
ITA-Serie A,2017,Sampdoria,Dawid Kownacki,POL,FW,20,1997,9.1,8,7,1,4,3,3,11,27.3,8,7,0,7,1,9,5,0,2018
ITA-Serie A,2017,Sampdoria,Dennis Praet,BEL,MF,23,1994,29.5,85,57,34,36,15,38,73,52.1,35,49,1,48,37,122,22,0,2018
ITA-Serie A,2017,Sampdoria,Duván Zapata,COL,FW,26,1991,23.4,12,7,1,7,4,1,6,16.7,5,13,0,13,5,17,22,1,2018
ITA-Serie A,2017,Sampdoria,Emiliano Viviano,ITA,GK,31,1985,27.0,0,0,0,0,0,0,0,,0,0,0,0,2,2,10,4,2018
ITA-Serie A,2017,Sampdoria,Fabio Quagliarella,ITA,FW,34,1983,30.2,11,9,1,3,7,2,25,8.0,23,34,0,34,7,18,23,0,2018
ITA-Serie A,2017,Sampdoria,Federico Bonazzoli,ITA,FW,20,1997,0.3,0,0,0,0,0,0,0,,0,0,0,0,0,0,0,0,2018
ITA-Serie A,2017,Sampdoria,Filip Đuričić,SRB,MF,25,1992,0.1,0,0,0,0,0,0,1,0.0,1,0,0,0,0,0,0,0,2018
ITA-Serie A,2017,Sampdoria,Gastón Ramírez,URU,MF,26,1990,24.6,33,20,4,15,14,9,56,16.1,47,30,3,27,18,51,24,0,2018
ITA-Serie A,2017,Sampdoria,Gian Marco Ferrari,ITA,DF,25,1992,29.4,12,8,8,4,0,5,10,50.0,5,42,38,4,31,43,149,4,2018
ITA-Serie A,2017,Sampdoria,Gianluca Caprari,ITA,"FW,MF",24,1993,20.1,19,11,2,11,6,0,10,0.0,10,25,2,23,5,24,3,0,2018
ITA-Serie A,2017,Sampdoria,Ivan Strinić,CRO,DF,30,1987,13.9,35,24,22,12,1,17,38,44.7,21,21,2,19,22,57,46,2,2018
ITA-Serie A,2017,Sampdoria,Jacopo Sala,ITA,DF,25,1991,11.0,17,10,12,4,1,4,10,40.0,6,9,1,8,8,25,28,2,2018
ITA-Serie A,2017,Sampdoria,Joachim Andersen,DEN,DF,21,1996,6.1,8,3,6,2,0,4,4,100.0,0,6,4,2,9,17,41,1,2018
ITA-Serie A,2017,Sampdoria,Karol Linetty,POL,MF,22,1995,23.8,66,49,25,31,10,17,77,22.1,60,40,2,38,18,84,13,0,2018
ITA-Serie A,2017,Sampdoria,Leonardo Capezzi,ITA,MF,22,1995,2.4,8,4,5,3,0,4,6,66.7,2,6,0,6,0,8,3,0,2018
ITA-Serie A,2017,Sampdoria,Lucas Torreira,URU,MF,21,1996,35.3,101,73,36,57,8,30,77,39.0,47,52,17,35,72,173,36,1,2018
ITA-Serie A,2017,Sampdoria,Matías Silvestre,ARG,DF,32,1984,34.0,12,8,10,1,1,6,12,50.0,6,33,26,7,11,23,154,3,2018
ITA-Serie A,2017,Sampdoria,Nicola Murru,ITA,DF,22,1994,16.1,40,31,18,18,4,24,38,63.2,14,29,4,25,17,57,60,1,2018
ITA-Serie A,2017,Sampdoria,Ognjen Stijepović,MNE,"FW,MF",17,1999,0.1,0,0,0,0,0,0,0,,0,0,0,0,0,0,0,0,2018
ITA-Serie A,2017,Sampdoria,Ricky Álvarez,ARG,MF,29,1988,3.0,4,2,1,3,0,1,4,25.0,3,5,0,5,2,6,3,0,2018
ITA-Serie A,2017,Sampdoria,Valerio Verre,ITA,MF,23,1994,4.0,7,3,3,2,2,2,7,28.6,5,12,0,12,8,15,7,0,2018
ITA-Serie A,2017,Sampdoria,Vasco Regini,ITA,DF,26,1990,12.0,13,7,11,0,2,6,11,54.5,5,14,7,7,11,24,68,0,2018
ITA-Serie A,2017,Sampdoria,Vid Belec,SVN,GK,27,1990,2.0,0,0,0,0,0,0,0,,0,0,0,0,0,0,1,0,2018
ITA-Serie A,2017,Sampdoria,Édgar Barreto,PAR,MF,33,1984,21.8,67,42,23,32,12,18,70,25.7,52,45,2,43,21,88,29,3,2018
ITA-Serie A,2017,Sassuolo,Alessandro Matri,ITA,FW,32,1984,10.2,2,1,1,1,0,0,3,0.0,3,1,0,1,0,2,5,0,2018
ITA-Serie A,2017,Sassuolo,Alfred Duncan,GHA,MF,24,1993,21.6,39,29,16,18,5,15,52,28.8,37,32,2,30,19,58,29,1,2018
ITA-Serie A,2017,Sassuolo,Andrea Consigli,ITA,GK,30,1987,36.8,0,0,0,0,0,0,2,0.0,2,0,0,0,0,0,27,6,2018
ITA-Serie A,2017,Sassuolo,Antonino Ragusa,ITA,"FW,MF",27,1990,9.2,17,7,11,4,2,8,23,34.8,15,12,1,11,6,23,16,0,2018
ITA-Serie A,2017,Sassuolo,Claud Adjapong,ITA,"DF,FW",19,1998,13.6,35,26,24,5,6,11,13,84.6,2,16,3,13,23,58,37,0,2018
ITA-Serie A,2017,Sassuolo,Cristian Dell'Orco,ITA,DF,23,1994,4.7,4,1,1,2,1,1,3,33.3,2,5,1,4,10,14,19,0,2018
ITA-Serie A,2017,Sassuolo,Davide Biondini,ITA,MF,34,1983,2.3,4,4,2,2,0,1,2,50.0,1,1,0,1,3,7,1,0,2018
ITA-Serie A,2017,Sassuolo,Diego Falcinelli,ITA,FW,26,1991,14.6,4,4,1,2,1,1,13,7.7,12,12,2,10,2,6,9,0,2018
ITA-Serie A,2017,Sassuolo,Domenico Berardi,ITA,FW,22,1994,25.5,31,17,9,16,6,11,65,16.9,54,23,0,23,17,48,14,1,2018
ITA-Serie A,2017,Sassuolo,Edoardo Goldaniga,ITA,DF,23,1993,12.8,14,8,10,4,0,5,9,55.6,4,10,5,5,19,33,56,0,2018
ITA-Serie A,2017,Sassuolo,Federico Peluso,ITA,DF,33,1984,28.8,46,34,29,13,4,14,26,53.8,12,39,13,26,40,86,132,1,2018
ITA-Serie A,2017,Sassuolo,Francesco Acerbi,ITA,DF,29,1988,38.0,51,32,26,22,3,22,36,61.1,14,42,21,21,88,139,255,1,2018
ITA-Serie A,2017,Sassuolo,Francesco Cassata,ITA,MF,20,1997,5.1,12,7,6,5,1,2,10,20.0,8,3,0,3,5,17,0,0,2018
ITA-Serie A,2017,Sassuolo,Francesco Magnanelli,ITA,MF,32,1984,27.7,56,38,30,20,6,20,65,30.8,45,26,7,19,58,114,78,2,2018
ITA-Serie A,2017,Sassuolo,Gianluca Pegolo,ITA,GK,36,1981,1.2,0,0,0,0,0,0,0,,0,0,0,0,0,0,0,0,2018
ITA-Serie A,2017,Sassuolo,Gianluca Scamacca,ITA,"FW,MF",18,1999,0.3,0,0,0,0,0,0,0,,0,1,0,1,0,0,0,0,2018
ITA-Serie A,2017,Sassuolo,Khouma Babacar,SEN,FW,24,1993,8.3,10,6,2,4,4,2,6,33.3,4,8,0,8,3,13,1,0,2018
ITA-Serie A,2017,Sassuolo,Luca Mazzitelli,ITA,MF,21,1995,11.3,37,24,14,15,8,10,36,27.8,26,21,2,19,21,58,19,0,2018
ITA-Serie A,2017,Sassuolo,Marcello Gazzola,ITA,DF,32,1985,8.2,10,9,3,6,1,8,12,66.7,4,10,2,8,8,18,25,0,2018
ITA-Serie A,2017,Sassuolo,Matteo Politano,ITA,FW,23,1993,31.2,23,16,8,10,5,3,32,9.4,29,13,2,11,14,37,13,0,2018
ITA-Serie A,2017,Sassuolo,Mauricio Lemos,URU,DF,21,1995,7.8,11,9,8,3,0,7,14,50.0,7,10,5,5,9,20,33,1,2018
ITA-Serie A,2017,Sassuolo,Nicholas Pierini,ITA,"MF,FW",18,1998,0.5,1,1,0,0,1,0,0,,0,1,0,1,1,2,0,0,2018
ITA-Serie A,2017,Sassuolo,Paolo Cannavaro,ITA,DF,36,1981,16.0,17,9,11,5,1,8,20,40.0,12,17,13,4,27,44,94,1,2018
ITA-Serie A,2017,Sassuolo,Pol Lirola,ESP,"DF,FW",19,1997,22.5,34,21,26,6,2,20,35,57.1,15,11,4,7,28,62,88,1,2018
ITA-Serie A,2017,Sassuolo,Rogério,BRA,DF,19,1998,10.1,18,14,10,5,3,7,15,46.7,8,11,1,10,9,27,31,0,2018
ITA-Serie A,2017,Sassuolo,Simone Missiroli,ITA,MF,31,1986,32.4,62,37,25,31,6,14,72,19.4,58,46,8,38,67,129,70,0,2018
ITA-Serie A,2017,Sassuolo,Stefano Sensi,ITA,MF,21,1995,11.6,17,13,11,6,0,9,22,40.9,13,16,3,13,22,39,10,1,2018
ITA-Serie A,2017,Sassuolo,Timo Letschert,NED,DF,24,1993,4.6,13,8,10,3,0,5,8,62.5,3,9,3,6,7,20,23,0,2018
ITA-Serie A,2017,Torino,Adem Ljajić,SRB,"MF,FW",25,1991,24.1,12,9,4,6,2,5,13,38.5,8,11,1,10,9,21,13,0,2018
ITA-Serie A,2017,Torino,Afriyie Acquah,GHA,MF,25,1992,10.6,8,6,2,6,0,1,7,14.3,6,8,1,7,16,24,10,2,2018
ITA-Serie A,2017,Torino,Alessandro Buongiorno,ITA,DF,18,1999,0.1,0,0,0,0,0,0,0,,0,0,0,0,0,0,1,0,2018
ITA-Serie A,2017,Torino,Andrea Belotti,ITA,FW,23,1993,29.8,32,23,9,15,8,3,30,10.0,27,14,1,13,6,38,19,1,2018
ITA-Serie A,2017,Torino,Antonio Barreca,ITA,DF,22,1995,5.2,9,8,3,5,1,4,4,100.0,0,3,0,3,5,14,16,0,2018
ITA-Serie A,2017,Torino,Cristian Ansaldi,ARG,DF,30,1986,20.8,49,33,25,20,4,14,37,37.8,23,23,5,18,20,69,61,0,2018
ITA-Serie A,2017,Torino,Cristian Molinaro,ITA,DF,34,1983,17.4,37,29,19,14,4,11,18,61.1,7,15,4,11,22,59,70,1,2018
ITA-Serie A,2017,Torino,Daniele Baselli,ITA,MF,25,1992,28.0,63,33,23,36,4,20,56,35.7,36,29,5,24,57,120,40,1,2018
ITA-Serie A,2017,Torino,Davide Zappacosta,ITA,"DF,FW",25,1992,1.1,1,0,1,0,0,0,0,,0,0,0,0,2,3,1,0,2018
ITA-Serie A,2017,Torino,Emiliano Moretti,ITA,DF,36,1981,19.8,31,18,25,6,0,14,16,87.5,2,30,23,7,21,52,77,2,2018
ITA-Serie A,2017,Torino,Iago Falque,ESP,"FW,MF",27,1990,31.3,41,31,15,20,6,6,43,14.0,37,22,0,22,15,56,15,0,2018
ITA-Serie A,2017,Torino,Joel Obi,NGA,MF,26,1991,13.9,45,25,20,20,5,8,26,30.8,18,17,3,14,24,69,15,0,2018
ITA-Serie A,2017,Torino,Kevin Bonifazi,ITA,"DF,MF",21,1996,4.5,11,7,6,5,0,4,6,66.7,2,7,5,2,13,24,15,0,2018
ITA-Serie A,2017,Torino,Lorenzo De Silvestri,ITA,DF,29,1988,32.8,39,25,19,13,7,16,26,61.5,10,47,10,37,27,66,165,0,2018
ITA-Serie A,2017,Torino,Lucas Boyé,ARG,FW,21,1996,1.7,9,8,5,3,1,1,3,33.3,2,5,0,5,2,11,2,0,2018
ITA-Serie A,2017,Torino,Lyanco,BRA,DF,20,1997,3.5,11,8,8,3,0,5,8,62.5,3,4,3,1,5,16,17,0,2018
ITA-Serie A,2017,Torino,M'Baye Niang,SEN,FW,22,1994,17.0,29,23,11,9,9,6,18,33.3,12,17,3,14,13,42,15,0,2018
ITA-Serie A,2017,Torino,Mirko Valdifiori,ITA,MF,31,1986,6.9,13,9,5,7,1,2,11,18.2,9,3,1,2,6,19,9,0,2018
ITA-Serie A,2017,Torino,Nicolas Nkoulou,CMR,DF,27,1990,36.2,56,40,40,15,1,22,33,66.7,11,44,22,22,57,113,163,1,2018
ITA-Serie A,2017,Torino,Nicolás Burdisso,ARG,DF,36,1981,23.0,20,11,13,7,0,7,11,63.6,4,23,14,9,30,50,124,3,2018
ITA-Serie A,2017,Torino,Salvatore Sirigu,ITA,GK,30,1987,37.0,0,0,0,0,0,0,0,,0,0,0,0,1,1,35,3,2018
ITA-Serie A,2017,Torino,Samuel Gustafson,SWE,"MF,FW",22,1995,0.9,3,2,3,0,0,1,3,33.3,2,2,0,2,0,3,0,0,2018
ITA-Serie A,2017,Torino,Simone Edera,ITA,"FW,MF",20,1997,3.6,6,2,2,4,0,3,10,30.0,7,0,0,0,2,8,1,0,2018
ITA-Serie A,2017,Torino,Tomás Rincón,VEN,MF,29,1988,33.3,66,40,30,34,2,24,66,36.4,42,33,8,25,57,123,61,1,2018
ITA-Serie A,2017,Torino,Umar Sadiq,NGA,FW,20,1997,2.5,0,0,0,0,0,0,3,0.0,3,1,0,1,1,1,2,0,2018
ITA-Serie A,2017,Torino,Vanja Milinković-Savić,SRB,GK,20,1997,1.0,0,0,0,0,0,0,0,,0,0,0,0,0,0,0,0,2018
ITA-Serie A,2017,Torino,Álex Berenguer,ESP,FW,22,1995,11.6,18,15,7,8,3,5,17,29.4,12,22,3,19,10,28,13,0,2018
ITA-Serie A,2017,Udinese,Albano Bizzarri,ARG,GK,39,1977,32.0,2,2,2,0,0,2,2,100.0,0,0,0,0,1,3,12,4,2018
ITA-Serie A,2017,Udinese,Ali Adnan Kadhim,IRQ,"DF,FW",23,1993,18.6,54,35,35,14,5,29,50,58.0,21,31,6,25,41,95,90,0,2018
ITA-Serie A,2017,Udinese,Andrija Balić,CRO,MF,19,1997,12.0,18,9,5,12,1,8,27,29.6,19,6,3,3,16,34,13,0,2018
ITA-Serie A,2017,Udinese,Antonín Barák,CZE,MF,22,1994,30.1,58,38,22,27,9,21,58,36.2,37,34,2,32,18,76,26,1,2018
ITA-Serie A,2017,Udinese,Bram Nuytinck,NED,DF,27,1990,26.2,65,41,40,24,1,25,39,64.1,14,43,24,19,37,102,124,1,2018
ITA-Serie A,2017,Udinese,Cyril Théréau,FRA,"FW,MF",34,1983,2.0,1,1,1,0,0,1,2,50.0,1,0,0,0,0,1,2,0,2018
ITA-Serie A,2017,Udinese,Danilo Larangeira,BRA,DF,33,1984,30.8,35,21,26,8,1,16,29,55.2,13,50,38,12,50,85,161,2,2018
ITA-Serie A,2017,Udinese,Emil Hallfreðsson,ISL,MF,33,1984,8.5,19,14,9,7,3,7,24,29.2,17,13,2,11,20,39,16,0,2018
ITA-Serie A,2017,Udinese,Francesco Zampano,ITA,DF,23,1993,4.6,9,7,5,3,1,5,10,50.0,5,4,0,4,6,15,7,0,2018
ITA-Serie A,2017,Udinese,Gabriele Angella,ITA,DF,28,1989,9.9,15,13,11,3,1,8,11,72.7,3,11,9,2,21,36,66,0,2018
ITA-Serie A,2017,Udinese,Giuseppe Pezzella,ITA,"DF,FW",19,1997,10.0,19,11,10,4,5,7,19,36.8,12,8,1,7,6,25,32,0,2018
ITA-Serie A,2017,Udinese,Jakub Jankto,CZE,"MF,FW",21,1996,29.5,29,18,9,14,6,10,46,21.7,36,46,8,38,20,49,27,0,2018
ITA-Serie A,2017,Udinese,Jens Stryger Larsen,DEN,DF,26,1991,28.1,36,27,25,10,1,21,39,53.8,18,35,14,21,31,67,82,2,2018
ITA-Serie A,2017,Udinese,Kevin Lasagna,ITA,FW,24,1992,23.7,10,7,0,8,2,2,7,28.6,5,27,4,23,8,18,18,0,2018
ITA-Serie A,2017,Udinese,Maxi López,ARG,FW,33,1984,18.7,12,8,2,7,3,0,4,0.0,4,8,2,6,2,14,18,0,2018
ITA-Serie A,2017,Udinese,Molla Wagué,MLI,DF,26,1991,0.6,1,0,0,1,0,0,0,,0,0,0,0,2,3,5,0,2018
ITA-Serie A,2017,Udinese,Riad Bajić,BIH,"FW,MF",23,1994,0.9,0,0,0,0,0,0,0,,0,0,0,0,0,0,3,0,2018
ITA-Serie A,2017,Udinese,Rodrigo De Paul,ARG,"FW,MF",23,1994,25.8,31,18,10,17,4,4,32,12.5,28,34,1,33,16,47,8,0,2018
ITA-Serie A,2017,Udinese,Ryder Matos,BRA,MF,24,1993,1.9,3,1,1,1,1,1,1,100.0,0,2,0,2,2,5,3,0,2018
ITA-Serie A,2017,Udinese,Samir Santos,BRA,DF,22,1994,28.5,55,38,35,17,3,19,38,50.0,19,33,16,17,75,130,161,1,2018
ITA-Serie A,2017,Udinese,Seko Fofana,CIV,MF,22,1995,20.8,20,17,8,12,0,4,20,20.0,16,17,3,14,27,47,26,1,2018
ITA-Serie A,2017,Udinese,Silvan Widmer,SUI,"DF,FW",24,1993,18.1,45,32,30,15,0,22,40,55.0,18,22,5,17,28,73,59,0,2018
ITA-Serie A,2017,Udinese,Simone Pontisso,ITA,MF,20,1997,0.1,1,0,0,1,0,0,0,,0,0,0,0,0,1,0,0,2018
ITA-Serie A,2017,Udinese,Simone Scuffet,ITA,GK,21,1996,6.0,0,0,0,0,0,0,0,,0,0,0,0,1,1,1,1,2018
ITA-Serie A,2017,Udinese,Stipe Perica,CRO,FW,22,1995,10.5,8,5,2,5,1,2,13,15.4,11,7,1,6,3,11,9,0,2018
ITA-Serie A,2017,Udinese,Svante Ingelsson,SWE,MF,19,1998,3.6,9,6,3,3,3,2,10,20.0,8,4,0,4,6,15,4,0,2018
ITA-Serie A,2017,Udinese,Valon Behrami,SUI,MF,32,1985,15.5,63,46,30,27,6,8,44,18.2,36,47,15,32,22,85,19,0,2018
ITA-Serie A,2018,Atalanta,Ali Adnan Kadhim,IRQ,DF,24,1993,1.8,1,1,1,0,0,1,2,50.0,1,1,1,0,3,4,6,0,2019
ITA-Serie A,2018,Atalanta,Andrea Masiello,ITA,DF,32,1986,20.4,28,14,13,15,0,17,29,58.6,12,21,6,15,44,72,49,0,2019
ITA-Serie A,2018,Atalanta,Arkadiusz Reca,POL,DF,23,1995,0.5,2,0,1,0,1,0,1,0.0,1,0,0,0,3,5,0,0,2019
ITA-Serie A,2018,Atalanta,Berat Djimsiti,ALB,DF,25,1993,20.1,32,22,18,12,2,13,29,44.8,16,21,11,10,34,66,96,0,2019
ITA-Serie A,2018,Atalanta,Dejan Kulusevski,SWE,MF,18,2000,1.2,3,3,0,2,1,1,3,33.3,2,1,0,1,0,3,0,0,2019
ITA-Serie A,2018,Atalanta,Duván Zapata,COL,FW,27,1991,32.2,9,5,3,2,4,1,9,11.1,8,26,6,20,4,13,25,0,2019
ITA-Serie A,2018,Atalanta,Emiliano Rigoni,ARG,"FW,MF",25,1993,5.8,6,1,2,2,2,2,6,33.3,4,3,0,3,3,9,3,0,2019
ITA-Serie A,2018,Atalanta,Etrit Berisha,ALB,GK,29,1989,18.0,0,0,0,0,0,0,2,0.0,2,0,0,0,0,0,5,3,2019
ITA-Serie A,2018,Atalanta,Francesco Rossi,ITA,GK,27,1991,0.0,0,0,0,0,0,0,0,,0,0,0,0,0,0,0,0,2019
ITA-Serie A,2018,Atalanta,Gianluca Mancini,ITA,DF,22,1996,25.0,40,30,22,17,1,16,29,55.2,13,19,4,15,48,88,77,1,2019
ITA-Serie A,2018,Atalanta,Hans Hateboer,NED,DF,24,1994,33.0,43,31,19,19,5,17,34,50.0,17,29,5,24,23,66,47,1,2019
ITA-Serie A,2018,Atalanta,Josip Iličić,SVN,"FW,MF",30,1988,23.8,15,7,2,7,6,5,20,25.0,15,20,1,19,5,20,2,0,2019
ITA-Serie A,2018,Atalanta,José Luis Palomino,ARG,DF,28,1990,25.1,49,31,31,15,3,23,38,60.5,15,34,17,17,68,117,79,0,2019
ITA-Serie A,2018,Atalanta,Luca Valzania,ITA,MF,22,1996,0.8,5,4,2,3,0,3,5,60.0,2,0,0,0,1,6,0,0,2019
ITA-Serie A,2018,Atalanta,Marco Tumminello,ITA,"FW,DF",19,1998,0.1,0,0,0,0,0,0,0,,0,0,0,0,0,0,0,0,2019
ITA-Serie A,2018,Atalanta,Mario Pašalić,CRO,MF,23,1995,18.0,32,19,9,13,10,7,29,24.1,22,19,4,15,12,44,14,1,2019
ITA-Serie A,2018,Atalanta,Marten de Roon,NED,MF,27,1991,33.1,102,57,32,61,9,34,94,36.2,60,48,9,39,53,155,49,1,2019
ITA-Serie A,2018,Atalanta,Matteo Pessina,ITA,"MF,FW",21,1997,2.6,4,2,0,4,0,2,3,66.7,1,2,1,1,0,4,4,0,2019
ITA-Serie A,2018,Atalanta,Musa Barrow,GAM,FW,19,1998,6.7,9,5,5,3,1,4,6,66.7,2,4,0,4,0,9,2,0,2019
ITA-Serie A,2018,Atalanta,Papu Gómez,ARG,"MF,FW",30,1988,32.2,19,14,5,10,4,6,30,20.0,24,21,0,21,16,35,4,0,2019
ITA-Serie A,2018,Atalanta,Pierluigi Gollini,ITA,GK,23,1995,20.0,2,2,2,0,0,1,2,50.0,1,0,0,0,0,2,3,2,2019
ITA-Serie A,2018,Atalanta,Rafael Tolói,ITA,DF,27,1990,19.4,27,17,15,9,3,16,24,66.7,8,28,10,18,33,60,54,1,2019
ITA-Serie A,2018,Atalanta,Remo Freuler,SUI,MF,26,1992,33.6,84,45,34,34,16,30,70,42.9,40,62,12,50,38,122,45,0,2019
ITA-Serie A,2018,Atalanta,Roberto Piccoli,ITA,"FW,MF",17,2001,0.5,2,2,0,1,1,1,1,100.0,0,1,0,1,0,2,0,0,2019
ITA-Serie A,2018,Atalanta,Robin Gosens,GER,"DF,MF",24,1994,21.6,63,46,32,26,5,37,54,68.5,17,41,3,38,38,101,60,0,2019
ITA-Serie A,2018,Atalanta,Roger Ibanez,BRA,"DF,FW",19,1998,0.0,0,0,0,0,0,0,0,,0,0,0,0,0,0,1,0,2019
ITA-Serie A,2018,Atalanta,Timothy Castagne,BEL,DF,22,1995,22.3,61,39,30,22,9,32,57,56.1,25,32,6,26,28,89,50,0,2019
ITA-Serie A,2018,Bologna,Andrea Poli,ITA,MF,28,1989,21.5,65,47,30,28,7,24,67,35.8,43,36,5,31,35,100,13,2,2019
ITA-Serie A,2018,Bologna,Arturo Calabresi,ITA,DF,22,1996,15.7,46,27,22,17,7,22,40,55.0,18,18,3,15,34,80,60,0,2019
ITA-Serie A,2018,Bologna,Blerim Džemaili,SUI,MF,32,1986,19.4,44,27,22,19,3,19,58,32.8,39,22,1,21,17,61,12,1,2019
ITA-Serie A,2018,Bologna,Danilo Larangeira,BRA,DF,34,1984,34.2,40,26,29,11,0,20,30,66.7,10,52,39,13,37,77,182,3,2019
ITA-Serie A,2018,Bologna,Diego Falcinelli,ITA,FW,27,1991,7.8,8,5,1,3,4,2,3,66.7,1,4,1,3,1,9,5,0,2019
ITA-Serie A,2018,Bologna,Erick Pulgar,CHI,MF,24,1994,26.2,65,36,35,23,7,22,73,30.1,51,35,5,30,50,115,54,1,2019
ITA-Serie A,2018,Bologna,Federico Mattiello,ITA,"DF,FW",23,1995,14.8,33,20,19,9,5,15,23,65.2,8,9,3,6,20,53,43,0,2019
ITA-Serie A,2018,Bologna,Federico Santander,PAR,FW,27,1991,22.9,18,10,6,8,4,2,23,8.7,21,20,2,18,9,27,30,0,2019
ITA-Serie A,2018,Bologna,Filip Helander,SWE,DF,25,1993,19.0,42,26,25,13,4,19,23,82.6,4,27,16,11,14,56,84,0,2019
ITA-Serie A,2018,Bologna,Gabriele Corbo,ITA,DF,18,2000,0.1,0,0,0,0,0,0,0,,0,0,0,0,0,0,0,0,2019
ITA-Serie A,2018,Bologna,Giancarlo González,CRC,DF,30,1988,8.3,13,7,12,1,0,5,9,55.6,4,15,11,4,12,25,42,0,2019
ITA-Serie A,2018,Bologna,Godfred Donsah,GHA,MF,22,1996,1.7,3,1,3,0,0,3,5,60.0,2,4,2,2,0,3,7,0,2019
ITA-Serie A,2018,Bologna,Ibrahima Mbaye,SEN,DF,23,1994,22.3,48,32,30,16,2,19,32,59.4,13,21,12,9,19,67,66,1,2019
ITA-Serie A,2018,Bologna,Juan Manuel Valencia,COL,FW,20,1998,0.3,0,0,0,0,0,0,0,,0,0,0,0,1,1,0,0,2019
ITA-Serie A,2018,Bologna,Ladislav Krejčí,CZE,"DF,MF",26,1992,11.8,16,12,6,9,1,7,12,58.3,5,8,2,6,6,22,18,0,2019
ITA-Serie A,2018,Bologna,Lyanco,BRA,DF,21,1997,12.4,29,18,19,10,0,13,18,72.2,5,24,16,8,22,51,64,0,2019
ITA-Serie A,2018,Bologna,Mattia Destro,ITA,FW,27,1991,5.5,3,2,2,0,1,0,0,,0,4,0,4,0,3,6,0,2019
ITA-Serie A,2018,Bologna,Mattias Svanberg,SWE,MF,19,1999,13.1,22,11,14,7,1,11,25,44.0,14,25,6,19,11,33,16,2,2019
ITA-Serie A,2018,Bologna,Mitchell Dijks,NED,DF,25,1993,22.5,30,18,19,7,4,13,36,36.1,23,18,1,17,23,53,49,0,2019
ITA-Serie A,2018,Bologna,Nehuén Paz,ARG,DF,25,1993,1.3,2,1,2,0,0,1,2,50.0,1,3,1,2,0,2,2,0,2019
ITA-Serie A,2018,Bologna,Nicola Sansone,ITA,FW,26,1991,12.7,29,17,9,14,6,9,27,33.3,18,13,1,12,9,38,4,0,2019
ITA-Serie A,2018,Bologna,Orji Okwonkwo,NGA,FW,20,1998,2.9,4,3,1,2,1,2,2,100.0,0,0,0,0,1,5,0,0,2019
ITA-Serie A,2018,Bologna,Riccardo Orsolini,ITA,"FW,MF",21,1997,21.8,40,24,16,18,6,9,39,23.1,30,23,2,21,14,54,25,1,2019
ITA-Serie A,2018,Bologna,Roberto Soriano,ITA,MF,27,1991,16.5,27,18,14,10,3,8,24,33.3,16,21,2,19,3,30,11,0,2019
ITA-Serie A,2018,Bologna,Rodrigo Palacio,ARG,FW,36,1982,25.9,24,13,8,12,4,4,34,11.8,30,35,0,35,5,29,13,0,2019
ITA-Serie A,2018,Bologna,Sebastien De Maio,FRA,DF,31,1987,5.5,5,4,3,2,0,1,2,50.0,1,8,5,3,1,6,32,0,2019
ITA-Serie A,2018,Bologna,Simone Edera,ITA,FW,21,1997,2.2,4,4,3,0,1,1,3,33.3,2,5,1,4,0,4,1,0,2019
ITA-Serie A,2018,Bologna,Ádám Nagy,HUN,MF,23,1995,10.8,29,21,15,13,1,11,21,52.4,10,13,5,8,25,54,12,2,2019
ITA-Serie A,2018,Bologna,Łukasz Skorupski,POL,GK,27,1991,38.0,0,0,0,0,0,0,0,,0,0,0,0,3,3,12,4,2019
ITA-Serie A,2018,Cagliari,Alberto Cerri,ITA,FW,22,1996,7.4,3,2,2,1,0,0,7,0.0,7,7,1,6,2,5,4,0,2019
ITA-Serie A,2018,Cagliari,Alessandro Deiola,ITA,MF,22,1995,5.0,7,3,1,6,0,3,13,23.1,10,14,0,14,6,13,8,0,2019
ITA-Serie A,2018,Cagliari,Alessio Cragno,ITA,GK,24,1994,38.0,0,0,0,0,0,0,1,0.0,1,0,0,0,2,2,19,1,2019
ITA-Serie A,2018,Cagliari,Artur Ioniță,MDA,MF,27,1990,33.0,67,38,23,31,13,16,57,28.1,41,40,5,35,27,94,30,0,2019
ITA-Serie A,2018,Cagliari,Charalambos Lykogiannis,GRE,DF,24,1993,9.2,14,8,8,3,3,6,11,54.5,5,18,3,15,19,33,33,0,2019
ITA-Serie A,2018,Cagliari,Cyril Théréau,FRA,FW,35,1983,1.5,1,1,0,1,0,1,1,100.0,0,0,0,0,0,1,2,0,2019
ITA-Serie A,2018,Cagliari,Daniele Dessena,ITA,MF,31,1987,3.9,2,2,0,2,0,1,3,33.3,2,3,1,2,3,5,5,0,2019
ITA-Serie A,2018,Cagliari,Darijo Srna,CRO,DF,36,1982,23.2,24,16,6,13,5,9,14,64.3,5,24,5,19,18,42,66,0,2019
ITA-Serie A,2018,Cagliari,Diego Farias,BRA,FW,28,1990,7.8,13,9,3,7,3,2,11,18.2,9,7,1,6,1,14,5,0,2019
ITA-Serie A,2018,Cagliari,Fabio Pisacane,ITA,DF,32,1986,25.2,33,17,22,8,3,18,31,58.1,13,36,23,13,23,56,108,0,2019
ITA-Serie A,2018,Cagliari,Fabrizio Cacciatore,ITA,DF,31,1986,6.4,9,7,7,0,2,1,5,20.0,4,6,4,2,7,16,17,0,2019
ITA-Serie A,2018,Cagliari,Filip Bradarić,CRO,MF,26,1992,16.6,26,21,11,12,3,10,20,50.0,10,13,3,10,39,65,50,0,2019
ITA-Serie A,2018,Cagliari,Filippo Romagna,ITA,DF,21,1997,16.4,14,9,10,4,0,4,8,50.0,4,20,12,8,19,33,68,0,2019
ITA-Serie A,2018,Cagliari,Francesco Verde,ITA,FW,19,1999,0.1,1,0,0,1,0,0,0,,0,0,0,0,0,1,0,0,2019
ITA-Serie A,2018,Cagliari,João Pedro,ITA,"FW,MF",26,1992,28.4,17,12,4,8,5,4,11,36.4,7,14,5,9,6,23,14,0,2019
ITA-Serie A,2018,Cagliari,Kiril Despodov,BUL,"FW,MF",21,1996,1.2,0,0,0,0,0,0,1,0.0,1,1,0,1,0,0,0,0,2019
ITA-Serie A,2018,Cagliari,Leonardo Pavoletti,ITA,FW,29,1988,30.4,32,21,6,17,9,6,16,37.5,10,12,3,9,7,39,26,0,2019
ITA-Serie A,2018,Cagliari,Luca Ceppitelli,ITA,DF,28,1989,22.8,40,24,28,11,1,13,22,59.1,9,34,24,10,20,60,111,2,2019
ITA-Serie A,2018,Cagliari,Luca Cigarini,ITA,MF,32,1986,18.7,54,33,27,22,5,28,63,44.4,35,28,5,23,26,80,41,0,2019
ITA-Serie A,2018,Cagliari,Luca Pellegrini,ITA,DF,19,1999,10.4,28,19,16,11,1,14,25,56.0,11,13,3,10,18,46,22,0,2019
ITA-Serie A,2018,Cagliari,Lucas Castro,ARG,MF,29,1989,10.0,18,11,8,8,2,8,23,34.8,15,20,4,16,17,35,6,0,2019
ITA-Serie A,2018,Cagliari,Marco Andreolli,ITA,DF,32,1986,1.2,1,1,1,0,0,1,1,100.0,0,2,1,1,1,2,5,0,2019
ITA-Serie A,2018,Cagliari,Marco Sau,ITA,"FW,MF",30,1987,6.2,4,2,0,2,2,0,3,0.0,3,5,0,5,1,5,4,0,2019
ITA-Serie A,2018,Cagliari,Marko Pajač,CRO,DF,25,1993,1.1,1,1,0,0,1,0,0,,0,1,1,0,1,2,3,0,2019
ITA-Serie A,2018,Cagliari,Nicolò Barella,ITA,MF,21,1997,34.5,99,65,38,41,20,30,82,36.6,52,61,2,59,38,137,27,0,2019
ITA-Serie A,2018,Cagliari,Paolo Faragò,ITA,"MF,DF",25,1993,18.9,46,29,20,16,10,13,43,30.2,30,28,2,26,15,61,38,0,2019
ITA-Serie A,2018,Cagliari,Ragnar Klavan,EST,DF,32,1985,13.7,9,8,5,3,1,5,11,45.5,6,19,13,6,10,19,68,1,2019
ITA-Serie A,2018,Cagliari,Riccardo Doratiotto,ITA,FW,19,1999,0.9,1,1,0,0,1,0,0,,0,0,0,0,0,1,0,0,2019
ITA-Serie A,2018,Cagliari,Simone Padoin,ITA,"DF,MF",34,1984,21.3,34,25,12,18,4,14,33,42.4,19,18,5,13,14,48,54,0,2019
ITA-Serie A,2018,Cagliari,Valter Birsa,SVN,"MF,FW",31,1986,3.9,5,3,1,3,1,4,8,50.0,4,5,0,5,4,9,3,0,2019
ITA-Serie A,2018,Chievo,Adrian Šemper,CRO,GK,20,1998,6.0,0,0,0,0,0,0,0,,0,0,0,0,1,1,3,0,2019
ITA-Serie A,2018,Chievo,Andrea Seculin,ITA,GK,28,1990,1.0,0,0,0,0,0,0,0,,0,0,0,0,0,0,1,0,2019
ITA-Serie A,2018,Chievo,Angelo Ndrecka,ALB,DF,16,2001,1.0,1,1,1,0,0,1,2,50.0,1,3,2,1,0,1,1,0,2019
ITA-Serie A,2018,Chievo,Assane Dioussé,SEN,MF,20,1997,9.9,24,16,11,8,5,10,23,43.5,13,14,4,10,19,43,13,2,2019
ITA-Serie A,2018,Chievo,Boštjan Cesar,SVN,DF,36,1982,12.0,16,10,9,7,0,7,17,41.2,10,14,8,6,14,30,60,2,2019
ITA-Serie A,2018,Chievo,Emanuel Vignato,ITA,"MF,FW",17,2000,7.3,8,4,4,3,1,0,6,0.0,6,4,0,4,10,18,0,0,2019
ITA-Serie A,2018,Chievo,Emanuele Giaccherini,ITA,"MF,FW",33,1985,22.3,14,8,5,7,2,6,31,19.4,25,21,2,19,16,30,10,2,2019
ITA-Serie A,2018,Chievo,Ezequiel Schelotto,ITA,DF,29,1989,1.6,3,0,3,0,0,2,3,66.7,1,1,0,1,2,5,8,0,2019
ITA-Serie A,2018,Chievo,Fabio Depaoli,ITA,DF,21,1997,27.4,74,43,37,32,5,34,67,50.7,33,42,16,26,35,109,99,3,2019
ITA-Serie A,2018,Chievo,Fabrizio Cacciatore,ITA,DF,31,1986,5.5,8,4,6,2,0,4,9,44.4,5,8,2,6,5,13,20,0,2019
ITA-Serie A,2018,Chievo,Federico Barba,ITA,DF,24,1993,27.6,30,14,21,9,0,8,21,38.1,13,29,15,14,65,95,129,0,2019
ITA-Serie A,2018,Chievo,Filip Đorđević,SRB,FW,30,1987,7.0,11,6,3,6,2,3,12,25.0,9,7,1,6,2,13,8,1,2019
ITA-Serie A,2018,Chievo,Ibrahim Karamoko,FRA,MF,17,2001,0.7,0,0,0,0,0,0,0,,0,1,0,1,0,0,1,0,2019
ITA-Serie A,2018,Chievo,Ivan Radovanović,SRB,MF,29,1988,19.0,27,22,20,7,0,11,31,35.5,20,19,7,12,26,53,36,0,2019
ITA-Serie A,2018,Chievo,Joel Obi,NGA,MF,27,1991,7.3,22,15,9,11,2,7,17,41.2,10,12,1,11,14,36,15,0,2019
ITA-Serie A,2018,Chievo,Luca Rossettini,ITA,DF,33,1985,20.3,26,17,18,8,0,15,20,75.0,5,23,15,8,35,61,114,0,2019
ITA-Serie A,2018,Chievo,Lucas Piazon,BRA,"MF,FW",24,1994,0.9,2,0,1,1,0,0,2,0.0,2,1,0,1,1,3,0,0,2019
ITA-Serie A,2018,Chievo,Manuel Pucciarelli,ITA,FW,27,1991,3.4,4,2,2,1,1,2,5,40.0,3,5,0,5,3,7,4,0,2019
ITA-Serie A,2018,Chievo,Marco Andreolli,ITA,DF,32,1986,7.2,10,6,7,2,1,6,10,60.0,4,4,2,2,6,16,33,0,2019
ITA-Serie A,2018,Chievo,Mariusz Stępiński,POL,FW,23,1995,27.5,18,13,1,11,6,1,17,5.9,16,10,2,8,5,23,20,0,2019
ITA-Serie A,2018,Chievo,Mattia Bani,ITA,DF,24,1993,29.0,67,40,46,21,0,27,40,67.5,13,51,35,16,57,124,162,2,2019
ITA-Serie A,2018,Chievo,Mauro Antonio Burruchaga,ARG,MF,20,1998,0.6,2,2,1,1,0,0,2,0.0,2,2,1,1,0,2,3,0,2019
ITA-Serie A,2018,Chievo,Mehdi Léris,ALG,"MF,DF",20,1998,17.9,53,33,19,24,10,24,54,44.4,30,34,1,33,28,81,24,1,2019
ITA-Serie A,2018,Chievo,Musa Juwara,GAM,FW,16,2001,0.1,0,0,0,0,0,0,0,,0,0,0,0,1,1,0,0,2019
ITA-Serie A,2018,Chievo,Nenad Tomović,SRB,DF,30,1987,8.2,9,7,5,4,0,7,10,70.0,3,5,1,4,13,22,34,0,2019
ITA-Serie A,2018,Chievo,Nicola Rigoni,ITA,MF,27,1990,21.7,43,25,22,15,6,22,51,43.1,29,20,5,15,23,66,45,1,2019
ITA-Serie A,2018,Chievo,Nicolas Frey,FRA,DF,34,1984,2.5,3,1,2,1,0,0,3,0.0,3,3,3,0,7,10,18,0,2019
ITA-Serie A,2018,Chievo,Paweł Jaroszyński,POL,DF,23,1994,15.0,29,18,17,8,4,16,32,50.0,16,15,4,11,24,53,41,1,2019
ITA-Serie A,2018,Chievo,Përparim Hetemaj,FIN,MF,31,1986,24.0,53,27,27,23,3,20,68,29.4,48,25,1,24,30,83,24,2,2019
ITA-Serie A,2018,Chievo,Riccardo Meggiorini,ITA,FW,32,1985,17.2,17,13,5,9,3,1,10,10.0,9,20,2,18,8,25,26,0,2019
ITA-Serie A,2018,Chievo,Sergej Grubac,MNE,FW,18,2000,1.7,2,1,1,0,1,1,1,100.0,0,1,0,1,0,2,1,0,2019
ITA-Serie A,2018,Chievo,Sergio Pellissier,ITA,FW,39,1979,10.6,4,3,1,1,2,3,4,75.0,1,8,1,7,2,6,8,0,2019
ITA-Serie A,2018,Chievo,Sofian Kiyine,MAR,"MF,DF",20,1997,9.1,28,13,11,14,3,9,18,50.0,9,10,0,10,10,38,4,0,2019
ITA-Serie A,2018,Chievo,Stefano Sorrentino,ITA,GK,39,1979,31.0,1,1,1,0,0,1,2,50.0,1,0,0,0,3,4,10,1,2019
ITA-Serie A,2018,Chievo,Strahinja Tanasijević,SRB,"DF,MF",21,1997,0.2,0,0,0,0,0,0,0,,0,0,0,0,0,0,0,0,2019
ITA-Serie A,2018,Chievo,Valter Birsa,SVN,"MF,FW",31,1986,12.2,14,9,4,7,3,4,17,23.5,13,9,1,8,6,20,13,0,2019
ITA-Serie A,2018,Empoli,Afriyie Acquah,GHA,MF,26,1992,16.8,27,9,9,12,6,4,11,36.4,7,11,1,10,12,39,16,0,2019
ITA-Serie A,2018,Empoli,Alejandro Rodríguez,ESP,MF,27,1991,0.3,0,0,0,0,0,0,0,,0,0,0,0,0,0,1,0,2019
ITA-Serie A,2018,Empoli,Antonino La Gumina,ITA,"FW,MF",22,1996,12.1,5,4,1,2,2,2,6,33.3,4,8,2,6,6,11,5,0,2019
ITA-Serie A,2018,Empoli,Bartłomiej Drągowski,POL,GK,20,1997,14.0,0,0,0,0,0,0,1,0.0,1,0,0,0,0,0,7,1,2019
ITA-Serie A,2018,Empoli,Cristian Dell'Orco,ITA,DF,24,1994,11.5,18,11,11,5,2,4,11,36.4,7,13,7,6,17,35,44,0,2019
ITA-Serie A,2018,Empoli,Diego Farias,BRA,FW,28,1990,13.3,11,4,2,8,1,3,10,30.0,7,7,1,6,0,11,4,0,2019
ITA-Serie A,2018,Empoli,Dimitri Oberlin,SUI,FW,20,1997,1.5,1,1,0,0,1,0,3,0.0,3,1,0,1,0,1,1,0,2019
ITA-Serie A,2018,Empoli,Dimitris Nikolaou,GRE,DF,19,1998,3.9,5,3,3,2,0,1,2,50.0,1,2,2,0,2,7,14,0,2019
ITA-Serie A,2018,Empoli,Domenico Maietta,ITA,DF,35,1982,19.0,33,15,22,10,1,16,36,44.4,20,19,14,5,24,57,78,2,2019
ITA-Serie A,2018,Empoli,Francesco Caputo,ITA,FW,30,1987,38.0,13,9,2,4,7,3,10,30.0,7,11,1,10,2,15,11,0,2019
ITA-Serie A,2018,Empoli,Freddie Veseli,ALB,DF,25,1992,28.2,34,21,16,15,3,19,27,70.4,8,28,17,11,30,64,99,1,2019
ITA-Serie A,2018,Empoli,Giovanni Di Lorenzo,ITA,"DF,FW",24,1993,37.0,66,43,38,23,5,24,44,54.5,20,34,13,21,36,102,93,3,2019
ITA-Serie A,2018,Empoli,Hamed Junior Traorè,CIV,MF,18,2000,25.1,67,38,26,32,9,27,72,37.5,45,29,4,25,30,97,17,0,2019
ITA-Serie A,2018,Empoli,Ismaël Bennacer,ALG,MF,20,1997,32.9,94,57,43,41,10,32,75,42.7,43,38,9,29,57,151,34,0,2019
ITA-Serie A,2018,Empoli,Ivan Provedel,ITA,GK,24,1994,16.0,0,0,0,0,0,0,1,0.0,1,0,0,0,0,0,4,0,2019
ITA-Serie A,2018,Empoli,Jacob Rasmussen,DEN,"DF,MF",21,1997,11.3,18,12,10,6,2,5,14,35.7,9,18,13,5,12,30,55,1,2019
ITA-Serie A,2018,Empoli,Joel Untersee,SUI,DF,24,1994,1.4,3,2,1,2,0,2,3,66.7,1,2,1,1,1,4,5,1,2019
ITA-Serie A,2018,Empoli,Leonardo Capezzi,ITA,MF,23,1995,8.6,14,9,6,8,0,7,13,53.8,6,14,4,10,10,24,13,0,2019
ITA-Serie A,2018,Empoli,Levan Mchedlidze,GEO,FW,28,1990,2.3,1,1,0,0,1,0,1,0.0,1,2,0,2,0,1,5,0,2019
ITA-Serie A,2018,Empoli,Luca Antonelli,ITA,DF,31,1987,8.4,13,11,4,5,4,7,17,41.2,10,19,4,15,16,29,25,1,2019
ITA-Serie A,2018,Empoli,Manuel Pasqual,ITA,DF,36,1982,14.9,26,19,12,11,3,17,45,37.8,28,7,0,7,11,37,31,0,2019
ITA-Serie A,2018,Empoli,Marko Pajač,CRO,"FW,DF",25,1993,8.2,7,7,2,3,2,5,11,45.5,6,3,0,3,7,14,18,0,2019
ITA-Serie A,2018,Empoli,Matteo Brighi,ITA,MF,37,1981,2.6,11,4,2,9,0,2,9,22.2,7,2,0,2,3,14,4,0,2019
ITA-Serie A,2018,Empoli,Matías Silvestre,ARG,DF,33,1984,34.0,31,17,22,5,4,17,26,65.4,9,29,24,5,21,52,165,0,2019
ITA-Serie A,2018,Empoli,Miha Zajc,SVN,"MF,FW",24,1994,13.0,6,4,1,1,4,2,11,18.2,9,15,4,11,5,11,8,0,2019
ITA-Serie A,2018,Empoli,Pietro Terracciano,ITA,GK,28,1990,8.0,0,0,0,0,0,0,0,,0,0,0,0,1,1,4,0,2019
ITA-Serie A,2018,Empoli,Rade Krunić,BIH,MF,24,1993,30.8,38,23,21,14,3,14,41,34.1,27,35,12,23,24,62,32,0,2019
ITA-Serie A,2018,Empoli,Salih Uçan,TUR,MF,24,1994,2.9,10,4,3,5,2,3,10,30.0,7,4,0,4,6,16,2,0,2019
ITA-Serie A,2018,Empoli,Samuel Mráz,SVK,FW,21,1997,1.9,0,0,0,0,0,0,0,,0,2,0,2,0,0,2,0,2019
ITA-Serie A,2018,Fiorentina,Alban Lafont,FRA,GK,19,1999,33.5,0,0,0,0,0,0,0,,0,0,0,0,1,1,16,4,2019
ITA-Serie A,2018,Fiorentina,Bartłomiej Drągowski,POL,GK,20,1997,2.5,0,0,0,0,0,0,0,,0,0,0,0,0,0,2,0,2019
ITA-Serie A,2018,Fiorentina,Bryan Dabo,BFA,"MF,DF",26,1992,9.2,10,6,1,8,1,1,6,16.7,5,11,6,5,10,20,21,0,2019
ITA-Serie A,2018,Fiorentina,Christian Nørgaard,DEN,MF,24,1994,3.6,4,2,1,2,1,2,5,40.0,3,2,0,2,10,14,16,0,2019
ITA-Serie A,2018,Fiorentina,Cristiano Biraghi,ITA,DF,25,1992,35.5,52,33,31,17,4,18,38,47.4,20,40,17,23,44,96,113,0,2019
ITA-Serie A,2018,Fiorentina,Cristóbal Montiel,ESP,FW,18,2000,0.1,0,0,0,0,0,0,0,,0,0,0,0,0,0,0,0,2019
ITA-Serie A,2018,Fiorentina,Cyril Théréau,FRA,"FW,MF",35,1983,0.3,0,0,0,0,0,0,0,,0,0,0,0,0,0,1,0,2019
ITA-Serie A,2018,Fiorentina,Dušan Vlahović,SRB,FW,18,2000,1.8,0,0,0,0,0,0,0,,0,2,0,2,0,0,4,0,2019
ITA-Serie A,2018,Fiorentina,Dávid Hancko,SVK,DF,20,1997,3.1,7,6,4,3,0,6,9,66.7,3,3,1,2,3,10,12,0,2019
ITA-Serie A,2018,Fiorentina,Edimilson Fernandes,SUI,MF,22,1996,21.9,36,24,17,16,3,14,36,38.9,22,31,6,25,26,62,31,0,2019
ITA-Serie A,2018,Fiorentina,Federico Ceccherini,ITA,DF,26,1992,11.0,13,10,8,3,2,5,9,55.6,4,12,8,4,21,34,40,0,2019
ITA-Serie A,2018,Fiorentina,Federico Chiesa,ITA,FW,20,1997,33.7,46,27,8,17,21,10,40,25.0,30,24,1,23,10,56,12,0,2019
ITA-Serie A,2018,Fiorentina,Germán Pezzella,ARG,DF,27,1991,31.7,56,36,42,13,1,31,51,60.8,20,42,30,12,60,116,159,1,2019
ITA-Serie A,2018,Fiorentina,Gerson,BRA,"MF,FW",21,1997,27.0,42,26,22,15,5,12,38,31.6,26,46,9,37,16,58,32,0,2019
ITA-Serie A,2018,Fiorentina,Giovanni Simeone,ARG,FW,23,1995,27.3,43,27,10,23,10,7,29,24.1,22,26,2,24,4,47,14,0,2019
ITA-Serie A,2018,Fiorentina,Jordan Veretout,FRA,MF,25,1993,32.7,64,40,22,31,11,21,52,40.4,31,33,7,26,46,110,54,2,2019
ITA-Serie A,2018,Fiorentina,Kevin Mirallas,BEL,"FW,MF",30,1987,14.4,17,7,8,4,5,6,15,40.0,9,17,0,17,4,21,10,0,2019
ITA-Serie A,2018,Fiorentina,Luis Muriel,COL,FW,27,1991,16.0,19,11,4,13,2,6,18,33.3,12,10,0,10,3,22,1,0,2019
ITA-Serie A,2018,Fiorentina,Marco Benassi,ITA,MF,23,1994,25.4,30,19,8,15,7,14,41,34.1,27,16,3,13,9,39,27,1,2019
ITA-Serie A,2018,Fiorentina,Marko Pjaca,CRO,"FW,MF",23,1995,8.3,9,4,3,4,2,2,6,33.3,4,2,0,2,7,16,6,0,2019
ITA-Serie A,2018,Fiorentina,Nicky Medja,SUI,"FW,MF",18,2000,0.5,1,0,0,0,1,1,2,50.0,1,0,0,0,0,1,0,0,2019
ITA-Serie A,2018,Fiorentina,Nikola Milenković,SRB,DF,20,1997,33.4,59,40,36,21,2,17,33,51.5,16,39,21,18,48,107,143,0,2019
ITA-Serie A,2018,Fiorentina,Pietro Terracciano,ITA,GK,28,1990,2.0,0,0,0,0,0,0,0,,0,0,0,0,0,0,1,1,2019
ITA-Serie A,2018,Fiorentina,Riccardo Sottil,ITA,"FW,MF",19,1999,0.2,1,1,0,1,0,1,1,100.0,0,0,0,0,0,1,0,0,2019
ITA-Serie A,2018,Fiorentina,Valentin Eysseric,FRA,"FW,MF",26,1992,4.0,6,5,3,2,1,2,4,50.0,2,6,1,5,4,10,1,0,2019
ITA-Serie A,2018,Fiorentina,Vincent Laurini,FRA,DF,29,1989,10.2,13,5,6,5,2,6,10,60.0,4,11,5,6,13,26,30,0,2019
ITA-Serie A,2018,Fiorentina,Vitor Hugo,BRA,DF,27,1991,27.4,64,42,38,25,1,17,27,63.0,10,28,13,15,74,138,141,2,2019
ITA-Serie A,2018,Frosinone,Andrea Beghetto,ITA,DF,23,1994,24.7,26,14,13,10,3,15,25,60.0,10,20,4,16,17,43,59,0,2019
ITA-Serie A,2018,Frosinone,Andrea Pinamonti,ITA,FW,19,1999,18.1,14,6,6,5,3,4,20,20.0,16,16,3,13,5,19,17,0,2019
ITA-Serie A,2018,Frosinone,Bartosz Salamon,POL,DF,27,1991,19.2,17,10,12,5,0,6,14,42.9,8,27,19,8,27,44,143,1,2019
ITA-Serie A,2018,Frosinone,Camillo Ciano,ITA,"FW,MF",28,1990,27.3,33,15,12,10,11,8,50,16.0,42,28,4,24,8,41,16,0,2019
ITA-Serie A,2018,Frosinone,Cristian Molinaro,ITA,"DF,MF",35,1983,12.9,15,10,7,7,1,3,9,33.3,6,11,4,7,15,30,43,0,2019
ITA-Serie A,2018,Frosinone,Daniel Ciofani,ITA,FW,33,1985,18.0,8,6,2,5,1,3,7,42.9,4,4,0,4,3,11,9,0,2019
ITA-Serie A,2018,Frosinone,Danilo Soddimo,ITA,"MF,FW",30,1987,2.8,11,9,3,6,2,3,6,50.0,3,2,1,1,7,18,3,0,2019
ITA-Serie A,2018,Frosinone,Edoardo Goldaniga,ITA,DF,24,1993,29.0,43,28,34,7,2,19,32,59.4,13,29,16,13,57,100,119,0,2019
ITA-Serie A,2018,Frosinone,Emil Hallfreðsson,ISL,MF,34,1984,4.4,10,6,5,4,1,0,9,0.0,9,4,1,3,2,12,3,0,2019
ITA-Serie A,2018,Frosinone,Federico Dionisi,ITA,"FW,MF",31,1987,2.3,3,1,0,2,1,0,2,0.0,2,0,0,0,0,3,0,0,2019
ITA-Serie A,2018,Frosinone,Federico Viviani,ITA,MF,26,1992,3.7,6,5,2,3,1,3,8,37.5,5,6,3,3,8,14,2,0,2019
ITA-Serie A,2018,Frosinone,Francesco Bardi,ITA,GK,26,1992,3.0,0,0,0,0,0,0,0,,0,0,0,0,0,0,2,0,2019
ITA-Serie A,2018,Frosinone,Francesco Cassata,ITA,MF,21,1997,12.5,20,11,12,4,4,9,23,39.1,14,8,1,7,6,26,15,1,2019
ITA-Serie A,2018,Frosinone,Francesco Zampano,ITA,"DF,MF",24,1993,23.4,35,25,23,9,3,15,31,48.4,16,24,4,20,13,48,48,0,2019
ITA-Serie A,2018,Frosinone,Joaquín Ardaiz,URU,FW,19,1999,0.2,0,0,0,0,0,0,0,,0,0,0,0,0,0,0,0,2019
ITA-Serie A,2018,Frosinone,Joel Campbell,CRC,"FW,MF",26,1992,9.9,15,10,5,8,2,3,17,17.6,14,2,0,2,3,18,2,1,2019
ITA-Serie A,2018,Frosinone,Lorenzo Ariaudo,ITA,DF,29,1989,18.7,20,14,15,4,1,6,10,60.0,4,31,20,11,14,34,103,0,2019
ITA-Serie A,2018,Frosinone,Lorenzo Crisetig,ITA,MF,25,1993,5.6,14,11,4,8,2,6,15,40.0,9,8,3,5,12,26,12,0,2019
ITA-Serie A,2018,Frosinone,Luca Matarese,ITA,FW,20,1998,0.2,0,0,0,0,0,0,0,,0,0,0,0,0,0,0,0,2019
ITA-Serie A,2018,Frosinone,Luca Paganini,ITA,"DF,MF",25,1993,12.5,25,13,8,13,4,8,23,34.8,15,19,4,15,19,44,17,1,2019
ITA-Serie A,2018,Frosinone,Luca Valzania,ITA,MF,22,1996,10.0,21,12,7,10,4,13,33,39.4,20,18,0,18,16,37,8,1,2019
ITA-Serie A,2018,Frosinone,Luka Krajnc,SVN,DF,23,1994,8.8,10,8,6,3,1,5,6,83.3,1,11,3,8,11,21,42,0,2019
ITA-Serie A,2018,Frosinone,Marcello Trotta,ITA,FW,25,1992,4.4,7,6,2,4,1,1,3,33.3,2,2,1,1,3,10,3,0,2019
ITA-Serie A,2018,Frosinone,Marco Capuano,ITA,DF,26,1991,25.6,53,33,37,15,1,26,46,56.5,20,44,31,13,34,87,101,2,2019
ITA-Serie A,2018,Frosinone,Marco Sportiello,ITA,GK,26,1992,35.0,1,0,1,0,0,1,1,100.0,0,1,0,1,0,1,8,2,2019
ITA-Serie A,2018,Frosinone,Mirko Gori,ITA,MF,25,1993,3.7,16,13,7,9,0,5,16,31.3,11,2,0,2,4,20,9,0,2019
ITA-Serie A,2018,Frosinone,Nicolò Brighenti,ITA,DF,28,1989,11.0,27,17,9,15,3,6,14,42.9,8,17,8,9,31,58,37,0,2019
ITA-Serie A,2018,Frosinone,Paolo Ghiglione,ITA,DF,21,1997,5.7,8,4,6,1,1,6,14,42.9,8,2,0,2,4,12,22,0,2019
ITA-Serie A,2018,Frosinone,Paolo Sammarco,ITA,MF,35,1983,6.1,16,7,7,6,3,6,9,66.7,3,5,0,5,3,19,1,2,2019
ITA-Serie A,2018,Frosinone,Raffaele Maiello,ITA,MF,27,1991,22.7,42,27,30,8,4,16,27,59.3,11,23,10,13,30,72,41,0,2019
ITA-Serie A,2018,Frosinone,Rai Vloet,NED,MF,23,1995,1.4,4,2,1,2,1,0,3,0.0,3,4,0,4,0,4,1,0,2019
ITA-Serie A,2018,Frosinone,Raman Chibsah,GHA,MF,25,1993,29.1,46,27,25,19,2,16,54,29.6,38,45,10,35,32,78,28,1,2019
ITA-Serie A,2018,Frosinone,Stipe Perica,CRO,FW,23,1995,5.3,5,3,2,2,1,1,3,33.3,2,3,1,2,0,5,4,0,2019
ITA-Serie A,2018,Genoa,Andrea Favilli,ITA,"FW,DF",21,1997,1.9,1,1,0,0,1,0,1,0.0,1,1,0,1,0,1,1,0,2019
ITA-Serie A,2018,Genoa,Antonio Sanabria,PAR,FW,22,1996,8.5,6,3,1,1,4,0,1,0.0,1,8,0,8,4,10,3,0,2019
ITA-Serie A,2018,Genoa,Christian Kouamé,CIV,FW,20,1997,34.1,31,22,8,16,7,2,13,15.4,11,23,3,20,25,56,28,0,2019
ITA-Serie A,2018,Genoa,Cristian Romero,ARG,DF,20,1998,26.0,61,35,38,18,5,27,40,67.5,13,49,27,22,37,98,128,1,2019
ITA-Serie A,2018,Genoa,Daniel Bessa,ITA,MF,25,1993,27.1,60,35,28,23,9,11,39,28.2,28,30,4,26,19,79,16,1,2019
ITA-Serie A,2018,Genoa,Darko Lazović,SRB,"DF,FW",27,1990,28.2,28,17,13,8,7,14,31,45.2,17,21,6,15,20,48,33,0,2019
ITA-Serie A,2018,Genoa,Davide Biraschi,ITA,DF,24,1994,31.6,58,38,37,19,2,25,42,59.5,17,32,13,19,64,122,107,1,2019
ITA-Serie A,2018,Genoa,Domenico Criscito,ITA,DF,31,1986,34.1,111,75,64,36,11,57,83,68.7,26,40,11,29,70,181,142,0,2019
ITA-Serie A,2018,Genoa,Ervin Zukanović,BIH,DF,31,1987,21.8,28,16,20,7,1,17,30,56.7,13,17,9,8,19,47,96,0,2019
ITA-Serie A,2018,Genoa,Esteban Rolón,ARG,MF,23,1995,11.6,46,29,14,20,12,20,44,45.5,24,18,2,16,16,62,12,0,2019
ITA-Serie A,2018,Genoa,Federico Marchetti,ITA,GK,35,1983,4.0,0,0,0,0,0,0,0,,0,0,0,0,0,0,1,0,2019
ITA-Serie A,2018,Genoa,Gianluca Lapadula,PER,FW,28,1990,4.5,2,1,2,0,0,1,5,20.0,4,2,0,2,1,3,2,0,2019
ITA-Serie A,2018,Genoa,Giuseppe Pezzella,ITA,"DF,MF",20,1997,1.2,2,1,1,1,0,0,0,,0,1,0,1,1,3,4,0,2019
ITA-Serie A,2018,Genoa,Goran Pandev,MKD,"FW,MF",35,1983,12.5,14,10,0,10,4,2,8,25.0,6,7,0,7,1,15,3,0,2019
ITA-Serie A,2018,Genoa,Ionuț Radu,ROU,GK,21,1997,33.0,0,0,0,0,0,0,1,0.0,1,0,0,0,1,1,11,4,2019
ITA-Serie A,2018,Genoa,Iuri Medeiros,POR,"MF,FW",24,1994,1.2,2,2,0,1,1,1,2,50.0,1,2,0,2,0,2,1,0,2019
ITA-Serie A,2018,Genoa,Ivan Radovanović,SRB,MF,29,1988,14.2,20,12,11,8,1,8,17,47.1,9,12,4,8,13,33,20,1,2019
ITA-Serie A,2018,Genoa,Jandrei,BRA,GK,25,1993,1.0,0,0,0,0,0,0,1,0.0,1,0,0,0,0,0,0,0,2019
ITA-Serie A,2018,Genoa,Koray Günter,GER,DF,23,1994,9.3,18,13,13,3,2,9,16,56.3,7,9,7,2,18,36,34,0,2019
ITA-Serie A,2018,Genoa,Krzysztof Piątek,POL,FW,23,1995,17.7,9,4,2,5,2,1,15,6.7,14,18,3,15,3,12,19,0,2019
ITA-Serie A,2018,Genoa,Luca Mazzitelli,ITA,MF,22,1995,3.6,5,2,3,1,1,2,3,66.7,1,4,1,3,6,11,7,0,2019
ITA-Serie A,2018,Genoa,Lukas Lerager,DEN,MF,25,1993,12.5,34,18,12,20,2,13,42,31.0,29,11,1,10,18,52,12,0,2019
ITA-Serie A,2018,Genoa,Miguel Veloso,POR,MF,32,1986,14.0,31,20,14,13,4,9,26,34.6,17,12,1,11,13,44,21,0,2019
ITA-Serie A,2018,Genoa,Nicola Dalmonte,ITA,"FW,MF",20,1997,0.5,2,2,0,2,0,0,0,,0,0,0,0,0,2,0,0,2019
ITA-Serie A,2018,Genoa,Nicolás Spolli,ARG,DF,35,1983,6.0,7,6,3,4,0,0,2,0.0,2,8,6,2,7,14,39,1,2019
ITA-Serie A,2018,Genoa,Oscar Hiljemark,SWE,MF,26,1992,13.3,16,9,8,7,1,5,16,31.3,11,13,3,10,13,29,14,0,2019
ITA-Serie A,2018,Genoa,Pedro Pereira,POR,"DF,FW",20,1998,15.4,20,14,15,2,3,11,19,57.9,8,10,5,5,14,34,55,1,2019
ITA-Serie A,2018,Genoa,Rômulo,ITA,"MF,FW",31,1987,15.0,26,18,9,10,7,7,17,41.2,10,16,3,13,18,44,20,0,2019
ITA-Serie A,2018,Genoa,Sandro,BRA,MF,29,1989,7.9,27,17,12,11,4,9,17,52.9,8,9,4,5,20,47,25,0,2019
ITA-Serie A,2018,Genoa,Stefano Sturaro,ITA,"MF,FW",25,1993,2.4,4,3,0,3,1,2,9,22.2,7,3,1,2,3,7,2,0,2019
ITA-Serie A,2018,Genoa,Stephane Omeonga,BEL,MF,22,1996,0.6,1,1,1,0,0,0,1,0.0,1,1,0,1,0,1,2,0,2019
ITA-Serie A,2018,Inter,Andrea Ranocchia,ITA,"DF,FW",30,1988,0.7,2,2,1,1,0,0,1,0.0,1,1,0,1,0,2,3,0,2019
ITA-Serie A,2018,Inter,Antonio Candreva,ITA,"FW,MF",31,1987,5.6,1,1,0,1,0,1,8,12.5,7,0,0,0,4,5,9,0,2019
ITA-Serie A,2018,Inter,Borja Valero,ESP,MF,33,1985,13.7,22,19,9,10,3,8,30,26.7,22,11,1,10,16,38,27,2,2019
ITA-Serie A,2018,Inter,Cédric Soares,POR,DF,26,1991,2.9,8,6,2,4,2,4,7,57.1,3,4,1,3,2,10,3,0,2019
ITA-Serie A,2018,Inter,Dalbert Henrique,BRA,DF,24,1993,8.6,33,24,18,14,1,12,21,57.1,9,9,3,6,8,41,20,0,2019
ITA-Serie A,2018,Inter,Danilo D'Ambrosio,ITA,DF,29,1988,28.7,69,40,34,27,8,24,57,42.1,33,25,8,17,27,96,39,0,2019
ITA-Serie A,2018,Inter,Ivan Perišić,CRO,FW,29,1989,30.0,34,26,7,20,7,16,51,31.4,35,40,4,36,23,57,55,0,2019
ITA-Serie A,2018,Inter,João Mário,POR,"MF,FW",25,1993,12.0,28,16,9,15,4,9,31,29.0,22,14,0,14,6,34,4,1,2019
ITA-Serie A,2018,Inter,Keita Baldé,SEN,FW,23,1995,9.9,10,6,4,2,4,2,9,22.2,7,8,0,8,3,13,1,0,2019
ITA-Serie A,2018,Inter,Kwadwo Asamoah,GHA,DF,29,1988,29.7,44,26,22,14,8,29,51,56.9,22,21,4,17,40,84,46,1,2019
ITA-Serie A,2018,Inter,Lautaro Martínez,ARG,"FW,MF",20,1997,14.9,6,5,0,2,4,2,6,33.3,4,16,0,16,3,9,7,0,2019
ITA-Serie A,2018,Inter,Marcelo Brozović,CRO,MF,25,1992,29.4,101,70,47,40,14,31,86,36.0,55,45,8,37,44,145,32,3,2019
ITA-Serie A,2018,Inter,Matteo Politano,ITA,FW,24,1993,28.3,18,7,9,4,5,8,30,26.7,22,18,0,18,14,32,10,1,2019
ITA-Serie A,2018,Inter,Matías Vecino,URU,MF,26,1991,22.4,50,39,18,23,9,26,53,49.1,27,38,9,29,17,67,22,0,2019
ITA-Serie A,2018,Inter,Mauro Icardi,ARG,FW,25,1993,25.2,9,8,2,2,5,1,6,16.7,5,4,1,3,3,12,20,1,2019
ITA-Serie A,2018,Inter,Milan Škriniar,SVK,DF,23,1995,35.0,64,37,46,17,1,38,60,63.3,22,48,29,19,27,91,138,0,2019
ITA-Serie A,2018,Inter,Miranda,BRA,DF,33,1984,12.9,11,7,7,4,0,4,8,50.0,4,11,7,4,14,25,48,2,2019
ITA-Serie A,2018,Inter,Radja Nainggolan,BEL,MF,30,1988,21.9,35,26,7,20,8,10,24,41.7,14,17,2,15,8,43,5,0,2019
ITA-Serie A,2018,Inter,Roberto Gagliardini,ITA,MF,24,1994,12.1,23,14,13,8,2,10,27,37.0,17,21,3,18,16,39,19,0,2019
ITA-Serie A,2018,Inter,Samir Handanović,SVN,GK,34,1984,38.0,1,0,1,0,0,1,1,100.0,0,0,0,0,0,1,12,1,2019
ITA-Serie A,2018,Inter,Stefan de Vrij,NED,DF,26,1992,28.0,25,16,14,10,1,8,15,53.3,7,32,23,9,25,50,95,1,2019
ITA-Serie A,2018,Inter,Yann Karamoh,FRA,"FW,MF",20,1998,0.1,0,0,0,0,0,0,0,,0,0,0,0,0,0,0,0,2019
ITA-Serie A,2018,Inter,Šime Vrsaljko,CRO,DF,26,1992,8.1,20,14,8,6,6,9,14,64.3,5,5,1,4,11,31,27,1,2019
ITA-Serie A,2018,Juventus,Alex Sandro,BRA,DF,27,1991,26.5,68,45,28,33,7,21,36,58.3,15,32,8,24,38,106,71,0,2019
ITA-Serie A,2018,Juventus,Andrea Barzagli,ITA,DF,37,1981,2.9,1,1,0,1,0,1,2,50.0,1,2,2,0,4,5,10,0,2019
ITA-Serie A,2018,Juventus,Blaise Matuidi,FRA,MF,31,1987,26.9,59,33,25,21,13,20,36,55.6,16,33,8,25,26,85,21,1,2019
ITA-Serie A,2018,Juventus,Carlo Pinsoglio,ITA,GK,28,1990,1.0,0,0,0,0,0,0,0,,0,0,0,0,0,0,0,0,2019
ITA-Serie A,2018,Juventus,Cristiano Ronaldo,POR,FW,33,1985,29.9,10,7,5,4,1,1,11,9.1,10,7,2,5,6,16,32,0,2019
ITA-Serie A,2018,Juventus,Daniele Rugani,ITA,DF,24,1994,15.0,8,5,5,3,0,2,5,40.0,3,19,14,5,16,24,51,1,2019
ITA-Serie A,2018,Juventus,Douglas Costa,BRA,"FW,MF",27,1990,6.9,10,8,2,8,0,4,9,44.4,5,8,0,8,4,14,2,0,2019
ITA-Serie A,2018,Juventus,Emre Can,GER,MF,24,1994,20.1,64,38,28,27,9,24,40,60.0,16,43,13,30,28,92,36,2,2019
ITA-Serie A,2018,Juventus,Federico Bernardeschi,ITA,"MF,FW",24,1994,16.4,14,8,5,6,3,7,18,38.9,11,9,0,9,6,20,10,0,2019
ITA-Serie A,2018,Juventus,Giorgio Chiellini,ITA,DF,33,1984,22.1,24,13,20,2,2,5,8,62.5,3,22,15,7,30,54,96,1,2019
ITA-Serie A,2018,Juventus,Grigoris Kastanos,CYP,MF,20,1998,0.7,3,1,3,0,0,0,0,,0,3,1,2,0,3,0,0,2019
ITA-Serie A,2018,Juventus,Hans Nicolussi Caviglia,ITA,MF,18,2000,0.6,2,1,0,2,0,0,2,0.0,2,2,1,1,0,2,0,0,2019
ITA-Serie A,2018,Juventus,João Cancelo,POR,DF,24,1994,21.9,43,28,18,18,7,27,49,55.1,22,14,4,10,15,58,48,0,2019
ITA-Serie A,2018,Juventus,Juan Cuadrado,COL,"MF,DF",30,1988,13.6,20,15,6,9,5,5,23,21.7,18,14,3,11,18,38,11,0,2019
ITA-Serie A,2018,Juventus,Leonardo Bonucci,ITA,DF,31,1987,27.5,18,9,11,6,1,10,13,76.9,3,32,21,11,38,56,88,3,2019
ITA-Serie A,2018,Juventus,Leonardo Spinazzola,ITA,DF,25,1993,6.7,9,4,4,2,3,4,8,50.0,4,5,0,5,3,12,7,0,2019
ITA-Serie A,2018,Juventus,Manolo Portanova,ITA,MF,18,2000,0.4,1,1,0,1,0,0,1,0.0,1,2,0,2,1,2,2,0,2019
ITA-Serie A,2018,Juventus,Mario Mandžukić,CRO,FW,32,1986,22.4,34,25,13,15,6,9,18,50.0,9,17,5,12,13,47,22,0,2019
ITA-Serie A,2018,Juventus,Martín Cáceres,URU,DF,31,1987,7.0,7,3,6,0,1,4,4,100.0,0,6,3,3,4,11,14,0,2019
ITA-Serie A,2018,Juventus,Matheus Pereira da Silva,BRA,MF,20,1998,1.0,3,2,0,2,1,2,4,50.0,2,1,0,1,0,3,1,0,2019
ITA-Serie A,2018,Juventus,Mattia De Sciglio,ITA,DF,25,1992,19.4,40,28,24,14,2,17,28,60.7,11,18,6,12,26,66,58,1,2019
ITA-Serie A,2018,Juventus,Mattia Perin,ITA,GK,25,1992,9.0,0,0,0,0,0,0,0,,0,0,0,0,0,0,3,2,2019
ITA-Serie A,2018,Juventus,Medhi Benatia,MAR,DF,31,1987,5.0,7,6,6,1,0,3,5,60.0,2,10,5,5,16,23,18,0,2019
ITA-Serie A,2018,Juventus,Miralem Pjanić,BIH,MF,28,1990,25.3,41,20,15,18,8,16,59,27.1,43,34,6,28,36,77,19,2,2019
ITA-Serie A,2018,Juventus,Moise Kean,ITA,FW,18,2000,6.0,0,0,0,0,0,0,1,0.0,1,1,0,1,2,2,1,0,2019
ITA-Serie A,2018,Juventus,Paolo Gozzi Iweru,ITA,DF,17,2001,1.0,3,2,2,1,0,0,0,,0,0,0,0,3,6,3,0,2019
ITA-Serie A,2018,Juventus,Paulo Dybala,ARG,"FW,MF",24,1993,23.7,17,8,3,9,5,7,23,30.4,16,20,2,18,14,31,1,0,2019
ITA-Serie A,2018,Juventus,Rodrigo Bentancur,URU,MF,21,1997,22.3,53,34,22,29,2,18,39,46.2,21,20,8,12,43,96,42,1,2019
ITA-Serie A,2018,Juventus,Sami Khedira,GER,MF,31,1987,7.8,10,9,6,2,2,5,9,55.6,4,8,3,5,5,15,6,0,2019
ITA-Serie A,2018,Juventus,Stephy Mavididi,ENG,FW,20,1998,0.2,0,0,0,0,0,0,0,,0,1,0,1,0,0,0,0,2019
ITA-Serie A,2018,Juventus,Wojciech Szczęsny,POL,GK,28,1990,28.0,2,1,2,0,0,1,1,100.0,0,0,0,0,1,3,8,2,2019
ITA-Serie A,2018,Lazio,Adam Marušić,MNE,DF,25,1992,23.5,32,15,14,14,4,16,25,64.0,9,25,4,21,24,56,36,0,2019
ITA-Serie A,2018,Lazio,Alessandro Murgia,ITA,MF,21,1996,0.1,0,0,0,0,0,0,0,,0,0,0,0,0,0,0,0,2019
ITA-Serie A,2018,Lazio,Bastos,ANG,DF,27,1991,12.7,22,17,16,4,2,17,27,63.0,10,16,8,8,7,29,49,1,2019
ITA-Serie A,2018,Lazio,Bruno Jordão,POR,"MF,DF",19,1998,1.0,4,3,2,1,1,1,3,33.3,2,1,0,1,0,4,2,0,2019
ITA-Serie A,2018,Lazio,Ciro Immobile,ITA,FW,28,1990,31.8,12,6,4,3,5,4,9,44.4,5,18,1,17,1,13,8,0,2019
ITA-Serie A,2018,Lazio,Danilo Cataldi,ITA,"MF,FW",23,1994,6.4,12,7,4,5,3,2,9,22.2,7,3,0,3,7,19,6,0,2019
ITA-Serie A,2018,Lazio,Felipe Caicedo,ECU,FW,29,1988,15.2,16,12,4,6,6,1,8,12.5,7,9,2,7,5,21,5,0,2019
ITA-Serie A,2018,Lazio,Francesco Acerbi,ITA,DF,30,1988,36.8,40,30,22,13,5,12,16,75.0,4,50,32,18,61,101,169,1,2019
ITA-Serie A,2018,Lazio,Guido Guerrieri,ITA,GK,22,1996,1.0,0,0,0,0,0,0,0,,0,0,0,0,0,0,2,0,2019
ITA-Serie A,2018,Lazio,Joaquín Correa,ARG,"FW,MF",23,1994,21.4,21,13,6,12,3,5,18,27.8,13,14,3,11,2,23,7,0,2019
ITA-Serie A,2018,Lazio,Jordan Lukaku,BEL,"DF,MF",24,1994,1.9,4,3,2,1,1,3,5,60.0,2,3,0,3,5,9,2,0,2019
ITA-Serie A,2018,Lazio,Luan Capanni,BRA,FW,18,2000,0.1,1,1,0,0,1,0,0,,0,0,0,0,0,1,0,0,2019
ITA-Serie A,2018,Lazio,Lucas Leiva,BRA,MF,31,1987,22.1,91,54,40,46,5,38,79,48.1,41,27,11,16,52,143,43,3,2019
ITA-Serie A,2018,Lazio,Luis Alberto,ESP,"MF,FW",25,1992,22.1,53,22,15,29,9,21,55,38.2,34,23,3,20,10,63,10,0,2019
ITA-Serie A,2018,Lazio,Luiz Felipe,ITA,DF,21,1997,14.3,27,18,20,7,0,13,20,65.0,7,27,15,12,26,53,57,1,2019
ITA-Serie A,2018,Lazio,Marco Parolo,ITA,MF,33,1985,28.5,68,45,24,37,7,18,56,32.1,38,48,11,37,28,96,56,0,2019
ITA-Serie A,2018,Lazio,Martín Cáceres,URU,DF,31,1987,3.4,4,2,3,1,0,4,6,66.7,2,4,0,4,0,4,12,1,2019
ITA-Serie A,2018,Lazio,Milan Badelj,CRO,MF,29,1989,12.7,33,20,10,19,4,16,37,43.2,21,27,9,18,33,66,20,1,2019
ITA-Serie A,2018,Lazio,Nicolò Armini,ITA,DF,17,2001,0.4,1,1,0,1,0,1,2,50.0,1,1,0,1,0,1,0,0,2019
ITA-Serie A,2018,Lazio,Patric,ESP,DF,25,1993,12.1,19,11,8,8,3,8,15,53.3,7,14,7,7,12,31,29,1,2019
ITA-Serie A,2018,Lazio,Pedro Neto,POR,"FW,DF",18,2000,0.5,0,0,0,0,0,0,0,,0,1,0,1,0,0,0,0,2019
ITA-Serie A,2018,Lazio,Riza Durmisi,DEN,DF,24,1994,3.6,4,4,2,0,2,2,3,66.7,1,0,0,0,1,5,9,0,2019
ITA-Serie A,2018,Lazio,Rômulo,ITA,DF,31,1987,8.6,10,5,8,2,0,5,7,71.4,2,10,2,8,5,15,13,0,2019
ITA-Serie A,2018,Lazio,Senad Lulić,BIH,"DF,FW",32,1986,32.5,71,43,37,27,7,32,76,42.1,44,27,3,24,49,120,58,1,2019
ITA-Serie A,2018,Lazio,Sergej Milinković-Savić,SRB,MF,23,1995,26.6,44,28,17,21,6,23,60,38.3,37,28,4,24,27,71,48,0,2019
ITA-Serie A,2018,Lazio,Silvio Proto,BEL,GK,35,1983,2.0,0,0,0,0,0,0,1,0.0,1,0,0,0,0,0,1,0,2019
ITA-Serie A,2018,Lazio,Thomas Strakosha,ALB,GK,23,1995,35.0,1,1,1,0,0,1,1,100.0,0,0,0,0,1,2,8,1,2019
ITA-Serie A,2018,Lazio,Valon Berisha,KVX,"MF,FW",25,1993,2.2,8,5,1,6,1,4,6,66.7,2,6,0,6,4,12,3,0,2019
ITA-Serie A,2018,Lazio,Wallace,BRA,DF,23,1994,13.7,17,13,11,6,0,8,17,47.1,9,13,7,6,30,47,60,2,2019
ITA-Serie A,2018,Lazio,Ștefan Radu,ROU,DF,31,1986,24.9,43,27,24,15,4,25,38,65.8,13,20,14,6,42,85,85,1,2019
ITA-Serie A,2018,Milan,Alessio Romagnoli,ITA,DF,23,1995,31.6,34,19,26,6,2,16,19,84.2,3,48,32,16,37,71,173,1,2019
ITA-Serie A,2018,Milan,Andrea Conti,ITA,DF,24,1994,5.6,9,5,3,4,2,2,9,22.2,7,4,0,4,15,24,12,1,2019
ITA-Serie A,2018,Milan,Cristián Zapata,COL,DF,31,1986,11.4,23,16,15,7,1,9,10,90.0,1,18,15,3,8,31,59,0,2019
ITA-Serie A,2018,Milan,Davide Calabria,ITA,DF,21,1996,21.7,79,51,58,16,5,37,67,55.2,30,33,1,32,32,111,78,1,2019
ITA-Serie A,2018,Milan,Diego Laxalt,URU,"DF,MF",25,1993,7.2,26,13,14,7,5,13,22,59.1,9,23,3,20,8,34,12,0,2019
ITA-Serie A,2018,Milan,Fabio Borini,ITA,"FW,DF",27,1991,11.7,14,10,7,7,0,3,9,33.3,6,17,0,17,12,26,28,0,2019
ITA-Serie A,2018,Milan,Franck Kessié,CIV,MF,21,1996,33.5,42,27,16,20,6,18,38,47.4,20,35,10,25,27,69,53,2,2019
ITA-Serie A,2018,Milan,Giacomo Bonaventura,ITA,MF,28,1989,7.2,6,2,2,4,0,2,7,28.6,5,3,0,3,7,13,8,0,2019
ITA-Serie A,2018,Milan,Gianluigi Donnarumma,ITA,GK,19,1999,34.3,1,1,1,0,0,1,2,50.0,1,0,0,0,1,2,13,3,2019
ITA-Serie A,2018,Milan,Gonzalo Higuaín,ARG,FW,30,1987,14.2,8,6,1,5,2,5,13,38.5,8,3,0,3,0,8,11,1,2019
ITA-Serie A,2018,Milan,Hakan Çalhanoğlu,TUR,"MF,FW",24,1994,32.0,52,31,27,16,9,23,46,50.0,23,27,5,22,28,80,19,0,2019
ITA-Serie A,2018,Milan,Ignazio Abate,ITA,DF,31,1986,14.5,34,19,16,13,5,14,22,63.6,8,19,6,13,18,52,50,0,2019
ITA-Serie A,2018,Milan,José Mauri,ITA,MF,22,1996,2.3,8,4,2,6,0,2,6,33.3,4,0,0,0,5,13,0,0,2019
ITA-Serie A,2018,Milan,Krzysztof Piątek,POL,FW,23,1995,15.3,8,6,2,1,5,3,10,30.0,7,7,2,5,1,9,15,0,2019
ITA-Serie A,2018,Milan,Lucas Biglia,ARG,MF,32,1986,12.4,60,33,31,25,4,20,45,44.4,25,19,3,16,22,82,21,1,2019
ITA-Serie A,2018,Milan,Lucas Paquetá,BRA,MF,20,1997,9.4,18,9,9,8,1,7,24,29.2,17,12,0,12,4,22,11,2,2019
ITA-Serie A,2018,Milan,Mateo Musacchio,ARG,DF,27,1990,29.0,41,22,30,8,3,19,27,70.4,8,26,19,7,29,70,114,0,2019
ITA-Serie A,2018,Milan,Patrick Cutrone,ITA,FW,20,1998,16.2,9,5,0,3,6,2,16,12.5,14,13,2,11,7,16,13,0,2019
ITA-Serie A,2018,Milan,Pepe Reina,ESP,GK,35,1982,3.7,0,0,0,0,0,0,0,,0,0,0,0,0,0,1,0,2019
ITA-Serie A,2018,Milan,Ricardo Rodríguez,SUI,DF,25,1992,33.9,57,32,34,21,2,32,39,82.1,7,25,5,20,38,95,98,0,2019
ITA-Serie A,2018,Milan,Samu Castillejo,ESP,"FW,MF",23,1995,11.4,15,10,10,2,3,4,25,16.0,21,16,0,16,8,23,11,0,2019
ITA-Serie A,2018,Milan,Suso,ESP,"FW,MF",24,1993,33.5,28,18,10,14,4,10,41,24.4,31,26,1,25,16,44,3,0,2019
ITA-Serie A,2018,Milan,Tiemoué Bakayoko,FRA,MF,23,1994,25.6,69,43,22,40,7,26,62,41.9,36,34,5,29,50,119,42,2,2019
ITA-Serie A,2018,Napoli,Adam Ounas,ALG,"MF,FW",21,1996,6.0,5,2,0,3,2,2,11,18.2,9,6,0,6,2,7,0,1,2019
ITA-Serie A,2018,Napoli,Alex Meret,ITA,GK,21,1997,12.8,0,0,0,0,0,0,0,,0,0,0,0,0,0,3,1,2019
ITA-Serie A,2018,Napoli,Allan,BRA,MF,27,1991,29.1,106,70,39,55,12,36,107,33.6,71,55,13,42,36,142,28,0,2019
ITA-Serie A,2018,Napoli,Amadou Diawara,GUI,MF,21,1997,7.3,12,4,1,9,2,4,5,80.0,1,6,0,6,11,23,12,0,2019
ITA-Serie A,2018,Napoli,Amin Younes,GER,"MF,FW",24,1993,5.5,11,6,3,6,2,3,6,50.0,3,7,0,7,2,13,0,0,2019
ITA-Serie A,2018,Napoli,Arkadiusz Milik,POL,FW,24,1994,26.6,19,9,1,8,10,1,20,5.0,19,7,2,5,3,22,15,0,2019
ITA-Serie A,2018,Napoli,David Ospina,COL,GK,29,1988,16.2,1,0,1,0,0,1,1,100.0,0,0,0,0,0,1,7,1,2019
ITA-Serie A,2018,Napoli,Dries Mertens,BEL,FW,31,1987,25.0,19,11,2,7,10,1,21,4.8,20,7,0,7,13,32,3,0,2019
ITA-Serie A,2018,Napoli,Elseid Hysaj,ALB,DF,24,1994,23.4,40,28,22,15,3,25,49,51.0,24,11,3,8,24,64,51,0,2019
ITA-Serie A,2018,Napoli,Fabián Ruiz Peña,ESP,MF,22,1996,22.1,54,33,22,25,7,20,46,43.5,26,23,4,19,21,75,29,2,2019
ITA-Serie A,2018,Napoli,Faouzi Ghoulam,ALG,DF,27,1991,12.8,9,7,3,5,1,8,9,88.9,1,6,2,4,8,17,17,0,2019
ITA-Serie A,2018,Napoli,Gianluca Gaetano,ITA,"MF,FW",18,2000,0.1,0,0,0,0,0,0,0,,0,0,0,0,0,0,0,0,2019
ITA-Serie A,2018,Napoli,José Callejón,ESP,"MF,FW",31,1987,29.4,34,18,12,14,8,18,57,31.6,39,34,5,29,22,56,11,0,2019
ITA-Serie A,2018,Napoli,Kalidou Koulibaly,SEN,DF,27,1991,34.8,61,40,37,22,2,19,36,52.8,17,55,33,22,40,101,144,0,2019
ITA-Serie A,2018,Napoli,Kévin Malcuit,MAR,DF,27,1991,20.1,43,31,23,14,6,23,36,63.9,13,18,4,14,44,87,67,0,2019
ITA-Serie A,2018,Napoli,Lorenzo Insigne,ITA,"FW,MF",27,1991,23.0,14,4,5,6,3,6,18,33.3,12,7,0,7,8,22,3,0,2019
ITA-Serie A,2018,Napoli,Marek Hamšík,SVK,MF,31,1987,10.2,7,5,2,4,1,0,11,0.0,11,8,1,7,12,19,14,1,2019
ITA-Serie A,2018,Napoli,Marko Rog,CRO,MF,23,1995,3.7,12,9,3,7,2,5,11,45.5,6,8,2,6,5,17,1,0,2019
ITA-Serie A,2018,Napoli,Mário Rui,POR,DF,27,1991,15.7,24,18,9,12,3,14,25,56.0,11,15,3,12,21,45,38,0,2019
ITA-Serie A,2018,Napoli,Nikola Maksimović,SRB,DF,26,1991,15.3,20,13,14,6,0,6,12,50.0,6,16,10,6,28,48,56,1,2019
ITA-Serie A,2018,Napoli,Orestis Karnezis,GRE,GK,33,1985,9.0,0,0,0,0,0,0,0,,0,0,0,0,0,0,3,0,2019
ITA-Serie A,2018,Napoli,Piotr Zieliński,POL,MF,24,1994,31.9,41,25,11,20,10,13,34,38.2,21,30,4,26,20,61,18,0,2019
ITA-Serie A,2018,Napoli,Raúl Albiol,ESP,DF,32,1985,19.0,16,8,12,4,0,8,15,53.3,7,19,16,3,20,36,90,1,2019
ITA-Serie A,2018,Napoli,Sebastiano Luperto,ITA,DF,21,1996,8.1,8,6,5,2,1,2,5,40.0,3,7,3,4,13,21,30,0,2019
ITA-Serie A,2018,Napoli,Simone Verdi,ITA,"MF,FW",26,1992,7.8,16,11,5,9,2,8,16,50.0,8,6,0,6,4,20,3,0,2019
ITA-Serie A,2018,Napoli,Vlad Chiricheș,ROU,DF,28,1989,1.6,2,1,1,1,0,0,2,0.0,2,2,2,0,1,3,2,0,2019
ITA-Serie A,2018,Parma,Abdou Lahat Diakhate,SEN,MF,19,1998,0.0,0,0,0,0,0,0,0,,0,0,0,0,0,0,0,0,2019
ITA-Serie A,2018,Parma,Alberto Grassi,ITA,MF,23,1995,5.1,20,12,7,10,3,2,10,20.0,8,8,2,6,8,28,10,0,2019
ITA-Serie A,2018,Parma,Alessandro Bastoni,ITA,DF,19,1999,18.8,25,12,20,5,0,6,15,40.0,9,26,18,8,22,47,96,0,2019
ITA-Serie A,2018,Parma,Alessandro Deiola,ITA,"MF,FW",22,1995,6.1,12,8,4,7,1,4,10,40.0,6,15,4,11,11,23,10,0,2019
ITA-Serie A,2018,Parma,Alessio da Cruz,CPV,"FW,MF",21,1997,1.6,2,1,0,2,0,0,1,0.0,1,0,0,0,0,2,0,0,2019
ITA-Serie A,2018,Parma,Amato Ciciretti,ITA,"FW,MF",24,1993,1.5,1,0,1,0,0,0,0,,0,3,0,3,3,4,0,0,2019
ITA-Serie A,2018,Parma,Antonino Barillà,ITA,MF,30,1988,29.1,64,36,40,17,7,19,53,35.8,34,40,13,27,36,100,50,1,2019
ITA-Serie A,2018,Parma,Antonio Di Gaudio,ITA,FW,28,1989,7.8,2,0,0,1,1,1,5,20.0,4,6,1,5,3,5,5,0,2019
ITA-Serie A,2018,Parma,Bruno Alves,POR,DF,36,1981,32.5,15,8,11,4,0,4,7,57.1,3,36,28,8,29,44,210,0,2019
ITA-Serie A,2018,Parma,Fabio Ceravolo,ITA,FW,31,1987,13.2,5,1,2,1,2,1,11,9.1,10,9,1,8,2,7,19,0,2019
ITA-Serie A,2018,Parma,Federico Dimarco,ITA,"DF,MF",20,1997,9.9,22,7,10,8,4,10,20,50.0,10,13,6,7,15,37,27,0,2019
ITA-Serie A,2018,Parma,Francisco Sierralta,CHI,DF,21,1997,3.0,11,8,8,3,0,4,6,66.7,2,1,1,0,4,15,27,0,2019
ITA-Serie A,2018,Parma,Gervinho,CIV,FW,31,1987,25.6,19,12,11,5,3,5,13,38.5,8,7,0,7,10,29,2,0,2019
ITA-Serie A,2018,Parma,Gianni Munari,ITA,MF,35,1983,0.0,0,0,0,0,0,0,0,,0,0,0,0,0,0,0,0,2019
ITA-Serie A,2018,Parma,Jacopo Dezi,ITA,MF,26,1992,1.0,1,1,1,0,0,0,1,0.0,1,1,0,1,3,4,2,0,2019
ITA-Serie A,2018,Parma,Jonathan Biabiany,FRA,FW,30,1988,11.9,30,22,18,10,2,9,17,52.9,8,8,1,7,11,41,11,1,2019
ITA-Serie A,2018,Parma,Juraj Kucka,SVK,MF,31,1987,17.1,51,32,17,29,5,19,53,35.8,34,27,7,20,17,68,37,1,2019
ITA-Serie A,2018,Parma,Leo Štulac,SVN,MF,23,1994,16.1,21,13,10,10,1,4,17,23.5,13,29,13,16,34,55,31,1,2019
ITA-Serie A,2018,Parma,Luca Rigoni,ITA,MF,33,1984,19.6,42,25,25,15,2,9,26,34.6,17,19,2,17,18,60,39,0,2019
ITA-Serie A,2018,Parma,Luca Siligardi,ITA,FW,30,1988,18.2,30,20,10,13,7,8,23,34.8,15,19,3,16,15,45,11,0,2019
ITA-Serie A,2018,Parma,Luigi Sepe,ITA,GK,27,1991,37.0,1,1,1,0,0,1,2,50.0,1,0,0,0,3,4,21,3,2019
ITA-Serie A,2018,Parma,Marcello Gazzola,ITA,"DF,MF",33,1985,10.2,9,4,2,5,2,5,9,55.6,4,6,3,3,4,13,33,0,2019
ITA-Serie A,2018,Parma,Massimo Gobbi,ITA,DF,37,1980,13.1,14,7,5,5,4,8,25,32.0,17,16,8,8,9,23,48,0,2019
ITA-Serie A,2018,Parma,Matteo Scozzarella,ITA,MF,30,1988,16.2,18,13,9,8,1,9,33,27.3,24,22,10,12,23,41,33,0,2019
ITA-Serie A,2018,Parma,Mattia Sprocati,ITA,"FW,MF",25,1993,7.2,10,4,5,5,0,5,11,45.5,6,6,0,6,7,17,6,0,2019
ITA-Serie A,2018,Parma,Nicolás Schiappacasse,URU,"FW,MF",19,1999,0.9,0,0,0,0,0,0,0,,0,2,0,2,0,0,0,0,2019
ITA-Serie A,2018,Parma,Pepín,EQG,MF,21,1996,0.9,4,2,3,1,0,1,4,25.0,3,0,0,0,3,7,0,0,2019
ITA-Serie A,2018,Parma,Pierluigi Frattali,ITA,GK,32,1985,1.0,0,0,0,0,0,0,0,,0,0,0,0,0,0,1,0,2019
ITA-Serie A,2018,Parma,Riccardo Gagliolo,SWE,DF,28,1990,33.8,69,45,52,15,2,33,68,48.5,35,60,33,27,66,135,213,2,2019
ITA-Serie A,2018,Parma,Roberto Inglese,ITA,FW,26,1991,21.8,20,14,7,7,6,1,13,7.7,12,26,2,24,6,26,27,0,2019
ITA-Serie A,2018,Parma,Simone Iacoponi,ITA,DF,31,1987,37.2,62,43,50,11,1,27,47,57.4,20,40,26,14,37,99,178,3,2019
ITA-Serie A,2018,Roma,Aleksandar Kolarov,SRB,DF,32,1985,32.3,38,26,22,10,6,21,34,61.8,13,23,15,8,41,79,82,2,2019
ITA-Serie A,2018,Roma,Alessandro Florenzi,ITA,"DF,FW",27,1991,24.2,38,21,22,11,5,17,37,45.9,20,27,5,22,46,84,58,0,2019
ITA-Serie A,2018,Roma,Ante Ćorić,CRO,MF,21,1997,0.3,0,0,0,0,0,0,0,,0,0,0,0,0,0,0,0,2019
ITA-Serie A,2018,Roma,Antonio Mirante,ITA,GK,35,1983,11.0,0,0,0,0,0,0,0,,0,0,0,0,0,0,6,1,2019
ITA-Serie A,2018,Roma,Bryan Cristante,ITA,MF,23,1995,26.9,63,34,21,35,7,19,49,38.8,30,37,5,32,29,92,48,0,2019
ITA-Serie A,2018,Roma,Cengiz Ünder,TUR,FW,21,1997,15.3,6,3,3,3,0,2,11,18.2,9,7,0,7,13,19,5,0,2019
ITA-Serie A,2018,Roma,Daniele De Rossi,ITA,MF,35,1983,14.1,16,10,6,7,3,3,14,21.4,11,18,12,6,26,42,33,0,2019
ITA-Serie A,2018,Roma,Davide Santon,ITA,DF,27,1991,11.2,14,6,8,6,0,8,12,66.7,4,11,7,4,15,29,27,0,2019
ITA-Serie A,2018,Roma,Diego Perotti,ARG,"FW,MF",30,1988,7.4,14,12,5,5,4,6,19,31.6,13,4,0,4,4,18,2,0,2019
ITA-Serie A,2018,Roma,Edin Džeko,BIH,FW,32,1986,28.7,13,7,3,5,5,4,16,25.0,12,10,1,9,0,13,36,1,2019
ITA-Serie A,2018,Roma,Federico Fazio,ARG,DF,31,1987,31.2,28,20,14,11,3,12,25,48.0,13,45,33,12,53,81,171,2,2019
ITA-Serie A,2018,Roma,Iván Marcano,ESP,DF,31,1987,9.0,8,4,4,4,0,5,8,62.5,3,13,6,7,24,32,45,0,2019
ITA-Serie A,2018,Roma,Javier Pastore,ARG,"MF,FW",29,1989,6.6,10,4,4,3,3,4,16,25.0,12,7,0,7,3,13,5,0,2019
ITA-Serie A,2018,Roma,Juan Jesus,BRA,DF,27,1991,15.6,37,29,30,5,2,17,30,56.7,13,20,12,8,16,53,41,0,2019
ITA-Serie A,2018,Roma,Justin Kluivert,NED,FW,19,1999,14.9,28,27,12,9,7,10,23,43.5,13,17,0,17,7,35,12,0,2019
ITA-Serie A,2018,Roma,Kevin Strootman,NED,MF,28,1990,1.0,2,2,1,0,1,0,1,0.0,1,5,0,5,2,4,2,0,2019
ITA-Serie A,2018,Roma,Kostas Manolas,GRE,DF,27,1991,25.8,32,24,23,8,1,17,26,65.4,9,34,25,9,50,82,117,2,2019
ITA-Serie A,2018,Roma,Lorenzo Pellegrini,ITA,MF,22,1996,20.2,39,23,16,18,5,10,30,33.3,20,20,2,18,12,51,21,0,2019
ITA-Serie A,2018,Roma,Luca Pellegrini,ITA,DF,19,1999,1.8,1,1,1,0,0,1,2,50.0,1,2,1,1,3,4,2,0,2019
ITA-Serie A,2018,Roma,Nicolò Zaniolo,ITA,"MF,FW",19,1999,19.6,35,21,7,18,10,7,37,18.9,30,14,0,14,13,48,8,0,2019
ITA-Serie A,2018,Roma,Patrik Schick,CZE,"FW,MF",22,1996,14.6,11,5,3,5,3,1,19,5.3,18,19,2,17,3,14,15,1,2019
ITA-Serie A,2018,Roma,Rick Karsdorp,NED,DF,23,1995,6.6,9,6,3,5,1,5,11,45.5,6,4,2,2,12,21,12,1,2019
ITA-Serie A,2018,Roma,Robin Olsen,SWE,GK,28,1990,27.0,0,0,0,0,0,0,1,0.0,1,1,0,1,0,0,10,4,2019
ITA-Serie A,2018,Roma,Stephan El Shaarawy,ITA,"FW,MF",25,1992,23.4,27,14,14,8,5,9,24,37.5,15,11,2,9,20,47,9,0,2019
ITA-Serie A,2018,Roma,Steven Nzonzi,FRA,MF,29,1988,29.1,66,45,24,36,6,21,34,61.8,13,40,24,16,27,93,55,2,2019
ITA-Serie A,2018,Roma,Žan Celar,SVN,FW,19,1999,0.1,0,0,0,0,0,0,0,,0,0,0,0,0,0,0,0,2019
ITA-Serie A,2018,SPAL,Alberto Paloschi,ITA,FW,28,1990,9.6,13,9,3,5,5,1,2,50.0,1,2,0,2,1,14,0,0,2019
ITA-Serie A,2018,SPAL,Alessandro Murgia,ITA,MF,21,1996,11.9,22,15,9,12,1,7,32,21.9,25,14,2,12,19,41,12,1,2019
ITA-Serie A,2018,SPAL,Alfred Gomis,SEN,GK,24,1993,19.2,0,0,0,0,0,0,1,0.0,1,0,0,0,1,1,14,1,2019
ITA-Serie A,2018,SPAL,Andrea Petagna,ITA,FW,23,1995,33.7,15,6,5,5,5,2,9,22.2,7,23,8,15,4,19,15,0,2019
ITA-Serie A,2018,SPAL,Emiliano Viviano,ITA,GK,32,1985,16.9,0,0,0,0,0,0,0,,0,0,0,0,0,0,5,2,2019
ITA-Serie A,2018,SPAL,Everton Luiz,BRA,MF,30,1988,3.5,11,6,5,5,1,4,7,57.1,3,9,1,8,3,14,7,2,2019
ITA-Serie A,2018,SPAL,Felipe dal Belo,BRA,DF,34,1984,26.2,36,25,21,13,2,16,32,50.0,16,29,18,11,17,53,88,1,2019
ITA-Serie A,2018,SPAL,Filippo Costa,ITA,"DF,FW",23,1995,6.3,15,13,6,6,3,4,9,44.4,5,10,3,7,8,23,31,1,2019
ITA-Serie A,2018,SPAL,Francesco Vicari,ITA,DF,23,1994,25.9,28,24,21,7,0,18,28,64.3,10,31,24,7,34,62,139,1,2019
ITA-Serie A,2018,SPAL,Gabriele Moncini,ITA,MF,22,1996,0.1,1,1,1,0,0,0,0,,0,0,0,0,0,1,0,0,2019
ITA-Serie A,2018,SPAL,Giacomo Poluzzi,ITA,GK,30,1988,0.1,0,0,0,0,0,0,0,,0,0,0,0,0,0,0,0,2019
ITA-Serie A,2018,SPAL,Jasmin Kurtić,SVN,MF,29,1989,28.4,35,20,19,13,3,13,41,31.7,28,30,3,27,20,55,52,0,2019
ITA-Serie A,2018,SPAL,Johan Djourou,SUI,DF,31,1987,3.1,3,1,3,0,0,2,2,100.0,0,5,3,2,4,7,20,0,2019
ITA-Serie A,2018,SPAL,Kevin Bonifazi,ITA,DF,22,1996,25.6,40,24,31,8,1,15,33,45.5,18,38,21,17,36,76,79,0,2019
ITA-Serie A,2018,SPAL,Lorenco Šimić,CRO,DF,22,1996,2.6,6,3,5,1,0,2,4,50.0,2,2,1,1,12,18,19,1,2019
ITA-Serie A,2018,SPAL,Lorenzo Dickmann,ITA,"DF,MF",21,1996,1.9,5,4,4,1,0,5,7,71.4,2,0,0,0,1,6,5,0,2019
ITA-Serie A,2018,SPAL,Manuel Lazzari,ITA,DF,24,1993,31.5,29,17,16,10,3,13,24,54.2,11,26,5,21,20,49,51,1,2019
ITA-Serie A,2018,SPAL,Marko Janković,MNE,"DF,MF",23,1995,0.6,3,1,2,1,0,0,2,0.0,2,0,0,0,0,3,0,0,2019
ITA-Serie A,2018,SPAL,Mattia Valoti,ITA,MF,24,1993,13.6,33,19,13,14,6,13,29,44.8,16,23,0,23,19,52,17,1,2019
ITA-Serie A,2018,SPAL,Mirco Antenucci,ITA,FW,33,1984,23.7,11,9,5,1,5,1,10,10.0,9,14,0,14,5,16,5,0,2019
ITA-Serie A,2018,SPAL,Mirko Valdifiori,ITA,MF,32,1986,7.4,20,15,12,7,1,8,14,57.1,6,4,2,2,5,25,9,0,2019
ITA-Serie A,2018,SPAL,Mohamed Fares,ALG,DF,22,1996,32.8,63,43,37,18,8,25,54,46.3,29,48,4,44,54,117,83,2,2019
ITA-Serie A,2018,SPAL,Pasquale Schiattarella,ITA,MF,31,1987,20.5,43,27,18,21,4,13,38,34.2,25,17,5,12,22,65,25,1,2019
ITA-Serie A,2018,SPAL,Sergio Floccari,ITA,FW,36,1981,10.8,13,5,1,5,7,1,7,14.3,6,6,2,4,2,15,6,0,2019
ITA-Serie A,2018,SPAL,Simone Missiroli,ITA,MF,32,1986,30.5,58,43,31,22,5,25,49,51.0,24,44,11,33,46,104,46,0,2019
ITA-Serie A,2018,SPAL,Thiago Cionek,POL,DF,32,1986,28.2,75,44,46,25,4,29,56,51.8,27,34,22,12,55,130,144,0,2019
ITA-Serie A,2018,SPAL,Vanja Milinković-Savić,SRB,GK,21,1997,1.8,0,0,0,0,0,0,0,,0,0,0,0,0,0,1,0,2019
ITA-Serie A,2018,SPAL,Vasco Regini,ITA,"DF,FW",27,1990,0.9,1,0,0,1,0,1,3,33.3,2,2,1,1,0,1,4,0,2019
ITA-Serie A,2018,Sampdoria,Albin Ekdal,SWE,MF,29,1989,29.4,61,39,16,38,7,37,68,54.4,31,42,12,30,53,114,62,1,2019
ITA-Serie A,2018,Sampdoria,Alex Ferrari,ITA,DF,24,1994,6.0,10,8,4,6,0,5,7,71.4,2,7,4,3,9,19,26,0,2019
ITA-Serie A,2018,Sampdoria,Bartosz Bereszyński,POL,DF,26,1992,24.4,46,30,27,15,4,24,51,47.1,27,22,7,15,31,77,76,0,2019
ITA-Serie A,2018,Sampdoria,Dawid Kownacki,POL,FW,21,1997,1.9,2,1,0,1,1,1,4,25.0,3,0,0,0,0,2,0,0,2019
ITA-Serie A,2018,Sampdoria,Dennis Praet,BEL,MF,24,1994,32.1,62,44,30,25,7,27,51,52.9,24,33,4,29,36,98,31,0,2019
ITA-Serie A,2018,Sampdoria,Emil Audero,ITA,GK,21,1997,36.0,4,3,4,0,0,3,3,100.0,0,0,0,0,1,5,21,4,2019
ITA-Serie A,2018,Sampdoria,Fabio Quagliarella,ITA,FW,35,1983,35.5,14,8,6,4,4,2,15,13.3,13,32,1,31,8,22,17,0,2019
ITA-Serie A,2018,Sampdoria,Gastón Ramírez,URU,MF,27,1990,17.5,38,22,12,18,8,11,31,35.5,20,28,4,24,8,46,27,0,2019
ITA-Serie A,2018,Sampdoria,Gianluca Caprari,ITA,"FW,MF",25,1993,11.5,15,9,4,9,2,5,12,41.7,7,7,0,7,4,19,3,0,2019
ITA-Serie A,2018,Sampdoria,Grégoire Defrel,MTQ,"FW,MF",27,1991,26.0,40,29,10,16,14,9,21,42.9,12,15,0,15,3,43,9,0,2019
ITA-Serie A,2018,Sampdoria,Jacopo Sala,ITA,DF,26,1991,16.9,38,23,20,14,4,23,41,56.1,18,11,3,8,20,58,47,2,2019
ITA-Serie A,2018,Sampdoria,Jakub Jankto,CZE,MF,22,1996,10.7,7,4,5,2,0,4,15,26.7,11,18,2,16,9,16,16,0,2019
ITA-Serie A,2018,Sampdoria,Joachim Andersen,DEN,DF,22,1996,32.0,40,27,31,8,1,19,31,61.3,12,30,15,15,35,75,147,1,2019
ITA-Serie A,2018,Sampdoria,Júnior Tavares,BRA,DF,21,1996,2.0,2,1,1,1,0,2,4,50.0,2,0,0,0,2,4,1,0,2019
ITA-Serie A,2018,Sampdoria,Karol Linetty,POL,MF,23,1995,27.9,72,48,26,32,14,15,69,21.7,54,39,4,35,25,97,17,0,2019
ITA-Serie A,2018,Sampdoria,Lorenzo Tonelli,ITA,DF,28,1990,18.4,31,22,19,9,3,15,19,78.9,4,27,21,6,24,55,92,0,2019
ITA-Serie A,2018,Sampdoria,Manolo Gabbiadini,ITA,FW,26,1991,9.0,5,2,1,3,1,3,11,27.3,8,6,1,5,4,9,4,0,2019
ITA-Serie A,2018,Sampdoria,Marco Sau,ITA,"MF,FW",30,1987,0.6,0,0,0,0,0,0,0,,0,1,0,1,0,0,0,0,2019
ITA-Serie A,2018,Sampdoria,Nicola Murru,ITA,DF,23,1994,32.6,83,59,42,25,16,41,54,75.9,13,50,22,28,41,124,99,0,2019
ITA-Serie A,2018,Sampdoria,Omar Colley,GAM,DF,25,1992,19.6,18,11,12,6,0,12,13,92.3,1,24,16,8,22,40,102,0,2019
ITA-Serie A,2018,Sampdoria,Rafael Cabral,BRA,GK,28,1990,2.0,0,0,0,0,0,0,0,,0,0,0,0,0,0,0,0,2019
ITA-Serie A,2018,Sampdoria,Riccardo Saponara,ITA,MF,26,1991,10.1,12,6,2,6,4,3,12,25.0,9,5,1,4,4,16,10,0,2019
ITA-Serie A,2018,Sampdoria,Ronaldo Vieira,GNB,MF,20,1998,6.7,,10,,,,,,,,,,,7,,,,2019
ITA-Serie A,2018,Sampdoria,Édgar Barreto,PAR,MF,34,1984,8.7,28,19,15,6,7,10,26,38.5,16,11,3,8,17,45,7,0,2019
ITA-Serie A,2018,Sassuolo,Alessandro Matri,ITA,FW,33,1984,6.7,2,1,0,0,2,0,3,0.0,3,4,2,2,4,6,7,0,2019
ITA-Serie A,2018,Sassuolo,Alfred Duncan,GHA,MF,25,1993,20.5,33,21,15,15,3,19,48,39.6,29,20,6,14,15,48,18,0,2019
ITA-Serie A,2018,Sassuolo,Andrea Consigli,ITA,GK,31,1987,35.7,0,0,0,0,0,0,2,0.0,2,0,0,0,1,1,15,6,2019
ITA-Serie A,2018,Sassuolo,Claud Adjapong,ITA,"MF,FW",20,1998,3.0,4,2,1,3,0,1,2,50.0,1,3,1,2,1,5,4,0,2019
ITA-Serie A,2018,Sassuolo,Cristian Dell'Orco,ITA,DF,24,1994,1.2,1,1,1,0,0,1,3,33.3,2,1,0,1,1,2,3,0,2019
ITA-Serie A,2018,Sassuolo,Domenico Berardi,ITA,"FW,MF",23,1994,31.9,38,21,16,9,13,15,73,20.5,58,31,2,29,27,65,24,0,2019
ITA-Serie A,2018,Sassuolo,Enrico Brignola,ITA,"FW,MF",19,1999,1.9,2,2,2,0,0,0,2,0.0,2,0,0,0,1,3,1,0,2019
ITA-Serie A,2018,Sassuolo,Federico Di Francesco,ITA,"FW,MF",24,1994,11.9,10,6,3,4,3,4,7,57.1,3,12,1,11,5,15,5,0,2019
ITA-Serie A,2018,Sassuolo,Federico Peluso,ITA,DF,34,1984,15.1,23,14,15,5,3,13,16,81.3,3,8,3,5,23,46,70,0,2019
ITA-Serie A,2018,Sassuolo,Filip Đuričić,SRB,"FW,MF",26,1992,13.9,17,13,2,11,4,5,22,22.7,17,20,1,19,8,25,8,1,2019
ITA-Serie A,2018,Sassuolo,Francesco Magnanelli,ITA,MF,33,1984,20.7,52,33,29,22,1,22,49,44.9,27,18,5,13,24,76,38,2,2019
ITA-Serie A,2018,Sassuolo,Giacomo Raspadori,ITA,DF,18,2000,0.0,0,0,0,0,0,0,0,,0,0,0,0,0,0,0,0,2019
ITA-Serie A,2018,Sassuolo,Gian Marco Ferrari,ITA,DF,26,1992,31.0,41,23,27,12,2,12,16,75.0,4,36,20,16,36,77,97,1,2019
ITA-Serie A,2018,Sassuolo,Giangiacomo Magnani,ITA,DF,22,1995,16.8,11,9,9,2,0,6,15,40.0,9,17,13,4,16,27,99,1,2019
ITA-Serie A,2018,Sassuolo,Gianluca Pegolo,ITA,GK,37,1981,2.3,0,0,0,0,0,0,0,,0,0,0,0,0,0,0,0,2019
ITA-Serie A,2018,Sassuolo,Jens Odgaard,DEN,FW,19,1999,0.2,0,0,0,0,0,0,0,,0,1,0,1,0,0,1,0,2019
ITA-Serie A,2018,Sassuolo,Jeremie Boga,CIV,"FW,MF",21,1997,16.0,7,4,5,1,1,4,14,28.6,10,19,0,19,2,9,4,0,2019
ITA-Serie A,2018,Sassuolo,Kevin-Prince Boateng,GHA,FW,31,1987,10.4,5,4,0,4,1,1,4,25.0,3,7,3,4,3,8,13,0,2019
ITA-Serie A,2018,Sassuolo,Khouma Babacar,SEN,FW,25,1993,16.5,7,3,2,5,0,2,10,20.0,8,8,2,6,3,10,25,1,2019
ITA-Serie A,2018,Sassuolo,Leonardo Sernicola,ITA,FW,21,1997,0.1,0,0,0,0,0,0,0,,0,0,0,0,0,0,0,0,2019
ITA-Serie A,2018,Sassuolo,Manuel Locatelli,ITA,MF,20,1998,20.5,44,28,19,15,10,13,29,44.8,16,21,3,18,27,71,33,1,2019
ITA-Serie A,2018,Sassuolo,Marcello Trotta,ITA,MF,25,1992,0.1,0,0,0,0,0,0,1,0.0,1,0,0,0,0,0,0,0,2019
ITA-Serie A,2018,Sassuolo,Marlon,BRA,DF,22,1995,16.8,29,18,25,3,1,15,21,71.4,6,22,12,10,24,53,39,0,2019
ITA-Serie A,2018,Sassuolo,Mauricio Lemos,URU,DF,22,1995,2.0,2,1,2,0,0,1,2,50.0,1,2,1,1,3,5,10,1,2019
ITA-Serie A,2018,Sassuolo,Mehdi Bourabia,MAR,MF,26,1991,22.3,51,28,23,21,7,15,46,32.6,31,28,5,23,33,84,32,0,2019
ITA-Serie A,2018,Sassuolo,Merih Demiral,TUR,DF,20,1998,14.0,24,16,23,1,0,10,13,76.9,3,16,11,5,19,43,80,0,2019
ITA-Serie A,2018,Sassuolo,Pol Lirola,ESP,"DF,MF",20,1997,33.1,35,22,19,11,5,21,34,61.8,13,25,5,20,32,67,89,0,2019
ITA-Serie A,2018,Sassuolo,Rogério,BRA,"DF,MF",20,1998,29.7,55,38,35,13,7,30,55,54.5,25,32,7,25,37,92,109,1,2019
ITA-Serie A,2018,Sassuolo,Stefano Sensi,ITA,MF,22,1995,21.9,36,20,15,18,3,6,30,20.0,24,36,7,29,33,69,17,0,2019
ITA-Serie A,2018,Torino,Adem Ljajić,SRB,MF,26,1991,0.3,0,0,0,0,0,0,1,0.0,1,0,0,0,0,0,0,0,2019
ITA-Serie A,2018,Torino,Andrea Belotti,ITA,FW,24,1993,36.7,33,22,8,15,10,6,30,20.0,24,36,5,31,15,48,23,0,2019
ITA-Serie A,2018,Torino,Armando Izzo,ITA,DF,26,1992,36.3,76,50,35,35,6,33,53,62.3,20,52,24,28,88,164,149,2,2019
ITA-Serie A,2018,Torino,Cristian Ansaldi,ARG,"DF,MF",31,1986,20.1,50,26,19,21,10,15,30,50.0,15,21,4,17,15,65,31,0,2019
ITA-Serie A,2018,Torino,Daniele Baselli,ITA,MF,26,1992,26.4,65,45,22,34,9,16,44,36.4,28,30,6,24,34,99,32,0,2019
ITA-Serie A,2018,Torino,Emiliano Moretti,ITA,DF,37,1981,22.3,30,21,21,9,0,13,20,65.0,7,14,6,8,24,54,65,1,2019
ITA-Serie A,2018,Torino,Gleison Bremer,BRA,DF,21,1997,2.0,3,1,1,2,0,1,2,50.0,1,4,1,3,8,11,9,0,2019
ITA-Serie A,2018,Torino,Iago Falque,ESP,"FW,MF",28,1990,17.9,13,8,3,8,2,3,16,18.8,13,14,0,14,3,16,2,0,2019
ITA-Serie A,2018,Torino,Koffi Djidji,CIV,DF,25,1992,15.4,37,23,27,9,1,12,20,60.0,8,26,19,7,24,61,72,1,2019
ITA-Serie A,2018,Torino,Lorenzo De Silvestri,ITA,DF,30,1988,26.8,15,11,8,5,2,7,24,29.2,17,53,3,50,22,37,69,2,2019
ITA-Serie A,2018,Torino,Lyanco,BRA,DF,21,1997,1.0,1,1,1,0,0,0,0,,0,1,1,0,4,5,5,0,2019
ITA-Serie A,2018,Torino,Nicolas Nkoulou,CMR,DF,28,1990,35.7,45,29,34,10,1,15,25,60.0,10,42,28,14,70,115,174,2,2019
ITA-Serie A,2018,Torino,Ola Aina,NGA,DF,21,1996,24.0,54,36,32,20,2,23,48,47.9,25,30,3,27,39,93,59,2,2019
ITA-Serie A,2018,Torino,Roberto Soriano,ITA,MF,27,1991,5.2,9,5,0,5,4,1,8,12.5,7,9,0,9,6,15,1,0,2019
ITA-Serie A,2018,Torino,Salvador Ichazo,URU,GK,26,1992,2.8,0,0,0,0,0,0,0,,0,0,0,0,0,0,0,0,2019
ITA-Serie A,2018,Torino,Salvatore Sirigu,ITA,GK,31,1987,35.2,0,0,0,0,0,0,2,0.0,2,0,0,0,2,2,21,1,2019
ITA-Serie A,2018,Torino,Saša Lukić,SRB,MF,21,1996,11.0,21,11,5,11,5,5,16,31.3,11,13,4,9,12,33,11,0,2019
ITA-Serie A,2018,Torino,Simone Edera,ITA,MF,21,1997,0.9,0,0,0,0,0,0,1,0.0,1,1,0,1,1,1,0,0,2019
ITA-Serie A,2018,Torino,Simone Zaza,ITA,"FW,MF",27,1991,16.0,20,9,3,12,5,1,8,12.5,7,12,1,11,4,24,9,0,2019
ITA-Serie A,2018,Torino,Soualiho Meïté,FRA,MF,24,1994,29.5,46,21,13,22,11,23,46,50.0,23,46,6,40,29,75,26,0,2019
ITA-Serie A,2018,Torino,Tomás Rincón,VEN,MF,30,1988,31.1,75,44,25,41,9,31,68,45.6,37,35,5,30,42,117,71,1,2019
ITA-Serie A,2018,Torino,Vincenzo Millico,ITA,MF,17,2000,0.0,0,0,0,0,0,0,0,,0,0,0,0,0,0,0,0,2019
ITA-Serie A,2018,Torino,Vitalie Damașcan,MDA,MF,19,1999,0.0,1,1,0,1,0,1,1,100.0,0,0,0,0,0,1,0,0,2019
ITA-Serie A,2018,Torino,Vittorio Parigini,ITA,"MF,DF",22,1996,4.2,11,10,3,6,2,6,9,66.7,3,3,0,3,1,12,5,0,2019
ITA-Serie A,2018,Torino,Álex Berenguer,ESP,"MF,DF",23,1995,16.5,31,20,12,17,2,14,34,41.2,20,20,1,19,8,39,14,0,2019
ITA-Serie A,2018,Udinese,Andrija Balić,CRO,"FW,MF",20,1997,0.3,1,0,0,0,1,0,1,0.0,1,0,0,0,0,1,1,0,2019
ITA-Serie A,2018,Udinese,Antonín Barák,CZE,"MF,FW",23,1994,3.7,9,6,4,5,0,2,11,18.2,9,4,0,4,2,11,2,0,2019
ITA-Serie A,2018,Udinese,Ben Wilmot,ENG,"DF,MF",18,1999,2.2,0,0,0,0,0,0,2,0.0,2,2,2,0,2,2,11,0,2019
ITA-Serie A,2018,Udinese,Bram Nuytinck,NED,DF,28,1990,23.6,50,35,34,13,3,25,33,75.8,8,44,27,17,29,79,126,0,2019
ITA-Serie A,2018,Udinese,Darwin Machís,VEN,"FW,MF",25,1993,5.1,7,6,4,3,0,0,4,0.0,4,6,0,6,2,9,8,0,2019
ITA-Serie A,2018,Udinese,Emil Hallfreðsson,ISL,MF,34,1984,1.5,0,0,0,0,0,0,1,0.0,1,1,1,0,3,3,4,0,2019
ITA-Serie A,2018,Udinese,Emmanuel Agyemang-Badu,GHA,MF,27,1990,1.8,4,0,1,2,1,1,1,100.0,0,2,0,2,1,5,2,0,2019
ITA-Serie A,2018,Udinese,Felipe Vizeu,BRA,"FW,DF",21,1997,0.4,0,0,0,0,0,0,0,,0,0,0,0,0,0,0,0,2019
ITA-Serie A,2018,Udinese,Giuseppe Pezzella,ITA,DF,20,1997,2.0,5,4,4,1,0,2,8,25.0,6,2,1,1,1,6,9,0,2019
ITA-Serie A,2018,Udinese,Hidde ter Avest,NED,"DF,FW",21,1997,10.8,26,14,17,6,3,14,20,70.0,6,14,3,11,10,36,39,1,2019
ITA-Serie A,2018,Udinese,Ignacio Pussetto,ARG,"FW,MF",22,1995,24.2,65,40,25,30,10,15,43,34.9,28,28,3,25,29,94,34,0,2019
ITA-Serie A,2018,Udinese,Jens Stryger Larsen,DEN,DF,27,1991,35.9,42,20,24,14,4,22,44,50.0,22,27,8,19,26,68,98,1,2019
ITA-Serie A,2018,Udinese,Juan Musso,ARG,GK,24,1994,29.0,0,0,0,0,0,0,1,0.0,1,0,0,0,0,0,10,4,2019
ITA-Serie A,2018,Udinese,Kevin Lasagna,ITA,FW,25,1992,27.3,6,1,0,3,3,2,12,16.7,10,20,2,18,8,14,35,0,2019
ITA-Serie A,2018,Udinese,Marco D'Alessandro,ITA,DF,27,1991,16.6,55,34,34,15,6,29,49,59.2,20,24,2,22,9,64,50,1,2019
ITA-Serie A,2018,Udinese,Marvin Zeegelaar,NED,DF,27,1990,10.6,30,23,21,6,3,16,24,66.7,8,11,2,9,17,47,38,0,2019
ITA-Serie A,2018,Udinese,Molla Wagué,MLI,DF,27,1991,1.1,1,1,1,0,0,0,1,0.0,1,1,0,1,4,5,5,0,2019
ITA-Serie A,2018,Udinese,Nicholas Opoku,GHA,DF,20,1997,10.1,16,9,15,1,0,10,17,58.8,7,8,5,3,18,34,29,0,2019
ITA-Serie A,2018,Udinese,Petar Mićin,SRB,MF,19,1998,0.0,0,0,0,0,0,0,0,,0,0,0,0,0,0,0,0,2019
ITA-Serie A,2018,Udinese,Rodrigo De Paul,ARG,"MF,FW",24,1994,35.4,53,33,21,27,5,13,42,31.0,29,35,2,33,32,85,28,0,2019
ITA-Serie A,2018,Udinese,Rolando Mandragora,ITA,MF,21,1997,32.4,66,35,25,34,7,24,69,34.8,45,49,9,40,43,109,59,0,2019
ITA-Serie A,2018,Udinese,Samir Santos,BRA,DF,23,1994,20.0,47,33,27,18,2,19,25,76.0,6,18,9,9,34,81,96,0,2019
ITA-Serie A,2018,Udinese,Sandro,BRA,MF,29,1989,6.6,18,10,10,8,0,7,13,53.8,6,14,5,9,11,29,16,0,2019
ITA-Serie A,2018,Udinese,Sebastien De Maio,FRA,DF,31,1987,13.0,11,7,7,4,0,3,12,25.0,9,22,17,5,12,23,93,0,2019
ITA-Serie A,2018,Udinese,Seko Fofana,CIV,MF,23,1995,29.3,25,13,14,10,1,6,36,16.7,30,20,7,13,29,54,18,3,2019
ITA-Serie A,2018,Udinese,Simone Scuffet,ITA,GK,22,1996,9.0,0,0,0,0,0,0,1,0.0,1,0,0,0,0,0,4,2,2019
ITA-Serie A,2018,Udinese,Stefano Okaka,ITA,FW,28,1989,10.8,13,7,4,5,4,2,8,25.0,6,6,1,5,0,13,16,1,2019
ITA-Serie A,2018,Udinese,Svante Ingelsson,SWE,"DF,MF",20,1998,1.1,1,1,1,0,0,0,0,,0,2,0,2,0,1,4,0,2019
ITA-Serie A,2018,Udinese,Valon Behrami,SUI,MF,33,1985,15.1,65,38,25,34,6,18,44,40.9,26,29,12,17,18,83,26,0,2019
ITA-Serie A,2018,Udinese,William Troost-Ekong,NGA,DF,24,1993,34.0,31,15,21,9,1,13,24,54.2,11,53,41,12,40,71,200,2,2019
ITA-Serie A,2018,Udinese,Łukasz Teodorczyk,POL,FW,27,1991,4.4,4,2,2,2,0,2,8,25.0,6,8,2,6,1,5,4,0,2019
ITA-Serie A,2019,Atalanta,Adrien Tameze,CMR,MF,25,1994,2.3,4,3,1,1,2,1,2,50.0,1,3,1,2,3,7,4,1,2020
ITA-Serie A,2019,Atalanta,Amad Diallo,CIV,FW,17,2002,0.3,1,1,0,1,0,0,0,,0,0,0,0,0,1,0,0,2020
ITA-Serie A,2019,Atalanta,Andrea Masiello,ITA,DF,33,1986,6.0,11,4,6,4,1,7,14,50.0,7,6,4,2,10,21,13,0,2020
ITA-Serie A,2019,Atalanta,Berat Djimsiti,ALB,DF,26,1993,30.9,42,23,17,23,2,22,39,56.4,17,21,14,7,49,91,92,0,2020
ITA-Serie A,2019,Atalanta,Bosko Sutalo,CRO,DF,19,2000,3.1,3,2,2,1,0,0,2,0.0,2,4,0,4,6,9,6,1,2020
ITA-Serie A,2019,Atalanta,Duván Zapata,COL,FW,28,1991,22.5,7,3,1,2,4,1,6,16.7,5,18,7,11,2,9,11,0,2020
ITA-Serie A,2019,Atalanta,Ebrima Colley,GAM,FW,19,2000,0.9,2,1,1,0,1,1,2,50.0,1,1,0,1,1,3,0,0,2020
ITA-Serie A,2019,Atalanta,Francesco Rossi,ITA,GK,28,1991,0.1,0,0,0,0,0,0,0,,0,0,0,0,0,0,0,0,2020
ITA-Serie A,2019,Atalanta,Guilherme Arana,BRA,DF,22,1997,0.9,4,4,1,3,0,3,5,60.0,2,0,0,0,2,6,0,0,2020
ITA-Serie A,2019,Atalanta,Hans Hateboer,NED,DF,25,1994,26.2,36,23,20,9,7,18,38,47.4,20,22,7,15,10,46,32,1,2020
ITA-Serie A,2019,Atalanta,Jacopo Da Riva,ITA,MF,18,2000,0.0,0,0,0,0,0,0,0,,0,0,0,0,0,0,0,0,2020
ITA-Serie A,2019,Atalanta,Josip Iličić,SVN,"FW,MF",31,1988,18.5,26,19,7,10,9,7,28,25.0,21,9,0,9,9,35,4,0,2020
ITA-Serie A,2019,Atalanta,José Luis Palomino,ARG,DF,29,1990,27.6,81,44,46,33,2,28,54,51.9,26,39,14,25,61,142,74,2,2020
ITA-Serie A,2019,Atalanta,Lennart-Marten Czyborra,GER,DF,20,1999,0.2,0,0,0,0,0,0,0,,0,2,0,2,0,0,0,0,2020
ITA-Serie A,2019,Atalanta,Luis Muriel,COL,FW,28,1991,14.0,15,9,3,8,4,3,14,21.4,11,12,0,12,4,19,0,0,2020
ITA-Serie A,2019,Atalanta,Marco Sportiello,ITA,GK,27,1992,5.8,0,0,0,0,0,0,0,,0,0,0,0,0,0,3,0,2020
ITA-Serie A,2019,Atalanta,Mario Pašalić,CRO,MF,24,1995,26.9,47,21,17,18,12,16,52,30.8,36,27,7,20,27,74,22,2,2020
ITA-Serie A,2019,Atalanta,Marten de Roon,NED,"MF,DF",28,1991,30.2,77,43,36,29,12,34,75,45.3,41,32,8,24,46,123,45,0,2020
ITA-Serie A,2019,Atalanta,Mattia Caldara,ITA,DF,25,1994,10.7,21,11,12,8,1,5,11,45.5,6,9,5,4,30,51,22,1,2020
ITA-Serie A,2019,Atalanta,Musa Barrow,GAM,"FW,MF",20,1998,2.1,1,1,0,0,1,1,4,25.0,3,4,0,4,0,1,1,0,2020
ITA-Serie A,2019,Atalanta,Papu Gómez,ARG,"MF,FW",31,1988,31.6,27,13,5,13,9,13,45,28.9,32,24,0,24,17,44,6,1,2020
ITA-Serie A,2019,Atalanta,Pierluigi Gollini,ITA,GK,24,1995,32.0,0,0,0,0,0,0,2,0.0,2,0,0,0,0,0,13,2,2020
ITA-Serie A,2019,Atalanta,Rafael Tolói,ITA,DF,28,1990,29.0,56,29,28,23,5,33,76,43.4,43,31,17,14,45,101,80,0,2020
ITA-Serie A,2019,Atalanta,Raoul Bellanova,ITA,DF,19,2000,0.2,0,0,0,0,0,0,0,,0,0,0,0,0,0,0,0,2020
ITA-Serie A,2019,Atalanta,Remo Freuler,SUI,MF,27,1992,26.0,51,30,18,25,8,22,63,34.9,41,41,6,35,28,79,26,0,2020
ITA-Serie A,2019,Atalanta,Roberto Piccoli,ITA,FW,18,2001,0.2,0,0,0,0,0,0,0,,0,1,0,1,0,0,0,0,2020
ITA-Serie A,2019,Atalanta,Robin Gosens,GER,DF,25,1994,29.1,53,27,19,26,8,23,51,45.1,28,38,10,28,39,92,40,0,2020
ITA-Serie A,2019,Atalanta,Ruslan Malinovskyi,UKR,"MF,FW",26,1993,17.1,22,14,2,17,3,9,31,29.0,22,13,2,11,5,27,5,0,2020
ITA-Serie A,2019,Atalanta,Simon Kjær,DEN,DF,30,1989,3.2,9,6,1,8,0,3,4,75.0,1,5,4,1,7,16,10,1,2020
ITA-Serie A,2019,Atalanta,Timothy Castagne,BEL,DF,23,1995,19.7,31,20,9,16,6,13,25,52.0,12,34,5,29,17,48,23,0,2020
ITA-Serie A,2019,Bologna,Andrea Poli,ITA,MF,29,1989,21.3,44,24,19,21,4,16,52,30.8,36,19,3,16,40,84,11,0,2020
ITA-Serie A,2019,Bologna,Andreas Skov Olsen,DEN,"FW,MF",19,1999,8.4,11,8,5,5,1,4,12,33.3,8,10,1,9,8,19,5,0,2020
ITA-Serie A,2019,Bologna,Andri Fannar Baldursson,ISL,MF,17,2002,1.6,1,0,0,1,0,0,1,0.0,1,2,0,2,1,2,3,0,2020
ITA-Serie A,2019,Bologna,Angelo da Costa Júnior,BRA,GK,35,1983,1.0,0,0,0,0,0,0,0,,0,0,0,0,0,0,0,0,2020
ITA-Serie A,2019,Bologna,Blerim Džemaili,SUI,MF,33,1986,7.8,19,12,3,13,3,4,22,18.2,18,9,3,6,7,26,6,0,2020
ITA-Serie A,2019,Bologna,Danilo Larangeira,BRA,DF,35,1984,29.3,34,17,19,15,0,16,28,57.1,12,54,39,15,30,64,99,0,2020
ITA-Serie A,2019,Bologna,Dion Ruffo Luci,ITA,MF,18,2001,0.0,0,0,0,0,0,0,0,,0,0,0,0,0,0,0,0,2020
ITA-Serie A,2019,Bologna,Federico Bonini,ITA,DF,17,2001,0.1,0,0,0,0,0,0,0,,0,0,0,0,0,0,0,0,2020
ITA-Serie A,2019,Bologna,Federico Santander,PAR,FW,28,1991,8.6,13,8,3,0,10,1,4,25.0,3,3,0,3,7,20,12,0,2020
ITA-Serie A,2019,Bologna,Gabriele Corbo,ITA,DF,19,2000,1.4,1,1,1,0,0,0,3,0.0,3,2,2,0,4,5,5,0,2020
ITA-Serie A,2019,Bologna,Gary Medel,CHI,MF,31,1987,19.8,43,22,15,24,4,16,43,37.2,27,24,8,16,34,77,31,2,2020
ITA-Serie A,2019,Bologna,Gianmarco Cangiano,ITA,"FW,MF",17,2001,0.2,1,1,0,1,0,0,0,,0,0,0,0,1,2,0,0,2020
ITA-Serie A,2019,Bologna,Ibrahima Mbaye,SEN,DF,24,1994,16.7,19,10,13,4,2,7,17,41.2,10,22,11,11,15,34,42,0,2020
ITA-Serie A,2019,Bologna,Jerdy Schouten,NED,MF,22,1997,12.0,26,16,13,11,2,10,26,38.5,16,19,7,12,26,52,22,0,2020
ITA-Serie A,2019,Bologna,Kingsley Michael,NGA,MF,19,1999,0.8,2,1,0,2,0,0,0,,0,0,0,0,1,3,1,0,2020
ITA-Serie A,2019,Bologna,Ladislav Krejčí,CZE,DF,27,1992,11.7,15,10,6,7,2,9,19,47.4,10,7,4,3,10,25,23,0,2020
ITA-Serie A,2019,Bologna,Mattia Bani,ITA,DF,25,1993,24.5,47,28,27,19,1,25,36,69.4,11,29,15,14,52,99,92,2,2020
ITA-Serie A,2019,Bologna,Mattia Destro,ITA,FW,28,1991,2.1,3,2,1,2,0,1,3,33.3,2,1,0,1,0,3,0,0,2020
ITA-Serie A,2019,Bologna,Mattias Svanberg,SWE,MF,20,1999,11.7,13,8,9,4,0,6,31,19.4,25,15,4,11,13,26,10,0,2020
ITA-Serie A,2019,Bologna,Mitchell Dijks,NED,DF,26,1993,11.2,13,10,6,5,2,8,12,66.7,4,5,1,4,10,23,23,0,2020
ITA-Serie A,2019,Bologna,Musa Barrow,GAM,"FW,MF",20,1998,15.0,20,13,11,7,2,6,20,30.0,14,15,0,15,5,25,11,0,2020
ITA-Serie A,2019,Bologna,Musa Juwara,GAM,"FW,MF",17,2001,1.7,4,2,1,1,2,1,5,20.0,4,2,1,1,0,4,1,0,2020
ITA-Serie A,2019,Bologna,Nehuén Paz,ARG,DF,26,1993,1.3,1,1,0,1,0,0,2,0.0,2,3,3,0,5,6,12,0,2020
ITA-Serie A,2019,Bologna,Nicola Sansone,ITA,"FW,MF",27,1991,25.2,34,20,12,18,4,15,59,25.4,44,21,0,21,11,45,9,0,2020
ITA-Serie A,2019,Bologna,Nicolás Domínguez,ARG,MF,21,1998,7.8,21,14,15,5,1,7,18,38.9,11,12,2,10,12,33,7,0,2020
ITA-Serie A,2019,Bologna,Riccardo Orsolini,ITA,"FW,MF",22,1997,29.8,36,22,21,10,5,12,47,25.5,35,23,1,22,16,52,20,0,2020
ITA-Serie A,2019,Bologna,Roberto Soriano,ITA,MF,28,1991,27.4,43,25,15,21,7,10,46,21.7,36,19,0,19,17,60,23,1,2020
ITA-Serie A,2019,Bologna,Rodrigo Palacio,ARG,FW,37,1982,28.0,19,11,0,9,10,4,27,14.8,23,17,3,14,5,24,38,2,2020
ITA-Serie A,2019,Bologna,Stefano Denswil,NED,DF,26,1993,24.9,49,28,29,19,1,26,44,59.1,18,23,8,15,31,80,68,0,2020
ITA-Serie A,2019,Bologna,Takehiro Tomiyasu,JPN,DF,20,1998,28.1,42,24,25,13,4,22,41,53.7,19,34,9,25,49,91,78,1,2020
ITA-Serie A,2019,Bologna,Łukasz Skorupski,POL,GK,28,1991,37.0,1,0,1,0,0,0,1,0.0,1,0,0,0,2,3,15,5,2020
ITA-Serie A,2019,Brescia,Alessandro Matri,ITA,"FW,MF",34,1984,1.0,1,0,0,0,1,0,0,,0,1,0,1,0,1,1,0,2020
ITA-Serie A,2019,Brescia,Alessandro Semprini,ITA,DF,21,1998,7.0,10,4,7,3,0,7,9,77.8,2,10,3,7,9,19,16,0,2020
ITA-Serie A,2019,Brescia,Aleš Matějů,CZE,DF,23,1996,28.3,48,27,33,9,6,23,45,51.1,22,41,24,17,37,85,109,3,2020
ITA-Serie A,2019,Brescia,Alfredo Donnarumma,ITA,FW,28,1990,18.7,17,9,3,9,5,6,18,33.3,12,7,0,7,5,22,1,0,2020
ITA-Serie A,2019,Brescia,Andrea Cistana,ITA,DF,22,1997,20.4,20,8,13,7,0,6,17,35.3,11,38,34,4,33,53,96,1,2020
ITA-Serie A,2019,Brescia,Andrea Ghezzi,ITA,"FW,MF",18,2001,0.4,2,0,0,1,1,1,1,100.0,0,0,0,0,0,2,0,0,2020
ITA-Serie A,2019,Brescia,Andrea Papetti,ITA,DF,17,2002,10.2,9,7,8,1,0,4,14,28.6,10,15,11,4,15,24,39,0,2020
ITA-Serie A,2019,Brescia,Birkir Bjarnason,ISL,"MF,FW",31,1988,8.9,5,3,1,3,1,2,13,15.4,11,9,4,5,5,10,4,0,2020
ITA-Serie A,2019,Brescia,Bruno Martella,ITA,DF,26,1992,14.1,18,9,14,3,1,9,16,56.3,7,13,7,6,17,35,48,1,2020
ITA-Serie A,2019,Brescia,Daniele Dessena,ITA,MF,32,1987,20.8,21,11,5,14,2,6,25,24.0,19,11,1,10,11,32,21,0,2020
ITA-Serie A,2019,Brescia,Daniele Gastaldello,ITA,DF,36,1983,4.3,8,5,5,3,0,2,3,66.7,1,6,3,3,5,13,29,1,2020
ITA-Serie A,2019,Brescia,Dimitri Bisoli,ITA,MF,25,1994,23.9,64,35,34,20,10,30,49,61.2,19,41,7,34,25,89,49,0,2020
ITA-Serie A,2019,Brescia,Emanuele Ndoj,ALB,MF,22,1996,6.2,9,6,2,6,1,3,13,23.1,10,7,0,7,5,14,5,0,2020
ITA-Serie A,2019,Brescia,Enrico Alfonso,ITA,GK,31,1988,3.1,0,0,0,0,0,0,0,,0,0,0,0,0,0,2,0,2020
ITA-Serie A,2019,Brescia,Ernesto Torregrossa,VEN,FW,27,1992,20.5,17,7,5,10,2,6,22,27.3,16,10,2,8,5,22,22,0,2020
ITA-Serie A,2019,Brescia,Felipe Curcio,BRA,DF,25,1993,0.1,0,0,0,0,0,0,0,,0,0,0,0,0,0,0,0,2020
ITA-Serie A,2019,Brescia,Florian Ayé,FRA,"FW,MF",22,1997,15.3,17,9,9,5,3,6,13,46.2,7,17,2,15,4,21,18,1,2020
ITA-Serie A,2019,Brescia,Giangiacomo Magnani,ITA,DF,23,1995,1.3,0,0,0,0,0,0,1,0.0,1,2,2,0,2,2,6,0,2020
ITA-Serie A,2019,Brescia,Jaromír Zmrhal,CZE,MF,25,1993,12.5,10,4,2,5,3,5,18,27.8,13,8,1,7,4,14,11,0,2020
ITA-Serie A,2019,Brescia,Jesse Joronen,FIN,GK,26,1993,29.0,3,1,3,0,0,3,3,100.0,0,0,0,0,6,9,22,0,2020
ITA-Serie A,2019,Brescia,Jhon Chancellor,VEN,DF,27,1992,24.9,30,14,22,8,0,11,22,50.0,11,34,29,5,34,64,145,3,2020
ITA-Serie A,2019,Brescia,Leonardo Morosini,ITA,"FW,DF",23,1995,0.3,1,1,1,0,0,0,0,,0,1,0,1,1,2,1,0,2020
ITA-Serie A,2019,Brescia,Lorenzo Andrenacci,ITA,GK,24,1995,5.9,1,0,1,0,0,1,3,33.3,2,0,0,0,0,1,0,0,2020
ITA-Serie A,2019,Brescia,Luca Tremolada,ITA,MF,27,1991,0.2,0,0,0,0,0,0,0,,0,0,0,0,0,0,0,0,2020
ITA-Serie A,2019,Brescia,Mario Balotelli,ITA,FW,28,1990,15.6,2,2,0,2,0,0,2,0.0,2,1,1,0,8,10,22,0,2020
ITA-Serie A,2019,Brescia,Massimiliano Mangraviti,ITA,DF,21,1998,10.8,8,6,1,6,1,3,6,50.0,3,11,6,5,8,16,43,0,2020
ITA-Serie A,2019,Brescia,Mattia Viviani,ITA,MF,18,2000,3.8,3,1,0,3,0,1,8,12.5,7,3,3,0,9,12,2,1,2020
ITA-Serie A,2019,Brescia,Nikolas Špalek,SVK,"MF,FW",22,1997,17.5,24,10,6,11,7,7,31,22.6,24,15,1,14,6,30,10,0,2020
ITA-Serie A,2019,Brescia,Rômulo,ITA,MF,32,1987,19.1,30,19,12,14,4,12,34,35.3,22,18,1,17,8,38,12,1,2020
ITA-Serie A,2019,Brescia,Sandro Tonali,ITA,MF,19,2000,33.5,39,25,16,20,3,16,55,29.1,39,36,14,22,41,80,42,0,2020
ITA-Serie A,2019,Brescia,Simon Skrabb,FIN,"FW,MF",24,1995,2.9,7,6,2,4,1,6,12,50.0,6,4,1,3,0,7,3,0,2020
ITA-Serie A,2019,Brescia,Stefano Sabelli,ITA,DF,26,1993,35.2,83,44,51,28,4,50,106,47.2,56,40,13,27,58,141,107,0,2020
ITA-Serie A,2019,Cagliari,Alberto Cerri,ITA,FW,23,1996,2.7,3,1,1,0,2,2,6,33.3,4,1,0,1,2,5,4,0,2020
ITA-Serie A,2019,Cagliari,Alberto Paloschi,ITA,"FW,MF",29,1990,2.3,0,0,0,0,0,0,1,0.0,1,1,0,1,1,1,3,0,2020
ITA-Serie A,2019,Cagliari,Alessandro Deiola,ITA,MF,23,1995,0.0,0,0,0,0,0,0,0,,0,0,0,0,1,1,0,0,2020
ITA-Serie A,2019,Cagliari,Alessio Cragno,ITA,GK,25,1994,16.0,0,0,0,0,0,0,0,,0,0,0,0,0,0,10,0,2020
ITA-Serie A,2019,Cagliari,Andrea Carboni,ITA,DF,18,2001,4.1,8,4,3,5,0,3,4,75.0,1,6,6,0,7,15,20,0,2020
ITA-Serie A,2019,Cagliari,Artur Ioniță,MDA,MF,28,1990,21.1,38,23,12,22,4,12,37,32.4,25,32,10,22,18,56,24,2,2020
ITA-Serie A,2019,Cagliari,Charalambos Lykogiannis,GRE,DF,25,1993,14.9,14,9,9,3,2,7,18,38.9,11,25,9,16,23,37,71,0,2020
ITA-Serie A,2019,Cagliari,Christian Oliva,URU,MF,23,1996,5.2,13,7,9,4,0,5,15,33.3,10,5,0,5,7,20,14,0,2020
ITA-Serie A,2019,Cagliari,Daniele Ragatzu,ITA,"MF,FW",27,1991,3.5,3,2,0,2,1,1,3,33.3,2,1,0,1,1,4,5,0,2020
ITA-Serie A,2019,Cagliari,Fabio Pisacane,ITA,DF,33,1986,27.1,32,21,22,10,0,21,37,56.8,16,36,28,8,27,59,110,2,2020
ITA-Serie A,2019,Cagliari,Fabrizio Cacciatore,ITA,DF,32,1986,12.8,14,4,9,4,1,6,9,66.7,3,10,6,4,16,30,44,0,2020
ITA-Serie A,2019,Cagliari,Federico Marigosu,ITA,MF,18,2001,0.3,0,0,0,0,0,0,0,,0,0,0,0,0,0,1,0,2020
ITA-Serie A,2019,Cagliari,Federico Mattiello,ITA,DF,24,1995,10.3,30,21,19,7,4,11,27,40.7,16,20,7,13,18,48,22,0,2020
ITA-Serie A,2019,Cagliari,Gastón Pereiro,URU,"MF,FW",24,1995,3.9,2,2,2,0,0,1,4,25.0,3,1,0,1,0,2,1,1,2020
ITA-Serie A,2019,Cagliari,Giovanni Simeone,ARG,FW,24,1995,32.5,24,13,9,10,5,5,32,15.6,27,24,7,17,11,35,16,1,2020
ITA-Serie A,2019,Cagliari,João Pedro,ITA,"FW,MF",27,1992,35.0,17,11,5,7,5,4,24,16.7,20,35,8,27,9,26,39,0,2020
ITA-Serie A,2019,Cagliari,Leonardo Pavoletti,ITA,FW,30,1988,0.5,0,0,0,0,0,0,0,,0,0,0,0,1,1,3,0,2020
ITA-Serie A,2019,Cagliari,Luca Ceppitelli,ITA,DF,29,1989,13.8,22,15,16,6,0,6,11,54.5,5,23,17,6,23,45,66,2,2020
ITA-Serie A,2019,Cagliari,Luca Cigarini,ITA,MF,33,1986,17.8,37,20,23,13,1,16,40,40.0,24,28,10,18,20,57,29,0,2020
ITA-Serie A,2019,Cagliari,Luca Gagliano,ITA,FW,19,2000,0.6,0,0,0,0,0,0,0,,0,0,0,0,1,1,0,0,2020
ITA-Serie A,2019,Cagliari,Luca Pellegrini,ITA,DF,20,1999,21.2,31,15,20,7,4,15,38,39.5,23,19,2,17,21,52,45,2,2020
ITA-Serie A,2019,Cagliari,Lucas Castro,ARG,MF,30,1989,6.7,7,3,3,4,0,1,12,8.3,11,6,1,5,8,15,14,0,2020
ITA-Serie A,2019,Cagliari,Marko Rog,CRO,MF,24,1995,25.7,69,47,31,29,9,22,84,26.2,62,40,12,28,22,91,23,0,2020
ITA-Serie A,2019,Cagliari,Nahitan Nández,URU,"MF,DF",23,1995,32.2,58,38,37,17,4,25,69,36.2,44,30,1,29,25,83,26,0,2020
ITA-Serie A,2019,Cagliari,Paolo Faragò,ITA,"DF,MF",26,1993,14.9,41,28,21,15,5,23,46,50.0,23,18,9,9,10,51,58,0,2020
ITA-Serie A,2019,Cagliari,Radja Nainggolan,BEL,MF,31,1988,23.0,30,18,9,12,9,9,29,31.0,20,25,6,19,13,43,30,0,2020
ITA-Serie A,2019,Cagliari,Rafael,BRA,GK,37,1982,5.0,0,0,0,0,0,0,0,,0,0,0,0,0,0,3,0,2020
ITA-Serie A,2019,Cagliari,Ragnar Klavan,EST,DF,33,1985,26.2,29,16,20,9,0,14,28,50.0,14,29,19,10,25,54,118,1,2020
ITA-Serie A,2019,Cagliari,Riccardo Ladinetti,ITA,MF,18,2000,1.4,2,2,0,2,0,1,1,100.0,0,0,0,0,4,6,0,1,2020
ITA-Serie A,2019,Cagliari,Robin Olsen,SWE,GK,29,1990,16.9,0,0,0,0,0,0,1,0.0,1,0,0,0,0,0,8,0,2020
ITA-Serie A,2019,Cagliari,Sebastian Walukiewicz,POL,DF,19,2000,12.9,25,11,17,8,0,14,22,63.6,8,21,14,7,14,39,41,0,2020
ITA-Serie A,2019,Cagliari,Simone Pinna,ITA,DF,21,1997,1.0,1,1,0,1,0,0,0,,0,3,1,2,5,6,4,1,2020
ITA-Serie A,2019,Cagliari,Valter Birsa,SVN,"MF,FW",32,1986,4.8,10,6,3,6,1,7,21,33.3,14,6,1,5,4,14,3,0,2020
ITA-Serie A,2019,Fiorentina,Aleksa Terzić,SRB,MF,19,1999,0.1,0,0,0,0,0,0,0,,0,0,0,0,0,0,0,0,2020
ITA-Serie A,2019,Fiorentina,Alfred Duncan,GHA,MF,26,1993,9.9,12,9,11,1,0,2,19,10.5,17,4,0,4,5,17,12,0,2020
ITA-Serie A,2019,Fiorentina,Bartłomiej Drągowski,POL,GK,21,1997,31.0,0,0,0,0,0,0,1,0.0,1,0,0,0,3,3,8,1,2020
ITA-Serie A,2019,Fiorentina,Christian Dalle Mura,ITA,FW,17,2002,0.0,0,0,0,0,0,0,0,,0,0,0,0,0,0,0,0,2020
ITA-Serie A,2019,Fiorentina,Christian Kouamé,CIV,"FW,MF",21,1997,3.3,3,2,0,3,0,0,1,0.0,1,5,1,4,1,4,1,0,2020
ITA-Serie A,2019,Fiorentina,Dalbert Henrique,BRA,"DF,MF",25,1993,27.6,52,25,35,12,5,18,51,35.3,33,34,4,30,19,71,65,0,2020
ITA-Serie A,2019,Fiorentina,Dušan Vlahović,SRB,FW,19,2000,16.7,6,2,1,4,1,4,13,30.8,9,5,2,3,7,13,6,0,2020
ITA-Serie A,2019,Fiorentina,Erick Pulgar,CHI,MF,25,1994,32.8,73,46,25,41,7,22,96,22.9,74,45,15,30,49,122,53,1,2020
ITA-Serie A,2019,Fiorentina,Federico Brancolini,ITA,GK,18,2001,0.1,0,0,0,0,0,0,0,,0,0,0,0,0,0,0,0,2020
ITA-Serie A,2019,Fiorentina,Federico Ceccherini,ITA,DF,27,1992,9.3,14,8,11,3,0,10,10,100.0,0,9,5,4,13,27,37,1,2020
ITA-Serie A,2019,Fiorentina,Federico Chiesa,ITA,"FW,DF",21,1997,29.3,38,22,13,15,10,10,52,19.2,42,19,0,19,6,44,6,0,2020
ITA-Serie A,2019,Fiorentina,Franck Ribéry,FRA,FW,36,1983,15.7,20,14,7,10,3,4,20,20.0,16,9,0,9,3,23,3,0,2020
ITA-Serie A,2019,Fiorentina,Gaetano Castrovilli,ITA,MF,22,1997,29.7,59,31,25,23,11,18,53,34.0,35,29,2,27,15,74,31,1,2020
ITA-Serie A,2019,Fiorentina,Germán Pezzella,ARG,DF,28,1991,31.4,36,18,26,9,1,14,32,43.8,18,31,20,11,55,91,134,1,2020
ITA-Serie A,2019,Fiorentina,Igor,BRA,DF,21,1998,6.8,12,10,8,2,2,6,7,85.7,1,10,4,6,7,19,16,0,2020
ITA-Serie A,2019,Fiorentina,Kevin Agudelo,COL,"MF,FW",20,1998,0.7,2,1,0,1,1,0,1,0.0,1,1,0,1,1,3,0,0,2020
ITA-Serie A,2019,Fiorentina,Kevin-Prince Boateng,GHA,FW,32,1987,6.7,3,1,0,2,1,2,8,25.0,6,3,0,3,1,4,7,0,2020
ITA-Serie A,2019,Fiorentina,Lorenzo Venuti,ITA,"DF,MF",24,1995,9.5,20,10,12,6,2,13,19,68.4,6,5,1,4,11,31,15,0,2020
ITA-Serie A,2019,Fiorentina,Luca Ranieri,ITA,DF,20,1999,2.6,2,2,2,0,0,2,3,66.7,1,1,0,1,2,4,7,0,2020
ITA-Serie A,2019,Fiorentina,Marco Benassi,ITA,MF,24,1994,10.9,18,12,9,5,4,10,24,41.7,14,11,1,10,4,22,9,0,2020
ITA-Serie A,2019,Fiorentina,Martín Cáceres,URU,DF,32,1987,26.2,47,31,34,11,2,16,34,47.1,18,29,13,16,31,78,74,2,2020
ITA-Serie A,2019,Fiorentina,Maximiliano Olivera,URU,MF,27,1992,0.1,1,0,1,0,0,0,0,,0,0,0,0,0,1,0,0,2020
ITA-Serie A,2019,Fiorentina,Milan Badelj,CRO,MF,30,1989,17.6,29,17,10,16,3,15,50,30.0,35,21,3,18,45,74,34,1,2020
ITA-Serie A,2019,Fiorentina,Nikola Milenković,SRB,DF,21,1997,36.2,46,25,30,16,0,11,31,35.5,20,39,21,18,29,75,129,1,2020
ITA-Serie A,2019,Fiorentina,Patrick Cutrone,ITA,FW,21,1998,9.3,4,2,2,1,1,1,15,6.7,14,6,1,5,2,6,6,0,2020
ITA-Serie A,2019,Fiorentina,Pedro,BRA,FW,22,1997,0.7,1,1,0,0,1,0,0,,0,1,0,1,0,1,0,0,2020
ITA-Serie A,2019,Fiorentina,Pietro Terracciano,ITA,GK,29,1990,6.9,0,0,0,0,0,0,0,,0,0,0,0,0,0,4,0,2020
ITA-Serie A,2019,Fiorentina,Pol Lirola,ESP,DF,21,1997,29.4,34,20,18,10,6,21,38,55.3,17,16,4,12,26,60,52,0,2020
ITA-Serie A,2019,Fiorentina,Rachid Ghezzal,ALG,"MF,FW",27,1992,9.2,27,15,14,10,3,10,33,30.3,23,6,0,6,11,38,9,0,2020
ITA-Serie A,2019,Fiorentina,Riccardo Sottil,ITA,"FW,DF",20,1999,5.7,6,4,4,2,0,3,10,30.0,7,4,0,4,0,6,0,0,2020
ITA-Serie A,2019,Fiorentina,Sebastián Cristóforo,URU,MF,25,1993,1.0,5,5,2,2,1,1,5,20.0,4,2,1,1,1,6,0,0,2020
ITA-Serie A,2019,Fiorentina,Szymon Żurkowski,POL,MF,21,1997,0.1,1,0,0,0,1,0,2,0.0,2,0,0,0,0,1,1,0,2020
ITA-Serie A,2019,Fiorentina,Valentin Eysseric,FRA,"FW,MF",27,1992,0.5,0,0,0,0,0,0,0,,0,1,0,1,0,0,0,0,2020
ITA-Serie A,2019,Genoa,Adama Soumaoro,FRA,DF,27,1992,7.1,3,2,3,0,0,1,3,33.3,2,12,12,0,11,14,32,0,2020
ITA-Serie A,2019,Genoa,Andrea Favilli,ITA,FW,22,1997,7.3,8,7,2,3,3,4,11,36.4,7,5,1,4,0,8,7,0,2020
ITA-Serie A,2019,Genoa,Andrea Masiello,ITA,DF,33,1986,14.7,26,15,17,8,1,16,32,50.0,16,8,2,6,26,52,55,2,2020
ITA-Serie A,2019,Genoa,Andrea Pinamonti,ITA,FW,20,1999,24.8,19,12,1,7,11,5,25,20.0,20,19,2,17,9,28,25,0,2020
ITA-Serie A,2019,Genoa,Antonio Barreca,ITA,"DF,FW",24,1995,12.2,10,7,5,3,2,4,5,80.0,1,12,7,5,1,11,22,0,2020
ITA-Serie A,2019,Genoa,Antonio Sanabria,PAR,FW,23,1996,15.4,14,11,2,7,5,3,14,21.4,11,13,1,12,5,19,12,1,2020
ITA-Serie A,2019,Genoa,Christian Kouamé,CIV,FW,21,1997,10.2,2,1,0,1,1,0,8,0.0,8,8,2,6,1,3,13,0,2020
ITA-Serie A,2019,Genoa,Cristian Romero,ARG,DF,21,1998,28.6,52,35,36,12,4,12,41,29.3,29,59,33,26,75,127,116,2,2020
ITA-Serie A,2019,Genoa,Cristián Zapata,COL,DF,32,1986,19.1,23,17,16,7,0,8,16,50.0,8,29,17,12,24,47,75,0,2020
ITA-Serie A,2019,Genoa,Davide Biraschi,ITA,DF,25,1994,21.9,32,17,17,13,2,15,26,57.7,11,22,12,10,34,66,69,0,2020
ITA-Serie A,2019,Genoa,Denilho Cleonise,NED,FW,17,2001,0.5,1,0,1,0,0,0,0,,0,0,0,0,1,2,0,0,2020
ITA-Serie A,2019,Genoa,Domenico Criscito,ITA,DF,32,1986,22.8,53,33,34,12,7,24,56,42.9,32,25,13,12,53,106,81,1,2020
ITA-Serie A,2019,Genoa,Edoardo Goldaniga,ITA,DF,25,1993,8.7,4,3,3,1,0,2,5,40.0,3,11,6,5,18,22,25,1,2020
ITA-Serie A,2019,Genoa,Filip Jagiełło,POL,MF,21,1997,6.1,7,2,0,3,4,3,7,42.9,4,4,0,4,5,12,4,0,2020
ITA-Serie A,2019,Genoa,Francesco Cassata,ITA,MF,22,1997,16.2,20,10,12,5,3,9,30,30.0,21,12,2,10,11,31,11,0,2020
ITA-Serie A,2019,Genoa,Goran Pandev,MKD,"FW,MF",36,1983,18.7,12,8,2,7,3,3,25,12.0,22,4,1,3,0,12,5,1,2020
ITA-Serie A,2019,Genoa,Iago Falque,ESP,MF,29,1990,5.8,7,3,1,4,2,4,8,50.0,4,7,0,7,1,8,4,0,2020
ITA-Serie A,2019,Genoa,Ionuț Radu,ROU,GK,22,1997,17.0,0,0,0,0,0,0,2,0.0,2,0,0,0,1,1,7,1,2020
ITA-Serie A,2019,Genoa,Ivan Radovanović,SRB,MF,30,1988,14.6,27,14,18,9,0,10,26,38.5,16,17,3,14,8,35,39,0,2020
ITA-Serie A,2019,Genoa,Jawad El Yamiq,MAR,DF,27,1992,2.2,3,2,3,0,0,1,4,25.0,3,3,2,1,1,4,3,0,2020
ITA-Serie A,2019,Genoa,Kevin Agudelo,COL,"MF,FW",20,1998,7.4,23,14,9,12,2,10,20,50.0,10,12,1,11,6,29,2,0,2020
ITA-Serie A,2019,Genoa,Lasse Schöne,DEN,MF,33,1986,27.0,42,26,16,22,4,15,48,31.3,33,22,6,16,37,79,25,2,2020
ITA-Serie A,2019,Genoa,Lukas Lerager,DEN,MF,26,1993,15.4,29,19,13,12,4,10,34,29.4,24,20,5,15,8,37,15,1,2020
ITA-Serie A,2019,Genoa,Marko Pajač,CRO,"DF,FW",26,1993,8.4,8,4,4,3,1,7,16,43.8,9,6,0,6,8,16,9,0,2020
ITA-Serie A,2019,Genoa,Mattia Destro,ITA,"FW,MF",28,1991,1.7,0,0,0,0,0,0,0,,0,0,0,0,0,0,1,0,2020
ITA-Serie A,2019,Genoa,Mattia Perin,ITA,GK,26,1992,21.0,1,1,1,0,0,1,1,100.0,0,1,0,1,0,1,5,1,2020
ITA-Serie A,2019,Genoa,Nicolò Rovella,ITA,MF,17,2001,1.2,0,0,0,0,0,0,1,0.0,1,0,0,0,4,4,0,0,2020
ITA-Serie A,2019,Genoa,Paolo Ghiglione,ITA,"DF,FW",22,1997,19.1,31,16,15,13,3,18,35,51.4,17,17,2,15,9,40,42,1,2020
ITA-Serie A,2019,Genoa,Peter Ankersen,DEN,DF,28,1990,11.8,16,4,7,7,2,4,13,30.8,9,19,5,14,9,25,25,1,2020
ITA-Serie A,2019,Genoa,Riccardo Saponara,ITA,"MF,FW",27,1991,1.9,4,3,2,2,0,0,2,0.0,2,2,1,1,0,4,2,0,2020
ITA-Serie A,2019,Genoa,Rômulo,ITA,DF,32,1987,0.2,2,1,1,1,0,0,0,,0,0,0,0,0,2,1,0,2020
ITA-Serie A,2019,Genoa,Sinan Gümüş,TUR,"FW,MF",25,1994,1.1,0,0,0,0,0,0,4,0.0,4,0,0,0,0,0,1,0,2020
ITA-Serie A,2019,Genoa,Stefano Sturaro,ITA,MF,26,1993,13.9,38,22,14,19,5,15,39,38.5,24,16,4,12,10,48,26,1,2020
ITA-Serie A,2019,Genoa,Valon Behrami,SUI,MF,34,1985,12.3,34,26,13,17,4,8,32,25.0,24,25,10,15,9,43,16,0,2020
ITA-Serie A,2019,Hellas Verona,Alan Empereur,BRA,DF,25,1994,9.5,16,8,11,4,1,6,10,60.0,4,19,12,7,22,38,36,0,2020
ITA-Serie A,2019,Hellas Verona,Amir Rrahmani,KVX,DF,25,1994,35.9,50,31,26,19,5,26,46,56.5,20,50,31,19,30,80,151,1,2020
ITA-Serie A,2019,Hellas Verona,Andrea Danzi,ITA,MF,20,1999,0.0,0,0,0,0,0,0,0,,0,0,0,0,0,0,0,0,2020
ITA-Serie A,2019,Hellas Verona,Boris Radunović,SRB,GK,23,1996,3.0,0,0,0,0,0,0,0,,0,0,0,0,0,0,1,0,2020
ITA-Serie A,2019,Hellas Verona,Claud Adjapong,ITA,DF,21,1998,2.6,5,3,4,1,0,2,3,66.7,1,4,3,1,3,8,7,0,2020
ITA-Serie A,2019,Hellas Verona,Darko Lazović,SRB,DF,28,1990,36.0,26,16,14,8,4,14,27,51.9,13,15,4,11,23,49,53,0,2020
ITA-Serie A,2019,Hellas Verona,Davide Faraoni,ITA,DF,27,1991,35.9,67,37,43,19,5,30,67,44.8,37,50,15,35,36,103,115,0,2020
ITA-Serie A,2019,Hellas Verona,Eddie Salcedo,ITA,"FW,MF",17,2001,7.6,3,1,2,0,1,0,5,0.0,5,4,0,4,1,4,2,0,2020
ITA-Serie A,2019,Hellas Verona,Emmanuel Agyemang-Badu,GHA,MF,28,1990,2.6,1,1,0,1,0,1,2,50.0,1,2,2,0,1,2,6,0,2020
ITA-Serie A,2019,Hellas Verona,Fabio Borini,ITA,"MF,FW",28,1991,9.0,2,1,2,0,0,0,4,0.0,4,3,0,3,13,15,6,0,2020
ITA-Serie A,2019,Hellas Verona,Federico Dimarco,ITA,DF,21,1997,5.8,11,5,4,4,3,6,10,60.0,4,3,2,1,4,15,11,0,2020
ITA-Serie A,2019,Hellas Verona,Gennaro Tutino,ITA,"FW,MF",22,1996,2.5,0,0,0,0,0,0,0,,0,0,0,0,2,2,1,0,2020
ITA-Serie A,2019,Hellas Verona,Giampaolo Pazzini,ITA,"FW,MF",34,1984,3.4,1,0,0,1,0,0,4,0.0,4,2,0,2,1,2,4,0,2020
ITA-Serie A,2019,Hellas Verona,Koray Günter,GER,DF,24,1994,30.4,39,25,22,15,2,19,29,65.5,10,45,39,6,55,94,131,1,2020
ITA-Serie A,2019,Hellas Verona,Liam Henderson,SCO,MF,23,1996,2.2,3,2,0,3,0,2,3,66.7,1,1,0,1,0,3,4,0,2020
ITA-Serie A,2019,Hellas Verona,Lucas Felippe,BRA,"MF,DF",19,2000,0.3,1,1,1,0,0,1,1,100.0,0,0,0,0,0,1,0,0,2020
ITA-Serie A,2019,Hellas Verona,Luigi Vitale,ITA,DF,31,1987,0.5,1,0,0,1,0,0,0,,0,1,0,1,0,1,0,0,2020
ITA-Serie A,2019,Hellas Verona,Marash Kumbulla,ALB,DF,19,2000,21.7,40,24,21,17,2,19,36,52.8,17,33,24,9,50,90,86,3,2020
ITA-Serie A,2019,Hellas Verona,Marco Silvestri,ITA,GK,28,1991,35.0,1,0,1,0,0,1,2,50.0,1,0,0,0,4,5,11,1,2020
ITA-Serie A,2019,Hellas Verona,Mariusz Stępiński,POL,"FW,MF",24,1995,7.8,5,3,2,1,2,1,2,50.0,1,3,1,2,1,6,7,0,2020
ITA-Serie A,2019,Hellas Verona,Matteo Lovato,ITA,DF,19,2000,0.1,0,0,0,0,0,0,0,,0,0,0,0,0,0,1,0,2020
ITA-Serie A,2019,Hellas Verona,Matteo Pessina,ITA,MF,22,1997,27.7,35,21,9,20,6,12,33,36.4,21,28,8,20,25,60,40,2,2020
ITA-Serie A,2019,Hellas Verona,Mattia Zaccagni,ITA,"MF,FW",24,1995,23.5,20,11,10,5,5,3,15,20.0,12,14,3,11,20,40,21,0,2020
ITA-Serie A,2019,Hellas Verona,Miguel Veloso,POR,MF,33,1986,31.2,52,29,20,28,4,18,60,30.0,42,36,12,24,32,84,46,1,2020
ITA-Serie A,2019,Hellas Verona,Paweł Dawidowicz,POL,DF,24,1995,7.7,15,12,11,4,0,5,11,45.5,6,6,5,1,12,27,26,0,2020
ITA-Serie A,2019,Hellas Verona,Salvatore Bocchetti,ITA,DF,32,1986,3.4,5,3,3,2,0,2,3,66.7,1,2,2,0,17,22,23,0,2020
ITA-Serie A,2019,Hellas Verona,Samuel Di Carmine,ITA,"FW,MF",30,1988,14.4,2,1,0,0,2,0,8,0.0,8,3,0,3,1,3,10,0,2020
ITA-Serie A,2019,Hellas Verona,Sofyan Amrabat,MAR,MF,22,1996,32.4,58,36,26,21,11,26,55,47.3,29,29,10,19,31,89,15,1,2020
ITA-Serie A,2019,Hellas Verona,Valentin Eysseric,FRA,"MF,FW",27,1992,3.9,4,4,1,2,1,0,4,0.0,4,3,0,3,1,5,2,0,2020
ITA-Serie A,2019,Hellas Verona,Valerio Verre,ITA,"MF,FW",25,1994,19.7,25,15,4,11,10,9,23,39.1,14,5,0,5,13,38,9,0,2020
ITA-Serie A,2019,Inter,Alessandro Bastoni,ITA,DF,20,1999,21.3,32,17,14,11,7,15,24,62.5,9,18,9,9,26,58,54,0,2020
ITA-Serie A,2019,Inter,Alexis Sánchez,CHI,FW,30,1988,10.3,9,7,1,4,4,5,13,38.5,8,7,0,7,3,12,1,0,2020
ITA-Serie A,2019,Inter,Andrea Ranocchia,ITA,DF,31,1988,5.8,17,10,10,7,0,5,8,62.5,3,11,6,5,8,25,18,0,2020
ITA-Serie A,2019,Inter,Antonio Candreva,ITA,DF,32,1987,22.1,11,6,9,1,1,7,29,24.1,22,26,10,16,14,25,33,1,2020
ITA-Serie A,2019,Inter,Ashley Young,ENG,DF,34,1985,13.2,11,5,3,5,3,6,19,31.6,13,11,3,8,14,25,24,0,2020
ITA-Serie A,2019,Inter,Borja Valero,ESP,MF,34,1985,10.3,18,7,9,3,6,6,24,25.0,18,12,3,9,8,26,9,0,2020
ITA-Serie A,2019,Inter,Christian Eriksen,DEN,MF,27,1992,7.8,11,6,2,8,1,5,20,25.0,15,3,0,3,0,11,0,0,2020
ITA-Serie A,2019,Inter,Cristiano Biraghi,ITA,DF,26,1992,17.5,22,6,10,8,4,10,24,41.7,14,21,7,14,13,35,41,0,2020
ITA-Serie A,2019,Inter,Daniele Padelli,ITA,GK,33,1985,3.0,0,0,0,0,0,0,0,,0,0,0,0,0,0,1,1,2020
ITA-Serie A,2019,Inter,Danilo D'Ambrosio,ITA,DF,30,1988,15.6,30,16,16,12,2,16,33,48.5,17,15,4,11,14,44,25,0,2020
ITA-Serie A,2019,Inter,Diego Godín,URU,DF,33,1986,18.1,38,29,19,16,3,18,32,56.3,14,17,7,10,45,83,60,1,2020
ITA-Serie A,2019,Inter,Federico Dimarco,ITA,DF,21,1997,0.3,1,0,0,1,0,0,0,,0,0,0,0,1,2,1,0,2020
ITA-Serie A,2019,Inter,Kwadwo Asamoah,GHA,"DF,FW",30,1988,7.1,10,8,4,5,1,6,14,42.9,8,8,1,7,9,19,13,0,2020
ITA-Serie A,2019,Inter,Lautaro Martínez,ARG,FW,21,1997,27.2,22,7,2,8,12,4,34,11.8,30,30,2,28,15,37,11,0,2020
ITA-Serie A,2019,Inter,Lorenzo Pirola,ITA,DF,17,2002,0.1,0,0,0,0,0,0,0,,0,0,0,0,1,1,0,0,2020
ITA-Serie A,2019,Inter,Lucien Agoume,FRA,MF,17,2002,0.8,3,2,0,2,1,0,0,,0,3,1,2,0,3,0,0,2020
ITA-Serie A,2019,Inter,Marcelo Brozović,CRO,MF,26,1992,30.0,67,35,26,31,10,19,71,26.8,52,26,9,17,46,113,46,2,2020
ITA-Serie A,2019,Inter,Matteo Politano,ITA,"FW,MF",25,1993,2.9,0,0,0,0,0,0,2,0.0,2,1,0,1,0,0,1,0,2020
ITA-Serie A,2019,Inter,Matías Vecino,URU,MF,27,1991,14.2,31,20,14,11,6,9,36,25.0,27,20,3,17,15,46,26,0,2020
ITA-Serie A,2019,Inter,Milan Škriniar,SVK,DF,24,1995,29.2,39,20,24,14,1,14,33,42.4,19,19,11,8,28,67,85,1,2020
ITA-Serie A,2019,Inter,Nicolò Barella,ITA,MF,22,1997,22.4,36,21,14,15,7,8,37,21.6,29,20,5,15,14,50,14,0,2020
ITA-Serie A,2019,Inter,Roberto Gagliardini,ITA,MF,25,1994,20.0,38,19,12,18,8,14,41,34.1,27,28,8,20,30,68,20,1,2020
ITA-Serie A,2019,Inter,Romelu Lukaku,BEL,FW,26,1993,33.1,13,7,4,7,2,3,10,30.0,7,14,6,8,1,14,28,0,2020
ITA-Serie A,2019,Inter,Samir Handanović,SVN,GK,35,1984,35.0,1,1,1,0,0,0,1,0.0,1,0,0,0,0,1,8,3,2020
ITA-Serie A,2019,Inter,Sebastiano Esposito,ITA,FW,17,2002,2.2,3,2,0,2,1,0,5,0.0,5,3,0,3,3,6,1,0,2020
ITA-Serie A,2019,Inter,Stefan de Vrij,NED,DF,27,1992,31.4,33,18,20,12,1,14,27,51.9,13,34,24,10,52,85,121,1,2020
ITA-Serie A,2019,Inter,Stefano Sensi,ITA,MF,23,1995,8.0,18,10,10,7,1,6,22,27.3,16,15,1,14,9,27,4,0,2020
ITA-Serie A,2019,Inter,Valentino Lazaro,AUT,DF,23,1996,3.6,6,5,3,2,1,4,8,50.0,4,5,0,5,1,7,8,1,2020
ITA-Serie A,2019,Inter,Victor Moses,NGA,DF,28,1990,4.7,4,3,1,2,1,2,8,25.0,6,4,0,4,0,4,4,0,2020
ITA-Serie A,2019,Juventus,Aaron Ramsey,WAL,MF,28,1990,11.7,20,15,6,8,6,6,24,25.0,18,18,3,15,11,31,12,0,2020
ITA-Serie A,2019,Juventus,Adrien Rabiot,FRA,MF,24,1995,21.2,47,31,16,19,12,15,41,36.6,26,36,6,30,32,79,19,0,2020
ITA-Serie A,2019,Juventus,Alex Sandro,BRA,DF,28,1991,26.5,44,26,23,14,7,12,33,36.4,21,26,6,20,47,91,46,3,2020
ITA-Serie A,2019,Juventus,Blaise Matuidi,FRA,MF,32,1987,24.9,48,27,13,27,8,13,34,38.2,21,35,6,29,22,70,16,0,2020
ITA-Serie A,2019,Juventus,Carlo Pinsoglio,ITA,GK,29,1990,0.2,0,0,0,0,0,0,0,,0,0,0,0,0,0,0,0,2020
ITA-Serie A,2019,Juventus,Cristiano Ronaldo,POR,FW,34,1985,32.4,14,10,3,3,8,4,20,20.0,16,10,3,7,6,20,21,1,2020
ITA-Serie A,2019,Juventus,Daniele Rugani,ITA,DF,25,1994,7.7,8,6,4,4,0,4,5,80.0,1,4,4,0,11,19,18,0,2020
ITA-Serie A,2019,Juventus,Danilo,BRA,DF,28,1991,16.0,30,20,16,12,2,18,30,60.0,12,12,3,9,26,56,44,0,2020
ITA-Serie A,2019,Juventus,Daouda Peeters,BEL,MF,20,1999,0.2,1,0,0,1,0,1,1,100.0,0,0,0,0,0,1,0,0,2020
ITA-Serie A,2019,Juventus,Douglas Costa,BRA,"FW,MF",28,1990,8.9,2,1,1,1,0,1,12,8.3,11,7,0,7,5,7,5,0,2020
ITA-Serie A,2019,Juventus,Emre Can,GER,MF,25,1994,3.2,10,7,5,3,2,3,10,30.0,7,4,0,4,2,12,3,0,2020
ITA-Serie A,2019,Juventus,Federico Bernardeschi,ITA,"MF,FW",25,1994,17.5,13,5,4,5,4,5,25,20.0,20,11,0,11,13,26,12,1,2020
ITA-Serie A,2019,Juventus,Giacomo Vrioni,ALB,FW,20,1998,0.1,0,0,0,0,0,0,0,,0,0,0,0,0,0,0,0,2020
ITA-Serie A,2019,Juventus,Gianluca Frabotta,ITA,DF,20,1999,1.0,3,1,0,2,1,2,2,100.0,0,2,0,2,1,4,2,0,2020
ITA-Serie A,2019,Juventus,Gianluigi Buffon,ITA,GK,41,1978,9.0,0,0,0,0,0,0,0,,0,0,0,0,0,0,3,1,2020
ITA-Serie A,2019,Juventus,Giorgio Chiellini,ITA,DF,34,1984,2.2,3,0,3,0,0,1,1,100.0,0,2,2,0,1,4,9,0,2020
ITA-Serie A,2019,Juventus,Gonzalo Higuaín,ARG,FW,31,1987,20.7,13,7,2,6,5,4,31,12.9,27,12,0,12,6,19,14,0,2020
ITA-Serie A,2019,Juventus,Juan Cuadrado,COL,"DF,FW",31,1988,29.5,67,43,32,28,7,35,62,56.5,27,22,8,14,35,102,47,0,2020
ITA-Serie A,2019,Juventus,Leonardo Bonucci,ITA,DF,32,1987,34.2,28,17,18,8,2,12,17,70.6,5,32,29,3,31,59,94,2,2020
ITA-Serie A,2019,Juventus,Luca Zanimacchia,ITA,"FW,MF",21,1998,1.3,5,1,1,2,2,1,2,50.0,1,1,0,1,0,5,0,0,2020
ITA-Serie A,2019,Juventus,Marco Olivieri,ITA,FW,20,1999,0.3,1,1,1,0,0,1,2,50.0,1,0,0,0,0,1,0,0,2020
ITA-Serie A,2019,Juventus,Matthijs de Ligt,NED,DF,19,1999,27.2,25,15,14,10,1,13,23,56.5,10,30,23,7,25,50,101,2,2020
ITA-Serie A,2019,Juventus,Mattia De Sciglio,ITA,DF,26,1992,5.2,10,8,6,4,0,6,14,42.9,8,5,2,3,8,18,18,1,2020
ITA-Serie A,2019,Juventus,Merih Demiral,TUR,DF,21,1998,4.6,8,7,5,3,0,1,3,33.3,2,4,3,1,4,12,16,1,2020
ITA-Serie A,2019,Juventus,Miralem Pjanić,BIH,MF,29,1990,25.3,46,21,16,23,7,21,63,33.3,42,29,12,17,32,78,30,0,2020
ITA-Serie A,2019,Juventus,Paulo Dybala,ARG,"FW,MF",25,1993,23.9,19,10,6,9,4,9,39,23.1,30,15,0,15,13,32,3,0,2020
ITA-Serie A,2019,Juventus,Rodrigo Bentancur,URU,MF,22,1997,24.4,58,32,27,18,13,31,66,47.0,35,44,9,35,32,90,34,1,2020
ITA-Serie A,2019,Juventus,Sami Khedira,GER,MF,32,1987,7.6,14,7,3,8,3,4,19,21.1,15,12,1,11,3,17,13,0,2020
ITA-Serie A,2019,Juventus,Simone Muratore,ITA,MF,21,1998,1.8,2,0,0,1,1,1,3,33.3,2,1,0,1,3,5,0,0,2020
ITA-Serie A,2019,Juventus,Wojciech Szczęsny,POL,GK,29,1990,28.8,0,0,0,0,0,0,0,,0,0,0,0,1,1,10,1,2020
ITA-Serie A,2019,Lazio,Adam Marušić,MNE,DF,26,1992,10.5,11,6,7,4,0,4,11,36.4,7,14,2,12,14,25,16,0,2020
ITA-Serie A,2019,Lazio,Anderson Lima,BRA,"MF,DF",19,1999,0.7,4,0,3,1,0,1,1,100.0,0,4,0,4,0,4,0,0,2020
ITA-Serie A,2019,Lazio,Bastos,ANG,DF,28,1991,8.5,9,5,6,3,0,4,11,36.4,7,13,8,5,13,22,26,0,2020
ITA-Serie A,2019,Lazio,Bobby Adekanye,NED,FW,20,1999,2.1,3,2,0,3,0,0,5,0.0,5,0,0,0,2,5,1,0,2020
ITA-Serie A,2019,Lazio,Ciro Immobile,ITA,FW,29,1990,35.2,8,6,2,4,2,0,24,0.0,24,10,2,8,11,19,7,0,2020
ITA-Serie A,2019,Lazio,Danilo Cataldi,ITA,MF,24,1994,6.6,17,11,10,5,2,10,20,50.0,10,7,1,6,13,30,10,0,2020
ITA-Serie A,2019,Lazio,Denis Vavro,SVK,DF,23,1996,3.6,3,3,2,1,0,1,3,33.3,2,8,6,2,5,8,10,0,2020
ITA-Serie A,2019,Lazio,Djavan Anderson,NED,"FW,DF",24,1995,1.9,0,0,0,0,0,0,0,,0,1,0,1,3,3,3,0,2020
ITA-Serie A,2019,Lazio,Felipe Caicedo,ECU,FW,30,1988,15.6,17,10,4,7,6,2,11,18.2,9,9,1,8,4,21,2,0,2020
ITA-Serie A,2019,Lazio,Francesco Acerbi,ITA,DF,31,1988,35.1,59,29,42,12,5,14,20,70.0,6,40,27,13,42,101,109,1,2020
ITA-Serie A,2019,Lazio,Joaquín Correa,ARG,FW,24,1994,22.2,13,7,3,7,3,5,24,20.8,19,5,1,4,7,20,10,0,2020
ITA-Serie A,2019,Lazio,Jony,ESP,"DF,FW",28,1991,13.1,13,9,7,4,2,5,23,21.7,18,11,2,9,14,27,17,0,2020
ITA-Serie A,2019,Lazio,Jordan Lukaku,BEL,DF,25,1994,4.4,4,2,1,1,2,2,4,50.0,2,2,1,1,0,4,9,0,2020
ITA-Serie A,2019,Lazio,Luca Falbo,ITA,DF,19,2000,0.0,0,0,0,0,0,0,0,,0,0,0,0,0,0,0,0,2020
ITA-Serie A,2019,Lazio,Lucas Leiva,BRA,MF,32,1987,20.1,60,35,25,31,4,28,72,38.9,44,29,6,23,47,107,34,1,2020
ITA-Serie A,2019,Lazio,Luis Alberto,ESP,MF,26,1992,34.6,50,30,21,19,10,27,82,32.9,55,32,1,31,21,71,9,1,2020
ITA-Serie A,2019,Lazio,Luiz Felipe,ITA,DF,22,1997,22.5,42,24,24,15,3,19,32,59.4,13,39,30,9,41,83,69,2,2020
ITA-Serie A,2019,Lazio,Manuel Lazzari,ITA,DF,25,1993,28.3,20,11,10,7,3,10,31,32.3,21,11,1,10,8,28,34,0,2020
ITA-Serie A,2019,Lazio,Marco Parolo,ITA,MF,34,1985,18.9,54,26,19,27,8,18,46,39.1,28,44,15,29,26,80,49,0,2020
ITA-Serie A,2019,Lazio,Nicolò Armini,ITA,DF,18,2001,0.0,1,1,1,0,0,1,1,100.0,0,0,0,0,0,1,1,0,2020
ITA-Serie A,2019,Lazio,Patric,ESP,DF,26,1993,18.6,34,20,24,7,3,18,25,72.0,7,19,9,10,15,49,45,0,2020
ITA-Serie A,2019,Lazio,Raúl Moro,ESP,FW,16,2002,0.0,0,0,0,0,0,0,0,,0,0,0,0,0,0,0,0,2020
ITA-Serie A,2019,Lazio,Senad Lulić,BIH,DF,33,1986,17.5,21,13,10,7,4,11,41,26.8,30,20,4,16,21,42,28,1,2020
ITA-Serie A,2019,Lazio,Sergej Milinković-Savić,SRB,MF,24,1995,33.7,60,35,25,24,11,15,79,19.0,64,67,16,51,37,97,60,1,2020
ITA-Serie A,2019,Lazio,Thomas Strakosha,ALB,GK,24,1995,38.0,0,0,0,0,0,0,1,0.0,1,0,0,0,0,0,7,2,2020
ITA-Serie A,2019,Lazio,Valon Berisha,KVX,MF,26,1993,0.4,1,1,0,1,0,1,2,50.0,1,0,0,0,0,1,1,0,2020
ITA-Serie A,2019,Lazio,Ștefan Radu,ROU,DF,32,1986,25.6,43,25,24,15,4,28,43,65.1,15,19,9,10,34,77,85,0,2020
ITA-Serie A,2019,Lecce,Alessandro Deiola,ITA,MF,23,1995,8.0,16,9,9,7,0,9,24,37.5,15,12,4,8,8,24,14,1,2020
ITA-Serie A,2019,Lecce,Andrea La Mantia,ITA,FW,28,1991,6.1,1,0,1,0,0,1,5,20.0,4,3,0,3,7,8,11,0,2020
ITA-Serie A,2019,Lecce,Andrea Rispoli,ITA,DF,30,1988,21.2,24,18,14,9,1,15,30,50.0,15,28,7,21,32,56,62,1,2020
ITA-Serie A,2019,Lecce,Andrea Tabanelli,ITA,MF,29,1990,10.7,22,13,10,9,3,8,28,28.6,20,13,2,11,11,33,19,0,2020
ITA-Serie A,2019,Lecce,Antonín Barák,CZE,MF,24,1994,15.2,19,10,9,10,0,6,24,25.0,18,18,1,17,9,28,20,2,2020
ITA-Serie A,2019,Lecce,Biagio Meccariello,ITA,DF,28,1991,8.5,23,13,15,6,2,12,29,41.4,17,14,2,12,10,33,25,0,2020
ITA-Serie A,2019,Lecce,Brayan Vera,COL,"DF,FW",20,1999,1.7,4,1,2,1,1,3,7,42.9,4,1,0,1,1,5,4,0,2020
ITA-Serie A,2019,Lecce,Cristian Dell'Orco,ITA,DF,25,1994,11.2,22,12,14,7,1,8,14,57.1,6,11,7,4,16,38,33,0,2020
ITA-Serie A,2019,Lecce,Davide Riccardi,ITA,DF,23,1996,0.2,0,0,0,0,0,0,1,0.0,1,0,0,0,0,0,1,0,2020
ITA-Serie A,2019,Lecce,Diego Farias,BRA,"MF,FW",29,1990,9.2,9,6,3,5,1,5,18,27.8,13,7,0,7,4,13,4,0,2020
ITA-Serie A,2019,Lecce,Edgaras Dubickas,LTU,DF,21,1998,0.0,0,0,0,0,0,0,0,,0,0,0,0,0,0,0,0,2020
ITA-Serie A,2019,Lecce,Fabio Lucioni,ITA,DF,31,1987,34.8,29,13,20,9,0,14,32,43.8,18,48,38,10,36,65,169,5,2020
ITA-Serie A,2019,Lecce,Filippo Falco,ITA,"FW,MF",27,1992,22.4,13,7,4,5,4,5,18,27.8,13,11,1,10,2,15,1,0,2020
ITA-Serie A,2019,Lecce,Gabriel,BRA,GK,26,1992,33.3,2,1,2,0,0,2,3,66.7,1,0,0,0,0,2,11,10,2020
ITA-Serie A,2019,Lecce,Gianluca Lapadula,PER,FW,29,1990,19.8,15,8,6,8,1,5,16,31.3,11,2,0,2,1,16,14,0,2020
ITA-Serie A,2019,Lecce,Giannelli Imbula,COD,MF,26,1992,1.4,2,0,2,0,0,0,1,0.0,1,4,1,3,2,4,0,0,2020
ITA-Serie A,2019,Lecce,Giulio Donati,ITA,DF,29,1990,19.6,32,21,22,8,2,15,28,53.6,13,19,10,9,25,57,42,0,2020
ITA-Serie A,2019,Lecce,Ilario Monterisi,ITA,DF,17,2001,0.0,0,0,0,0,0,0,0,,0,0,0,0,0,0,0,0,2020
ITA-Serie A,2019,Lecce,Jacopo Petriccione,ITA,MF,24,1995,23.8,38,20,29,9,0,15,57,26.3,42,20,7,13,28,66,25,2,2020
ITA-Serie A,2019,Lecce,Khouma Babacar,SEN,FW,26,1993,15.8,12,8,2,6,4,1,7,14.3,6,12,3,9,3,15,34,0,2020
ITA-Serie A,2019,Lecce,Luca Rossettini,ITA,DF,34,1985,25.1,25,14,18,7,0,17,34,50.0,17,31,22,9,35,60,126,1,2020
ITA-Serie A,2019,Lecce,Marco Calderoni,ITA,DF,30,1989,22.9,38,25,22,13,3,20,39,51.3,19,27,10,17,37,75,54,1,2020
ITA-Serie A,2019,Lecce,Marco Mancosu,ITA,"MF,FW",30,1988,27.1,32,18,11,16,5,10,46,21.7,36,34,9,25,16,48,15,1,2020
ITA-Serie A,2019,Lecce,Mauro Vigorito,ITA,GK,29,1990,4.7,0,0,0,0,0,0,0,,0,0,0,0,0,0,3,1,2020
ITA-Serie A,2019,Lecce,Nehuén Paz,ARG,DF,26,1993,9.4,14,5,11,3,0,10,12,83.3,2,12,6,6,20,34,38,1,2020
ITA-Serie A,2019,Lecce,Panagiotis Tachtsidis,GRE,MF,28,1991,22.3,52,27,26,20,6,20,56,35.7,36,27,11,16,35,87,32,2,2020
ITA-Serie A,2019,Lecce,Riccardo Saponara,ITA,"MF,FW",27,1991,10.5,12,8,4,8,0,6,13,46.2,7,2,0,2,5,17,7,0,2020
ITA-Serie A,2019,Lecce,Romario Benzar,ROU,DF,27,1992,1.1,2,2,1,1,0,2,3,66.7,1,1,0,1,0,2,2,0,2020
ITA-Serie A,2019,Lecce,Yevhen Shakhov,UKR,"MF,FW",28,1990,12.1,28,16,12,13,3,8,27,29.6,19,11,3,8,14,42,9,1,2020
ITA-Serie A,2019,Lecce,Žan Majer,SVN,MF,27,1992,18.5,39,18,19,12,8,17,56,30.4,39,27,6,21,26,65,18,1,2020
ITA-Serie A,2019,Milan,Alessio Romagnoli,ITA,DF,24,1995,34.3,46,25,28,15,3,16,27,59.3,11,32,18,14,56,102,157,1,2020
ITA-Serie A,2019,Milan,Alexis Saelemaekers,BEL,"FW,DF",20,1999,7.6,14,8,5,7,2,6,20,30.0,14,13,1,12,8,22,1,0,2020
ITA-Serie A,2019,Milan,Andrea Conti,ITA,DF,25,1994,19.2,41,25,23,15,3,21,49,42.9,28,21,8,13,43,84,42,1,2020
ITA-Serie A,2019,Milan,André Silva,POR,FW,23,1995,0.7,2,1,0,0,2,0,1,0.0,1,0,0,0,0,2,0,0,2020
ITA-Serie A,2019,Milan,Ante Rebić,CRO,"FW,MF",25,1993,15.5,16,11,4,9,3,7,34,20.6,27,14,1,13,3,19,12,0,2020
ITA-Serie A,2019,Milan,Asmir Begović,BIH,GK,32,1987,1.4,0,0,0,0,0,0,0,,0,0,0,0,0,0,0,0,2020
ITA-Serie A,2019,Milan,Daniel Maldini,ITA,"FW,MF",17,2001,0.3,0,0,0,0,0,0,2,0.0,2,1,0,1,1,1,0,0,2020
ITA-Serie A,2019,Milan,Davide Calabria,ITA,DF,22,1996,18.0,52,33,28,22,2,17,41,41.5,24,23,5,18,21,73,47,1,2020
ITA-Serie A,2019,Milan,Diego Laxalt,URU,DF,26,1993,1.9,3,3,3,0,0,1,3,33.3,2,4,0,4,0,3,3,0,2020
ITA-Serie A,2019,Milan,Fabio Borini,ITA,MF,28,1991,0.8,2,2,0,0,2,0,2,0.0,2,1,0,1,0,2,3,0,2020
ITA-Serie A,2019,Milan,Franck Kessié,CIV,MF,22,1996,32.3,54,29,28,18,8,16,52,30.8,36,34,5,29,34,88,32,2,2020
ITA-Serie A,2019,Milan,Giacomo Bonaventura,ITA,"MF,FW",29,1989,14.9,16,9,5,6,5,5,17,29.4,12,8,3,5,7,23,10,0,2020
ITA-Serie A,2019,Milan,Gianluigi Donnarumma,ITA,GK,20,1999,35.6,1,0,1,0,0,1,2,50.0,1,0,0,0,3,4,25,7,2020
ITA-Serie A,2019,Milan,Hakan Çalhanoğlu,TUR,"MF,FW",25,1994,30.0,42,21,15,21,6,12,35,34.3,23,26,2,24,26,68,26,1,2020
ITA-Serie A,2019,Milan,Ismaël Bennacer,ALG,MF,21,1997,27.6,67,47,21,34,12,29,73,39.7,44,25,7,18,54,121,15,2,2020
ITA-Serie A,2019,Milan,Krzysztof Piątek,POL,FW,24,1995,13.1,9,4,0,7,2,3,11,27.3,8,5,2,3,3,12,10,0,2020
ITA-Serie A,2019,Milan,Lorenzo Colombo,ITA,FW,17,2002,0.1,0,0,0,0,0,0,0,,0,0,0,0,0,0,0,0,2020
ITA-Serie A,2019,Milan,Lucas Biglia,ARG,MF,33,1986,7.6,13,7,7,6,0,4,15,26.7,11,12,4,8,7,20,10,1,2020
ITA-Serie A,2019,Milan,Lucas Paquetá,BRA,"MF,FW",21,1997,12.3,33,19,12,17,4,14,37,37.8,23,17,2,15,8,41,9,0,2020
ITA-Serie A,2019,Milan,Léo Duarte,BRA,DF,23,1996,4.5,4,3,0,3,1,1,4,25.0,3,9,6,3,3,7,9,0,2020
ITA-Serie A,2019,Milan,Marco Brescianini,ITA,MF,19,2000,0.3,1,1,1,0,0,0,0,,0,0,0,0,2,3,0,0,2020
ITA-Serie A,2019,Milan,Mateo Musacchio,ARG,DF,28,1990,16.3,15,8,11,4,0,7,20,35.0,13,10,7,3,22,37,50,0,2020
ITA-Serie A,2019,Milan,Matteo Gabbia,ITA,DF,19,1999,7.6,7,5,5,2,0,5,8,62.5,3,6,6,0,9,16,21,0,2020
ITA-Serie A,2019,Milan,Pepe Reina,ESP,GK,36,1982,1.0,0,0,0,0,0,0,0,,0,0,0,0,0,0,0,1,2020
ITA-Serie A,2019,Milan,Rade Krunić,BIH,"MF,FW",25,1993,6.0,16,8,8,5,3,9,16,56.3,7,5,0,5,9,25,5,0,2020
ITA-Serie A,2019,Milan,Rafael Leão,POR,FW,20,1999,15.6,7,4,2,5,0,3,9,33.3,6,4,0,4,0,7,5,0,2020
ITA-Serie A,2019,Milan,Ricardo Rodríguez,SUI,DF,26,1992,4.3,6,1,2,2,2,2,6,33.3,4,3,2,1,5,11,17,0,2020
ITA-Serie A,2019,Milan,Samu Castillejo,ESP,"FW,MF",24,1995,13.4,24,15,10,11,3,9,42,21.4,33,17,2,15,24,48,5,0,2020
ITA-Serie A,2019,Milan,Simon Kjær,DEN,DF,30,1989,13.8,22,13,17,5,0,10,18,55.6,8,20,16,4,15,37,52,0,2020
ITA-Serie A,2019,Milan,Suso,ESP,"FW,MF",25,1993,15.1,7,3,2,3,2,2,10,20.0,8,5,0,5,8,15,3,0,2020
ITA-Serie A,2019,Milan,Theo Hernández,FRA,DF,21,1997,31.3,56,39,32,18,6,33,53,62.3,20,34,6,28,43,99,62,2,2020
ITA-Serie A,2019,Milan,Zlatan Ibrahimović,SWE,FW,37,1981,15.1,5,1,0,2,3,1,13,7.7,12,4,3,1,5,10,21,0,2020
ITA-Serie A,2019,Napoli,Alex Meret,ITA,GK,22,1997,21.7,0,0,0,0,0,0,2,0.0,2,1,0,1,1,1,7,2,2020
ITA-Serie A,2019,Napoli,Allan,BRA,MF,28,1991,14.2,50,27,20,21,9,18,54,33.3,36,19,3,16,16,66,11,1,2020
ITA-Serie A,2019,Napoli,Amin Younes,GER,"FW,MF",25,1993,2.0,3,2,1,2,0,2,4,50.0,2,2,0,2,0,3,1,0,2020
ITA-Serie A,2019,Napoli,Arkadiusz Milik,POL,FW,25,1994,19.4,12,5,4,1,7,3,11,27.3,8,11,1,10,2,14,12,0,2020
ITA-Serie A,2019,Napoli,David Ospina,COL,GK,30,1988,16.3,0,0,0,0,0,0,0,,0,0,0,0,0,0,2,1,2020
ITA-Serie A,2019,Napoli,Diego Demme,GER,MF,27,1991,10.0,18,8,14,3,1,8,23,34.8,15,9,1,8,8,26,9,0,2020
ITA-Serie A,2019,Napoli,Dries Mertens,BEL,FW,32,1987,18.8,13,9,1,8,4,2,27,7.4,25,10,1,9,7,20,4,0,2020
ITA-Serie A,2019,Napoli,Elif Elmas,MKD,MF,19,1999,12.6,16,7,5,6,5,5,20,25.0,15,11,1,10,11,27,4,0,2020
ITA-Serie A,2019,Napoli,Elseid Hysaj,ALB,DF,25,1994,16.5,18,9,13,4,1,12,26,46.2,14,16,3,13,24,42,26,0,2020
ITA-Serie A,2019,Napoli,Fabián Ruiz Peña,ESP,MF,23,1996,29.8,43,26,19,18,6,24,65,36.9,41,32,4,28,32,75,18,2,2020
ITA-Serie A,2019,Napoli,Faouzi Ghoulam,ALG,DF,28,1991,4.2,6,4,1,4,1,2,5,40.0,3,3,2,1,4,10,8,0,2020
ITA-Serie A,2019,Napoli,Fernando Llorente,ESP,FW,34,1985,5.6,0,0,0,0,0,0,1,0.0,1,4,0,4,1,1,3,0,2020
ITA-Serie A,2019,Napoli,Giovanni Di Lorenzo,ITA,DF,25,1993,33.0,59,35,27,19,13,32,61,52.5,29,27,11,16,28,87,54,0,2020
ITA-Serie A,2019,Napoli,Hirving Lozano,MEX,"FW,MF",24,1995,11.4,6,4,1,5,0,2,15,13.3,13,13,0,13,5,11,5,0,2020
ITA-Serie A,2019,Napoli,José Callejón,ESP,"FW,MF",32,1987,24.1,13,9,3,7,3,9,25,36.0,16,15,3,12,10,23,14,1,2020
ITA-Serie A,2019,Napoli,Kalidou Koulibaly,SEN,DF,28,1991,23.4,51,33,30,17,4,17,28,60.7,11,28,16,12,31,82,61,1,2020
ITA-Serie A,2019,Napoli,Kostas Manolas,GRE,DF,28,1991,24.2,23,15,13,10,0,10,17,58.8,7,19,14,5,25,48,76,1,2020
ITA-Serie A,2019,Napoli,Kévin Malcuit,MAR,DF,28,1991,2.8,8,6,4,3,1,5,6,83.3,1,4,1,3,3,11,2,0,2020
ITA-Serie A,2019,Napoli,Lorenzo Insigne,ITA,"FW,MF",28,1991,31.2,21,15,6,8,7,6,35,17.1,29,13,0,13,30,51,4,1,2020
ITA-Serie A,2019,Napoli,Matteo Politano,ITA,FW,25,1993,8.3,12,6,8,2,2,5,14,35.7,9,6,0,6,5,17,3,0,2020
ITA-Serie A,2019,Napoli,Mário Rui,POR,DF,28,1991,21.8,31,17,12,12,7,11,29,37.9,18,24,5,19,21,52,43,0,2020
ITA-Serie A,2019,Napoli,Nikola Maksimović,SRB,DF,27,1991,20.0,35,24,21,14,0,10,21,47.6,11,19,11,8,30,65,64,1,2020
ITA-Serie A,2019,Napoli,Piotr Zieliński,POL,MF,25,1994,32.5,26,16,10,11,5,12,30,40.0,18,28,5,23,21,47,15,0,2020
ITA-Serie A,2019,Napoli,Sebastiano Luperto,ITA,DF,22,1996,5.9,12,9,7,3,2,6,9,66.7,3,5,3,2,6,18,16,0,2020
ITA-Serie A,2019,Napoli,Stanislav Lobotka,SVK,MF,24,1994,8.4,11,9,3,5,3,5,12,41.7,7,3,1,2,9,20,2,0,2020
ITA-Serie A,2019,Parma,Alberto Grassi,ITA,MF,24,1995,7.1,10,4,7,3,0,5,13,38.5,8,5,2,3,19,29,9,1,2020
ITA-Serie A,2019,Parma,Andreas Cornelius,DEN,FW,26,1993,16.6,9,4,2,5,2,4,11,36.4,7,7,0,7,2,11,26,0,2020
ITA-Serie A,2019,Parma,Antonino Barillà,ITA,MF,31,1988,18.8,43,31,22,19,2,16,45,35.6,29,26,8,18,17,60,32,0,2020
ITA-Serie A,2019,Parma,Bruno Alves,POR,DF,37,1981,29.7,17,11,12,5,0,8,13,61.5,5,30,21,9,25,42,150,2,2020
ITA-Serie A,2019,Parma,Dejan Kulusevski,SWE,"FW,MF",19,2000,32.6,41,21,10,24,7,19,64,29.7,45,25,1,24,23,64,17,0,2020
ITA-Serie A,2019,Parma,Gastón Brugman,URU,MF,26,1992,16.2,47,24,25,15,7,19,46,41.3,27,33,15,18,27,74,19,2,2020
ITA-Serie A,2019,Parma,Gervinho,CIV,FW,32,1987,25.2,12,6,5,6,1,6,17,35.3,11,4,0,4,5,17,3,0,2020
ITA-Serie A,2019,Parma,Gianluca Caprari,ITA,"FW,MF",26,1993,6.5,1,1,0,1,0,0,5,0.0,5,7,2,5,4,5,2,0,2020
ITA-Serie A,2019,Parma,Giuseppe Pezzella,ITA,DF,21,1997,10.5,20,12,17,3,0,11,19,57.9,8,13,9,4,6,26,30,0,2020
ITA-Serie A,2019,Parma,Hernani,BRA,MF,25,1994,26.9,61,31,25,31,5,30,112,26.8,82,53,11,42,50,111,51,1,2020
ITA-Serie A,2019,Parma,Jasmin Kurtić,SVN,"MF,FW",30,1989,18.5,32,23,19,10,3,13,35,37.1,22,19,5,14,15,47,27,2,2020
ITA-Serie A,2019,Parma,Juraj Kucka,SVK,"MF,FW",32,1987,21.5,43,22,21,16,6,14,61,23.0,47,21,4,17,29,72,36,0,2020
ITA-Serie A,2019,Parma,Kastriot Dermaku,ALB,DF,27,1992,11.4,13,5,10,3,0,3,5,60.0,2,20,16,4,12,25,61,1,2020
ITA-Serie A,2019,Parma,Luca Siligardi,ITA,"MF,FW",31,1988,3.7,6,2,3,2,1,4,8,50.0,4,3,0,3,3,9,5,0,2020
ITA-Serie A,2019,Parma,Luigi Sepe,ITA,GK,28,1991,34.0,1,0,1,0,0,1,2,50.0,1,0,0,0,0,1,6,2,2020
ITA-Serie A,2019,Parma,Matteo Darmian,ITA,DF,29,1989,29.8,81,42,48,30,3,40,83,48.2,43,38,16,22,25,106,78,1,2020
ITA-Serie A,2019,Parma,Matteo Scozzarella,ITA,MF,31,1988,10.2,23,15,8,13,2,14,29,48.3,15,19,14,5,27,50,28,0,2020
ITA-Serie A,2019,Parma,Mattia Sprocati,ITA,"FW,MF",26,1993,6.6,4,2,3,1,0,0,1,0.0,1,5,1,4,2,6,2,0,2020
ITA-Serie A,2019,Parma,Riccardo Gagliolo,SWE,DF,29,1990,28.9,57,32,37,12,8,30,60,50.0,30,35,18,17,53,110,100,0,2020
ITA-Serie A,2019,Parma,Roberto Inglese,ITA,FW,27,1991,8.5,9,6,2,2,5,2,10,20.0,8,8,2,6,2,11,1,0,2020
ITA-Serie A,2019,Parma,Simone Colombi,ITA,GK,28,1991,4.0,0,0,0,0,0,0,0,,0,0,0,0,0,0,1,0,2020
ITA-Serie A,2019,Parma,Simone Iacoponi,ITA,DF,32,1987,33.9,49,25,36,12,1,26,42,61.9,16,37,29,8,35,84,140,2,2020
ITA-Serie A,2019,Parma,Vasco Regini,ITA,DF,28,1990,0.6,0,0,0,0,0,0,0,,0,0,0,0,0,0,3,0,2020
ITA-Serie A,2019,Parma,Vincent Laurini,FRA,DF,30,1989,9.8,26,22,11,11,4,14,18,77.8,4,10,3,7,11,37,29,0,2020
ITA-Serie A,2019,Parma,Yann Karamoh,FRA,"FW,MF",21,1998,6.4,10,7,5,4,1,3,9,33.3,6,5,0,5,2,12,3,0,2020
ITA-Serie A,2019,Roma,Aleksandar Kolarov,SRB,DF,33,1985,30.4,37,28,16,16,5,20,37,54.1,17,20,9,11,31,68,57,0,2020
ITA-Serie A,2019,Roma,Alessandro Florenzi,ITA,"DF,FW",28,1991,11.1,14,11,8,4,2,7,20,35.0,13,9,3,6,16,30,19,0,2020
ITA-Serie A,2019,Roma,Amadou Diawara,GUI,MF,22,1997,16.9,40,25,14,20,6,8,30,26.7,22,10,1,9,33,73,16,2,2020
ITA-Serie A,2019,Roma,Antonio Mirante,ITA,GK,36,1983,5.0,0,0,0,0,0,0,1,0.0,1,0,0,0,0,0,2,1,2020
ITA-Serie A,2019,Roma,Bruno Peres,BRA,DF,29,1990,11.7,14,10,10,3,1,8,21,38.1,13,12,3,9,15,29,19,2,2020
ITA-Serie A,2019,Roma,Bryan Cristante,ITA,MF,24,1995,18.0,25,15,6,14,5,8,27,29.6,19,13,4,9,22,47,23,0,2020
ITA-Serie A,2019,Roma,Carles Pérez,ESP,"FW,MF",21,1998,6.3,12,8,4,6,2,3,10,30.0,7,6,1,5,3,15,1,0,2020
ITA-Serie A,2019,Roma,Cengiz Ünder,TUR,FW,22,1997,9.7,10,6,4,4,2,2,9,22.2,7,7,2,5,8,18,7,0,2020
ITA-Serie A,2019,Roma,Chris Smalling,ENG,DF,29,1989,28.5,25,16,15,9,1,10,13,76.9,3,44,35,9,56,81,126,2,2020
ITA-Serie A,2019,Roma,Daniel Fuzato,BRA,GK,22,1997,1.0,0,0,0,0,0,0,0,,0,0,0,0,0,0,0,0,2020
ITA-Serie A,2019,Roma,Davide Santon,ITA,DF,28,1991,6.9,11,6,6,5,0,6,17,35.3,11,2,1,1,11,22,13,0,2020
ITA-Serie A,2019,Roma,Davide Zappacosta,ITA,DF,27,1992,5.0,7,3,2,3,2,4,8,50.0,4,3,1,2,6,13,8,1,2020
ITA-Serie A,2019,Roma,Diego Perotti,ARG,"FW,MF",31,1988,9.7,16,13,5,8,3,5,20,25.0,15,14,0,14,3,19,6,0,2020
ITA-Serie A,2019,Roma,Edin Džeko,BIH,FW,33,1986,31.7,16,11,2,7,7,2,13,15.4,11,11,4,7,6,22,33,0,2020
ITA-Serie A,2019,Roma,Federico Fazio,ARG,DF,32,1987,13.5,19,11,12,6,1,6,11,54.5,5,8,6,2,19,38,52,0,2020
ITA-Serie A,2019,Roma,Gianluca Mancini,ITA,"DF,MF",23,1996,30.4,49,26,26,18,5,22,44,50.0,22,32,15,17,60,109,98,1,2020
ITA-Serie A,2019,Roma,Gonzalo Villar,ESP,MF,21,1998,3.3,5,3,4,0,1,2,4,50.0,2,2,0,2,2,7,3,0,2020
ITA-Serie A,2019,Roma,Henrikh Mkhitaryan,ARM,"MF,FW",30,1989,17.0,32,22,10,17,5,19,45,42.2,26,27,3,24,11,43,6,0,2020
ITA-Serie A,2019,Roma,Javier Pastore,ARG,MF,30,1989,5.7,14,10,3,5,6,5,12,41.7,7,4,0,4,5,19,5,0,2020
ITA-Serie A,2019,Roma,Jordan Veretout,FRA,MF,26,1993,29.2,36,18,13,16,7,14,43,32.6,29,35,5,30,18,54,31,1,2020
ITA-Serie A,2019,Roma,Juan Jesus,BRA,DF,28,1991,1.5,2,1,2,0,0,0,3,0.0,3,1,0,1,1,3,7,0,2020
ITA-Serie A,2019,Roma,Justin Kluivert,NED,FW,20,1999,16.8,17,11,4,8,5,7,16,43.8,9,15,0,15,6,23,7,0,2020
ITA-Serie A,2019,Roma,Leonardo Spinazzola,ITA,DF,26,1993,17.2,24,12,11,8,5,12,21,57.1,9,13,5,8,20,44,41,0,2020
ITA-Serie A,2019,Roma,Lorenzo Pellegrini,ITA,MF,23,1996,23.3,30,13,9,13,8,12,33,36.4,21,28,0,28,15,45,18,0,2020
ITA-Serie A,2019,Roma,Mirko Antonucci,ITA,"FW,MF",20,1999,0.9,4,3,1,0,3,3,3,100.0,0,2,0,2,2,6,1,0,2020
ITA-Serie A,2019,Roma,Nicolò Zaniolo,ITA,"FW,MF",20,1999,16.7,15,11,4,7,4,3,24,12.5,21,14,0,14,5,20,5,0,2020
ITA-Serie A,2019,Roma,Nikola Kalinić,CRO,FW,31,1988,6.3,2,1,0,2,0,0,0,,0,2,0,2,1,3,1,0,2020
ITA-Serie A,2019,Roma,Pau López,ESP,GK,24,1994,32.0,1,0,1,0,0,1,5,20.0,4,0,0,0,1,2,10,3,2020
ITA-Serie A,2019,Roma,Riccardo Calafiori,ITA,DF,17,2002,0.7,0,0,0,0,0,0,1,0.0,1,0,0,0,2,2,0,0,2020
ITA-Serie A,2019,Roma,Roger Ibanez,BRA,DF,20,1998,6.8,11,8,6,3,2,5,7,71.4,2,9,6,3,18,29,21,1,2020
ITA-Serie A,2019,Roma,Yıldırım Mert Çetin,TUR,DF,22,1997,2.9,5,1,4,1,0,3,5,60.0,2,4,3,1,4,9,8,1,2020
ITA-Serie A,2019,SPAL,Alberto Cerri,ITA,FW,23,1996,4.7,2,1,0,2,0,1,3,33.3,2,1,0,1,0,2,3,0,2020
ITA-Serie A,2019,SPAL,Alberto Paloschi,ITA,FW,29,1990,4.9,3,0,3,0,0,2,8,25.0,6,3,0,3,0,3,2,0,2020
ITA-Serie A,2019,SPAL,Alessandro Murgia,ITA,MF,22,1996,19.4,27,17,16,8,3,14,34,41.2,20,10,3,7,18,45,15,0,2020
ITA-Serie A,2019,SPAL,Andrea Petagna,ITA,FW,24,1995,33.7,9,4,2,7,0,3,17,17.6,14,11,5,6,1,10,27,0,2020
ITA-Serie A,2019,SPAL,Arkadiusz Reca,POL,DF,24,1995,21.4,38,23,22,10,6,13,39,33.3,26,15,2,13,32,70,48,1,2020
ITA-Serie A,2019,SPAL,Bartosz Salamon,POL,DF,28,1991,3.8,2,1,2,0,0,1,2,50.0,1,4,4,0,6,8,14,0,2020
ITA-Serie A,2019,SPAL,Bryan Dabo,BFA,MF,27,1992,12.5,18,10,13,4,1,5,15,33.3,10,13,2,11,9,27,14,0,2020
ITA-Serie A,2019,SPAL,Demba Thiam,SEN,GK,21,1998,2.0,0,0,0,0,0,0,0,,0,0,0,0,1,1,0,0,2020
ITA-Serie A,2019,SPAL,Ervin Zukanović,BIH,DF,32,1987,2.3,1,0,0,0,1,1,1,100.0,0,3,1,2,3,4,15,0,2020
ITA-Serie A,2019,SPAL,Etrit Berisha,ALB,GK,30,1989,26.0,3,2,3,0,0,2,3,66.7,1,0,0,0,1,4,9,0,2020
ITA-Serie A,2019,SPAL,Federico Di Francesco,ITA,FW,25,1994,12.0,11,5,2,6,3,3,15,20.0,12,9,1,8,3,14,2,1,2020
ITA-Serie A,2019,SPAL,Felipe dal Belo,BRA,DF,35,1984,11.1,13,6,9,4,0,9,15,60.0,6,14,12,2,9,22,30,0,2020
ITA-Serie A,2019,SPAL,Francesco Vicari,ITA,DF,24,1994,32.2,27,13,20,6,1,12,25,48.0,13,48,37,11,38,65,145,1,2020
ITA-Serie A,2019,SPAL,Gabriel Strefezza,BRA,"DF,MF",22,1997,23.4,64,40,28,26,10,22,54,40.7,32,29,3,26,21,85,17,0,2020
ITA-Serie A,2019,SPAL,Gabriele Moncini,ITA,"FW,MF",23,1996,1.7,1,0,0,1,0,0,0,,0,2,1,1,1,2,0,0,2020
ITA-Serie A,2019,SPAL,Georgi Tunjov,EST,MF,18,2001,3.2,4,4,3,1,0,1,11,9.1,10,3,1,2,1,5,0,0,2020
ITA-Serie A,2019,SPAL,Igor,BRA,DF,21,1998,14.9,24,16,13,10,1,14,20,70.0,6,17,9,8,24,48,37,1,2020
ITA-Serie A,2019,SPAL,Jacopo Sala,ITA,DF,27,1991,9.5,29,24,17,11,1,17,31,54.8,14,4,0,4,13,42,15,1,2020
ITA-Serie A,2019,SPAL,Jakub Iskra,POL,DF,16,2002,0.9,0,0,0,0,0,0,0,,0,0,0,0,1,1,2,0,2020
ITA-Serie A,2019,SPAL,Jasmin Kurtić,SVN,MF,30,1989,15.7,20,7,8,8,4,6,27,22.2,21,14,2,12,10,30,20,1,2020
ITA-Serie A,2019,SPAL,Jaume Cuéllar,BOL,"MF,FW",17,2001,0.8,1,0,0,0,1,0,1,0.0,1,0,0,0,0,1,0,0,2020
ITA-Serie A,2019,SPAL,Karlo Letica,CRO,GK,22,1997,10.0,0,0,0,0,0,0,2,0.0,2,0,0,0,0,0,4,3,2020
ITA-Serie A,2019,SPAL,Kevin Bonifazi,ITA,DF,23,1996,13.2,16,9,15,1,0,9,18,50.0,9,20,12,8,35,51,50,2,2020
ITA-Serie A,2019,SPAL,Krisztofer Horváth,HUN,"FW,DF",17,2002,0.5,1,1,0,1,0,0,0,,0,0,0,0,0,1,0,0,2020
ITA-Serie A,2019,SPAL,Lucas Castro,ARG,MF,30,1989,4.7,13,5,5,5,3,2,4,50.0,2,4,0,4,2,15,3,0,2020
ITA-Serie A,2019,SPAL,Marco D'Alessandro,ITA,"MF,DF",28,1991,8.7,11,8,5,3,3,5,8,62.5,3,11,0,11,5,16,6,0,2020
ITA-Serie A,2019,SPAL,Marko Janković,MNE,"FW,DF",24,1995,1.3,2,1,0,0,2,1,2,50.0,1,2,1,1,0,2,0,0,2020
ITA-Serie A,2019,SPAL,Mattia Valoti,ITA,"MF,FW",25,1993,17.0,48,30,21,25,2,16,43,37.2,27,27,6,21,16,64,18,0,2020
ITA-Serie A,2019,SPAL,Mirko Valdifiori,ITA,MF,33,1986,15.6,31,15,14,17,0,16,33,48.5,17,8,3,5,4,35,25,0,2020
ITA-Serie A,2019,SPAL,Mohamed Fares,ALG,"DF,MF",23,1996,4.7,6,4,3,2,1,2,10,20.0,8,5,3,2,5,11,8,0,2020
ITA-Serie A,2019,SPAL,Nenad Tomović,SRB,DF,31,1987,19.5,26,19,18,6,2,10,21,47.6,11,32,23,9,30,56,65,1,2020
ITA-Serie A,2019,SPAL,Sergio Floccari,ITA,FW,37,1981,10.5,8,3,3,1,4,0,13,0.0,13,9,1,8,5,13,1,0,2020
ITA-Serie A,2019,SPAL,Simone Missiroli,ITA,MF,33,1986,31.1,42,27,18,20,4,13,43,30.2,30,42,27,15,54,96,62,1,2020
ITA-Serie A,2019,SPAL,Thiago Cionek,POL,DF,33,1986,24.1,53,32,36,12,5,22,53,41.5,31,30,11,19,46,99,91,2,2020
ITA-Serie A,2019,Sampdoria,Albin Ekdal,SWE,MF,30,1989,26.5,51,25,18,31,2,24,68,35.3,44,35,14,21,33,84,46,1,2020
ITA-Serie A,2019,Sampdoria,Alex Ferrari,ITA,DF,25,1994,11.2,18,13,13,5,0,7,12,58.3,5,13,8,5,12,30,31,0,2020
ITA-Serie A,2019,Sampdoria,Andrea Bertolacci,ITA,MF,28,1991,5.9,7,4,2,3,2,1,8,12.5,7,4,1,3,2,9,13,0,2020
ITA-Serie A,2019,Sampdoria,Antonino La Gumina,ITA,FW,23,1996,2.1,0,0,0,0,0,0,0,,0,0,0,0,0,0,1,0,2020
ITA-Serie A,2019,Sampdoria,Bartosz Bereszyński,POL,DF,27,1992,26.7,53,35,25,23,5,26,52,50.0,26,38,16,22,35,88,88,1,2020
ITA-Serie A,2019,Sampdoria,Emil Audero,ITA,GK,22,1997,36.0,1,1,1,0,0,1,3,33.3,2,0,0,0,0,1,21,1,2020
ITA-Serie A,2019,Sampdoria,Emiliano Rigoni,ARG,"MF,FW",26,1993,4.8,5,4,2,1,2,3,10,30.0,7,5,1,4,3,8,1,0,2020
ITA-Serie A,2019,Sampdoria,Fabio Depaoli,ITA,"MF,DF",22,1997,20.6,41,28,26,10,5,17,31,54.8,14,29,3,26,16,57,39,0,2020
ITA-Serie A,2019,Sampdoria,Fabio Quagliarella,ITA,FW,36,1983,25.3,9,5,0,6,3,2,30,6.7,28,13,0,13,8,17,15,0,2020
ITA-Serie A,2019,Sampdoria,Federico Bonazzoli,ITA,FW,22,1997,8.3,7,5,1,4,2,0,7,0.0,7,3,0,3,5,12,2,0,2020
ITA-Serie A,2019,Sampdoria,Felice D'Amico,ITA,MF,18,2000,0.0,1,1,0,0,1,0,0,,0,0,0,0,0,1,0,0,2020
ITA-Serie A,2019,Sampdoria,Gastón Ramírez,URU,"MF,FW",28,1990,15.5,32,21,7,16,9,8,30,26.7,22,28,2,26,11,43,10,0,2020
ITA-Serie A,2019,Sampdoria,Gianluca Caprari,ITA,"FW,MF",26,1993,7.4,9,7,1,6,2,4,13,30.8,9,5,0,5,7,16,1,0,2020
ITA-Serie A,2019,Sampdoria,Gonzalo Maroni,ARG,"MF,FW",20,1999,2.0,3,1,1,1,1,3,7,42.9,4,1,0,1,3,6,0,0,2020
ITA-Serie A,2019,Sampdoria,Jakub Jankto,CZE,"MF,FW",23,1996,23.3,27,13,14,10,3,10,42,23.8,32,30,3,27,22,49,22,0,2020
ITA-Serie A,2019,Sampdoria,Jeison Murillo,COL,DF,27,1992,7.4,18,6,14,4,0,10,19,52.6,9,8,4,4,10,28,28,0,2020
ITA-Serie A,2019,Sampdoria,Julian Chabot,GER,DF,21,1998,6.3,11,7,6,5,0,6,11,54.5,5,3,2,1,15,26,26,0,2020
ITA-Serie A,2019,Sampdoria,Karol Linetty,POL,MF,24,1995,22.4,61,32,24,25,12,21,65,32.3,44,26,3,23,26,87,17,0,2020
ITA-Serie A,2019,Sampdoria,Kristoffer Askildsen,NOR,MF,18,2001,0.8,1,1,1,0,0,0,0,,0,1,0,1,1,2,0,0,2020
ITA-Serie A,2019,Sampdoria,Lorenzo Tonelli,ITA,DF,29,1990,7.8,13,9,13,0,0,4,10,40.0,6,10,7,3,4,17,23,0,2020
ITA-Serie A,2019,Sampdoria,Manolo Gabbiadini,ITA,FW,27,1991,22.6,9,7,2,3,4,1,7,14.3,6,12,0,12,10,19,11,0,2020
ITA-Serie A,2019,Sampdoria,Maya Yoshida,JPN,DF,30,1988,13.2,4,3,2,2,0,2,6,33.3,4,15,12,3,27,31,72,0,2020
ITA-Serie A,2019,Sampdoria,Mehdi Léris,ALG,"MF,FW",21,1998,5.7,13,11,4,2,7,7,19,36.8,12,12,4,8,6,19,6,0,2020
ITA-Serie A,2019,Sampdoria,Morten Thorsby,NOR,"MF,DF",23,1996,20.7,53,34,17,23,13,27,52,51.9,25,24,6,18,17,70,34,0,2020
ITA-Serie A,2019,Sampdoria,Nicola Murru,ITA,DF,24,1994,25.1,40,22,24,8,8,21,41,51.2,20,22,4,18,27,67,58,0,2020
ITA-Serie A,2019,Sampdoria,Omar Colley,GAM,DF,26,1992,30.8,42,26,27,14,1,12,24,50.0,12,33,22,11,59,101,155,1,2020
ITA-Serie A,2019,Sampdoria,Ronaldo Vieira,GNB,MF,21,1998,20.2,,21,,,,,,,,,,,22,,,,2020
ITA-Serie A,2019,Sampdoria,Tommaso Augello,ITA,DF,24,1994,12.6,14,9,6,3,5,5,7,71.4,2,8,0,8,15,29,21,1,2020
ITA-Serie A,2019,Sampdoria,Vasco Regini,ITA,DF,28,1990,1.9,4,2,3,1,0,0,0,,0,4,2,2,1,5,6,0,2020
ITA-Serie A,2019,Sampdoria,Wladimiro Falcone,ITA,GK,24,1995,2.0,0,0,0,0,0,0,0,,0,0,0,0,0,0,0,0,2020
ITA-Serie A,2019,Sampdoria,Édgar Barreto,PAR,MF,35,1984,1.0,4,3,0,1,3,2,3,66.7,1,1,0,1,0,4,0,0,2020
ITA-Serie A,2019,Sassuolo,Alessandro Tripaldelli,ITA,DF,20,1999,1.5,4,4,1,3,0,1,3,33.3,2,1,0,1,3,7,3,0,2020
ITA-Serie A,2019,Sassuolo,Alfred Duncan,GHA,MF,26,1993,9.4,19,12,8,7,4,6,16,37.5,10,7,0,7,9,28,13,0,2020
ITA-Serie A,2019,Sassuolo,Andrea Consigli,ITA,GK,32,1987,31.0,0,0,0,0,0,0,1,0.0,1,0,0,0,4,4,19,2,2020
ITA-Serie A,2019,Sassuolo,Andrea Ghion,ITA,"FW,MF",19,2000,0.5,3,1,1,2,0,1,1,100.0,0,0,0,0,0,3,0,0,2020
ITA-Serie A,2019,Sassuolo,Domenico Berardi,ITA,FW,24,1994,27.7,32,16,19,8,5,13,59,22.0,46,31,3,28,33,65,27,0,2020
ITA-Serie A,2019,Sassuolo,Federico Peluso,ITA,DF,35,1984,16.8,19,16,8,8,3,8,9,88.9,1,14,9,5,22,41,58,1,2020
ITA-Serie A,2019,Sassuolo,Filip Đuričić,SRB,"MF,FW",27,1992,18.1,23,14,2,10,11,3,19,15.8,16,20,3,17,8,31,14,0,2020
ITA-Serie A,2019,Sassuolo,Filippo Romagna,ITA,DF,22,1997,16.4,7,6,2,5,0,5,6,83.3,1,24,17,7,10,17,69,0,2020
ITA-Serie A,2019,Sassuolo,Francesco Caputo,ITA,FW,31,1987,32.6,7,4,3,2,2,3,11,27.3,8,15,0,15,1,8,8,0,2020
ITA-Serie A,2019,Sassuolo,Francesco Magnanelli,ITA,MF,34,1984,15.5,25,13,9,12,4,11,35,31.4,24,12,6,6,19,44,23,1,2020
ITA-Serie A,2019,Sassuolo,Giacomo Manzari,ITA,"FW,MF",18,2000,0.2,0,0,0,0,0,0,0,,0,0,0,0,0,0,0,0,2020
ITA-Serie A,2019,Sassuolo,Giacomo Raspadori,ITA,"MF,FW",19,2000,2.9,8,6,5,2,1,3,4,75.0,1,5,0,5,1,9,0,0,2020
ITA-Serie A,2019,Sassuolo,Gian Marco Ferrari,ITA,DF,27,1992,21.1,9,5,6,3,0,4,8,50.0,4,25,22,3,26,35,41,1,2020
ITA-Serie A,2019,Sassuolo,Giangiacomo Magnani,ITA,DF,23,1995,1.6,0,0,0,0,0,0,0,,0,2,1,1,2,2,7,0,2020
ITA-Serie A,2019,Sassuolo,Gianluca Pegolo,ITA,GK,38,1981,5.0,0,0,0,0,0,0,0,,0,0,0,0,0,0,4,0,2020
ITA-Serie A,2019,Sassuolo,Giorgos Kyriakopoulos,GRE,DF,23,1996,18.3,35,18,22,7,6,18,32,56.3,14,19,6,13,18,53,41,0,2020
ITA-Serie A,2019,Sassuolo,Grégoire Defrel,MTQ,"FW,MF",28,1991,10.9,12,8,4,6,2,4,15,26.7,11,9,0,9,3,15,5,0,2020
ITA-Serie A,2019,Sassuolo,Hamed Junior Traorè,CIV,"MF,FW",19,2000,17.4,31,15,10,15,6,14,39,35.9,25,22,1,21,11,42,7,0,2020
ITA-Serie A,2019,Sassuolo,Jeremie Boga,CIV,FW,22,1997,27.9,12,7,3,8,1,6,20,30.0,14,24,0,24,3,15,4,0,2020
ITA-Serie A,2019,Sassuolo,Jeremy Toljan,GER,DF,24,1994,24.3,37,21,24,10,3,18,35,51.4,17,23,12,11,18,55,58,1,2020
ITA-Serie A,2019,Sassuolo,Luca Mazzitelli,ITA,MF,23,1995,0.1,1,1,0,1,0,1,1,100.0,0,0,0,0,0,1,0,0,2020
ITA-Serie A,2019,Sassuolo,Lukáš Haraslín,SVK,FW,23,1996,4.3,5,2,1,3,1,2,9,22.2,7,5,0,5,4,9,1,0,2020
ITA-Serie A,2019,Sassuolo,Manuel Locatelli,ITA,MF,21,1998,28.7,76,50,35,37,4,33,69,47.8,36,42,14,28,33,109,36,0,2020
ITA-Serie A,2019,Sassuolo,Marlon,BRA,DF,23,1995,20.2,40,23,24,15,1,17,27,63.0,10,20,13,7,35,75,69,0,2020
ITA-Serie A,2019,Sassuolo,Mehdi Bourabia,MAR,MF,27,1991,10.3,19,9,8,10,1,9,22,40.9,13,12,2,10,22,41,23,0,2020
ITA-Serie A,2019,Sassuolo,Mert Müldür,TUR,DF,20,1999,14.1,47,27,33,8,6,27,42,64.3,15,10,0,10,22,69,42,0,2020
ITA-Serie A,2019,Sassuolo,Pedro Obiang,EQG,MF,27,1992,18.6,46,31,21,19,6,19,40,47.5,21,24,10,14,21,67,31,1,2020
ITA-Serie A,2019,Sassuolo,Rogério,BRA,DF,21,1998,11.3,22,14,12,8,2,16,23,69.6,7,13,3,10,9,31,34,0,2020
ITA-Serie A,2019,Sassuolo,Stefano Piccinini,ITA,DF,16,2002,0.1,0,0,0,0,0,0,0,,0,0,0,0,0,0,0,0,2020
ITA-Serie A,2019,Sassuolo,Stefano Turati,ITA,GK,17,2001,2.0,0,0,0,0,0,0,0,,0,0,0,0,0,0,1,0,2020
ITA-Serie A,2019,Sassuolo,Vlad Chiricheș,ROU,DF,29,1989,7.9,14,9,12,2,0,7,10,70.0,3,13,8,5,11,25,28,2,2020
ITA-Serie A,2019,Torino,Andrea Belotti,ITA,FW,25,1993,33.4,29,16,7,17,5,5,31,16.1,26,23,5,18,5,34,20,1,2020
ITA-Serie A,2019,Torino,Antonio Rosati,ITA,GK,36,1983,1.0,0,0,0,0,0,0,0,,0,0,0,0,0,0,0,1,2020
ITA-Serie A,2019,Torino,Armando Izzo,ITA,DF,27,1992,29.8,42,24,24,14,4,17,35,48.6,18,44,29,15,71,113,121,1,2020
ITA-Serie A,2019,Torino,Christian Celesia,ITA,DF,17,2002,0.0,0,0,0,0,0,0,0,,0,0,0,0,0,0,0,0,2020
ITA-Serie A,2019,Torino,Cristian Ansaldi,ARG,"DF,MF",32,1986,19.6,37,25,24,7,6,19,34,55.9,15,23,3,20,14,51,20,4,2020
ITA-Serie A,2019,Torino,Daniele Baselli,ITA,MF,27,1992,14.2,43,23,17,19,7,13,40,32.5,27,20,4,16,25,68,25,0,2020
ITA-Serie A,2019,Torino,Diego Laxalt,URU,"DF,MF",26,1993,6.6,19,10,10,6,3,6,20,30.0,14,12,4,8,6,25,20,0,2020
ITA-Serie A,2019,Torino,Gleison Bremer,BRA,DF,22,1997,25.2,63,36,37,20,6,20,34,58.8,14,48,22,26,74,137,118,1,2020
ITA-Serie A,2019,Torino,Iago Falque,ESP,"FW,MF",29,1990,1.1,0,0,0,0,0,0,1,0.0,1,1,0,1,0,0,0,0,2020
ITA-Serie A,2019,Torino,Kevin Bonifazi,ITA,DF,23,1996,2.7,9,8,6,3,0,5,6,83.3,1,3,2,1,5,14,10,0,2020
ITA-Serie A,2019,Torino,Koffi Djidji,CIV,DF,26,1992,9.5,27,12,19,8,0,8,18,44.4,10,28,23,5,15,42,53,1,2020
ITA-Serie A,2019,Torino,Lorenzo De Silvestri,ITA,DF,31,1988,24.9,15,8,4,7,4,11,27,40.7,16,20,7,13,19,34,72,0,2020
ITA-Serie A,2019,Torino,Lyanco,BRA,DF,22,1997,13.1,23,13,9,12,2,7,13,53.8,6,29,19,10,23,46,54,2,2020
ITA-Serie A,2019,Torino,Michel Ndary Adopo,FRA,"DF,MF",19,2000,0.0,0,0,0,0,0,0,0,,0,1,1,0,0,0,0,0,2020
ITA-Serie A,2019,Torino,Nicolas Nkoulou,CMR,DF,29,1990,29.9,34,24,21,11,2,16,22,72.7,6,40,18,22,70,104,138,2,2020
ITA-Serie A,2019,Torino,Ola Aina,NGA,DF,22,1996,23.1,45,24,23,18,4,17,37,45.9,20,24,6,18,41,86,61,0,2020
ITA-Serie A,2019,Torino,Salvatore Sirigu,ITA,GK,32,1987,36.0,0,0,0,0,0,0,0,,0,0,0,0,2,2,12,0,2020
ITA-Serie A,2019,Torino,Samir Ujkani,KVX,GK,31,1988,1.0,0,0,0,0,0,0,0,,0,0,0,0,0,0,1,0,2020
ITA-Serie A,2019,Torino,Saša Lukić,SRB,MF,22,1996,20.7,29,17,8,19,2,10,35,28.6,25,21,7,14,29,58,15,0,2020
ITA-Serie A,2019,Torino,Simone Edera,ITA,"MF,FW",22,1997,4.4,13,5,3,7,3,2,12,16.7,10,1,0,1,1,14,3,0,2020
ITA-Serie A,2019,Torino,Simone Verdi,ITA,"MF,FW",27,1992,23.0,19,10,4,12,3,9,38,23.7,29,14,0,14,7,26,1,0,2020
ITA-Serie A,2019,Torino,Simone Zaza,ITA,FW,28,1991,18.2,15,10,6,4,5,3,10,30.0,7,11,0,11,9,24,13,1,2020
ITA-Serie A,2019,Torino,Soualiho Meïté,FRA,MF,25,1994,24.5,32,18,14,13,5,12,35,34.3,23,31,6,25,24,56,36,0,2020
ITA-Serie A,2019,Torino,Tomás Rincón,VEN,MF,31,1988,30.0,56,25,23,25,8,23,65,35.4,42,20,3,17,36,92,62,0,2020
ITA-Serie A,2019,Torino,Vincenzo Millico,ITA,"MF,FW",18,2000,2.4,1,0,1,0,0,1,3,33.3,2,2,0,2,0,1,1,0,2020
ITA-Serie A,2019,Torino,Wilfried Singo,CIV,DF,18,2000,1.5,1,0,0,1,0,0,0,,0,0,0,0,1,2,2,0,2020
ITA-Serie A,2019,Torino,Álex Berenguer,ESP,"MF,DF",24,1995,20.3,20,6,6,13,1,8,33,24.2,25,17,1,16,18,38,17,0,2020
ITA-Serie A,2019,Udinese,Antonín Barák,CZE,"MF,FW",24,1994,2.2,5,4,3,0,2,1,5,20.0,4,6,1,5,0,5,4,0,2020
ITA-Serie A,2019,Udinese,Bram Nuytinck,NED,DF,29,1990,24.7,46,32,30,13,3,17,27,63.0,10,50,32,18,27,73,96,1,2020
ITA-Serie A,2019,Udinese,Giuseppe Pezzella,ITA,DF,21,1997,0.9,0,0,0,0,0,0,0,,0,0,0,0,1,1,4,0,2020
ITA-Serie A,2019,Udinese,Hidde ter Avest,NED,DF,22,1997,7.6,18,9,13,3,2,14,17,82.4,3,6,1,5,9,27,27,0,2020
ITA-Serie A,2019,Udinese,Ignacio Pussetto,ARG,"FW,MF",23,1995,3.8,8,4,4,3,1,1,4,25.0,3,3,0,3,4,12,7,0,2020
ITA-Serie A,2019,Udinese,Ilija Nestorovski,MKD,FW,29,1990,13.9,10,7,5,5,0,6,21,28.6,15,13,2,11,4,14,12,0,2020
ITA-Serie A,2019,Udinese,Jens Stryger Larsen,DEN,DF,28,1991,31.0,27,19,15,9,3,17,30,56.7,13,20,5,15,20,47,52,0,2020
ITA-Serie A,2019,Udinese,Juan Musso,ARG,GK,25,1994,38.0,0,0,0,0,0,0,1,0.0,1,0,0,0,1,1,18,2,2020
ITA-Serie A,2019,Udinese,Ken Sema,SWE,"DF,MF",25,1993,27.3,59,41,43,15,1,36,68,52.9,32,26,6,20,17,76,41,1,2020
ITA-Serie A,2019,Udinese,Kevin Lasagna,ITA,FW,26,1992,28.5,27,14,7,13,7,6,31,19.4,25,23,1,22,10,37,18,1,2020
ITA-Serie A,2019,Udinese,Marco Ballarini,ITA,MF,18,2001,0.0,0,0,0,0,0,0,0,,0,0,0,0,0,0,0,0,2020
ITA-Serie A,2019,Udinese,Martin Palumbo,NOR,MF,17,2002,0.0,0,0,0,0,0,0,0,,0,0,0,0,0,0,0,0,2020
ITA-Serie A,2019,Udinese,Marvin Zeegelaar,NED,DF,28,1990,6.6,15,9,8,4,3,6,11,54.5,5,9,2,7,5,20,10,0,2020
ITA-Serie A,2019,Udinese,Mato Jajalo,BIH,MF,31,1988,18.3,44,19,19,22,3,14,38,36.8,24,20,7,13,19,63,19,2,2020
ITA-Serie A,2019,Udinese,Nicholas Opoku,GHA,DF,21,1997,5.3,13,8,8,3,2,6,11,54.5,5,6,4,2,4,17,19,0,2020
ITA-Serie A,2019,Udinese,Rodrigo Becão,BRA,DF,23,1996,24.6,56,25,34,19,3,26,46,56.5,20,40,20,20,45,101,77,0,2020
ITA-Serie A,2019,Udinese,Rodrigo De Paul,ARG,MF,25,1994,31.4,61,31,31,26,4,27,65,41.5,38,38,3,35,29,90,8,1,2020
ITA-Serie A,2019,Udinese,Rolando Mandragora,ITA,MF,22,1997,22.8,47,24,15,25,7,15,55,27.3,40,30,5,25,26,73,25,0,2020
ITA-Serie A,2019,Udinese,Samir Santos,BRA,DF,24,1994,17.2,35,27,24,8,3,12,23,52.2,11,16,6,10,33,68,64,1,2020
ITA-Serie A,2019,Udinese,Sebastien De Maio,FRA,DF,32,1987,16.7,18,11,11,7,0,7,11,63.6,4,28,20,8,32,50,86,2,2020
ITA-Serie A,2019,Udinese,Seko Fofana,CIV,MF,24,1995,25.0,17,12,8,8,1,9,35,25.7,26,20,1,19,17,34,19,0,2020
ITA-Serie A,2019,Udinese,Stefano Okaka,ITA,FW,29,1989,26.8,19,11,6,8,5,7,27,25.9,20,23,2,21,8,27,28,0,2020
ITA-Serie A,2019,Udinese,Walace,BRA,MF,24,1995,12.7,28,9,19,6,3,13,42,31.0,29,14,6,8,33,61,19,0,2020
ITA-Serie A,2019,Udinese,William Troost-Ekong,NGA,DF,25,1993,28.6,37,19,25,12,0,10,18,55.6,8,41,29,12,31,68,135,2,2020
ITA-Serie A,2019,Udinese,Łukasz Teodorczyk,POL,FW,28,1991,2.5,7,5,1,5,1,3,7,42.9,4,2,0,2,0,7,1,0,2020
ITA-Serie A,2020,Atalanta,Aleksei Miranchuk,RUS,"MF,FW",24,1995,7.5,24,13,8,9,7,6,9,66.7,3,1,0,1,3,27,1,0,2021
ITA-Serie A,2020,Atalanta,Amad Diallo,CIV,MF,18,2002,0.2,0,0,0,0,0,0,0,,0,0,0,0,0,0,0,0,2021
ITA-Serie A,2020,Atalanta,Berat Djimsiti,ALB,DF,27,1993,29.2,41,29,27,12,2,17,34,50.0,17,34,20,14,62,103,89,1,2021
ITA-Serie A,2020,Atalanta,Bosko Sutalo,CRO,DF,20,2000,2.6,5,5,0,3,2,4,5,80.0,1,2,1,1,2,7,7,1,2021
ITA-Serie A,2020,Atalanta,Cristian Romero,ARG,DF,22,1998,28.3,63,32,41,19,3,27,49,55.1,22,31,13,18,96,159,71,2,2021
ITA-Serie A,2020,Atalanta,Cristiano Piccini,ITA,DF,27,1992,0.7,1,1,1,0,0,0,1,0.0,1,1,0,1,0,1,0,0,2021
ITA-Serie A,2020,Atalanta,Davide Angelo Ghislandi,ITA,DF,19,2001,0.1,0,0,0,0,0,0,0,,0,0,0,0,0,0,1,0,2021
ITA-Serie A,2020,Atalanta,Duván Zapata,COL,FW,29,1991,26.4,12,5,2,3,7,4,13,30.8,9,19,5,14,6,18,19,0,2021
ITA-Serie A,2020,Atalanta,Fabio Depaoli,ITA,DF,23,1997,2.1,3,2,0,1,2,1,2,50.0,1,4,0,4,3,6,2,0,2021
ITA-Serie A,2020,Atalanta,Hans Hateboer,NED,DF,26,1994,19.6,28,17,12,14,2,13,23,56.5,10,8,1,7,17,45,9,0,2021
ITA-Serie A,2020,Atalanta,Joakim Mæhle,DEN,DF,23,1997,13.5,18,10,7,5,6,8,19,42.1,11,17,2,15,11,29,5,0,2021
ITA-Serie A,2020,Atalanta,Johan Mojica,COL,DF,27,1992,3.3,4,4,3,1,0,2,3,66.7,1,3,0,3,7,11,6,0,2021
ITA-Serie A,2020,Atalanta,Josip Iličić,SVN,"MF,FW",32,1988,17.0,9,4,1,5,3,5,21,23.8,16,12,0,12,2,11,0,1,2021
ITA-Serie A,2020,Atalanta,José Luis Palomino,ARG,DF,30,1990,27.0,67,33,41,19,7,24,48,50.0,24,30,16,14,79,146,60,2,2021
ITA-Serie A,2020,Atalanta,Luis Muriel,COL,FW,29,1991,16.0,20,9,4,8,8,9,26,34.6,17,17,0,17,7,27,4,0,2021
ITA-Serie A,2020,Atalanta,Manu Gyabuaa,ITA,MF,18,2001,0.0,0,0,0,0,0,0,0,,0,0,0,0,0,0,0,0,2021
ITA-Serie A,2020,Atalanta,Marco Sportiello,ITA,GK,28,1992,14.0,2,2,2,0,0,1,3,33.3,2,0,0,0,2,4,5,1,2021
ITA-Serie A,2020,Atalanta,Mario Pašalić,CRO,MF,25,1995,12.5,26,15,5,17,4,12,19,63.2,7,12,1,11,8,34,6,0,2021
ITA-Serie A,2020,Atalanta,Marten de Roon,NED,MF,29,1991,33.6,80,48,30,36,14,36,84,42.9,48,44,9,35,69,149,40,0,2021
ITA-Serie A,2020,Atalanta,Matteo Pessina,ITA,MF,23,1997,18.3,14,7,4,6,4,7,24,29.2,17,17,2,15,17,31,7,1,2021
ITA-Serie A,2020,Atalanta,Matteo Ruggeri,ITA,DF,18,2002,2.3,3,0,1,2,0,2,3,66.7,1,2,0,2,4,7,2,0,2021
ITA-Serie A,2020,Atalanta,Mattia Caldara,ITA,DF,26,1994,1.2,1,0,0,1,0,1,1,100.0,0,3,2,1,4,5,3,0,2021
ITA-Serie A,2020,Atalanta,Papu Gómez,ARG,"MF,FW",32,1988,7.4,3,2,2,1,0,2,8,25.0,6,8,1,7,1,4,1,0,2021
ITA-Serie A,2020,Atalanta,Pierluigi Gollini,ITA,GK,25,1995,24.0,1,0,1,0,0,1,2,50.0,1,1,0,1,1,2,11,0,2021
ITA-Serie A,2020,Atalanta,Rafael Tolói,ITA,DF,29,1990,28.2,51,23,21,26,4,26,48,54.2,22,37,7,30,33,84,66,0,2021
ITA-Serie A,2020,Atalanta,Remo Freuler,SUI,MF,28,1992,30.1,63,39,17,38,8,32,76,42.1,44,52,4,48,39,102,27,2,2021
ITA-Serie A,2020,Atalanta,Robin Gosens,GER,DF,26,1994,28.0,46,35,20,15,11,17,41,41.5,24,50,7,43,41,87,34,0,2021
ITA-Serie A,2020,Atalanta,Ruslan Malinovskyi,UKR,"MF,FW",27,1993,20.8,19,8,2,13,4,8,23,34.8,15,16,1,15,2,21,4,0,2021
ITA-Serie A,2020,Atalanta,Sam Lammers,NED,"FW,MF",23,1997,3.2,2,0,0,2,0,0,6,0.0,6,0,0,0,0,2,3,0,2021
ITA-Serie A,2020,Atalanta,Viktor Kovalenko,UKR,FW,24,1996,0.0,0,0,0,0,0,0,0,,0,0,0,0,0,0,1,0,2021
ITA-Serie A,2020,Benevento,Adolfo Gaich,ARG,FW,21,1999,8.5,9,4,1,7,1,1,13,7.7,12,4,0,4,2,11,4,0,2021
ITA-Serie A,2020,Benevento,Alessandro Tuia,ITA,DF,30,1990,19.6,39,17,34,4,1,15,25,60.0,10,22,10,12,36,75,91,1,2021
ITA-Serie A,2020,Benevento,Amadou Diambo,GHA,FW,19,2001,0.0,0,0,0,0,0,0,0,,0,0,0,0,0,0,0,0,2021
ITA-Serie A,2020,Benevento,Andrés Tello,COL,"DF,MF",23,1996,4.6,9,6,8,0,1,5,20,25.0,15,8,1,7,6,15,6,0,2021
ITA-Serie A,2020,Benevento,Artur Ioniță,MDA,MF,29,1990,31.5,47,22,11,31,5,17,63,27.0,46,38,14,24,19,66,28,0,2021
ITA-Serie A,2020,Benevento,Bryan Dabo,BFA,MF,28,1992,12.4,11,8,5,3,3,5,16,31.3,11,7,1,6,13,24,16,0,2021
ITA-Serie A,2020,Benevento,Christian Maggio,ITA,DF,38,1982,3.3,9,4,2,7,0,3,9,33.3,6,4,1,3,2,11,6,0,2021
ITA-Serie A,2020,Benevento,Christian Pastina,ITA,DF,19,2001,1.3,0,0,0,0,0,0,1,0.0,1,1,0,1,1,1,8,0,2021
ITA-Serie A,2020,Benevento,Daam Foulon,BEL,DF,21,1999,11.3,26,15,21,5,0,16,28,57.1,12,12,3,9,14,40,34,0,2021
ITA-Serie A,2020,Benevento,Fabio Depaoli,ITA,DF,23,1997,12.4,25,13,15,6,4,15,32,46.9,17,16,4,12,12,37,38,0,2021
ITA-Serie A,2020,Benevento,Federico Barba,ITA,DF,26,1993,29.5,31,16,22,8,1,21,35,60.0,14,39,18,21,48,79,94,4,2021
ITA-Serie A,2020,Benevento,Gabriele Moncini,ITA,"FW,MF",24,1996,4.0,2,1,2,0,0,0,1,0.0,1,2,0,2,2,4,4,0,2021
ITA-Serie A,2020,Benevento,Gaetano Letizia,ITA,DF,30,1990,17.4,36,25,19,13,4,17,36,47.2,19,15,3,12,20,56,42,1,2021
ITA-Serie A,2020,Benevento,Gianluca Caprari,ITA,"MF,FW",27,1993,20.7,16,11,5,5,6,6,31,19.4,25,19,1,18,18,34,8,0,2021
ITA-Serie A,2020,Benevento,Gianluca Lapadula,PER,FW,30,1990,28.5,22,12,3,13,6,6,25,24.0,19,18,3,15,5,27,16,0,2021
ITA-Serie A,2020,Benevento,Giuseppe Di Serio,ITA,"FW,MF",19,2001,3.2,2,2,1,1,0,0,4,0.0,4,5,0,5,0,2,4,0,2021
ITA-Serie A,2020,Benevento,Iago Falque,ESP,"MF,FW",30,1990,4.0,4,2,2,2,0,1,6,16.7,5,4,1,3,0,4,1,0,2021
ITA-Serie A,2020,Benevento,Kamil Glik,POL,DF,32,1988,35.6,44,24,33,10,1,25,53,47.2,28,37,31,6,62,106,153,0,2021
ITA-Serie A,2020,Benevento,Lorenzo Del Pinto,ITA,MF,30,1990,0.1,0,0,0,0,0,0,2,0.0,2,0,0,0,0,0,0,0,2021
ITA-Serie A,2020,Benevento,Lorenzo Montipò,ITA,GK,24,1996,37.0,0,0,0,0,0,0,0,,0,1,0,1,0,0,16,3,2021
ITA-Serie A,2020,Benevento,Luca Caldirola,ITA,DF,29,1991,17.5,21,13,13,6,2,10,22,45.5,12,20,15,5,20,41,56,0,2021
ITA-Serie A,2020,Benevento,Marco Sau,ITA,"MF,FW",32,1987,8.7,6,2,0,6,0,1,16,6.3,15,7,0,7,5,11,3,0,2021
ITA-Serie A,2020,Benevento,Niccolò Manfredini,ITA,GK,32,1988,1.0,0,0,0,0,0,0,0,,0,0,0,0,0,0,2,1,2021
ITA-Serie A,2020,Benevento,Nicolas Viola,ITA,MF,30,1989,11.5,16,9,2,11,3,6,28,21.4,22,10,3,7,9,25,7,0,2021
ITA-Serie A,2020,Benevento,Pasquale Schiattarella,ITA,MF,33,1987,25.0,37,22,25,12,0,19,47,40.4,28,19,5,14,32,69,29,2,2021
ITA-Serie A,2020,Benevento,Përparim Hetemaj,FIN,MF,33,1986,24.6,44,27,21,18,5,26,61,42.6,35,41,5,36,22,66,24,1,2021
ITA-Serie A,2020,Benevento,Riccardo Improta,ITA,"DF,MF",26,1993,25.9,39,23,25,8,6,21,45,46.7,24,23,4,19,28,67,47,0,2021
ITA-Serie A,2020,Benevento,Roberto Insigne,ITA,"MF,FW",26,1994,17.8,16,10,8,3,5,7,27,25.9,20,10,0,10,7,23,9,0,2021
ITA-Serie A,2020,Benevento,Siriki Sanogo,CIV,MF,18,2001,0.1,0,0,0,0,0,0,0,,0,0,0,0,0,0,0,0,2021
ITA-Serie A,2020,Bologna,Aaron Hickey,SCO,DF,18,2002,8.4,12,8,10,2,0,7,17,41.2,10,6,1,5,15,27,15,1,2021
ITA-Serie A,2020,Bologna,Adama Soumaoro,FRA,DF,28,1992,19.5,24,14,17,7,0,6,12,50.0,6,28,23,5,20,44,72,0,2021
ITA-Serie A,2020,Bologna,Andrea Poli,ITA,MF,30,1989,4.3,9,7,4,2,3,6,12,50.0,6,7,1,6,7,16,7,0,2021
ITA-Serie A,2020,Bologna,Andreas Skov Olsen,DEN,"FW,DF",20,1999,13.1,19,10,11,4,4,11,21,52.4,10,15,0,15,3,22,25,0,2021
ITA-Serie A,2020,Bologna,Andri Fannar Baldursson,ISL,MF,18,2002,2.4,6,6,1,2,3,1,3,33.3,2,3,1,2,3,9,7,0,2021
ITA-Serie A,2020,Bologna,Angelo da Costa Júnior,BRA,GK,36,1983,6.0,0,0,0,0,0,0,0,,0,0,0,0,0,0,2,3,2021
ITA-Serie A,2020,Bologna,Antonio Raimondo,ITA,FW,16,2004,0.0,0,0,0,0,0,0,0,,0,0,0,0,0,0,0,0,2021
ITA-Serie A,2020,Bologna,Arturo Calabresi,ITA,"DF,FW",24,1996,0.2,0,0,0,0,0,0,0,,0,0,0,0,0,0,2,0,2021
ITA-Serie A,2020,Bologna,Danilo Larangeira,BRA,DF,36,1984,34.8,33,24,23,10,0,8,29,27.6,21,58,36,22,51,84,127,2,2021
ITA-Serie A,2020,Bologna,Edoardo Vergani,ITA,FW,19,2001,0.1,0,0,0,0,0,0,0,,0,0,0,0,0,0,0,0,2021
ITA-Serie A,2020,Bologna,Emanuel Vignato,ITA,"FW,MF",19,2000,13.4,18,9,9,6,3,3,15,20.0,12,6,1,5,10,28,7,0,2021
ITA-Serie A,2020,Bologna,Federico Ravaglia,ITA,GK,20,1999,4.0,0,0,0,0,0,0,1,0.0,1,0,0,0,0,0,2,0,2021
ITA-Serie A,2020,Bologna,Federico Santander,PAR,FW,29,1991,0.4,0,0,0,0,0,0,0,,0,0,0,0,0,0,0,0,2021
ITA-Serie A,2020,Bologna,Gary Medel,CHI,"DF,MF",32,1987,5.7,12,9,6,5,1,4,10,40.0,6,8,6,2,7,19,10,0,2021
ITA-Serie A,2020,Bologna,Ibrahima Mbaye,SEN,DF,25,1994,4.8,6,5,5,1,0,3,5,60.0,2,5,3,2,1,7,10,0,2021
ITA-Serie A,2020,Bologna,Jerdy Schouten,NED,MF,23,1997,27.9,50,25,23,25,2,16,37,43.2,21,36,13,23,79,129,37,6,2021
ITA-Serie A,2020,Bologna,Kacper Urbanski,POL,FW,15,2004,0.0,0,0,0,0,0,0,0,,0,0,0,0,0,0,0,0,2021
ITA-Serie A,2020,Bologna,Lorenzo De Silvestri,ITA,DF,32,1988,23.8,34,24,18,13,3,16,37,43.2,21,37,10,27,30,64,62,3,2021
ITA-Serie A,2020,Bologna,Mattia Pagliuca,ITA,MF,18,2002,0.1,0,0,0,0,0,0,0,,0,0,0,0,1,1,0,0,2021
ITA-Serie A,2020,Bologna,Mattias Svanberg,SWE,MF,21,1999,20.6,38,17,21,9,8,16,45,35.6,29,25,4,21,30,68,25,1,2021
ITA-Serie A,2020,Bologna,Mitchell Dijks,NED,DF,27,1993,16.5,21,14,15,5,1,12,21,57.1,9,17,2,15,17,38,35,0,2021
ITA-Serie A,2020,Bologna,Musa Barrow,GAM,"FW,MF",21,1998,32.5,26,10,8,10,8,10,25,40.0,15,37,2,35,11,37,15,0,2021
ITA-Serie A,2020,Bologna,Musa Juwara,GAM,"MF,DF",18,2001,0.5,2,2,2,0,0,1,3,33.3,2,1,0,1,0,2,0,0,2021
ITA-Serie A,2020,Bologna,Nehuén Paz,ARG,DF,27,1993,4.0,9,4,4,5,0,6,7,85.7,1,4,2,2,11,20,16,0,2021
ITA-Serie A,2020,Bologna,Nicola Sansone,ITA,"FW,MF",28,1991,13.0,22,11,7,12,3,10,31,32.3,21,15,0,15,9,31,7,0,2021
ITA-Serie A,2020,Bologna,Nicolás Domínguez,ARG,MF,22,1998,13.9,48,28,26,17,5,15,37,40.5,22,26,7,19,24,72,20,0,2021
ITA-Serie A,2020,Bologna,Omar Khailoti,ITA,DF,18,2001,0.3,0,0,0,0,0,0,0,,0,2,0,2,1,1,0,0,2021
ITA-Serie A,2020,Bologna,Paolo Faragò,ITA,DF,27,1993,0.3,1,1,1,0,0,1,2,50.0,1,1,0,1,0,1,0,0,2021
ITA-Serie A,2020,Bologna,Riccardo Orsolini,ITA,"FW,MF",23,1997,19.5,37,18,13,12,12,16,39,41.0,23,22,3,19,10,47,22,0,2021
ITA-Serie A,2020,Bologna,Roberto Soriano,ITA,MF,29,1991,36.1,48,26,15,20,13,15,64,23.4,49,31,8,23,18,66,43,0,2021
ITA-Serie A,2020,Bologna,Rodrigo Palacio,ARG,FW,38,1982,27.8,13,6,2,3,8,1,15,6.7,14,18,0,18,7,20,29,0,2021
ITA-Serie A,2020,Bologna,Simone Rabbi,ITA,"FW,DF",18,2001,0.4,0,0,0,0,0,0,1,0.0,1,0,0,0,0,0,0,0,2021
ITA-Serie A,2020,Bologna,Stefano Denswil,NED,DF,27,1993,1.3,2,1,1,1,0,0,1,0.0,1,1,0,1,1,3,1,0,2021
ITA-Serie A,2020,Bologna,Takehiro Tomiyasu,JPN,DF,21,1998,30.2,47,31,27,14,6,21,34,61.8,13,37,19,18,54,101,106,0,2021
ITA-Serie A,2020,Bologna,Valentin Antov,BUL,DF,19,2000,2.6,4,2,3,1,0,3,10,30.0,7,6,5,1,4,8,13,0,2021
ITA-Serie A,2020,Bologna,Wisdom Amey,ITA,DF,14,2005,0.0,0,0,0,0,0,0,0,,0,0,0,0,0,0,0,0,2021
ITA-Serie A,2020,Bologna,Łukasz Skorupski,POL,GK,29,1991,28.0,1,1,1,0,0,1,4,25.0,3,0,0,0,0,1,23,5,2021
ITA-Serie A,2020,Cagliari,Adam Ounas,ALG,"MF,FW",23,1996,3.4,3,2,3,0,0,0,11,0.0,11,5,0,5,3,6,0,0,2021
ITA-Serie A,2020,Cagliari,Alberto Cerri,ITA,FW,24,1996,4.1,3,2,0,2,1,0,5,0.0,5,4,2,2,2,5,6,0,2021
ITA-Serie A,2020,Cagliari,Alessandro Deiola,ITA,MF,24,1995,6.8,13,5,5,4,4,8,23,34.8,15,7,2,5,11,24,11,0,2021
ITA-Serie A,2020,Cagliari,Alessandro Tripaldelli,ITA,DF,21,1999,3.3,13,6,5,6,2,5,6,83.3,1,6,1,5,3,16,15,0,2021
ITA-Serie A,2020,Cagliari,Alessio Cragno,ITA,GK,26,1994,34.0,0,0,0,0,0,0,1,0.0,1,0,0,0,1,1,10,0,2021
ITA-Serie A,2020,Cagliari,Alfred Duncan,GHA,MF,27,1993,11.9,18,10,8,9,1,4,21,19.0,17,8,0,8,16,34,8,1,2021
ITA-Serie A,2020,Cagliari,Andrea Carboni,ITA,DF,19,2001,12.1,34,23,23,11,0,15,28,53.6,13,15,4,11,14,48,52,0,2021
ITA-Serie A,2020,Cagliari,Arturo Calabresi,ITA,DF,24,1996,0.2,0,0,0,0,0,0,1,0.0,1,0,0,0,0,0,0,0,2021
ITA-Serie A,2020,Cagliari,Charalambos Lykogiannis,GRE,DF,26,1993,26.9,34,21,22,9,3,22,38,57.9,16,34,13,21,32,66,94,0,2021
ITA-Serie A,2020,Cagliari,Christian Oliva,URU,MF,24,1996,4.3,10,4,6,3,1,6,17,35.3,11,11,1,10,8,18,7,0,2021
ITA-Serie A,2020,Cagliari,Daniele Rugani,ITA,DF,26,1994,11.1,24,11,10,12,2,10,20,50.0,10,15,10,5,15,39,46,0,2021
ITA-Serie A,2020,Cagliari,Diego Godín,URU,DF,34,1986,27.9,60,32,51,9,0,24,39,61.5,15,41,24,17,56,116,117,0,2021
ITA-Serie A,2020,Cagliari,Fabio Pisacane,ITA,DF,34,1986,2.5,3,2,2,1,0,3,7,42.9,4,8,5,3,1,4,9,1,2021
ITA-Serie A,2020,Cagliari,Fabrizio Caligara,ITA,"MF,FW",20,2000,2.0,6,4,2,2,2,6,9,66.7,3,9,2,7,3,9,3,0,2021
ITA-Serie A,2020,Cagliari,Gabriele Zappa,ITA,DF,20,1999,26.6,34,17,16,15,3,22,49,44.9,27,36,4,32,24,58,50,0,2021
ITA-Serie A,2020,Cagliari,Gastón Pereiro,URU,"MF,DF",25,1995,3.0,3,1,2,1,0,1,2,50.0,1,2,0,2,1,4,2,1,2021
ITA-Serie A,2020,Cagliari,Giovanni Simeone,ARG,FW,25,1995,19.3,24,11,2,15,7,7,31,22.6,24,23,1,22,10,34,18,0,2021
ITA-Serie A,2020,Cagliari,Guglielmo Vicario,ITA,GK,23,1996,4.0,0,0,0,0,0,0,0,,0,0,0,0,0,0,1,0,2021
ITA-Serie A,2020,Cagliari,João Pedro,ITA,"FW,MF",28,1992,36.1,13,6,2,6,5,2,27,7.4,25,32,6,26,13,26,28,0,2021
ITA-Serie A,2020,Cagliari,Kiril Despodov,BUL,FW,23,1996,0.1,1,1,0,1,0,1,1,100.0,0,0,0,0,0,1,0,0,2021
ITA-Serie A,2020,Cagliari,Kwadwo Asamoah,GHA,"DF,MF",31,1988,2.5,4,3,2,2,0,2,3,66.7,1,5,1,4,4,8,2,1,2021
ITA-Serie A,2020,Cagliari,Leonardo Pavoletti,ITA,FW,31,1988,17.6,7,3,2,5,0,1,20,5.0,19,4,2,2,4,11,32,0,2021
ITA-Serie A,2020,Cagliari,Luca Ceppitelli,ITA,DF,30,1989,16.3,25,19,13,10,2,14,26,53.8,12,23,12,11,25,50,58,1,2021
ITA-Serie A,2020,Cagliari,Marko Rog,CRO,MF,25,1995,12.9,40,24,15,22,3,16,37,43.2,21,17,6,11,19,59,15,0,2021
ITA-Serie A,2020,Cagliari,Mattéo Tramoni,FRA,"MF,FW",20,2000,0.8,4,2,2,1,1,1,2,50.0,1,5,0,5,1,5,2,0,2021
ITA-Serie A,2020,Cagliari,Nahitan Nández,URU,"MF,DF",24,1995,30.4,56,28,23,23,10,25,68,36.8,43,26,4,22,23,79,49,0,2021
ITA-Serie A,2020,Cagliari,Paolo Faragò,ITA,DF,27,1993,4.1,13,9,10,3,0,9,20,45.0,11,3,2,1,6,19,15,0,2021
ITA-Serie A,2020,Cagliari,Radja Nainggolan,BEL,MF,32,1988,20.5,41,26,22,14,5,19,34,55.9,15,18,0,18,15,56,15,1,2021
ITA-Serie A,2020,Cagliari,Ragnar Klavan,EST,DF,34,1985,8.6,15,9,9,5,1,7,11,63.6,4,9,4,5,8,23,34,0,2021
ITA-Serie A,2020,Cagliari,Riccardo Sottil,ITA,"FW,MF",21,1999,13.2,7,3,2,3,2,0,7,0.0,7,4,0,4,5,12,3,0,2021
ITA-Serie A,2020,Cagliari,Răzvan Marin,ROU,MF,24,1996,32.9,54,33,26,22,6,27,53,50.9,26,29,10,19,29,83,15,0,2021
ITA-Serie A,2020,Cagliari,Sebastian Walukiewicz,POL,DF,20,2000,18.0,27,19,11,13,3,12,30,40.0,18,22,14,8,36,63,60,0,2021
ITA-Serie A,2020,Crotone,Adam Ounas,ALG,"FW,MF",23,1996,13.3,9,4,4,4,1,0,7,0.0,7,12,1,11,3,12,4,0,2021
ITA-Serie A,2020,Crotone,Ahmad Benali,LBY,MF,28,1992,13.5,19,11,10,9,0,11,38,28.9,27,15,2,13,6,25,15,0,2021
ITA-Serie A,2020,Crotone,Alex Cordaz,ITA,GK,37,1983,36.0,0,0,0,0,0,0,0,,0,0,0,0,1,1,7,2,2021
ITA-Serie A,2020,Crotone,Andrea Rispoli,ITA,DF,31,1988,7.2,6,3,2,3,1,2,7,28.6,5,12,3,9,5,11,15,1,2021
ITA-Serie A,2020,Crotone,Antonio Mazzotta,ITA,DF,30,1989,0.6,1,1,0,1,0,0,0,,0,0,0,0,0,1,1,0,2021
ITA-Serie A,2020,Crotone,Arkadiusz Reca,POL,DF,25,1995,25.7,34,16,15,11,8,10,45,22.2,35,30,3,27,50,84,64,0,2021
ITA-Serie A,2020,Crotone,Augustus Kargbo,SLE,FW,20,1999,0.4,0,0,0,0,0,0,0,,0,0,0,0,0,0,0,0,2021
ITA-Serie A,2020,Crotone,Denis Drăguș,ROU,"FW,MF",21,1999,2.0,3,1,0,0,3,0,4,0.0,4,4,0,4,1,4,0,0,2021
ITA-Serie A,2020,Crotone,Eduardo Henrique,BRA,MF,25,1995,10.3,5,2,1,4,0,3,12,25.0,9,6,1,5,7,12,7,1,2021
ITA-Serie A,2020,Crotone,Emmanuel Rivière,FRA,FW,30,1990,7.1,2,1,2,0,0,0,3,0.0,3,5,1,4,1,3,0,0,2021
ITA-Serie A,2020,Crotone,Gian Crespi,ITA,GK,19,2001,1.0,0,0,0,0,0,0,0,,0,0,0,0,0,0,0,0,2021
ITA-Serie A,2020,Crotone,Giovanni Crociata,ITA,DF,22,1997,0.3,1,0,0,1,0,0,1,0.0,1,1,0,1,0,1,0,0,2021
ITA-Serie A,2020,Crotone,Giuseppe Cuomo,ITA,DF,22,1998,8.9,26,19,17,9,0,9,14,64.3,5,10,2,8,18,44,19,1,2021
ITA-Serie A,2020,Crotone,Jacopo Petriccione,ITA,MF,25,1995,10.6,14,8,6,7,1,9,24,37.5,15,11,2,9,8,22,11,0,2021
ITA-Serie A,2020,Crotone,Junior Messias,BRA,"MF,FW",29,1991,35.7,60,35,26,24,10,22,70,31.4,48,32,12,20,35,95,40,0,2021
ITA-Serie A,2020,Crotone,Koffi Djidji,CIV,DF,27,1992,16.9,39,28,30,8,1,10,20,50.0,10,35,20,15,28,67,73,0,2021
ITA-Serie A,2020,Crotone,Lisandro Magallán,ARG,DF,26,1993,24.2,54,31,28,24,2,17,42,40.5,25,29,15,14,44,98,78,1,2021
ITA-Serie A,2020,Crotone,Luca Cigarini,ITA,MF,34,1986,10.3,26,14,11,12,3,12,28,42.9,16,10,1,9,12,38,9,0,2021
ITA-Serie A,2020,Crotone,Luca Marrone,ITA,DF,30,1990,17.6,25,18,16,9,0,13,21,61.9,8,22,11,11,26,51,56,1,2021
ITA-Serie A,2020,Crotone,Luca Siligardi,ITA,"MF,FW",32,1988,0.5,4,2,0,3,1,1,5,20.0,4,0,0,0,0,4,0,0,2021
ITA-Serie A,2020,Crotone,Luis Rojas,CHI,"MF,FW",18,2002,1.2,1,0,0,1,0,1,2,50.0,1,2,0,2,1,2,0,0,2021
ITA-Serie A,2020,Crotone,Marco Festa,ITA,GK,28,1992,1.0,0,0,0,0,0,0,0,,0,0,0,0,0,0,0,0,2021
ITA-Serie A,2020,Crotone,Miloš Vulić,SRB,MF,23,1996,14.5,15,8,9,1,5,8,21,38.1,13,10,1,9,8,23,8,0,2021
ITA-Serie A,2020,Crotone,Niccolò Zanellato,ITA,MF,22,1998,18.2,24,14,16,6,2,13,36,36.1,23,19,5,14,16,40,12,2,2021
ITA-Serie A,2020,Crotone,Pedro Pereira,POR,DF,22,1998,28.3,50,32,29,17,4,21,40,52.5,19,33,11,22,19,69,61,0,2021
ITA-Serie A,2020,Crotone,Salvatore Molina,ITA,"MF,DF",28,1992,25.7,39,22,18,14,7,29,45,64.4,16,30,8,22,17,56,41,0,2021
ITA-Serie A,2020,Crotone,Samuel Di Carmine,ITA,FW,31,1988,5.3,2,2,1,0,1,1,3,33.3,2,2,0,2,0,2,5,0,2021
ITA-Serie A,2020,Crotone,Sebastiano Luperto,ITA,DF,23,1996,20.9,38,20,28,8,2,16,27,59.3,11,17,7,10,27,65,74,1,2021
ITA-Serie A,2020,Crotone,Simeon Nwankwo,NGA,FW,28,1992,32.7,9,2,2,6,1,3,22,13.6,19,21,5,16,6,15,51,0,2021
ITA-Serie A,2020,Crotone,Tomislav Gomelt,CRO,MF,25,1995,0.2,1,1,0,1,0,0,0,,0,0,0,0,1,2,0,0,2021
ITA-Serie A,2020,Crotone,Vladimir Golemić,SVN,DF,29,1991,26.0,33,16,17,13,3,14,19,73.7,5,38,26,12,40,73,97,2,2021
ITA-Serie A,2020,Fiorentina,Aleksandr Kokorin,RUS,"FW,MF",29,1991,1.0,1,0,0,1,0,0,1,0.0,1,1,0,1,0,1,0,0,2021
ITA-Serie A,2020,Fiorentina,Alfred Duncan,GHA,MF,27,1993,1.8,3,0,1,1,1,0,2,0.0,2,2,0,2,2,5,0,0,2021
ITA-Serie A,2020,Fiorentina,Antonio Barreca,ITA,DF,25,1995,0.9,1,0,0,1,0,1,1,100.0,0,0,0,0,0,1,1,0,2021
ITA-Serie A,2020,Fiorentina,Bartłomiej Drągowski,POL,GK,22,1997,35.0,1,0,1,0,0,1,1,100.0,0,0,0,0,1,2,13,1,2021
ITA-Serie A,2020,Fiorentina,Borja Valero,ESP,"MF,FW",35,1985,5.5,13,9,7,4,2,3,15,20.0,12,6,1,5,6,19,2,0,2021
ITA-Serie A,2020,Fiorentina,Christian Kouamé,CIV,FW,22,1997,11.1,9,4,2,4,3,4,12,33.3,8,9,1,8,5,14,4,0,2021
ITA-Serie A,2020,Fiorentina,Cristiano Biraghi,ITA,DF,27,1992,31.1,42,23,19,15,8,27,45,60.0,18,23,9,14,27,69,56,3,2021
ITA-Serie A,2020,Fiorentina,Cristóbal Montiel,ESP,"MF,FW",20,2000,0.0,0,0,0,0,0,0,1,0.0,1,0,0,0,0,0,0,0,2021
ITA-Serie A,2020,Fiorentina,Dušan Vlahović,SRB,FW,20,2000,32.5,13,4,3,4,6,5,16,31.3,11,16,2,14,4,17,15,0,2021
ITA-Serie A,2020,Fiorentina,Erick Pulgar,CHI,MF,26,1994,22.2,41,18,17,23,1,22,49,44.9,27,24,10,14,41,82,45,1,2021
ITA-Serie A,2020,Fiorentina,Federico Ceccherini,ITA,DF,28,1992,3.0,4,1,1,3,0,1,1,100.0,0,6,5,1,7,11,15,0,2021
ITA-Serie A,2020,Fiorentina,Federico Chiesa,ITA,DF,22,1997,2.7,6,2,2,2,2,3,8,37.5,5,3,1,2,1,7,3,0,2021
ITA-Serie A,2020,Fiorentina,Franck Ribéry,FRA,FW,37,1983,23.9,24,11,4,9,11,5,29,17.2,24,11,2,9,3,27,1,0,2021
ITA-Serie A,2020,Fiorentina,Gaetano Castrovilli,ITA,MF,23,1997,25.9,33,19,15,11,7,11,42,26.2,31,25,2,23,34,67,14,0,2021
ITA-Serie A,2020,Fiorentina,Germán Pezzella,ARG,DF,29,1991,30.5,34,20,22,12,0,18,32,56.3,14,26,14,12,36,70,109,1,2021
ITA-Serie A,2020,Fiorentina,Giacomo Bonaventura,ITA,MF,30,1989,25.1,34,19,16,13,5,16,53,30.2,37,26,2,24,39,73,12,0,2021
ITA-Serie A,2020,Fiorentina,Igor,BRA,DF,22,1998,13.0,15,9,9,6,0,7,12,58.3,5,17,9,8,23,38,34,0,2021
ITA-Serie A,2020,Fiorentina,José Callejón,ESP,"FW,MF",33,1987,7.4,10,7,0,6,4,5,9,55.6,4,4,1,3,4,14,5,0,2021
ITA-Serie A,2020,Fiorentina,Kévin Malcuit,MAR,DF,29,1991,2.3,5,3,2,2,1,0,1,0.0,1,5,0,5,3,8,6,0,2021
ITA-Serie A,2020,Fiorentina,Lorenzo Venuti,ITA,DF,25,1995,19.5,24,11,14,7,3,14,28,50.0,14,18,3,15,17,41,24,0,2021
ITA-Serie A,2020,Fiorentina,Lucas Martínez Quarta,ARG,DF,24,1996,16.5,32,20,17,11,4,18,41,43.9,23,27,9,18,39,71,48,0,2021
ITA-Serie A,2020,Fiorentina,Martín Cáceres,URU,DF,33,1987,24.9,28,12,16,11,1,15,35,42.9,20,20,14,6,14,42,52,1,2021
ITA-Serie A,2020,Fiorentina,Maximiliano Olivera,URU,DF,28,1992,1.0,2,0,1,1,0,1,1,100.0,0,3,1,2,0,2,8,0,2021
ITA-Serie A,2020,Fiorentina,Nikola Milenković,SRB,DF,22,1997,33.7,49,29,33,14,2,21,33,63.6,12,42,33,9,44,93,122,1,2021
ITA-Serie A,2020,Fiorentina,Patrick Cutrone,ITA,FW,22,1998,2.2,4,3,1,2,1,1,2,50.0,1,1,0,1,1,5,0,0,2021
ITA-Serie A,2020,Fiorentina,Pietro Terracciano,ITA,GK,30,1990,3.0,0,0,0,0,0,0,0,,0,0,0,0,0,0,1,0,2021
ITA-Serie A,2020,Fiorentina,Pol Lirola,ESP,"DF,FW",22,1997,5.5,13,8,8,2,3,6,12,50.0,6,6,3,3,6,19,9,0,2021
ITA-Serie A,2020,Fiorentina,Riccardo Saponara,ITA,MF,28,1991,0.6,2,1,0,2,0,1,3,33.3,2,0,0,0,1,3,0,0,2021
ITA-Serie A,2020,Fiorentina,Sofyan Amrabat,MAR,MF,23,1996,27.1,39,22,11,24,4,18,48,37.5,30,30,5,25,23,62,12,0,2021
ITA-Serie A,2020,Fiorentina,Valentin Eysseric,FRA,"MF,FW",28,1992,8.1,14,8,6,7,1,5,11,45.5,6,11,0,11,7,21,8,0,2021
ITA-Serie A,2020,Genoa,Alberto Paleari,ITA,GK,27,1992,2.3,0,0,0,0,0,0,0,,0,0,0,0,0,0,1,0,2021
ITA-Serie A,2020,Genoa,Andrea Masiello,ITA,DF,34,1986,28.5,38,22,29,6,3,23,48,47.9,25,32,13,19,53,91,107,3,2021
ITA-Serie A,2020,Genoa,Cristián Zapata,COL,DF,33,1986,10.8,18,12,11,7,0,10,14,71.4,4,15,11,4,15,33,56,0,2021
ITA-Serie A,2020,Genoa,Davide Biraschi,ITA,DF,26,1994,10.2,17,9,12,5,0,5,10,50.0,5,12,6,6,21,38,26,0,2021
ITA-Serie A,2020,Genoa,Davide Zappacosta,ITA,DF,28,1992,22.7,33,16,15,13,5,15,30,50.0,15,17,1,16,18,51,41,0,2021
ITA-Serie A,2020,Genoa,Domenico Criscito,ITA,DF,33,1986,19.2,43,22,29,11,3,22,39,56.4,17,27,14,13,44,87,51,0,2021
ITA-Serie A,2020,Genoa,Edoardo Goldaniga,ITA,DF,26,1993,20.6,28,18,21,7,0,14,23,60.9,9,17,7,10,38,66,62,1,2021
ITA-Serie A,2020,Genoa,Eldor Shomurodov,UZB,FW,25,1995,18.6,28,14,7,13,8,9,37,24.3,28,17,2,15,6,34,11,0,2021
ITA-Serie A,2020,Genoa,Federico Marchetti,ITA,GK,37,1983,3.7,1,0,1,0,0,1,1,100.0,0,0,0,0,0,1,2,1,2021
ITA-Serie A,2020,Genoa,Filippo Melegoni,ITA,"MF,DF",21,1999,4.3,7,6,2,5,0,3,6,50.0,3,5,0,5,5,12,8,0,2021
ITA-Serie A,2020,Genoa,Francesco Cassata,ITA,"DF,FW",23,1997,2.5,7,6,7,0,0,4,7,57.1,3,0,0,0,3,10,1,0,2021
ITA-Serie A,2020,Genoa,Gianluca Scamacca,ITA,FW,21,1999,15.0,19,10,6,7,6,7,19,36.8,12,21,4,17,9,28,12,0,2021
ITA-Serie A,2020,Genoa,Giuseppe Caso,ITA,"DF,FW",21,1998,0.6,0,0,0,0,0,0,0,,0,0,0,0,0,0,0,0,2021
ITA-Serie A,2020,Genoa,Goran Pandev,MKD,"FW,MF",37,1983,15.6,9,5,1,6,2,4,10,40.0,6,6,0,6,2,11,7,1,2021
ITA-Serie A,2020,Genoa,Ivan Radovanović,SRB,"DF,MF",31,1988,24.8,18,15,13,5,0,12,31,38.7,19,39,21,18,37,55,114,2,2021
ITA-Serie A,2020,Genoa,Jérôme Onguéné,CMR,DF,22,1997,2.0,2,1,2,0,0,2,7,28.6,5,2,0,2,2,4,8,0,2021
ITA-Serie A,2020,Genoa,Kevin Strootman,NED,MF,30,1990,14.6,30,18,13,15,2,14,32,43.8,18,35,3,32,25,55,18,0,2021
ITA-Serie A,2020,Genoa,Lennart-Marten Czyborra,GER,DF,21,1999,13.0,19,10,7,7,5,11,19,57.9,8,6,1,5,17,36,27,0,2021
ITA-Serie A,2020,Genoa,Luca Pellegrini,ITA,"DF,MF",21,1999,7.1,9,6,6,2,1,4,10,40.0,6,11,2,9,8,17,13,1,2021
ITA-Serie A,2020,Genoa,Lukas Lerager,DEN,MF,27,1993,12.9,24,13,14,9,1,11,30,36.7,19,13,3,10,14,38,25,1,2021
ITA-Serie A,2020,Genoa,Manolo Portanova,ITA,"MF,FW",20,2000,0.7,3,3,1,1,1,0,2,0.0,2,3,1,2,1,4,2,0,2021
ITA-Serie A,2020,Genoa,Marko Pjaca,CRO,"FW,MF",25,1995,15.8,13,6,6,3,4,4,16,25.0,12,7,2,5,7,20,12,0,2021
ITA-Serie A,2020,Genoa,Mattia Bani,ITA,DF,26,1993,10.2,10,5,5,5,0,5,12,41.7,7,16,11,5,27,37,44,0,2021
ITA-Serie A,2020,Genoa,Mattia Destro,ITA,FW,29,1991,17.8,6,3,0,3,3,2,9,22.2,7,11,0,11,4,10,8,0,2021
ITA-Serie A,2020,Genoa,Mattia Perin,ITA,GK,27,1992,32.0,0,0,0,0,0,0,0,,0,0,0,0,1,1,6,0,2021
ITA-Serie A,2020,Genoa,Miha Zajc,SVN,MF,26,1994,20.7,22,14,9,10,3,13,39,33.3,26,30,4,26,27,49,19,0,2021
ITA-Serie A,2020,Genoa,Milan Badelj,CRO,MF,31,1989,26.8,56,27,27,22,7,26,84,31.0,58,51,10,41,87,143,45,1,2021
ITA-Serie A,2020,Genoa,Nicolò Rovella,ITA,MF,18,2001,13.2,29,16,15,11,3,9,32,28.1,23,11,0,11,20,49,19,1,2021
ITA-Serie A,2020,Genoa,Paolo Ghiglione,ITA,"DF,MF",23,1997,15.1,27,15,17,8,2,13,28,46.4,15,14,2,12,13,40,25,0,2021
ITA-Serie A,2020,Genoa,Steeve-Mike Ebongue,FRA,MF,19,2001,0.6,2,1,1,0,1,0,3,0.0,3,1,0,1,0,2,0,0,2021
ITA-Serie A,2020,Genoa,Stefano Sturaro,ITA,MF,27,1993,4.9,11,5,3,6,2,3,15,20.0,12,5,0,5,7,18,2,0,2021
ITA-Serie A,2020,Genoa,Valon Behrami,SUI,MF,35,1985,9.9,21,9,9,10,2,9,26,34.6,17,13,5,8,9,30,13,0,2021
ITA-Serie A,2020,Genoa,Vittorio Parigini,ITA,"MF,DF",24,1996,0.6,5,2,4,0,1,0,1,0.0,1,0,0,0,0,5,0,0,2021
ITA-Serie A,2020,Genoa,Yayah Kallon,SLE,FW,19,2001,0.5,0,0,0,0,0,0,0,,0,0,0,0,0,0,0,0,2021
ITA-Serie A,2020,Hellas Verona,Adrien Tameze,CMR,MF,26,1994,25.6,39,25,23,15,1,11,27,40.7,16,31,8,23,32,71,46,2,2021
ITA-Serie A,2020,Hellas Verona,Alan Empereur,BRA,DF,26,1994,2.4,0,0,0,0,0,0,0,,0,1,1,0,6,6,7,1,2021
ITA-Serie A,2020,Hellas Verona,Alessandro Berardi,ITA,GK,29,1991,0.3,0,0,0,0,0,0,0,,0,0,0,0,0,0,0,0,2021
ITA-Serie A,2020,Hellas Verona,Andrea Danzi,ITA,DF,21,1999,1.2,0,0,0,0,0,0,1,0.0,1,0,0,0,3,3,1,0,2021
ITA-Serie A,2020,Hellas Verona,Andrea Favilli,ITA,FW,23,1997,3.8,3,1,0,1,2,2,3,66.7,1,2,0,2,0,3,2,0,2021
ITA-Serie A,2020,Hellas Verona,Antonín Barák,CZE,MF,25,1994,30.7,30,19,8,16,6,14,47,29.8,33,26,7,19,12,42,38,1,2021
ITA-Serie A,2020,Hellas Verona,Daniel Bessa,ITA,MF,27,1993,6.8,15,8,3,11,1,6,14,42.9,8,5,1,4,2,17,0,0,2021
ITA-Serie A,2020,Hellas Verona,Darko Lazović,SRB,"DF,MF",29,1990,27.8,29,17,8,17,4,20,42,47.6,22,17,7,10,20,49,29,0,2021
ITA-Serie A,2020,Hellas Verona,Davide Faraoni,ITA,DF,28,1991,32.1,62,33,36,19,7,28,51,54.9,23,48,17,31,49,111,83,1,2021
ITA-Serie A,2020,Hellas Verona,Ebrima Colley,GAM,"MF,FW",20,2000,8.2,11,4,2,6,3,3,11,27.3,8,6,0,6,6,17,1,0,2021
ITA-Serie A,2020,Hellas Verona,Eddie Salcedo,ITA,"MF,FW",18,2001,8.4,6,2,3,2,1,3,3,100.0,0,6,0,6,6,12,6,0,2021
ITA-Serie A,2020,Hellas Verona,Federico Ceccherini,ITA,DF,28,1992,19.3,16,12,10,6,0,2,7,28.6,5,15,8,7,40,56,60,0,2021
ITA-Serie A,2020,Hellas Verona,Federico Dimarco,ITA,DF,22,1997,29.0,32,19,23,7,2,13,28,46.4,15,18,9,9,47,79,50,1,2021
ITA-Serie A,2020,Hellas Verona,Giangiacomo Magnani,ITA,DF,24,1995,16.8,26,15,14,9,3,9,16,56.3,7,25,16,9,44,70,105,1,2021
ITA-Serie A,2020,Hellas Verona,Ivan Ilić,SRB,MF,19,2001,20.4,26,14,11,11,4,7,21,33.3,14,17,5,12,27,53,26,0,2021
ITA-Serie A,2020,Hellas Verona,Ivor Pandur,CRO,GK,20,2000,3.7,0,0,0,0,0,0,0,,0,0,0,0,0,0,0,0,2021
ITA-Serie A,2020,Hellas Verona,Iyenoma Udogie,ITA,"DF,MF",17,2002,1.9,6,4,2,2,2,2,2,100.0,0,3,0,3,2,8,4,0,2021
ITA-Serie A,2020,Hellas Verona,Kevin Lasagna,ITA,FW,27,1992,14.1,7,3,0,5,2,1,5,20.0,4,12,1,11,1,8,11,0,2021
ITA-Serie A,2020,Hellas Verona,Kevin Rüegg,SUI,"DF,MF",21,1998,2.3,0,0,0,0,0,0,0,,0,3,0,3,2,2,3,0,2021
ITA-Serie A,2020,Hellas Verona,Koray Günter,GER,DF,25,1994,19.6,20,10,10,9,1,4,9,44.4,5,27,21,6,70,90,87,0,2021
ITA-Serie A,2020,Hellas Verona,Marco Silvestri,ITA,GK,29,1991,34.0,0,0,0,0,0,0,0,,0,0,0,0,0,0,14,1,2021
ITA-Serie A,2020,Hellas Verona,Matteo Lovato,ITA,DF,20,2000,15.4,21,12,14,5,2,10,21,47.6,11,20,10,10,37,58,48,1,2021
ITA-Serie A,2020,Hellas Verona,Mattia Zaccagni,ITA,MF,25,1995,29.0,27,13,8,11,8,8,25,32.0,17,28,4,24,27,54,13,1,2021
ITA-Serie A,2020,Hellas Verona,Miguel Veloso,POR,MF,34,1986,14.6,24,17,10,10,4,12,34,35.3,22,12,1,11,12,36,25,0,2021
ITA-Serie A,2020,Hellas Verona,Nikola Kalinić,CRO,FW,32,1988,11.8,5,1,2,2,1,0,3,0.0,3,6,0,6,1,6,7,0,2021
ITA-Serie A,2020,Hellas Verona,Paweł Dawidowicz,POL,DF,25,1995,20.7,42,28,30,10,2,14,24,58.3,10,28,19,9,27,69,62,1,2021
ITA-Serie A,2020,Hellas Verona,Philip Ankhrah,GHA,MF,17,2002,0.1,0,0,0,0,0,0,0,,0,1,0,1,0,0,0,0,2021
ITA-Serie A,2020,Hellas Verona,Ronaldo Vieira,GNB,MF,22,1998,2.5,,3,,,,,,,,,,,0,,,,2021
ITA-Serie A,2020,Hellas Verona,Samuel Di Carmine,ITA,FW,31,1988,5.6,1,2,0,1,0,0,3,0.0,3,1,0,1,0,1,5,0,2021
ITA-Serie A,2020,Hellas Verona,Stefano Sturaro,ITA,MF,27,1993,4.7,4,3,3,0,1,2,8,25.0,6,5,1,4,5,9,10,0,2021
ITA-Serie A,2020,Hellas Verona,Yıldırım Mert Çetin,TUR,DF,23,1997,4.6,8,4,3,5,0,2,6,33.3,4,7,5,2,14,22,11,1,2021
ITA-Serie A,2020,Hellas Verona,Ľubomír Tupta,SVK,FW,22,1998,0.6,0,0,0,0,0,0,0,,0,0,0,0,0,0,0,0,2021
ITA-Serie A,2020,Inter,Achraf Hakimi,MAR,DF,21,1998,29.6,53,32,23,19,11,23,48,47.9,25,31,1,30,22,75,23,1,2021
ITA-Serie A,2020,Inter,Aleksandar Kolarov,SRB,DF,34,1985,4.3,4,4,0,4,0,1,2,50.0,1,2,0,2,7,11,8,0,2021
ITA-Serie A,2020,Inter,Alessandro Bastoni,ITA,DF,21,1999,32.5,36,22,13,21,2,17,27,63.0,10,34,16,18,40,76,75,0,2021
ITA-Serie A,2020,Inter,Alexis Sánchez,CHI,FW,31,1988,12.7,14,8,4,4,6,5,18,27.8,13,11,0,11,7,21,1,1,2021
ITA-Serie A,2020,Inter,Andrea Pinamonti,ITA,FW,21,1999,1.9,0,0,0,0,0,0,0,,0,1,0,1,1,1,2,0,2021
ITA-Serie A,2020,Inter,Andrea Ranocchia,ITA,DF,32,1988,7.8,13,10,6,6,1,7,8,87.5,1,5,3,2,12,25,19,0,2021
ITA-Serie A,2020,Inter,Arturo Vidal,CHI,MF,33,1987,12.6,27,14,8,13,6,12,41,29.3,29,23,3,20,29,56,11,0,2021
ITA-Serie A,2020,Inter,Ashley Young,ENG,DF,35,1985,15.8,15,7,8,4,3,3,13,23.1,10,13,0,13,6,21,31,0,2021
ITA-Serie A,2020,Inter,Christian Eriksen,DEN,MF,28,1992,15.4,12,6,6,4,2,7,20,35.0,13,16,1,15,9,21,13,1,2021
ITA-Serie A,2020,Inter,Daniele Padelli,ITA,GK,34,1985,0.5,0,0,0,0,0,0,0,,0,0,0,0,0,0,0,0,2021
ITA-Serie A,2020,Inter,Danilo D'Ambrosio,ITA,DF,31,1988,7.8,15,9,6,7,2,6,15,40.0,9,9,7,2,4,19,15,0,2021
ITA-Serie A,2020,Inter,Ionuț Radu,ROU,GK,23,1997,1.5,0,0,0,0,0,0,0,,0,0,0,0,0,0,1,0,2021
ITA-Serie A,2020,Inter,Ivan Perišić,CRO,"DF,FW",31,1989,19.9,22,13,11,6,5,12,33,36.4,21,33,4,29,19,41,36,1,2021
ITA-Serie A,2020,Inter,Lautaro Martínez,ARG,FW,22,1997,28.5,25,12,5,11,9,7,24,29.2,17,31,1,30,27,52,16,0,2021
ITA-Serie A,2020,Inter,Marcelo Brozović,CRO,MF,27,1992,28.7,54,29,23,24,7,20,61,32.8,41,43,17,26,40,94,38,0,2021
ITA-Serie A,2020,Inter,Matteo Darmian,ITA,DF,30,1989,12.9,30,16,12,7,11,16,28,57.1,12,9,2,7,17,47,35,0,2021
ITA-Serie A,2020,Inter,Matías Vecino,URU,MF,28,1991,3.1,1,1,0,0,1,0,5,0.0,5,7,1,6,4,5,3,0,2021
ITA-Serie A,2020,Inter,Milan Škriniar,SVK,DF,25,1995,30.9,48,32,29,16,3,23,34,67.6,11,30,19,11,30,78,89,1,2021
ITA-Serie A,2020,Inter,Nicolò Barella,ITA,MF,23,1997,32.2,58,31,23,29,6,23,72,31.9,49,29,4,25,26,84,14,0,2021
ITA-Serie A,2020,Inter,Radja Nainggolan,BEL,MF,32,1988,0.5,0,0,0,0,0,0,0,,0,0,0,0,1,1,0,0,2021
ITA-Serie A,2020,Inter,Roberto Gagliardini,ITA,MF,26,1994,13.7,30,17,17,8,5,5,28,17.9,23,15,3,12,19,49,16,0,2021
ITA-Serie A,2020,Inter,Romelu Lukaku,BEL,FW,27,1993,32.0,11,1,1,6,4,6,14,42.9,8,11,1,10,3,14,34,0,2021
ITA-Serie A,2020,Inter,Samir Handanović,SVN,GK,36,1984,36.0,1,0,1,0,0,1,1,100.0,0,0,0,0,0,1,6,3,2021
ITA-Serie A,2020,Inter,Stefan de Vrij,NED,DF,28,1992,30.4,28,16,15,12,1,15,24,62.5,9,24,18,6,41,69,95,0,2021
ITA-Serie A,2020,Inter,Stefano Sensi,ITA,MF,24,1995,6.7,9,6,3,5,1,4,11,36.4,7,6,1,5,7,16,1,0,2021
ITA-Serie A,2020,Juventus,Aaron Ramsey,WAL,MF,29,1990,12.1,22,14,8,13,1,8,25,32.0,17,13,2,11,7,29,8,2,2021
ITA-Serie A,2020,Juventus,Adrien Rabiot,FRA,MF,25,1995,25.7,72,42,24,41,7,28,60,46.7,32,32,11,21,43,115,29,1,2021
ITA-Serie A,2020,Juventus,Alessandro Di Pardo,ITA,"FW,DF",21,1999,0.2,0,0,0,0,0,0,0,,0,1,1,0,0,0,0,0,2021
ITA-Serie A,2020,Juventus,Alex Sandro,BRA,DF,29,1991,20.6,37,23,19,13,5,13,25,52.0,12,20,4,16,31,68,57,0,2021
ITA-Serie A,2020,Juventus,Arthur Melo,BRA,MF,23,1996,12.9,17,9,7,10,0,12,31,38.7,19,6,1,5,18,35,9,1,2021
ITA-Serie A,2020,Juventus,Carlo Pinsoglio,ITA,GK,30,1990,0.3,0,0,0,0,0,0,0,,0,0,0,0,0,0,0,0,2021
ITA-Serie A,2020,Juventus,Cristiano Ronaldo,POR,FW,35,1985,31.1,6,3,1,3,2,3,15,20.0,12,11,3,8,5,11,15,1,2021
ITA-Serie A,2020,Juventus,Danilo,BRA,"DF,MF",29,1991,32.4,62,31,37,16,9,35,66,53.0,31,32,12,20,66,128,68,2,2021
ITA-Serie A,2020,Juventus,Dejan Kulusevski,SWE,"MF,FW",20,2000,21.4,33,19,12,10,11,14,43,32.6,29,22,0,22,9,42,2,1,2021
ITA-Serie A,2020,Juventus,Douglas Costa,BRA,"MF,FW",29,1990,0.5,1,0,1,0,0,1,3,33.3,2,0,0,0,0,1,0,0,2021
ITA-Serie A,2020,Juventus,Federico Bernardeschi,ITA,"MF,DF",26,1994,10.8,9,4,3,5,1,4,20,20.0,16,6,2,4,14,23,7,1,2021
ITA-Serie A,2020,Juventus,Federico Chiesa,ITA,"MF,DF",22,1997,24.6,47,26,21,14,12,19,50,38.0,31,23,1,22,12,59,16,0,2021
ITA-Serie A,2020,Juventus,Félix Correia,POR,MF,19,2001,0.1,0,0,0,0,0,0,0,,0,0,0,0,0,0,1,0,2021
ITA-Serie A,2020,Juventus,Giacomo Vrioni,ALB,FW,21,1998,0.0,0,0,0,0,0,0,0,,0,0,0,0,0,0,0,0,2021
ITA-Serie A,2020,Juventus,Gianluca Frabotta,ITA,"DF,MF",21,1999,7.7,7,4,5,0,2,5,12,41.7,7,9,1,8,14,21,15,0,2021
ITA-Serie A,2020,Juventus,Gianluigi Buffon,ITA,GK,42,1978,8.0,0,0,0,0,0,0,0,,0,0,0,0,0,0,3,1,2021
ITA-Serie A,2020,Juventus,Giorgio Chiellini,ITA,DF,35,1984,15.4,12,9,9,3,0,5,11,45.5,6,18,13,5,27,39,56,0,2021
ITA-Serie A,2020,Juventus,Juan Cuadrado,COL,"DF,MF",32,1988,24.2,43,25,22,15,6,29,60,48.3,31,16,2,14,43,86,22,2,2021
ITA-Serie A,2020,Juventus,Leonardo Bonucci,ITA,DF,33,1987,22.5,19,14,10,8,1,6,14,42.9,8,24,13,11,33,52,67,0,2021
ITA-Serie A,2020,Juventus,Manolo Portanova,ITA,MF,20,2000,0.8,2,0,2,0,0,0,2,0.0,2,4,1,3,0,2,1,0,2021
ITA-Serie A,2020,Juventus,Matthijs de Ligt,NED,DF,20,1999,24.7,37,19,20,16,1,18,28,64.3,10,42,21,21,31,68,64,0,2021
ITA-Serie A,2020,Juventus,Mattia De Sciglio,ITA,DF,27,1992,0.3,0,0,0,0,0,0,0,,0,0,0,0,0,0,1,0,2021
ITA-Serie A,2020,Juventus,Merih Demiral,TUR,DF,22,1998,10.4,12,9,8,4,0,5,13,38.5,8,16,9,7,21,33,40,0,2021
ITA-Serie A,2020,Juventus,Nicolò Fagioli,ITA,MF,19,2001,0.2,0,0,0,0,0,0,0,,0,0,0,0,0,0,1,0,2021
ITA-Serie A,2020,Juventus,Paulo Dybala,ARG,FW,26,1993,12.6,14,8,3,4,7,2,14,14.3,12,15,0,15,1,15,1,0,2021
ITA-Serie A,2020,Juventus,Radu Drăgușin,ROU,DF,18,2002,0.0,0,0,0,0,0,0,0,,0,0,0,0,0,0,0,0,2021
ITA-Serie A,2020,Juventus,Rodrigo Bentancur,URU,MF,23,1997,25.8,63,33,21,37,5,20,59,33.9,39,35,12,23,47,110,46,1,2021
ITA-Serie A,2020,Juventus,Weston McKennie,USA,MF,21,1998,18.9,34,19,9,20,5,12,33,36.4,21,21,3,18,28,62,26,0,2021
ITA-Serie A,2020,Juventus,Wojciech Szczęsny,POL,GK,30,1990,29.7,0,0,0,0,0,0,0,,0,2,0,2,3,3,5,1,2021
ITA-Serie A,2020,Juventus,Álvaro Morata,ESP,FW,27,1992,22.4,17,12,2,10,5,4,28,14.3,24,22,2,20,5,22,21,0,2021
ITA-Serie A,2020,Lazio,Adam Marušić,MNE,DF,27,1992,33.0,38,22,22,15,1,20,40,50.0,20,38,6,32,40,78,54,0,2021
ITA-Serie A,2020,Lazio,Andreas Pereira,BRA,"FW,MF",24,1996,6.0,5,0,1,3,1,2,12,16.7,10,6,0,6,1,6,4,0,2021
ITA-Serie A,2020,Lazio,Bastos,ANG,DF,29,1991,0.7,3,1,2,0,1,3,5,60.0,2,1,0,1,0,3,3,0,2021
ITA-Serie A,2020,Lazio,Ciro Immobile,ITA,FW,30,1990,31.7,14,13,4,6,4,7,22,31.8,15,13,1,12,6,20,9,0,2021
ITA-Serie A,2020,Lazio,Danilo Cataldi,ITA,MF,25,1994,6.3,7,2,1,5,1,4,18,22.2,14,3,1,2,9,16,7,0,2021
ITA-Serie A,2020,Lazio,Denis Vavro,SVK,DF,24,1996,0.4,0,0,0,0,0,0,1,0.0,1,0,0,0,1,1,3,0,2021
ITA-Serie A,2020,Lazio,Djavan Anderson,NED,DF,25,1995,0.8,0,0,0,0,0,0,1,0.0,1,1,0,1,1,1,0,0,2021
ITA-Serie A,2020,Lazio,Felipe Caicedo,ECU,FW,31,1988,10.3,10,7,4,4,2,1,8,12.5,7,7,0,7,4,14,2,0,2021
ITA-Serie A,2020,Lazio,Francesco Acerbi,ITA,DF,32,1988,31.3,51,32,34,13,4,18,40,45.0,22,24,15,9,76,127,121,2,2021
ITA-Serie A,2020,Lazio,Gonzalo Escalante,ARG,MF,27,1993,8.1,26,13,11,14,1,8,28,28.6,20,10,3,7,19,45,13,0,2021
ITA-Serie A,2020,Lazio,Jean-Daniel Akpa-Akpro,CIV,MF,27,1992,11.7,38,25,13,22,3,8,27,29.6,19,24,6,18,18,56,13,0,2021
ITA-Serie A,2020,Lazio,Joaquín Correa,ARG,FW,25,1994,21.5,21,12,6,11,4,7,25,28.0,18,14,0,14,7,28,12,0,2021
ITA-Serie A,2020,Lazio,Lucas Leiva,BRA,MF,33,1987,23.7,68,32,38,28,2,30,86,34.9,56,21,0,21,57,125,21,0,2021
ITA-Serie A,2020,Lazio,Luis Alberto,ESP,MF,27,1992,29.1,43,24,15,19,9,15,73,20.5,58,41,2,39,13,56,11,1,2021
ITA-Serie A,2020,Lazio,Luiz Felipe,ITA,DF,23,1997,10.1,32,20,19,11,2,16,24,66.7,8,20,9,11,21,53,29,1,2021
ITA-Serie A,2020,Lazio,Manuel Lazzari,ITA,DF,26,1993,29.0,24,14,15,4,5,14,39,35.9,25,22,3,19,18,42,28,0,2021
ITA-Serie A,2020,Lazio,Marco Bertini,ITA,MF,17,2002,0.1,1,0,1,0,0,0,0,,0,0,0,0,0,1,0,0,2021
ITA-Serie A,2020,Lazio,Marco Parolo,ITA,"DF,MF",35,1985,7.3,21,8,8,11,2,8,20,40.0,12,20,6,14,14,35,31,0,2021
ITA-Serie A,2020,Lazio,Mateo Musacchio,ARG,DF,29,1990,2.5,1,1,1,0,0,0,0,,0,5,2,3,2,3,5,0,2021
ITA-Serie A,2020,Lazio,Mohamed Fares,ALG,DF,24,1996,12.7,20,15,9,7,4,11,19,57.9,8,14,1,13,16,36,21,0,2021
ITA-Serie A,2020,Lazio,Nicolò Armini,ITA,DF,19,2001,0.1,0,0,0,0,0,0,0,,0,0,0,0,0,0,0,0,2021
ITA-Serie A,2020,Lazio,Patric,ESP,DF,27,1993,17.7,30,16,15,11,4,13,24,54.2,11,13,3,10,18,48,51,1,2021
ITA-Serie A,2020,Lazio,Pepe Reina,ESP,GK,37,1982,29.0,0,0,0,0,0,0,1,0.0,1,0,0,0,1,1,6,0,2021
ITA-Serie A,2020,Lazio,Raúl Moro,ESP,FW,17,2002,0.1,0,0,0,0,0,0,1,0.0,1,0,0,0,0,0,0,0,2021
ITA-Serie A,2020,Lazio,Senad Lulić,BIH,DF,34,1986,8.0,14,7,6,5,3,7,15,46.7,8,10,1,9,4,18,13,0,2021
ITA-Serie A,2020,Lazio,Sergej Milinković-Savić,SRB,MF,25,1995,30.5,59,40,20,30,9,27,84,32.1,57,52,12,40,33,92,47,0,2021
ITA-Serie A,2020,Lazio,Thomas Strakosha,ALB,GK,25,1995,9.0,1,1,1,0,0,0,0,,0,0,0,0,1,2,4,0,2021
ITA-Serie A,2020,Lazio,Vedat Muriqi,KVX,FW,26,1994,9.2,3,1,0,2,1,0,8,0.0,8,9,2,7,3,6,20,0,2021
ITA-Serie A,2020,Lazio,Wesley Hoedt,NED,DF,26,1994,10.6,22,16,18,4,0,10,17,58.8,7,9,5,4,17,39,48,1,2021
ITA-Serie A,2020,Lazio,Ștefan Radu,ROU,DF,33,1986,27.3,43,24,20,19,4,25,40,62.5,15,27,14,13,45,88,73,1,2021
ITA-Serie A,2020,Milan,Alessio Romagnoli,ITA,DF,25,1995,21.2,17,7,8,7,2,8,19,42.1,11,29,22,7,24,41,80,0,2021
ITA-Serie A,2020,Milan,Alexis Saelemaekers,BEL,FW,21,1999,22.4,43,26,20,18,5,19,60,31.7,41,29,1,28,25,68,6,0,2021
ITA-Serie A,2020,Milan,Andrea Conti,ITA,DF,26,1994,0.3,1,1,1,0,0,0,1,0.0,1,0,0,0,1,2,0,0,2021
ITA-Serie A,2020,Milan,Ante Rebić,CRO,FW,26,1993,19.7,26,9,4,8,14,8,37,21.6,29,21,1,20,7,33,17,0,2021
ITA-Serie A,2020,Milan,Brahim Díaz,ESP,"MF,FW",20,1999,13.6,18,10,7,7,4,10,23,43.5,13,10,0,10,2,20,2,0,2021
ITA-Serie A,2020,Milan,Ciprian Tătărușanu,ROU,GK,34,1986,1.0,0,0,0,0,0,0,0,,0,0,0,0,0,0,0,1,2021
ITA-Serie A,2020,Milan,Daniel Maldini,ITA,"FW,DF",18,2001,0.3,1,0,0,1,0,0,2,0.0,2,0,0,0,0,1,0,0,2021
ITA-Serie A,2020,Milan,Davide Calabria,ITA,DF,23,1996,29.4,101,64,61,32,8,54,90,60.0,36,42,9,33,37,138,82,1,2021
ITA-Serie A,2020,Milan,Diogo Dalot,POR,DF,21,1999,12.1,32,17,23,6,3,17,34,50.0,17,18,5,13,25,57,42,0,2021
ITA-Serie A,2020,Milan,Fikayo Tomori,ENG,DF,22,1997,16.3,28,18,17,9,2,8,14,57.1,6,32,20,12,18,46,61,1,2021
ITA-Serie A,2020,Milan,Franck Kessié,CIV,MF,23,1996,35.8,53,30,28,19,6,20,38,52.6,18,47,15,32,46,99,51,0,2021
ITA-Serie A,2020,Milan,Gianluigi Donnarumma,ITA,GK,21,1999,37.0,0,0,0,0,0,0,1,0.0,1,1,0,1,1,1,23,2,2021
ITA-Serie A,2020,Milan,Hakan Çalhanoğlu,TUR,"MF,FW",26,1994,29.0,26,7,3,17,6,7,28,25.0,21,21,6,15,15,41,24,1,2021
ITA-Serie A,2020,Milan,Ismaël Bennacer,ALG,MF,22,1997,14.7,39,18,17,21,1,15,32,46.9,17,10,1,9,20,59,12,0,2021
ITA-Serie A,2020,Milan,Jens Petter Hauge,NOR,FW,20,1999,5.9,7,4,3,3,1,6,10,60.0,4,4,0,4,1,8,3,0,2021
ITA-Serie A,2020,Milan,Lorenzo Colombo,ITA,FW,18,2002,1.0,2,1,1,1,0,0,3,0.0,3,0,0,0,0,2,3,0,2021
ITA-Serie A,2020,Milan,Léo Duarte,BRA,DF,24,1996,0.2,1,1,0,1,0,0,0,,0,0,0,0,1,2,0,0,2021
ITA-Serie A,2020,Milan,Mario Mandžukić,CRO,FW,34,1986,2.4,7,6,2,4,1,2,3,66.7,1,0,0,0,2,9,3,0,2021
ITA-Serie A,2020,Milan,Mateo Musacchio,ARG,DF,29,1990,0.4,2,1,2,0,0,2,3,66.7,1,1,0,1,3,5,0,0,2021
ITA-Serie A,2020,Milan,Matteo Gabbia,ITA,DF,20,1999,6.2,9,5,3,6,0,2,2,100.0,0,8,6,2,3,12,21,0,2021
ITA-Serie A,2020,Milan,Pierre Kalulu,FRA,DF,20,2000,8.1,18,14,11,6,1,10,14,71.4,4,9,3,6,19,37,20,0,2021
ITA-Serie A,2020,Milan,Rade Krunić,BIH,"MF,FW",26,1993,8.0,15,12,6,6,3,7,17,41.2,10,12,2,10,10,25,9,0,2021
ITA-Serie A,2020,Milan,Rafael Leão,POR,FW,21,1999,21.4,13,6,4,7,2,6,15,40.0,9,17,0,17,4,17,14,1,2021
ITA-Serie A,2020,Milan,Samu Castillejo,ESP,FW,25,1995,13.1,24,12,9,14,1,14,40,35.0,26,21,0,21,6,30,9,0,2021
ITA-Serie A,2020,Milan,Sandro Tonali,ITA,MF,20,2000,14.8,28,19,14,13,1,13,28,46.4,15,18,5,13,22,50,18,0,2021
ITA-Serie A,2020,Milan,Simon Kjær,DEN,DF,31,1989,26.6,45,26,23,20,2,18,30,60.0,12,42,26,16,42,87,125,0,2021
ITA-Serie A,2020,Milan,Soualiho Meïté,FRA,MF,26,1994,6.5,18,10,10,6,2,8,17,47.1,9,9,2,7,8,26,16,0,2021
ITA-Serie A,2020,Milan,Theo Hernández,FRA,DF,22,1997,32.6,48,29,22,21,5,19,38,50.0,19,29,6,23,34,82,64,5,2021
ITA-Serie A,2020,Milan,Zlatan Ibrahimović,SWE,FW,38,1981,16.6,5,4,0,4,1,3,6,50.0,3,5,3,2,6,11,27,1,2021
ITA-Serie A,2020,Napoli,Alex Meret,ITA,GK,23,1997,22.0,0,0,0,0,0,0,1,0.0,1,0,0,0,0,0,5,0,2021
ITA-Serie A,2020,Napoli,Amir Rrahmani,KVX,DF,26,1994,12.2,13,8,7,6,0,6,9,66.7,3,17,14,3,8,21,39,1,2021
ITA-Serie A,2020,Napoli,Andrea Petagna,ITA,FW,25,1995,10.7,2,0,0,2,0,2,7,28.6,5,4,0,4,1,3,7,0,2021
ITA-Serie A,2020,Napoli,Antonio Cioffi,ITA,FW,17,2002,0.1,0,0,0,0,0,0,0,,0,1,0,1,1,1,0,0,2021
ITA-Serie A,2020,Napoli,David Ospina,COL,GK,31,1988,16.0,0,0,0,0,0,0,0,,0,0,0,0,0,0,4,0,2021
ITA-Serie A,2020,Napoli,Diego Demme,GER,MF,28,1991,17.7,56,32,26,22,8,23,63,36.5,40,14,1,13,11,67,15,1,2021
ITA-Serie A,2020,Napoli,Dries Mertens,BEL,"FW,MF",33,1987,16.2,16,14,4,7,5,5,25,20.0,20,7,1,6,9,25,3,1,2021
ITA-Serie A,2020,Napoli,Elif Elmas,MKD,"MF,FW",20,1999,8.2,15,4,3,6,6,7,12,58.3,5,11,1,10,2,17,10,0,2021
ITA-Serie A,2020,Napoli,Elseid Hysaj,ALB,DF,26,1994,19.6,29,17,16,11,2,17,33,51.5,16,18,4,14,30,59,52,0,2021
ITA-Serie A,2020,Napoli,Fabián Ruiz Peña,ESP,MF,24,1996,28.5,58,31,26,21,11,25,70,35.7,45,33,3,30,36,94,32,1,2021
ITA-Serie A,2020,Napoli,Faouzi Ghoulam,ALG,"DF,FW",29,1991,3.2,6,5,3,2,1,0,1,0.0,1,4,2,2,3,9,1,0,2021
ITA-Serie A,2020,Napoli,Fernando Llorente,ESP,"FW,MF",35,1985,0.6,0,0,0,0,0,0,0,,0,0,0,0,0,0,0,0,2021
ITA-Serie A,2020,Napoli,Giovanni Di Lorenzo,ITA,DF,26,1993,36.0,79,50,54,21,4,43,75,57.3,32,37,13,24,35,114,64,1,2021
ITA-Serie A,2020,Napoli,Hirving Lozano,MEX,FW,25,1995,21.8,29,18,10,13,6,10,36,27.8,26,37,1,36,18,47,14,0,2021
ITA-Serie A,2020,Napoli,Kalidou Koulibaly,SEN,DF,29,1991,24.5,36,24,25,7,4,19,32,59.4,13,46,26,20,29,65,64,2,2021
ITA-Serie A,2020,Napoli,Kostas Manolas,GRE,DF,29,1991,25.5,31,18,24,7,0,17,24,70.8,7,22,13,9,23,54,82,2,2021
ITA-Serie A,2020,Napoli,Kévin Malcuit,MAR,"FW,MF",29,1991,0.4,2,1,2,0,0,0,1,0.0,1,0,0,0,2,4,2,0,2021
ITA-Serie A,2020,Napoli,Lorenzo Insigne,ITA,FW,29,1991,31.8,26,18,8,12,6,13,72,18.1,59,30,1,29,37,63,6,1,2021
ITA-Serie A,2020,Napoli,Matteo Politano,ITA,"FW,MF",26,1993,21.2,24,16,13,9,2,11,47,23.4,36,14,1,13,14,38,18,0,2021
ITA-Serie A,2020,Napoli,Mário Rui,POR,DF,29,1991,18.5,24,13,17,6,1,17,33,51.5,16,17,4,13,28,52,29,1,2021
ITA-Serie A,2020,Napoli,Nikola Maksimović,SRB,DF,28,1991,13.4,18,9,11,6,1,9,18,50.0,9,15,6,9,21,39,49,3,2021
ITA-Serie A,2020,Napoli,Piotr Zieliński,POL,MF,26,1994,28.0,18,10,8,7,3,7,20,35.0,13,23,4,19,18,36,12,0,2021
ITA-Serie A,2020,Napoli,Stanislav Lobotka,SVK,MF,25,1994,1.7,1,1,0,1,0,0,1,0.0,1,1,1,0,0,1,1,1,2021
ITA-Serie A,2020,Napoli,Tiemoué Bakayoko,FRA,MF,25,1994,21.8,69,41,21,41,7,23,40,57.5,17,24,2,22,36,105,13,2,2021
ITA-Serie A,2020,Napoli,Victor Osimhen,NGA,FW,21,1998,17.5,22,15,2,6,14,3,15,20.0,12,6,0,6,7,29,10,0,2021
ITA-Serie A,2020,Parma,Alberto Grassi,ITA,"MF,DF",25,1995,13.1,30,11,14,13,3,8,29,27.6,21,22,9,13,26,56,32,0,2021
ITA-Serie A,2020,Parma,Andrea Adorante,ITA,FW,20,2000,0.1,0,0,0,0,0,0,0,,0,0,0,0,0,0,0,0,2021
ITA-Serie A,2020,Parma,Andrea Conti,ITA,DF,26,1994,9.0,21,10,16,4,1,13,26,50.0,13,13,4,9,16,37,23,0,2021
ITA-Serie A,2020,Parma,Andreas Cornelius,DEN,FW,27,1993,21.1,11,4,1,5,5,2,12,16.7,10,9,2,7,1,12,25,1,2021
ITA-Serie A,2020,Parma,Botond Balogh,HUN,DF,18,2002,1.8,9,7,9,0,0,2,5,40.0,3,4,3,1,2,11,8,0,2021
ITA-Serie A,2020,Parma,Bruno Alves,POR,DF,38,1981,18.1,13,10,10,3,0,7,9,77.8,2,17,12,5,26,39,81,0,2021
ITA-Serie A,2020,Parma,Chaka Traorè,CIV,"FW,DF",15,2004,0.2,0,0,0,0,0,0,0,,0,0,0,0,0,0,1,1,2021
ITA-Serie A,2020,Parma,Daan Dierckx,BEL,DF,17,2003,5.2,5,4,5,0,0,3,5,60.0,2,10,6,4,13,18,21,0,2021
ITA-Serie A,2020,Parma,Dennis Man,ROU,"FW,MF",21,1998,7.8,12,6,6,4,2,6,21,28.6,15,5,0,5,2,14,6,0,2021
ITA-Serie A,2020,Parma,Drissa Camara,CIV,MF,18,2002,0.2,0,0,0,0,0,0,0,,0,0,0,0,0,0,0,0,2021
ITA-Serie A,2020,Parma,Gastón Brugman,URU,MF,27,1992,18.0,35,19,18,15,2,11,44,25.0,33,33,4,29,45,80,34,0,2021
ITA-Serie A,2020,Parma,Gervinho,CIV,FW,33,1987,22.5,5,1,2,2,1,1,14,7.1,13,11,1,10,10,15,3,0,2021
ITA-Serie A,2020,Parma,Giacomo Ricci,ITA,DF,23,1996,0.7,3,1,1,2,0,0,0,,0,2,2,0,1,4,4,0,2021
ITA-Serie A,2020,Parma,Giuseppe Pezzella,ITA,DF,22,1997,20.3,34,19,23,9,2,22,41,53.7,19,22,9,13,12,46,52,3,2021
ITA-Serie A,2020,Parma,Graziano Pellè,ITA,FW,35,1985,6.8,2,2,0,1,1,1,8,12.5,7,3,0,3,2,4,8,0,2021
ITA-Serie A,2020,Parma,Hernani,BRA,MF,26,1994,24.3,51,25,21,27,3,29,66,43.9,37,35,4,31,31,82,40,1,2021
ITA-Serie A,2020,Parma,Jacopo Dezi,ITA,"FW,MF",28,1992,0.9,4,3,0,2,2,3,6,50.0,3,2,0,2,0,4,0,0,2021
ITA-Serie A,2020,Parma,Jasmin Kurtić,SVN,MF,31,1989,30.4,46,28,22,21,3,21,70,30.0,49,22,2,20,33,79,57,1,2021
ITA-Serie A,2020,Parma,Joshua Zirkzee,NED,"FW,MF",19,2001,1.3,2,2,1,1,0,1,3,33.3,2,1,1,0,0,2,1,0,2021
ITA-Serie A,2020,Parma,Juan Brunetta,ARG,"FW,MF",23,1997,5.3,2,2,0,2,0,1,6,16.7,5,5,0,5,1,3,2,0,2021
ITA-Serie A,2020,Parma,Juraj Kucka,SVK,"MF,FW",33,1987,25.9,67,36,21,37,9,26,74,35.1,48,25,3,22,28,95,25,0,2021
ITA-Serie A,2020,Parma,Kastriot Dermaku,ALB,"DF,MF",28,1992,1.1,1,1,1,0,0,0,0,,0,2,1,1,2,3,8,0,2021
ITA-Serie A,2020,Parma,Lautaro Valenti,ARG,DF,21,1999,5.5,10,4,7,2,1,6,15,40.0,9,11,3,8,11,21,30,0,2021
ITA-Serie A,2020,Parma,Luca Siligardi,ITA,"FW,MF",32,1988,0.4,0,0,0,0,0,0,2,0.0,2,0,0,0,0,0,0,0,2021
ITA-Serie A,2020,Parma,Luigi Sepe,ITA,GK,29,1991,36.0,0,0,0,0,0,0,2,0.0,2,0,0,0,2,2,13,2,2021
ITA-Serie A,2020,Parma,Matteo Darmian,ITA,DF,30,1989,2.3,6,5,3,3,0,4,7,57.1,3,2,0,2,6,12,7,0,2021
ITA-Serie A,2020,Parma,Matteo Scozzarella,ITA,MF,32,1988,1.7,4,0,3,1,0,2,3,66.7,1,3,1,2,6,10,0,0,2021
ITA-Serie A,2020,Parma,Mattia Bani,ITA,DF,26,1993,12.7,20,11,15,4,1,4,8,50.0,4,10,6,4,33,53,50,0,2021
ITA-Serie A,2020,Parma,Mattia Sprocati,ITA,"MF,FW",27,1993,0.2,1,0,0,1,0,1,1,100.0,0,0,0,0,1,2,0,0,2021
ITA-Serie A,2020,Parma,Maxime Busi,BEL,DF,20,1999,13.3,23,13,19,3,1,11,28,39.3,17,14,1,13,16,39,32,0,2021
ITA-Serie A,2020,Parma,Márk Kosznovszky,HUN,MF,18,2002,1.0,2,2,1,1,0,1,4,25.0,3,2,0,2,1,3,1,0,2021
ITA-Serie A,2020,Parma,Riccardo Gagliolo,SWE,DF,30,1990,21.7,45,18,35,8,2,28,45,62.2,17,34,7,27,36,81,64,1,2021
ITA-Serie A,2020,Parma,Roberto Inglese,ITA,FW,28,1991,6.4,5,2,1,2,2,2,11,18.2,9,10,0,10,0,5,3,0,2021
ITA-Serie A,2020,Parma,Simon Sohm,SUI,MF,19,2001,10.0,18,12,11,6,1,11,26,42.3,15,8,0,8,5,23,7,0,2021
ITA-Serie A,2020,Parma,Simone Colombi,ITA,GK,29,1991,2.0,0,0,0,0,0,0,0,,0,0,0,0,0,0,2,0,2021
ITA-Serie A,2020,Parma,Simone Iacoponi,ITA,DF,33,1987,13.3,22,12,16,5,1,13,26,50.0,13,9,4,5,11,33,42,1,2021
ITA-Serie A,2020,Parma,Valentin Mihaila,ROU,"FW,MF",20,2000,7.8,2,1,1,1,0,0,10,0.0,10,8,1,7,5,7,8,0,2021
ITA-Serie A,2020,Parma,Vasilios Zagaritis,GRE,DF,19,2001,0.7,0,0,0,0,0,0,0,,0,1,0,1,0,0,0,0,2021
ITA-Serie A,2020,Parma,Vincent Laurini,FRA,DF,31,1989,9.7,16,11,8,6,2,7,9,77.8,2,8,4,4,17,33,22,1,2021
ITA-Serie A,2020,Parma,Wylan Cyprien,FRA,MF,25,1995,4.6,9,4,5,3,1,2,4,50.0,2,13,8,5,5,14,6,1,2021
ITA-Serie A,2020,Parma,Yann Karamoh,FRA,"FW,MF",22,1998,14.4,27,17,8,12,7,11,31,35.5,20,6,0,6,4,31,11,0,2021
ITA-Serie A,2020,Parma,Yordan Osorio,VEN,DF,26,1994,20.1,22,14,13,9,0,9,24,37.5,15,30,18,12,53,75,77,1,2021
ITA-Serie A,2020,Roma,Amadou Diawara,GUI,MF,23,1997,7.3,10,8,4,6,0,2,8,25.0,6,11,2,9,12,22,4,0,2021
ITA-Serie A,2020,Roma,Antonio Mirante,ITA,GK,37,1983,12.8,0,0,0,0,0,0,1,0.0,1,1,0,1,0,0,7,2,2021
ITA-Serie A,2020,Roma,Borja Mayoral,ESP,FW,23,1997,17.2,3,2,0,0,3,1,10,10.0,9,5,0,5,0,3,5,2,2021
ITA-Serie A,2020,Roma,Bruno Peres,BRA,DF,30,1990,15.9,21,11,11,7,3,13,24,54.2,11,18,4,14,27,48,11,0,2021
ITA-Serie A,2020,Roma,Bryan Cristante,ITA,"DF,MF",25,1995,23.9,27,20,10,14,3,10,28,35.7,18,21,7,14,40,67,61,1,2021
ITA-Serie A,2020,Roma,Bryan Reynolds,USA,DF,19,2001,3.1,4,2,1,1,2,1,5,20.0,4,4,0,4,6,10,4,0,2021
ITA-Serie A,2020,Roma,Carles Pérez,ESP,"MF,FW",22,1998,8.6,9,4,3,6,0,6,31,19.4,25,9,0,9,6,15,1,0,2021
ITA-Serie A,2020,Roma,Chris Smalling,ENG,DF,30,1989,12.3,14,8,5,7,2,6,10,60.0,4,17,11,6,28,42,46,1,2021
ITA-Serie A,2020,Roma,Daniel Fuzato,BRA,GK,23,1997,5.0,0,0,0,0,0,0,0,,0,1,0,1,0,0,1,1,2021
ITA-Serie A,2020,Roma,Davide Santon,ITA,DF,29,1991,6.5,4,3,2,2,0,3,7,42.9,4,10,1,9,4,8,12,0,2021
ITA-Serie A,2020,Roma,Ebrima Darboe,GAM,MF,19,2001,3.6,5,2,3,1,1,3,10,30.0,7,3,0,3,8,13,0,1,2021
ITA-Serie A,2020,Roma,Edin Džeko,BIH,FW,34,1986,20.3,8,6,2,3,3,3,9,33.3,6,9,4,5,1,9,11,0,2021
ITA-Serie A,2020,Roma,Edoardo Bove,ITA,MF,18,2002,0.1,0,0,0,0,0,0,1,0.0,1,0,0,0,0,0,0,0,2021
ITA-Serie A,2020,Roma,Federico Fazio,ARG,DF,33,1987,4.5,3,2,3,0,0,3,4,75.0,1,3,3,0,7,10,18,1,2021
ITA-Serie A,2020,Roma,Gianluca Mancini,ITA,DF,24,1996,31.7,50,29,29,19,2,18,31,58.1,13,38,18,20,72,122,77,3,2021
ITA-Serie A,2020,Roma,Gonzalo Villar,ESP,MF,22,1998,20.7,44,18,14,24,6,18,61,29.5,43,25,3,22,22,66,14,1,2021
ITA-Serie A,2020,Roma,Henrikh Mkhitaryan,ARM,"MF,FW",31,1989,30.5,58,24,13,27,18,13,62,21.0,49,34,0,34,39,97,10,0,2021
ITA-Serie A,2020,Roma,Javier Pastore,ARG,"MF,FW",31,1989,0.9,2,2,2,0,0,2,2,100.0,0,0,0,0,0,2,0,0,2021
ITA-Serie A,2020,Roma,Jordan Veretout,FRA,MF,27,1993,22.8,20,12,8,12,0,9,33,27.3,24,14,3,11,14,34,21,3,2021
ITA-Serie A,2020,Roma,Juan Jesus,BRA,DF,29,1991,1.7,3,1,2,1,0,2,4,50.0,2,1,0,1,2,5,5,0,2021
ITA-Serie A,2020,Roma,Justin Kluivert,NED,MF,21,1999,0.2,0,0,0,0,0,0,0,,0,0,0,0,0,0,0,0,2021
ITA-Serie A,2020,Roma,Leonardo Spinazzola,ITA,DF,27,1993,23.6,12,6,3,9,0,8,20,40.0,12,16,1,15,25,37,31,0,2021
ITA-Serie A,2020,Roma,Lorenzo Pellegrini,ITA,MF,24,1996,28.9,40,24,13,20,7,21,60,35.0,39,37,2,35,42,82,23,1,2021
ITA-Serie A,2020,Roma,Marash Kumbulla,ALB,DF,20,2000,15.1,16,11,8,7,1,5,17,29.4,12,12,5,7,24,40,38,1,2021
ITA-Serie A,2020,Roma,Nicola Zalewski,POL,MF,18,2002,0.1,1,1,0,1,0,1,1,100.0,0,0,0,0,0,1,0,0,2021
ITA-Serie A,2020,Roma,Pau López,ESP,GK,25,1994,20.2,2,0,2,0,0,2,2,100.0,0,1,0,1,0,2,7,4,2021
ITA-Serie A,2020,Roma,Pedro,ESP,"MF,FW",33,1987,17.7,22,14,6,11,5,7,35,20.0,28,10,0,10,9,31,2,1,2021
ITA-Serie A,2020,Roma,Riccardo Calafiori,ITA,DF,18,2002,0.7,1,0,1,0,0,1,4,25.0,3,1,0,1,0,1,0,0,2021
ITA-Serie A,2020,Roma,Rick Karsdorp,NED,DF,25,1995,28.3,36,23,19,12,5,21,48,43.8,27,18,1,17,30,66,32,0,2021
ITA-Serie A,2020,Roma,Roger Ibanez,BRA,DF,21,1998,26.6,59,37,28,25,6,25,45,55.6,20,38,17,21,68,127,78,3,2021
ITA-Serie A,2020,Roma,Stephan El Shaarawy,ITA,"MF,FW",27,1992,6.4,4,3,0,3,1,2,9,22.2,7,3,1,2,3,7,2,0,2021
ITA-Serie A,2020,Sampdoria,Adrien Silva,POR,MF,31,1989,17.8,49,22,21,22,6,18,54,33.3,36,34,1,33,30,79,10,1,2021
ITA-Serie A,2020,Sampdoria,Albin Ekdal,SWE,MF,31,1989,25.5,56,29,21,32,3,23,65,35.4,42,31,12,19,49,105,35,0,2021
ITA-Serie A,2020,Sampdoria,Alex Ferrari,ITA,DF,26,1994,9.8,27,15,16,9,2,15,24,62.5,9,18,6,12,23,50,26,0,2021
ITA-Serie A,2020,Sampdoria,Antonino La Gumina,ITA,FW,24,1996,3.8,3,2,0,1,2,0,3,0.0,3,5,1,4,3,6,5,0,2021
ITA-Serie A,2020,Sampdoria,Antonio Candreva,ITA,MF,33,1987,27.8,28,19,17,9,2,21,53,39.6,32,24,3,21,9,37,27,1,2021
ITA-Serie A,2020,Sampdoria,Antonio Palumbo,ITA,MF,23,1996,0.1,0,0,0,0,0,0,1,0.0,1,0,0,0,0,0,0,0,2021
ITA-Serie A,2020,Sampdoria,Bartosz Bereszyński,POL,DF,28,1992,29.0,66,44,37,22,7,41,73,56.2,32,40,20,20,42,108,88,0,2021
ITA-Serie A,2020,Sampdoria,Emil Audero,ITA,GK,23,1997,37.0,1,1,1,0,0,1,2,50.0,1,0,0,0,1,2,16,0,2021
ITA-Serie A,2020,Sampdoria,Ernesto Torregrossa,VEN,FW,28,1992,1.9,1,1,0,0,1,0,2,0.0,2,4,0,4,1,2,1,0,2021
ITA-Serie A,2020,Sampdoria,Fabio Depaoli,ITA,MF,23,1997,0.9,1,0,0,1,0,0,2,0.0,2,0,0,0,1,2,1,0,2021
ITA-Serie A,2020,Sampdoria,Fabio Quagliarella,ITA,FW,37,1983,24.5,12,8,4,4,4,2,19,10.5,17,14,1,13,7,19,10,0,2021
ITA-Serie A,2020,Sampdoria,Federico Bonazzoli,ITA,FW,23,1997,1.5,0,0,0,0,0,0,0,,0,1,0,1,0,0,0,0,2021
ITA-Serie A,2020,Sampdoria,Gastón Ramírez,URU,"FW,MF",29,1990,10.8,31,15,10,17,4,8,27,29.6,19,19,3,16,4,35,13,0,2021
ITA-Serie A,2020,Sampdoria,Jakub Jankto,CZE,MF,24,1996,26.8,28,17,14,7,7,11,35,31.4,24,16,1,15,24,52,34,0,2021
ITA-Serie A,2020,Sampdoria,Karlo Letica,CRO,GK,23,1997,1.0,0,0,0,0,0,0,0,,0,0,0,0,0,0,2,0,2021
ITA-Serie A,2020,Sampdoria,Keita Baldé,SEN,FW,25,1995,13.3,9,6,2,6,1,4,10,40.0,6,10,1,9,0,9,3,0,2021
ITA-Serie A,2020,Sampdoria,Kristoffer Askildsen,NOR,MF,19,2001,1.1,0,0,0,0,0,0,0,,0,2,0,2,3,3,3,0,2021
ITA-Serie A,2020,Sampdoria,Lorenzo Tonelli,ITA,DF,30,1990,19.8,33,18,20,11,2,10,21,47.6,11,21,14,7,25,58,94,1,2021
ITA-Serie A,2020,Sampdoria,Manolo Gabbiadini,ITA,FW,28,1991,9.7,2,2,0,2,0,0,1,0.0,1,3,1,2,3,5,5,0,2021
ITA-Serie A,2020,Sampdoria,Maya Yoshida,JPN,DF,31,1988,25.3,17,4,10,7,0,7,13,53.8,6,45,34,11,57,74,93,1,2021
ITA-Serie A,2020,Sampdoria,Mehdi Léris,ALG,"DF,MF",22,1998,4.3,11,5,6,4,1,6,16,37.5,10,12,2,10,12,23,15,0,2021
ITA-Serie A,2020,Sampdoria,Mikkel Damsgaard,DEN,"MF,FW",20,2000,19.7,42,21,14,20,8,22,70,31.4,48,40,4,36,24,66,17,0,2021
ITA-Serie A,2020,Sampdoria,Morten Thorsby,NOR,MF,24,1996,29.4,76,42,32,36,8,20,60,33.3,40,51,16,35,25,101,30,0,2021
ITA-Serie A,2020,Sampdoria,Omar Colley,GAM,DF,27,1992,28.8,28,16,19,8,1,13,23,56.5,10,43,29,14,68,96,133,1,2021
ITA-Serie A,2020,Sampdoria,Tommaso Augello,ITA,DF,25,1994,35.7,42,30,27,10,5,23,39,59.0,16,22,2,20,32,74,76,1,2021
ITA-Serie A,2020,Sampdoria,Valerio Verre,ITA,"FW,MF",26,1994,11.1,11,7,2,7,2,4,19,21.1,15,14,2,12,9,20,3,0,2021
ITA-Serie A,2020,Sampdoria,Vasco Regini,ITA,DF,29,1990,1.0,2,2,2,0,0,2,2,100.0,0,1,1,0,1,3,5,0,2021
ITA-Serie A,2020,Sassuolo,Andrea Consigli,ITA,GK,33,1987,37.0,2,2,2,0,0,2,2,100.0,0,0,0,0,0,2,14,4,2021
ITA-Serie A,2020,Sassuolo,Brian Oddei,ITA,"FW,MF",17,2002,0.5,2,1,1,1,0,2,3,66.7,1,1,0,1,0,2,1,0,2021
ITA-Serie A,2020,Sassuolo,Domenico Berardi,ITA,FW,25,1994,27.5,42,22,17,11,14,21,62,33.9,41,23,1,22,26,68,34,0,2021
ITA-Serie A,2020,Sassuolo,Federico Peluso,ITA,DF,36,1984,2.3,1,1,1,0,0,1,2,50.0,1,2,2,0,3,4,12,0,2021
ITA-Serie A,2020,Sassuolo,Federico Ricci,ITA,FW,26,1994,0.0,0,0,0,0,0,0,0,,0,0,0,0,0,0,0,0,2021
ITA-Serie A,2020,Sassuolo,Filip Đuričić,SRB,"MF,FW",28,1992,23.1,32,23,6,16,10,12,30,40.0,18,20,2,18,9,41,12,0,2021
ITA-Serie A,2020,Sassuolo,Francesco Caputo,ITA,FW,32,1987,18.9,0,0,0,0,0,0,2,0.0,2,4,0,4,1,1,3,0,2021
ITA-Serie A,2020,Sassuolo,Francesco Magnanelli,ITA,MF,35,1984,4.9,7,5,2,5,0,3,10,30.0,7,6,2,4,13,20,10,0,2021
ITA-Serie A,2020,Sassuolo,Giacomo Raspadori,ITA,"FW,MF",20,2000,13.7,5,3,1,1,3,0,4,0.0,4,13,5,8,2,7,9,0,2021
ITA-Serie A,2020,Sassuolo,Gian Marco Ferrari,ITA,DF,28,1992,33.5,32,20,15,14,3,10,23,43.5,13,46,37,9,50,82,100,1,2021
ITA-Serie A,2020,Sassuolo,Gianluca Pegolo,ITA,GK,39,1981,1.0,0,0,0,0,0,0,0,,0,0,0,0,0,0,1,0,2021
ITA-Serie A,2020,Sassuolo,Giorgos Kyriakopoulos,GRE,DF,24,1996,16.2,35,18,17,12,6,8,28,28.6,20,16,5,11,15,50,42,0,2021
ITA-Serie A,2020,Sassuolo,Grégoire Defrel,MTQ,"MF,FW",29,1991,14.8,13,8,5,5,3,5,13,38.5,8,9,0,9,7,20,5,0,2021
ITA-Serie A,2020,Sassuolo,Hamed Junior Traorè,CIV,"MF,FW",20,2000,19.9,29,17,10,10,9,14,35,40.0,21,27,3,24,18,47,9,0,2021
ITA-Serie A,2020,Sassuolo,Isaac Karamoko,FRA,DF,18,2002,0.0,1,0,0,0,1,1,1,100.0,0,0,0,0,0,1,0,0,2021
ITA-Serie A,2020,Sassuolo,Jeremie Boga,CIV,"FW,MF",23,1997,19.8,11,9,5,0,6,3,11,27.3,8,10,0,10,8,19,7,0,2021
ITA-Serie A,2020,Sassuolo,Jeremy Toljan,GER,DF,25,1994,16.6,21,12,16,3,2,12,27,44.4,15,15,7,8,13,34,28,0,2021
ITA-Serie A,2020,Sassuolo,Kaan Ayhan,TUR,DF,25,1994,8.8,15,9,8,5,2,8,13,61.5,5,9,5,4,16,31,33,0,2021
ITA-Serie A,2020,Sassuolo,Lukáš Haraslín,SVK,"FW,MF",24,1996,3.7,8,4,2,5,1,2,5,40.0,3,1,0,1,0,8,2,0,2021
ITA-Serie A,2020,Sassuolo,Manuel Locatelli,ITA,MF,22,1998,32.0,81,47,43,28,10,29,56,51.8,27,35,15,20,51,132,65,1,2021
ITA-Serie A,2020,Sassuolo,Marlon,BRA,DF,24,1995,19.4,19,13,13,6,0,13,18,72.2,5,23,17,6,27,46,44,2,2021
ITA-Serie A,2020,Sassuolo,Maxime Lopez,FRA,MF,22,1997,20.7,24,13,15,6,3,14,41,34.1,27,9,0,9,16,40,10,1,2021
ITA-Serie A,2020,Sassuolo,Mehdi Bourabia,MAR,MF,28,1991,5.9,6,5,1,4,1,2,7,28.6,5,14,6,8,12,18,8,0,2021
ITA-Serie A,2020,Sassuolo,Mert Müldür,TUR,DF,21,1999,18.6,43,20,26,9,8,27,53,50.9,26,17,1,16,36,79,41,0,2021
ITA-Serie A,2020,Sassuolo,Nicolás Schiappacasse,URU,MF,21,1999,0.2,0,0,0,0,0,0,0,,0,0,0,0,0,0,0,0,2021
ITA-Serie A,2020,Sassuolo,Pedro Obiang,EQG,MF,28,1992,16.3,35,22,17,15,3,12,35,34.3,23,26,7,19,22,57,27,0,2021
ITA-Serie A,2020,Sassuolo,Rogério,BRA,DF,22,1998,20.9,26,13,19,5,2,19,27,70.4,8,26,5,21,31,57,53,0,2021
ITA-Serie A,2020,Sassuolo,Vlad Chiricheș,ROU,DF,30,1989,20.4,38,23,34,3,1,21,35,60.0,14,31,21,10,50,88,59,2,2021
ITA-Serie A,2020,Spezia,Alessandro Deiola,ITA,MF,24,1995,4.0,6,3,2,3,1,5,13,38.5,8,3,1,2,3,9,1,0,2021
ITA-Serie A,2020,Spezia,Andrey Galabinov,BUL,FW,31,1988,4.8,2,1,1,1,0,1,3,33.3,2,2,0,2,0,2,5,0,2021
ITA-Serie A,2020,Spezia,Ardian Ismajli,ALB,DF,23,1996,14.4,19,9,10,8,1,8,13,61.5,5,10,7,3,23,42,52,1,2021
ITA-Serie A,2020,Spezia,Claudio Terzi,ITA,DF,36,1984,20.8,34,21,19,14,1,19,28,67.9,9,23,12,11,35,69,55,1,2021
ITA-Serie A,2020,Spezia,Cristian Dell'Orco,ITA,DF,26,1994,2.9,1,0,1,0,0,1,3,33.3,2,8,5,3,7,8,9,1,2021
ITA-Serie A,2020,Spezia,Daniele Verde,ITA,FW,24,1996,10.9,5,4,2,2,1,4,10,40.0,6,5,0,5,9,14,7,0,2021
ITA-Serie A,2020,Spezia,Diego Farias,BRA,FW,30,1990,16.8,9,5,4,1,4,4,21,19.0,17,12,0,12,13,22,3,0,2021
ITA-Serie A,2020,Spezia,Elio Capradossi,ITA,DF,24,1996,1.0,2,1,2,0,0,2,2,100.0,0,0,0,0,1,3,5,0,2021
ITA-Serie A,2020,Spezia,Emmanuel Gyasi,GHA,FW,26,1994,31.7,30,16,16,10,4,9,31,29.0,22,13,2,11,14,44,8,0,2021
ITA-Serie A,2020,Spezia,Federico Mattiello,ITA,DF,25,1995,0.4,0,0,0,0,0,0,0,,0,0,0,0,0,0,0,0,2021
ITA-Serie A,2020,Spezia,Gennaro Acampora,ITA,"MF,FW",26,1994,4.9,6,4,1,4,1,2,7,28.6,5,4,1,3,4,10,4,0,2021
ITA-Serie A,2020,Spezia,Giulio Maggiore,ITA,MF,22,1998,24.6,61,36,26,28,7,21,53,39.6,32,33,6,27,19,80,25,1,2021
ITA-Serie A,2020,Spezia,Giuseppe Mastinu,ITA,FW,28,1991,0.4,1,1,0,0,1,1,1,100.0,0,1,0,1,0,1,0,0,2021
ITA-Serie A,2020,Spezia,Ivan Provedel,ITA,GK,26,1994,29.0,2,0,2,0,0,2,6,33.3,4,0,0,0,2,4,20,1,2021
ITA-Serie A,2020,Spezia,Jacopo Sala,ITA,DF,28,1991,4.2,17,9,14,1,2,8,22,36.4,14,5,2,3,5,22,6,0,2021
ITA-Serie A,2020,Spezia,Jeroen Zoet,NED,GK,29,1991,6.7,0,0,0,0,0,0,1,0.0,1,0,0,0,0,0,4,2,2021
ITA-Serie A,2020,Spezia,Juan Manuel Ramos,URU,DF,23,1996,3.3,5,0,3,0,2,4,7,57.1,3,1,0,1,2,7,6,0,2021
ITA-Serie A,2020,Spezia,Julian Chabot,GER,DF,22,1998,18.4,48,34,28,16,4,23,37,62.2,14,25,13,12,37,85,43,1,2021
ITA-Serie A,2020,Spezia,Kevin Agudelo,COL,FW,21,1998,15.1,39,28,9,15,15,12,34,35.3,22,30,0,30,10,49,2,0,2021
ITA-Serie A,2020,Spezia,Luca Mora,ITA,MF,32,1988,1.3,3,1,1,2,0,2,4,50.0,2,2,1,1,0,3,2,0,2021
ITA-Serie A,2020,Spezia,Luca Vignali,ITA,DF,24,1996,17.7,19,9,10,6,3,7,25,28.0,18,13,5,8,22,41,25,0,2021
ITA-Serie A,2020,Spezia,Lucien Agoume,FRA,MF,18,2002,8.9,18,10,11,7,0,6,19,31.6,13,10,5,5,15,33,10,0,2021
ITA-Serie A,2020,Spezia,Léo Sena,BRA,MF,24,1995,9.8,22,12,7,10,5,12,26,46.2,14,19,4,15,11,33,5,0,2021
ITA-Serie A,2020,Spezia,M'Bala Nzola,ANG,FW,23,1996,21.1,12,5,2,6,4,4,7,57.1,3,15,1,14,3,15,20,0,2021
ITA-Serie A,2020,Spezia,Martin Erlic,CRO,DF,22,1998,20.0,23,14,16,6,1,11,20,55.0,9,22,16,6,41,64,71,2,2021
ITA-Serie A,2020,Spezia,Matteo Ricci,ITA,MF,26,1994,24.8,40,23,14,24,2,27,52,51.9,25,24,4,20,34,74,13,0,2021
ITA-Serie A,2020,Spezia,Nahuel Estévez,ARG,MF,24,1995,19.6,13,5,4,6,3,5,32,15.6,27,23,5,18,20,33,22,1,2021
ITA-Serie A,2020,Spezia,Paolo Bartolomei,ITA,MF,30,1989,3.6,6,2,3,1,2,4,7,57.1,3,1,0,1,1,7,2,0,2021
ITA-Serie A,2020,Spezia,Rafael,BRA,GK,38,1982,2.3,0,0,0,0,0,0,0,,0,0,0,0,0,0,0,0,2021
ITA-Serie A,2020,Spezia,Riccardo Marchizza,ITA,DF,22,1998,17.3,20,11,12,5,3,12,21,57.1,9,13,4,9,11,31,27,0,2021
ITA-Serie A,2020,Spezia,Riccardo Saponara,ITA,"FW,MF",28,1991,4.3,4,1,1,0,3,1,3,33.3,2,1,0,1,1,5,4,0,2021
ITA-Serie A,2020,Spezia,Roberto Piccoli,ITA,FW,19,2001,7.8,7,3,0,4,3,2,4,50.0,2,4,0,4,2,9,5,0,2021
ITA-Serie A,2020,Spezia,Salvador Ferrer,ESP,DF,22,1998,13.2,20,10,10,8,2,8,22,36.4,14,13,4,9,24,44,37,1,2021
ITA-Serie A,2020,Spezia,Simone Bastoni,ITA,DF,23,1996,16.9,50,29,26,22,2,27,52,51.9,25,19,1,18,16,66,31,0,2021
ITA-Serie A,2020,Spezia,Tommaso Pobega,ITA,MF,21,1999,13.7,24,13,7,13,4,11,31,35.5,20,10,2,8,9,33,22,0,2021
ITA-Serie A,2020,Torino,Alessandro Buongiorno,ITA,DF,21,1999,9.5,12,5,8,4,0,7,12,58.3,5,15,9,6,11,23,44,1,2021
ITA-Serie A,2020,Torino,Amer Gojak,BIH,"MF,FW",23,1997,5.3,1,0,1,0,0,1,7,14.3,6,5,0,5,3,4,1,0,2021
ITA-Serie A,2020,Torino,Andrea Belotti,ITA,FW,26,1993,32.1,30,18,4,16,10,11,35,31.4,24,27,4,23,12,42,21,0,2021
ITA-Serie A,2020,Torino,Antonio Sanabria,PAR,FW,24,1996,10.9,8,3,0,4,4,2,9,22.2,7,5,0,5,5,13,8,0,2021
ITA-Serie A,2020,Torino,Armando Izzo,ITA,DF,28,1992,22.3,30,16,13,13,4,13,33,39.4,20,22,9,13,53,83,62,0,2021
ITA-Serie A,2020,Torino,Cristian Ansaldi,ARG,"DF,FW",33,1986,21.6,48,33,25,14,9,24,38,63.2,14,21,7,14,16,64,38,0,2021
ITA-Serie A,2020,Torino,Daniele Baselli,ITA,MF,28,1992,4.4,12,7,3,6,3,6,10,60.0,4,2,0,2,9,21,5,0,2021
ITA-Serie A,2020,Torino,Federico Bonazzoli,ITA,FW,23,1997,6.3,6,4,0,4,2,2,13,15.4,11,3,0,3,2,8,3,0,2021
ITA-Serie A,2020,Torino,Gleison Bremer,BRA,DF,23,1997,32.6,51,34,36,14,1,21,36,58.3,15,54,21,33,70,121,142,1,2021
ITA-Serie A,2020,Torino,Jacopo Segre,ITA,MF,23,1997,2.1,5,2,2,1,2,2,5,40.0,3,0,0,0,0,5,1,0,2021
ITA-Serie A,2020,Torino,Karol Linetty,POL,MF,25,1995,20.4,38,28,13,19,6,16,45,35.6,29,19,5,14,15,53,7,0,2021
ITA-Serie A,2020,Torino,Lyanco,BRA,DF,23,1997,21.8,21,14,13,6,2,8,14,57.1,6,36,26,10,46,67,76,0,2021
ITA-Serie A,2020,Torino,Mërgim Vojvoda,KVX,"DF,FW",25,1995,15.1,24,14,18,5,1,12,22,54.5,10,19,4,15,18,42,35,1,2021
ITA-Serie A,2020,Torino,Nicola Murru,ITA,DF,25,1994,6.3,9,6,1,5,3,3,5,60.0,2,11,1,10,12,21,24,0,2021
ITA-Serie A,2020,Torino,Nicolas Nkoulou,CMR,DF,30,1990,15.1,14,9,11,3,0,7,12,58.3,5,28,14,14,33,47,71,1,2021
ITA-Serie A,2020,Torino,Ricardo Rodríguez,SUI,DF,27,1992,13.8,21,14,11,8,2,13,22,59.1,9,16,5,11,20,41,43,0,2021
ITA-Serie A,2020,Torino,Rolando Mandragora,ITA,MF,23,1997,16.9,19,4,4,9,6,7,30,23.3,23,19,6,13,20,39,19,0,2021
ITA-Serie A,2020,Torino,Salvatore Sirigu,ITA,GK,33,1987,32.0,1,0,1,0,0,1,2,50.0,1,0,0,0,0,1,6,2,2021
ITA-Serie A,2020,Torino,Samir Ujkani,KVX,GK,32,1988,1.0,0,0,0,0,0,0,0,,0,0,0,0,0,0,1,0,2021
ITA-Serie A,2020,Torino,Saša Lukić,SRB,MF,23,1996,23.4,32,13,11,18,3,15,50,30.0,35,23,5,18,17,49,17,0,2021
ITA-Serie A,2020,Torino,Simone Edera,ITA,"DF,MF",23,1997,0.6,3,1,2,1,0,3,4,75.0,1,0,0,0,1,4,1,0,2021
ITA-Serie A,2020,Torino,Simone Verdi,ITA,"MF,FW",28,1992,18.0,19,12,10,6,3,6,19,31.6,13,8,0,8,8,27,2,2,2021
ITA-Serie A,2020,Torino,Simone Zaza,ITA,FW,29,1991,16.6,15,9,4,6,5,6,20,30.0,14,14,0,14,3,18,5,1,2021
ITA-Serie A,2020,Torino,Soualiho Meïté,FRA,MF,26,1994,10.2,11,7,6,4,1,5,16,31.3,11,18,1,17,10,21,9,1,2021
ITA-Serie A,2020,Torino,Tomás Rincón,VEN,MF,32,1988,31.6,68,38,27,33,8,36,71,50.7,35,32,7,25,31,99,44,0,2021
ITA-Serie A,2020,Torino,Vanja Milinković-Savić,SRB,GK,23,1997,5.0,1,1,1,0,0,1,1,100.0,0,0,0,0,0,1,1,3,2021
ITA-Serie A,2020,Torino,Vincenzo Millico,ITA,"FW,MF",19,2000,0.2,0,0,0,0,0,0,0,,0,0,0,0,0,0,0,0,2021
ITA-Serie A,2020,Torino,Wilfried Singo,CIV,DF,19,2000,20.6,29,14,16,6,7,17,33,51.5,16,13,3,10,29,58,40,0,2021
ITA-Serie A,2020,Torino,Álex Berenguer,ESP,MF,25,1995,1.5,2,0,0,0,2,2,5,40.0,3,2,0,2,0,2,1,0,2021
ITA-Serie A,2020,Udinese,Bram Nuytinck,NED,DF,30,1990,18.2,21,15,10,9,2,13,20,65.0,7,30,17,13,25,46,77,0,2021
ITA-Serie A,2020,Udinese,Fernando Forestieri,ITA,"FW,MF",30,1990,6.1,9,7,4,4,1,3,7,42.9,4,7,0,7,2,11,0,0,2021
ITA-Serie A,2020,Udinese,Fernando Llorente,ESP,FW,35,1985,7.9,4,1,2,2,0,2,5,40.0,3,3,0,3,2,6,17,0,2021
ITA-Serie A,2020,Udinese,Gerard Deulofeu,ESP,"FW,MF",26,1994,6.6,2,2,1,1,0,2,12,16.7,10,2,0,2,3,5,0,0,2021
ITA-Serie A,2020,Udinese,Hidde ter Avest,NED,DF,23,1997,3.9,5,2,3,2,0,2,5,40.0,3,3,1,2,2,7,5,0,2021
ITA-Serie A,2020,Udinese,Ignacio Pussetto,ARG,FW,24,1995,8.4,16,8,5,6,5,6,17,35.3,11,14,0,14,13,29,6,0,2021
ITA-Serie A,2020,Udinese,Ilija Nestorovski,MKD,"FW,MF",30,1990,7.8,6,4,2,3,1,2,13,15.4,11,5,0,5,1,7,7,0,2021
ITA-Serie A,2020,Udinese,Jayden Braaf,NED,FW,17,2002,1.3,0,0,0,0,0,0,1,0.0,1,0,0,0,0,0,0,0,2021
ITA-Serie A,2020,Udinese,Jean-Victor Makengo,FRA,MF,22,1998,5.8,8,7,5,3,0,3,13,23.1,10,7,1,6,5,13,7,0,2021
ITA-Serie A,2020,Udinese,Jens Stryger Larsen,DEN,DF,29,1991,29.3,17,11,14,3,0,8,25,32.0,17,26,11,15,24,41,65,0,2021
ITA-Serie A,2020,Udinese,Juan Musso,ARG,GK,26,1994,35.0,1,1,1,0,0,1,1,100.0,0,0,0,0,1,2,8,1,2021
ITA-Serie A,2020,Udinese,Kevin Bonifazi,ITA,DF,24,1996,27.4,32,21,24,6,2,8,23,34.8,15,33,20,13,50,82,85,1,2021
ITA-Serie A,2020,Udinese,Kevin Lasagna,ITA,FW,27,1992,12.3,6,1,2,3,1,3,14,21.4,11,11,0,11,6,12,7,0,2021
ITA-Serie A,2020,Udinese,Mamadou Coulibaly,SEN,MF,21,1999,2.0,10,8,5,5,0,0,0,,0,2,0,2,1,11,0,0,2021
ITA-Serie A,2020,Udinese,Manuel Gasparini,ITA,GK,18,2002,0.0,0,0,0,0,0,0,0,,0,0,0,0,0,0,0,0,2021
ITA-Serie A,2020,Udinese,Martin Palumbo,NOR,MF,18,2002,0.7,0,0,0,0,0,0,0,,0,5,0,5,1,1,0,0,2021
ITA-Serie A,2020,Udinese,Marvin Zeegelaar,NED,DF,29,1990,19.3,40,18,23,16,1,20,39,51.3,19,21,9,12,24,64,43,0,2021
ITA-Serie A,2020,Udinese,Mato Jajalo,BIH,MF,32,1988,0.4,1,1,1,0,0,1,1,100.0,0,1,0,1,2,3,0,0,2021
ITA-Serie A,2020,Udinese,Nahuel Molina,ARG,DF,22,1998,20.3,27,18,13,10,4,16,42,38.1,26,26,4,22,21,48,49,1,2021
ITA-Serie A,2020,Udinese,Nícolas Andrade,BRA,GK,32,1988,2.0,0,0,0,0,0,0,0,,0,0,0,0,0,0,0,0,2021
ITA-Serie A,2020,Udinese,Petar Mićin,SRB,MF,21,1998,0.2,0,0,0,0,0,0,0,,0,0,0,0,0,0,0,0,2021
ITA-Serie A,2020,Udinese,Roberto Pereyra,ARG,"MF,FW",29,1991,32.5,18,11,7,8,3,7,23,30.4,16,24,5,19,27,45,24,0,2021
ITA-Serie A,2020,Udinese,Rodrigo Becão,BRA,DF,24,1996,30.9,59,33,36,20,3,27,49,55.1,22,48,27,21,68,127,94,2,2021
ITA-Serie A,2020,Udinese,Rodrigo De Paul,ARG,MF,26,1994,35.6,41,24,17,22,2,15,60,25.0,45,32,1,31,17,58,20,1,2021
ITA-Serie A,2020,Udinese,Rolando Mandragora,ITA,MF,23,1997,4.4,8,5,3,4,1,3,10,30.0,7,10,3,7,6,14,5,0,2021
ITA-Serie A,2020,Udinese,Ryder Matos,BRA,MF,27,1993,0.1,0,0,0,0,0,0,0,,0,0,0,0,0,0,0,0,2021
ITA-Serie A,2020,Udinese,Samir Santos,BRA,DF,25,1994,24.6,40,23,26,12,2,13,29,44.8,16,33,17,16,58,98,60,1,2021
ITA-Serie A,2020,Udinese,Sebastien De Maio,FRA,DF,33,1987,9.5,15,10,6,9,0,4,5,80.0,1,16,9,7,18,33,41,0,2021
ITA-Serie A,2020,Udinese,Simone Scuffet,ITA,GK,24,1996,1.0,0,0,0,0,0,0,0,,0,0,0,0,0,0,0,0,2021
ITA-Serie A,2020,Udinese,Stefano Okaka,ITA,FW,30,1989,16.5,10,7,2,5,3,2,10,20.0,8,7,1,6,2,12,19,0,2021
ITA-Serie A,2020,Udinese,Thomas Ouwejan,NED,DF,23,1996,4.6,4,1,0,3,1,2,9,22.2,7,4,0,4,5,9,6,0,2021
ITA-Serie A,2020,Udinese,Tolgay Arslan,GER,MF,29,1990,20.2,52,32,24,24,4,25,54,46.3,29,22,2,20,22,74,15,1,2021
ITA-Serie A,2020,Udinese,Walace,BRA,MF,25,1995,22.8,50,23,28,19,3,21,60,35.0,39,36,3,33,34,84,23,0,2021
ITA-Serie A,2021,Atalanta,Alassane Sidibe,CIV,MF,19,2002,0.1,1,1,1,0,0,0,0,,0,0,0,0,0,1,0,0,2022
ITA-Serie A,2021,Atalanta,Aleksei Miranchuk,RUS,"MF,FW",25,1995,8.6,11,7,3,7,1,4,12,33.3,8,3,0,3,1,12,7,0,2022
ITA-Serie A,2021,Atalanta,Berat Djimsiti,ALB,DF,28,1993,25.1,43,24,21,20,2,29,46,63.0,17,21,11,10,31,74,56,0,2022
ITA-Serie A,2021,Atalanta,Davide Zappacosta,ITA,DF,29,1992,26.1,32,22,12,13,7,19,37,51.4,18,32,2,30,12,44,22,0,2022
ITA-Serie A,2021,Atalanta,Duván Zapata,COL,FW,30,1991,19.1,6,2,0,4,2,4,8,50.0,4,8,1,7,3,9,5,0,2022
ITA-Serie A,2021,Atalanta,Francesco Rossi,ITA,GK,30,1991,0.4,0,0,0,0,0,0,0,,0,0,0,0,0,0,0,0,2022
ITA-Serie A,2021,Atalanta,Giorgio Cittadini,ITA,DF,19,2002,0.0,0,0,0,0,0,0,0,,0,0,0,0,1,1,0,0,2022
ITA-Serie A,2021,Atalanta,Giorgio Scalvini,ITA,"DF,MF",17,2003,8.5,22,11,13,8,1,9,19,47.4,10,12,1,11,22,44,16,0,2022
ITA-Serie A,2021,Atalanta,Giuseppe Pezzella,ITA,"DF,MF",23,1997,11.9,28,13,15,7,6,8,18,44.4,10,13,5,8,9,37,16,0,2022
ITA-Serie A,2021,Atalanta,Hans Hateboer,NED,"DF,MF",27,1994,15.4,22,14,10,8,4,11,26,42.3,15,11,1,10,7,29,20,0,2022
ITA-Serie A,2021,Atalanta,Jeremie Boga,CIV,"FW,MF",24,1997,8.5,7,3,0,4,3,4,6,66.7,2,6,0,6,1,8,3,1,2022
ITA-Serie A,2021,Atalanta,Joakim Mæhle,DEN,"DF,MF",24,1997,16.3,21,11,6,9,6,12,27,44.4,15,18,2,16,14,35,13,0,2022
ITA-Serie A,2021,Atalanta,Josip Iličić,SVN,"MF,FW",33,1988,9.3,7,7,3,2,2,4,17,23.5,13,6,1,5,3,10,1,0,2022
ITA-Serie A,2021,Atalanta,José Luis Palomino,ARG,DF,31,1990,29.7,78,40,42,33,3,32,50,64.0,18,43,21,22,100,178,80,2,2022
ITA-Serie A,2021,Atalanta,Juan Musso,ARG,GK,27,1994,32.6,1,1,1,0,0,0,0,,0,0,0,0,0,1,17,1,2022
ITA-Serie A,2021,Atalanta,Luis Muriel,COL,"FW,MF",30,1991,17.1,15,4,2,7,6,3,19,15.8,16,12,0,12,4,19,5,0,2022
ITA-Serie A,2021,Atalanta,Marco Sportiello,ITA,GK,29,1992,5.0,0,0,0,0,0,0,0,,0,0,0,0,0,0,2,0,2022
ITA-Serie A,2021,Atalanta,Mario Pašalić,CRO,"MF,FW",26,1995,22.2,27,12,8,13,6,12,30,40.0,18,27,6,21,20,47,14,0,2022
ITA-Serie A,2021,Atalanta,Marten de Roon,NED,"MF,DF",30,1991,28.3,69,42,33,29,7,34,62,54.8,28,36,2,34,45,114,41,0,2022
ITA-Serie A,2021,Atalanta,Matteo Lovato,ITA,DF,21,2000,3.4,5,4,4,1,0,0,1,0.0,1,4,2,2,7,12,8,0,2022
ITA-Serie A,2021,Atalanta,Matteo Pessina,ITA,"MF,FW",24,1997,16.0,27,14,10,11,6,14,33,42.4,19,22,3,19,13,40,7,0,2022
ITA-Serie A,2021,Atalanta,Merih Demiral,TUR,DF,23,1998,21.3,31,17,18,12,1,15,28,53.6,13,26,14,12,58,89,68,1,2022
ITA-Serie A,2021,Atalanta,Moustapha Cissé,GUI,FW,17,2003,0.4,1,0,0,1,0,0,3,0.0,3,0,0,0,0,1,0,0,2022
ITA-Serie A,2021,Atalanta,Rafael Tolói,ITA,DF,30,1990,16.0,38,15,12,15,11,24,39,61.5,15,23,11,12,26,64,35,0,2022
ITA-Serie A,2021,Atalanta,Remo Freuler,SUI,MF,29,1992,26.3,69,39,22,33,14,30,70,42.9,40,48,8,40,35,104,26,1,2022
ITA-Serie A,2021,Atalanta,Roberto Piccoli,ITA,FW,20,2001,2.2,2,0,0,0,2,0,2,0.0,2,1,0,1,0,2,0,0,2022
ITA-Serie A,2021,Atalanta,Robin Gosens,GER,DF,27,1994,5.1,7,3,3,4,0,4,8,50.0,4,4,0,4,9,16,1,0,2022
ITA-Serie A,2021,Atalanta,Ruslan Malinovskyi,UKR,"MF,FW",28,1993,17.7,18,10,3,10,5,5,19,26.3,14,27,3,24,5,23,1,0,2022
ITA-Serie A,2021,Atalanta,Sam Lammers,NED,"FW,MF",24,1997,0.4,1,0,0,0,1,0,0,,0,0,0,0,0,1,0,0,2022
ITA-Serie A,2021,Atalanta,Teun Koopmeiners,NED,MF,23,1998,23.6,40,24,10,19,11,22,54,40.7,32,31,2,29,15,55,19,0,2022
ITA-Serie A,2021,Atalanta,Tommaso De Nipoti,ITA,FW,18,2003,0.1,0,0,0,0,0,0,0,,0,0,0,0,0,0,0,0,2022
ITA-Serie A,2021,Atalanta,Valentin Mihaila,ROU,"MF,FW",21,2000,0.8,1,1,0,1,0,0,1,0.0,1,2,0,2,0,1,0,0,2022
ITA-Serie A,2021,Bologna,Aaron Hickey,SCO,DF,19,2002,31.3,46,29,24,15,7,20,30,66.7,10,36,13,23,29,75,44,0,2022
ITA-Serie A,2021,Bologna,Adama Soumaoro,FRA,DF,29,1992,25.2,15,5,5,8,2,4,9,44.4,5,22,16,6,34,49,95,0,2022
ITA-Serie A,2021,Bologna,Andreas Skov Olsen,DEN,"FW,DF",21,1999,8.3,12,10,4,4,4,5,11,45.5,6,9,1,8,3,15,11,0,2022
ITA-Serie A,2021,Bologna,Antonio Raimondo,ITA,FW,17,2004,0.8,0,0,0,0,0,0,1,0.0,1,1,0,1,0,0,1,0,2022
ITA-Serie A,2021,Bologna,Arthur Theate,BEL,DF,21,2000,26.9,33,19,26,3,4,14,31,45.2,17,29,16,13,42,75,69,0,2022
ITA-Serie A,2021,Bologna,Denso Kasius,NED,"DF,FW",18,2002,2.0,9,7,5,3,1,2,5,40.0,3,4,0,4,3,12,4,0,2022
ITA-Serie A,2021,Bologna,Diego Falcinelli,ITA,FW,30,1991,0.7,2,2,2,0,0,0,0,,0,0,0,0,1,3,1,0,2022
ITA-Serie A,2021,Bologna,Ebenezer Annan,GHA,DF,18,2002,0.3,1,1,1,0,0,0,0,,0,0,0,0,1,2,1,0,2022
ITA-Serie A,2021,Bologna,Emanuel Vignato,ITA,"MF,DF",20,2000,6.6,12,7,5,7,0,6,13,46.2,7,2,0,2,2,14,5,0,2022
ITA-Serie A,2021,Bologna,Federico Santander,PAR,"FW,DF",30,1991,0.7,2,1,1,1,0,1,1,100.0,0,0,0,0,0,2,0,0,2022
ITA-Serie A,2021,Bologna,Francesco Bardi,ITA,GK,29,1992,2.0,0,0,0,0,0,0,0,,0,0,0,0,0,0,0,0,2022
ITA-Serie A,2021,Bologna,Gary Medel,CHI,DF,33,1987,31.4,39,23,27,11,1,16,36,44.4,20,30,21,9,44,83,112,0,2022
ITA-Serie A,2021,Bologna,Ibrahima Mbaye,SEN,DF,26,1994,1.2,1,1,1,0,0,1,2,50.0,1,1,1,0,1,2,6,0,2022
ITA-Serie A,2021,Bologna,Jerdy Schouten,NED,MF,24,1997,15.5,25,17,10,12,3,9,22,40.9,13,22,5,17,33,58,29,1,2022
ITA-Serie A,2021,Bologna,Kacper Urbanski,POL,MF,16,2004,0.5,3,2,1,2,0,2,2,100.0,0,2,0,2,0,3,0,0,2022
ITA-Serie A,2021,Bologna,Kevin Bonifazi,ITA,DF,25,1996,13.4,25,16,16,7,2,13,14,92.9,1,22,7,15,16,41,35,0,2022
ITA-Serie A,2021,Bologna,Kingsley Michael,NGA,MF,21,1999,0.8,4,1,2,2,0,1,2,50.0,1,2,1,1,1,5,1,1,2022
ITA-Serie A,2021,Bologna,Lorenzo De Silvestri,ITA,DF,33,1988,25.5,23,14,13,8,2,9,31,29.0,22,25,7,18,26,49,52,0,2022
ITA-Serie A,2021,Bologna,Luis Binks,ENG,DF,19,2001,7.2,8,4,7,1,0,4,6,66.7,2,6,5,1,17,25,33,1,2022
ITA-Serie A,2021,Bologna,Marko Arnautović,AUT,FW,32,1989,29.9,17,9,1,11,5,7,30,23.3,23,13,2,11,7,24,17,0,2022
ITA-Serie A,2021,Bologna,Mattias Svanberg,SWE,MF,22,1999,28.5,39,15,15,16,8,16,54,29.6,38,31,9,22,28,67,34,0,2022
ITA-Serie A,2021,Bologna,Michel Aebischer,SUI,MF,24,1997,4.9,14,5,5,8,1,6,11,54.5,5,4,1,3,6,20,3,0,2022
ITA-Serie A,2021,Bologna,Mitchell Dijks,NED,"DF,FW",28,1993,7.7,15,6,6,6,3,5,12,41.7,7,11,2,9,3,18,10,1,2022
ITA-Serie A,2021,Bologna,Musa Barrow,GAM,"FW,MF",22,1998,23.7,12,4,4,4,4,6,20,30.0,14,20,1,19,6,18,8,0,2022
ITA-Serie A,2021,Bologna,Nicola Bagnolini,ITA,GK,17,2004,0.0,0,0,0,0,0,0,0,,0,0,0,0,0,0,0,0,2022
ITA-Serie A,2021,Bologna,Nicola Sansone,ITA,"FW,MF",29,1991,10.0,13,7,5,6,2,3,15,20.0,12,1,0,1,4,17,2,0,2022
ITA-Serie A,2021,Bologna,Nicolas Viola,ITA,MF,31,1989,1.1,2,2,1,1,0,1,2,50.0,1,1,1,0,0,2,1,0,2022
ITA-Serie A,2021,Bologna,Nicolás Domínguez,ARG,MF,23,1998,22.4,76,45,36,32,8,32,76,42.1,44,38,9,29,32,108,34,1,2022
ITA-Serie A,2021,Bologna,Niklas Pyyhtiä,FIN,MF,17,2003,0.2,0,0,0,0,0,0,1,0.0,1,0,0,0,0,0,0,0,2022
ITA-Serie A,2021,Bologna,Riccardo Orsolini,ITA,"FW,MF",24,1997,19.8,21,13,9,11,1,13,29,44.8,16,9,4,5,5,26,14,0,2022
ITA-Serie A,2021,Bologna,Riccardo Stivanello,ITA,DF,17,2004,0.5,1,1,1,0,0,1,1,100.0,0,2,2,0,0,1,6,0,2022
ITA-Serie A,2021,Bologna,Roberto Soriano,ITA,MF,30,1991,29.1,57,30,27,22,8,17,56,30.4,39,37,3,34,22,79,32,0,2022
ITA-Serie A,2021,Bologna,Sydney van Hooijdonk,NED,"FW,MF",21,2000,0.4,0,0,0,0,0,0,1,0.0,1,1,0,1,0,0,0,0,2022
ITA-Serie A,2021,Bologna,Takehiro Tomiyasu,JPN,DF,22,1998,0.1,0,0,0,0,0,0,0,,0,1,0,1,1,1,0,0,2022
ITA-Serie A,2021,Bologna,Wisdom Amey,ITA,DF,15,2005,0.8,3,2,1,1,1,2,3,66.7,1,2,0,2,3,6,1,0,2022
ITA-Serie A,2021,Bologna,Łukasz Skorupski,POL,GK,30,1991,36.0,0,0,0,0,0,0,1,0.0,1,0,0,0,0,0,17,0,2022
ITA-Serie A,2021,Cagliari,Adam Obert,SVK,"DF,MF",18,2002,3.0,8,5,6,2,0,5,6,83.3,1,6,4,2,4,12,11,0,2022
ITA-Serie A,2021,Cagliari,Alberto Grassi,ITA,MF,26,1995,24.2,47,26,13,30,4,16,38,42.1,22,27,9,18,63,110,33,1,2022
ITA-Serie A,2021,Cagliari,Alessandro Deiola,ITA,MF,25,1995,23.7,47,22,15,25,7,23,58,39.7,35,28,10,18,26,73,45,0,2022
ITA-Serie A,2021,Cagliari,Alessio Cragno,ITA,GK,27,1994,35.0,3,3,2,1,0,3,3,100.0,0,0,0,0,1,4,14,1,2022
ITA-Serie A,2021,Cagliari,Andrea Carboni,ITA,DF,20,2001,24.6,53,24,33,16,4,19,42,45.2,23,42,15,27,27,80,87,0,2022
ITA-Serie A,2021,Cagliari,Boris Radunović,SRB,GK,25,1996,3.0,0,0,0,0,0,0,0,,0,0,0,0,0,0,0,0,2022
ITA-Serie A,2021,Cagliari,Charalambos Lykogiannis,GRE,"DF,FW",27,1993,20.2,19,12,16,1,2,11,20,55.0,9,18,8,10,31,50,73,0,2022
ITA-Serie A,2021,Cagliari,Christian Oliva,URU,MF,25,1996,0.5,2,2,2,0,0,1,4,25.0,3,0,0,0,0,2,0,0,2022
ITA-Serie A,2021,Cagliari,Christos Kourfalidis,GRE,"MF,FW",18,2002,0.2,0,0,0,0,0,0,1,0.0,1,1,0,1,0,0,0,0,2022
ITA-Serie A,2021,Cagliari,Dalbert Henrique,BRA,"DF,MF",27,1993,23.1,43,23,23,16,4,11,35,31.4,24,28,5,23,24,67,34,0,2022
ITA-Serie A,2021,Cagliari,Damir Ceter,COL,FW,23,1997,0.1,0,0,0,0,0,0,0,,0,0,0,0,0,0,0,0,2022
ITA-Serie A,2021,Cagliari,Daniele Baselli,ITA,MF,29,1992,3.2,6,5,3,1,2,1,5,20.0,4,2,0,2,2,8,5,0,2022
ITA-Serie A,2021,Cagliari,Diego Farias,BRA,"MF,FW",31,1990,0.7,1,1,0,1,0,1,3,33.3,2,0,0,0,0,1,0,0,2022
ITA-Serie A,2021,Cagliari,Diego Godín,URU,DF,35,1986,9.1,18,7,13,3,2,10,15,66.7,5,7,5,2,13,31,46,0,2022
ITA-Serie A,2021,Cagliari,Edoardo Goldaniga,ITA,DF,27,1993,10.4,12,5,7,5,0,4,11,36.4,7,8,5,3,22,34,23,0,2022
ITA-Serie A,2021,Cagliari,Gabriele Zappa,ITA,DF,21,1999,12.7,21,9,12,6,3,6,24,25.0,18,15,5,10,14,35,28,0,2022
ITA-Serie A,2021,Cagliari,Gastón Pereiro,URU,"FW,MF",26,1995,10.8,13,5,7,4,2,5,18,27.8,13,12,1,11,1,14,8,0,2022
ITA-Serie A,2021,Cagliari,Giorgio Altare,ITA,DF,22,1998,16.3,39,28,18,18,3,21,26,80.8,5,17,5,12,30,69,70,0,2022
ITA-Serie A,2021,Cagliari,Giovanni Simeone,ARG,FW,26,1995,0.1,0,0,0,0,0,0,0,,0,0,0,0,0,0,0,0,2022
ITA-Serie A,2021,Cagliari,João Pedro,ITA,FW,29,1992,36.9,15,12,2,8,5,4,18,22.2,14,23,5,18,8,23,18,1,2022
ITA-Serie A,2021,Cagliari,Keita Baldé,SEN,FW,26,1995,13.7,8,4,1,5,2,1,10,10.0,9,6,0,6,4,12,6,0,2022
ITA-Serie A,2021,Cagliari,Kevin Strootman,NED,MF,31,1990,7.1,8,4,2,4,2,5,12,41.7,7,11,2,9,10,18,15,0,2022
ITA-Serie A,2021,Cagliari,Leonardo Pavoletti,ITA,FW,32,1988,16.9,10,6,2,5,3,3,9,33.3,6,9,5,4,2,12,12,0,2022
ITA-Serie A,2021,Cagliari,Luca Ceppitelli,ITA,DF,31,1989,16.1,23,12,13,10,0,16,27,59.3,11,21,14,7,25,48,54,0,2022
ITA-Serie A,2021,Cagliari,Luca Gagliano,ITA,"FW,DF",21,2000,0.1,0,0,0,0,0,0,0,,0,1,0,1,0,0,1,0,2022
ITA-Serie A,2021,Cagliari,Marko Rog,CRO,MF,26,1995,3.5,5,3,1,2,2,1,8,12.5,7,6,1,5,1,6,3,0,2022
ITA-Serie A,2021,Cagliari,Martín Cáceres,URU,DF,34,1987,9.2,13,7,5,5,3,4,12,33.3,8,12,3,9,14,27,21,0,2022
ITA-Serie A,2021,Cagliari,Matteo Lovato,ITA,DF,21,2000,13.8,23,15,13,10,0,8,20,40.0,12,21,10,11,28,51,43,0,2022
ITA-Serie A,2021,Cagliari,Nahitan Nández,URU,"MF,DF",25,1995,16.9,39,21,16,15,8,18,33,54.5,15,16,1,15,9,48,15,1,2022
ITA-Serie A,2021,Cagliari,Paolo Faragò,ITA,MF,28,1993,0.2,1,1,1,0,0,0,0,,0,2,0,2,0,1,0,0,2022
ITA-Serie A,2021,Cagliari,Raoul Bellanova,ITA,"DF,FW",21,2000,27.7,29,15,14,12,3,6,27,22.2,21,39,8,31,21,50,51,0,2022
ITA-Serie A,2021,Cagliari,Răzvan Marin,ROU,MF,25,1996,31.3,42,21,16,22,4,24,54,44.4,30,23,5,18,10,52,17,1,2022
ITA-Serie A,2021,Cagliari,Sebastian Walukiewicz,POL,DF,21,2000,3.4,9,5,7,2,0,3,5,60.0,2,5,2,3,7,16,14,0,2022
ITA-Serie A,2021,Empoli,Andrea La Mantia,ITA,"FW,MF",30,1991,5.4,2,0,0,0,2,1,2,50.0,1,3,1,2,1,3,6,0,2022
ITA-Serie A,2021,Empoli,Andrea Pinamonti,ITA,FW,22,1999,31.9,11,6,0,7,4,2,18,11.1,16,24,3,21,7,18,23,0,2022
ITA-Serie A,2021,Empoli,Ardian Ismajli,ALB,DF,24,1996,14.1,13,9,8,4,1,5,14,35.7,9,21,11,10,24,37,80,0,2022
ITA-Serie A,2021,Empoli,Fabiano Parisi,ITA,DF,20,2000,16.4,35,19,25,5,5,13,31,41.9,18,30,10,20,22,57,42,0,2022
ITA-Serie A,2021,Empoli,Federico Di Francesco,ITA,"FW,MF",27,1994,15.2,16,5,2,8,6,9,23,39.1,14,17,1,16,9,25,11,0,2022
ITA-Serie A,2021,Empoli,Filippo Bandinelli,ITA,MF,26,1995,21.7,33,20,10,17,6,15,31,48.4,16,22,5,17,10,43,37,2,2022
ITA-Serie A,2021,Empoli,Giovanni Crociata,ITA,FW,23,1997,0.2,0,0,0,0,0,0,1,0.0,1,0,0,0,0,0,0,0,2022
ITA-Serie A,2021,Empoli,Guglielmo Vicario,ITA,GK,24,1996,38.0,1,1,1,0,0,1,1,100.0,0,1,0,1,1,2,21,1,2022
ITA-Serie A,2021,Empoli,Kristjan Asllani,ALB,MF,19,2002,15.0,18,9,9,8,1,11,29,37.9,18,16,7,9,19,37,15,1,2022
ITA-Serie A,2021,Empoli,Leo Štulac,SVN,MF,26,1994,9.3,13,6,5,6,2,7,19,36.8,12,6,2,4,8,21,15,0,2022
ITA-Serie A,2021,Empoli,Leonardo Mancuso,ITA,FW,29,1992,4.7,1,1,0,1,0,0,6,0.0,6,2,0,2,1,2,2,0,2022
ITA-Serie A,2021,Empoli,Liam Henderson,SCO,MF,25,1996,22.4,22,13,7,8,7,9,31,29.0,22,14,4,10,9,31,13,0,2022
ITA-Serie A,2021,Empoli,Liberato Cacace,NZL,DF,20,2000,5.2,15,6,8,4,3,8,8,100.0,0,7,2,5,8,23,9,0,2022
ITA-Serie A,2021,Empoli,Lorenzo Tonelli,ITA,DF,31,1990,9.7,17,9,11,4,2,6,13,46.2,7,14,8,6,19,36,28,2,2022
ITA-Serie A,2021,Empoli,Marco Benassi,ITA,MF,26,1994,4.2,6,3,3,2,1,1,10,10.0,9,4,0,4,3,9,6,0,2022
ITA-Serie A,2021,Empoli,Mattia Viti,ITA,DF,19,2002,16.6,28,16,16,9,3,15,24,62.5,9,28,25,3,29,57,69,1,2022
ITA-Serie A,2021,Empoli,Nedim Bajrami,ALB,"MF,FW",22,1999,22.8,21,14,5,13,3,4,14,28.6,10,11,0,11,3,24,8,0,2022
ITA-Serie A,2021,Empoli,Nicolas Haas,SUI,MF,25,1996,11.1,35,22,15,10,10,17,39,43.6,22,24,4,20,9,44,17,1,2022
ITA-Serie A,2021,Empoli,Patrick Cutrone,ITA,FW,23,1998,15.6,5,2,0,3,2,1,9,11.1,8,11,1,10,5,10,1,0,2022
ITA-Serie A,2021,Empoli,Petar Stojanović,SVN,DF,25,1995,30.4,96,63,55,32,9,59,114,51.8,55,39,13,26,27,123,65,1,2022
ITA-Serie A,2021,Empoli,Riccardo Fiamozzi,ITA,DF,28,1993,6.9,7,5,2,2,3,2,4,50.0,2,6,5,1,7,14,12,0,2022
ITA-Serie A,2021,Empoli,Riccardo Marchizza,ITA,DF,23,1998,15.0,21,15,11,8,2,11,16,68.8,5,15,6,9,10,31,24,0,2022
ITA-Serie A,2021,Empoli,Samuele Ricci,ITA,MF,19,2001,17.0,33,19,17,13,3,20,34,58.8,14,24,5,19,31,64,18,0,2022
ITA-Serie A,2021,Empoli,Sebastiano Luperto,ITA,DF,24,1996,21.8,29,17,17,10,2,10,20,50.0,10,32,26,6,45,74,132,0,2022
ITA-Serie A,2021,Empoli,Simone Romagnoli,ITA,DF,31,1990,16.6,28,12,14,12,2,15,20,75.0,5,34,28,6,9,37,86,0,2022
ITA-Serie A,2021,Empoli,Szymon Żurkowski,POL,MF,23,1997,25.6,58,33,24,21,13,29,68,42.6,39,43,10,33,35,93,32,1,2022
ITA-Serie A,2021,Empoli,Tommaso Baldanzi,ITA,FW,18,2003,0.2,0,0,0,0,0,0,0,,0,1,0,1,0,0,0,0,2022
ITA-Serie A,2021,Empoli,Valerio Verre,ITA,MF,27,1994,3.4,4,2,3,1,0,2,7,28.6,5,2,0,2,1,5,0,0,2022
ITA-Serie A,2021,Fiorentina,Aleksa Terzić,SRB,DF,21,1999,3.0,8,5,3,3,2,4,7,57.1,3,7,0,7,4,12,5,0,2022
ITA-Serie A,2021,Fiorentina,Aleksandr Kokorin,RUS,"FW,MF",30,1991,0.6,1,1,1,0,0,0,0,,0,1,0,1,0,1,0,0,2022
ITA-Serie A,2021,Fiorentina,Alfred Duncan,GHA,MF,28,1993,21.5,34,19,13,16,5,11,32,34.4,21,32,3,29,10,44,7,0,2022
ITA-Serie A,2021,Fiorentina,Arthur,BRA,FW,23,1998,8.3,9,5,2,5,2,4,7,57.1,3,4,1,3,1,10,8,0,2022
ITA-Serie A,2021,Fiorentina,Bartłomiej Drągowski,POL,GK,23,1997,6.2,0,0,0,0,0,0,0,,0,0,0,0,1,1,5,2,2022
ITA-Serie A,2021,Fiorentina,Cristiano Biraghi,ITA,DF,28,1992,35.0,37,24,17,15,5,22,53,41.5,31,28,10,18,19,56,31,1,2022
ITA-Serie A,2021,Fiorentina,Dušan Vlahović,SRB,FW,21,2000,20.6,5,0,0,2,3,2,11,18.2,9,6,2,4,1,6,16,0,2022
ITA-Serie A,2021,Fiorentina,Erick Pulgar,CHI,MF,27,1994,3.8,6,6,4,2,0,4,9,44.4,5,5,1,4,5,11,2,1,2022
ITA-Serie A,2021,Fiorentina,Filippo Distefano,ITA,FW,17,2003,0.0,0,0,0,0,0,0,0,,0,0,0,0,0,0,0,0,2022
ITA-Serie A,2021,Fiorentina,Gaetano Castrovilli,ITA,MF,24,1997,15.5,25,17,15,6,4,12,23,52.2,11,18,4,14,11,36,6,0,2022
ITA-Serie A,2021,Fiorentina,Giacomo Bonaventura,ITA,MF,31,1989,25.2,33,17,12,16,5,21,46,45.7,25,20,2,18,14,47,9,1,2022
ITA-Serie A,2021,Fiorentina,Igor,BRA,DF,23,1998,24.9,53,31,34,16,3,30,40,75.0,10,37,19,18,31,84,46,4,2022
ITA-Serie A,2021,Fiorentina,Jonathan Ikone,FRA,FW,23,1998,7.2,7,3,2,3,2,3,10,30.0,7,10,2,8,1,8,2,0,2022
ITA-Serie A,2021,Fiorentina,José Callejón,ESP,FW,34,1987,14.4,15,6,6,6,3,13,31,41.9,18,6,0,6,3,18,1,1,2022
ITA-Serie A,2021,Fiorentina,Krzysztof Piątek,POL,FW,26,1995,8.1,5,4,1,1,3,2,3,66.7,1,6,0,6,2,7,8,0,2022
ITA-Serie A,2021,Fiorentina,Lorenzo Venuti,ITA,DF,26,1995,17.5,25,10,13,10,2,14,24,58.3,10,13,4,9,5,30,27,0,2022
ITA-Serie A,2021,Fiorentina,Lucas Martínez Quarta,ARG,DF,25,1996,15.9,36,25,23,11,2,21,34,61.8,13,22,9,13,19,55,46,0,2022
ITA-Serie A,2021,Fiorentina,Lucas Torreira,URU,MF,25,1996,24.4,37,29,13,21,3,18,40,45.0,22,18,1,17,26,63,18,0,2022
ITA-Serie A,2021,Fiorentina,Marco Benassi,ITA,"DF,MF",26,1994,1.8,1,0,1,0,0,1,2,50.0,1,3,0,3,3,4,3,0,2022
ITA-Serie A,2021,Fiorentina,Matija Nastasić,SRB,DF,28,1993,2.4,1,1,1,0,0,1,1,100.0,0,1,1,0,5,6,11,0,2022
ITA-Serie A,2021,Fiorentina,Nicolás González,ARG,FW,23,1998,26.2,21,16,6,8,7,9,28,32.1,19,26,2,24,21,42,4,1,2022
ITA-Serie A,2021,Fiorentina,Nikola Milenković,SRB,DF,23,1997,32.5,54,32,31,20,3,29,34,85.3,5,30,15,15,39,93,94,0,2022
ITA-Serie A,2021,Fiorentina,Pietro Terracciano,ITA,GK,31,1990,31.8,0,0,0,0,0,0,4,0.0,4,0,0,0,2,2,20,1,2022
ITA-Serie A,2021,Fiorentina,Riccardo Saponara,ITA,FW,29,1991,14.3,10,2,1,6,3,6,16,37.5,10,5,0,5,1,11,3,0,2022
ITA-Serie A,2021,Fiorentina,Riccardo Sottil,ITA,FW,22,1999,13.8,9,4,4,4,1,3,9,33.3,6,3,0,3,1,10,2,0,2022
ITA-Serie A,2021,Fiorentina,Sofyan Amrabat,MAR,MF,24,1996,10.5,24,13,9,13,2,11,19,57.9,8,25,8,17,5,29,6,1,2022
ITA-Serie A,2021,Fiorentina,Youssef Maleh,MAR,MF,22,1998,11.3,27,16,8,13,6,12,25,48.0,13,14,1,13,6,33,2,0,2022
ITA-Serie A,2021,Fiorentina,Álvaro Odriozola,ESP,DF,25,1995,19.3,25,15,12,6,7,15,32,46.9,17,17,6,11,8,33,25,2,2022
ITA-Serie A,2021,Genoa,Abdoulaye Touré,FRA,MF,27,1994,4.8,12,4,3,8,1,5,11,45.5,6,6,1,5,4,16,6,0,2022
ITA-Serie A,2021,Genoa,Adrian Šemper,CRO,GK,23,1998,1.0,0,0,0,0,0,0,0,,0,0,0,0,0,0,0,0,2022
ITA-Serie A,2021,Genoa,Albert Guðmundsson,ISL,"FW,MF",24,1997,6.7,5,3,2,1,2,3,8,37.5,5,2,0,2,5,10,4,0,2022
ITA-Serie A,2021,Genoa,Aleksander Buksa,POL,FW,18,2003,0.7,0,0,0,0,0,0,1,0.0,1,0,0,0,0,0,1,0,2022
ITA-Serie A,2021,Genoa,Andrea Cambiaso,ITA,DF,21,2000,19.9,46,20,28,14,4,18,32,56.3,14,33,8,25,23,69,37,1,2022
ITA-Serie A,2021,Genoa,Andrea Favilli,ITA,FW,24,1997,0.4,1,1,0,0,1,0,0,,0,0,0,0,0,1,2,0,2022
ITA-Serie A,2021,Genoa,Andrea Masiello,ITA,DF,35,1986,5.7,5,3,4,1,0,4,7,57.1,3,8,4,4,11,16,20,1,2022
ITA-Serie A,2021,Genoa,Caleb Ekuban,GHA,"FW,MF",27,1994,19.1,19,12,2,12,5,7,23,30.4,16,19,5,14,9,28,6,0,2022
ITA-Serie A,2021,Genoa,Davide Biraschi,ITA,DF,27,1994,10.3,31,16,19,9,3,17,24,70.8,7,16,9,7,16,47,26,0,2022
ITA-Serie A,2021,Genoa,Domenico Criscito,ITA,DF,34,1986,18.0,37,21,19,14,4,16,25,64.0,9,22,12,10,39,76,57,0,2022
ITA-Serie A,2021,Genoa,Felipe Caicedo,ECU,FW,32,1988,3.2,3,3,0,2,1,0,1,0.0,1,1,0,1,0,3,4,0,2022
ITA-Serie A,2021,Genoa,Filippo Melegoni,ITA,"MF,FW",22,1999,10.9,20,12,5,8,7,8,16,50.0,8,10,1,9,11,31,8,1,2022
ITA-Serie A,2021,Genoa,Flavio Junior Bianchi,ITA,"FW,MF",21,2000,3.5,2,2,1,0,1,0,2,0.0,2,0,0,0,0,2,0,0,2022
ITA-Serie A,2021,Genoa,Francesco Cassata,ITA,MF,24,1997,0.1,0,0,0,0,0,0,0,,0,0,0,0,0,0,0,0,2022
ITA-Serie A,2021,Genoa,Goran Pandev,MKD,"FW,MF",38,1983,9.4,2,0,1,0,1,0,9,0.0,9,3,1,2,2,4,0,0,2022
ITA-Serie A,2021,Genoa,Hernani,BRA,"MF,FW",27,1994,7.6,20,10,8,9,3,13,32,40.6,19,17,4,13,13,33,5,1,2022
ITA-Serie A,2021,Genoa,Johan Vásquez,MEX,DF,22,1998,25.3,79,46,44,32,3,48,75,64.0,27,32,10,22,42,121,85,0,2022
ITA-Serie A,2021,Genoa,Kelvin Yeboah,ITA,"FW,MF",21,2000,9.4,14,7,5,7,2,9,19,47.4,10,22,1,21,1,15,7,0,2022
ITA-Serie A,2021,Genoa,Laurens Serpe,ITA,DF,20,2001,0.5,1,0,1,0,0,1,2,50.0,1,0,0,0,0,1,1,0,2022
ITA-Serie A,2021,Genoa,Leo Skiri Østigård,NOR,DF,21,1999,13.0,16,9,8,7,1,9,11,81.8,2,17,10,7,8,24,55,1,2022
ITA-Serie A,2021,Genoa,Manolo Portanova,ITA,"FW,MF",21,2000,14.7,46,28,9,26,11,14,34,41.2,20,26,2,24,17,63,22,0,2022
ITA-Serie A,2021,Genoa,Mattia Bani,ITA,DF,27,1993,13.5,23,13,17,6,0,14,18,77.8,4,19,11,8,20,43,76,0,2022
ITA-Serie A,2021,Genoa,Mattia Destro,ITA,FW,30,1991,19.4,9,4,1,4,4,1,6,16.7,5,14,1,13,2,11,16,0,2022
ITA-Serie A,2021,Genoa,Milan Badelj,CRO,MF,32,1989,31.6,64,37,25,30,9,34,80,42.5,46,39,7,32,85,149,43,0,2022
ITA-Serie A,2021,Genoa,Mohamed Fares,ALG,"DF,FW",25,1996,6.5,4,2,1,3,0,0,4,0.0,4,8,3,5,8,12,11,0,2022
ITA-Serie A,2021,Genoa,Morten Frendrup,DEN,"DF,MF",20,2001,7.7,40,24,19,13,8,13,29,44.8,16,19,2,17,17,57,7,1,2022
ITA-Serie A,2021,Genoa,Nadiem Amiri,GER,"MF,FW",24,1996,7.6,6,4,2,2,2,2,9,22.2,7,7,0,7,0,6,0,0,2022
ITA-Serie A,2021,Genoa,Nicolò Rovella,ITA,MF,19,2001,16.3,37,26,16,14,7,15,40,37.5,25,21,1,20,20,57,20,0,2022
ITA-Serie A,2021,Genoa,Nikola Maksimović,SRB,DF,29,1991,12.4,14,6,10,4,0,7,9,77.8,2,17,11,6,12,26,61,1,2022
ITA-Serie A,2021,Genoa,Pablo Galdames Millán,CHI,MF,24,1996,11.4,28,12,6,16,6,12,35,34.3,23,16,2,14,8,36,9,1,2022
ITA-Serie A,2021,Genoa,Paolo Ghiglione,ITA,DF,24,1997,6.7,17,12,8,6,3,9,14,64.3,5,11,5,6,10,27,12,1,2022
ITA-Serie A,2021,Genoa,Riccardo Calafiori,ITA,DF,19,2002,0.9,1,0,0,0,1,1,2,50.0,1,2,1,1,2,3,4,0,2022
ITA-Serie A,2021,Genoa,Roberto Piccoli,ITA,FW,20,2001,2.4,1,1,0,1,0,0,0,,0,0,0,0,1,2,1,1,2022
ITA-Serie A,2021,Genoa,Salvatore Sirigu,ITA,GK,34,1987,37.0,1,1,1,0,0,1,2,50.0,1,0,0,0,0,1,19,2,2022
ITA-Serie A,2021,Genoa,Silvan Hefti,SUI,DF,23,1997,14.3,50,30,23,22,5,32,58,55.2,26,20,4,16,20,70,34,1,2022
ITA-Serie A,2021,Genoa,Stefano Sabelli,ITA,DF,28,1993,3.9,6,3,3,2,1,3,9,33.3,6,5,1,4,3,9,12,0,2022
ITA-Serie A,2021,Genoa,Stefano Sturaro,ITA,MF,28,1993,19.6,43,26,16,16,11,22,48,45.8,26,25,1,24,15,58,29,2,2022
ITA-Serie A,2021,Genoa,Valon Behrami,SUI,"MF,FW",36,1985,3.5,3,1,0,2,1,0,7,0.0,7,4,1,3,1,4,4,0,2022
ITA-Serie A,2021,Genoa,Yayah Kallon,SLE,"FW,MF",20,2001,7.1,15,11,5,6,4,3,11,27.3,8,7,1,6,1,16,5,0,2022
ITA-Serie A,2021,Genoa,Zinho Vanheusden,BEL,DF,22,1999,11.0,18,6,12,5,1,8,14,57.1,6,19,14,5,23,41,42,0,2022
ITA-Serie A,2021,Hellas Verona,Adrien Tameze,CMR,"MF,DF",27,1994,28.6,52,29,24,21,7,20,59,33.9,39,40,5,35,52,104,41,0,2022
ITA-Serie A,2021,Hellas Verona,Alessandro Berardi,ITA,GK,30,1991,1.0,0,0,0,0,0,0,0,,0,0,0,0,0,0,0,0,2022
ITA-Serie A,2021,Hellas Verona,Antonín Barák,CZE,"MF,FW",26,1994,26.0,18,8,9,8,1,5,17,29.4,12,32,5,27,6,24,26,0,2022
ITA-Serie A,2021,Hellas Verona,Bosko Sutalo,CRO,DF,21,2000,10.2,20,13,11,6,3,8,16,50.0,8,10,5,5,17,37,39,0,2022
ITA-Serie A,2021,Hellas Verona,Daniel Bessa,ITA,MF,28,1993,8.5,7,2,3,3,1,4,15,26.7,11,13,3,10,5,12,11,0,2022
ITA-Serie A,2021,Hellas Verona,Darko Lazović,SRB,DF,30,1990,30.7,36,23,20,8,8,21,39,53.8,18,28,4,24,19,55,49,1,2022
ITA-Serie A,2021,Hellas Verona,Davide Faraoni,ITA,DF,29,1991,28.6,62,40,38,21,3,29,62,46.8,33,38,5,33,23,85,62,1,2022
ITA-Serie A,2021,Hellas Verona,Diego Coppola,ITA,DF,17,2003,2.8,8,4,4,4,0,3,3,100.0,0,5,1,4,4,12,5,0,2022
ITA-Serie A,2021,Hellas Verona,Fabio Depaoli,ITA,DF,24,1997,7.8,12,7,6,4,2,1,7,14.3,6,9,2,7,8,20,14,0,2022
ITA-Serie A,2021,Hellas Verona,Federico Ceccherini,ITA,DF,29,1992,26.2,32,16,19,10,3,19,33,57.6,14,13,8,5,50,82,76,1,2022
ITA-Serie A,2021,Hellas Verona,Filippo Terracciano,ITA,DF,18,2003,0.1,0,0,0,0,0,0,0,,0,0,0,0,0,0,1,0,2022
ITA-Serie A,2021,Hellas Verona,Giangiacomo Magnani,ITA,DF,25,1995,5.9,10,7,5,5,0,8,16,50.0,8,5,3,2,10,20,46,0,2022
ITA-Serie A,2021,Hellas Verona,Gianluca Caprari,ITA,"MF,FW",28,1993,30.4,43,25,10,22,11,17,51,33.3,34,32,0,32,4,47,7,0,2022
ITA-Serie A,2021,Hellas Verona,Gianluca Frabotta,ITA,"DF,MF",22,1999,0.2,0,0,0,0,0,0,1,0.0,1,1,0,1,1,1,0,0,2022
ITA-Serie A,2021,Hellas Verona,Giovanni Simeone,ARG,FW,26,1995,29.5,27,15,6,12,9,9,39,23.1,30,37,3,34,6,33,23,0,2022
ITA-Serie A,2021,Hellas Verona,Ivan Ilić,SRB,MF,20,2001,28.1,39,18,16,19,4,20,54,37.0,34,34,12,22,22,61,55,0,2022
ITA-Serie A,2021,Hellas Verona,Ivor Pandur,CRO,GK,21,2000,3.0,0,0,0,0,0,0,0,,0,0,0,0,0,0,2,0,2022
ITA-Serie A,2021,Hellas Verona,Kevin Lasagna,ITA,"MF,FW",28,1992,13.2,13,7,4,5,4,4,15,26.7,11,16,0,16,3,16,7,0,2022
ITA-Serie A,2021,Hellas Verona,Koray Günter,GER,DF,26,1994,26.8,32,18,19,11,2,16,32,50.0,16,27,21,6,69,101,110,1,2022
ITA-Serie A,2021,Hellas Verona,Lorenzo Montipò,ITA,GK,25,1996,34.0,0,0,0,0,0,0,0,,0,0,0,0,1,1,16,3,2022
ITA-Serie A,2021,Hellas Verona,Martin Hongla,CMR,MF,23,1998,7.2,14,8,5,6,3,4,8,50.0,4,6,2,4,4,18,16,1,2022
ITA-Serie A,2021,Hellas Verona,Mateusz Praszelik,POL,MF,20,2000,0.3,0,0,0,0,0,0,0,,0,0,0,0,0,0,0,0,2022
ITA-Serie A,2021,Hellas Verona,Matteo Cancellieri,ITA,"MF,DF",19,2002,2.5,4,4,2,2,0,0,5,0.0,5,2,0,2,1,5,0,0,2022
ITA-Serie A,2021,Hellas Verona,Mattia Zaccagni,ITA,MF,26,1995,2.0,3,1,1,0,2,1,2,50.0,1,1,0,1,4,7,0,0,2022
ITA-Serie A,2021,Hellas Verona,Miguel Veloso,POR,MF,35,1986,14.9,23,15,4,17,2,10,16,62.5,6,18,5,13,11,34,18,1,2022
ITA-Serie A,2021,Hellas Verona,Nicolò Casale,ITA,DF,23,1998,28.7,46,30,25,19,2,21,37,56.8,16,31,12,19,49,95,95,0,2022
ITA-Serie A,2021,Hellas Verona,Nikola Kalinić,CRO,FW,33,1988,4.5,2,0,0,1,1,1,2,50.0,1,2,0,2,0,2,2,0,2022
ITA-Serie A,2021,Hellas Verona,Panagiotis Retsos,GRE,DF,22,1998,0.6,0,0,0,0,0,0,2,0.0,2,0,0,0,2,2,3,0,2022
ITA-Serie A,2021,Hellas Verona,Paweł Dawidowicz,POL,DF,26,1995,13.3,30,18,16,10,4,16,25,64.0,9,14,11,3,21,51,53,0,2022
ITA-Serie A,2021,Hellas Verona,Samuel Di Carmine,ITA,FW,32,1988,0.4,0,0,0,0,0,0,0,,0,0,0,0,0,0,0,0,2022
ITA-Serie A,2021,Hellas Verona,Yıldırım Mert Çetin,TUR,MF,24,1997,0.5,1,0,1,0,0,1,1,100.0,0,0,0,0,0,1,2,0,2022
ITA-Serie A,2021,Inter,Aleksandar Kolarov,SRB,DF,35,1985,0.5,1,1,1,0,0,1,1,100.0,0,0,0,0,1,2,2,0,2022
ITA-Serie A,2021,Inter,Alessandro Bastoni,ITA,DF,22,1999,25.7,44,25,28,13,3,17,34,50.0,17,22,12,10,35,79,59,1,2022
ITA-Serie A,2021,Inter,Alexis Sánchez,CHI,FW,32,1988,9.8,9,8,0,6,3,2,11,18.2,9,4,0,4,2,11,3,0,2022
ITA-Serie A,2021,Inter,Andrea Ranocchia,ITA,DF,33,1988,3.8,8,4,5,1,2,1,3,33.3,2,4,3,1,4,12,16,0,2022
ITA-Serie A,2021,Inter,Arturo Vidal,CHI,MF,34,1987,8.2,26,10,16,9,1,9,26,34.6,17,13,5,8,7,33,7,1,2022
ITA-Serie A,2021,Inter,Danilo D'Ambrosio,ITA,DF,32,1988,11.1,30,15,21,8,1,11,22,50.0,11,21,10,11,8,38,20,0,2022
ITA-Serie A,2021,Inter,Denzel Dumfries,NED,DF,25,1996,22.5,32,12,9,14,9,16,32,50.0,16,15,6,9,9,41,26,0,2022
ITA-Serie A,2021,Inter,Edin Džeko,BIH,FW,35,1986,27.4,14,8,7,4,3,8,25,32.0,17,22,5,17,4,18,35,0,2022
ITA-Serie A,2021,Inter,Federico Dimarco,ITA,DF,23,1997,15.9,28,15,10,15,3,13,24,54.2,11,6,1,5,19,47,19,0,2022
ITA-Serie A,2021,Inter,Felipe Caicedo,ECU,"FW,DF",32,1988,0.3,0,0,0,0,0,0,0,,0,1,0,1,0,0,0,0,2022
ITA-Serie A,2021,Inter,Hakan Çalhanoğlu,TUR,MF,27,1994,27.6,41,23,16,19,6,11,40,27.5,29,29,5,24,25,66,12,0,2022
ITA-Serie A,2021,Inter,Ionuț Radu,ROU,GK,24,1997,1.0,0,0,0,0,0,0,0,,0,0,0,0,0,0,0,1,2022
ITA-Serie A,2021,Inter,Ivan Perišić,CRO,DF,32,1989,31.3,38,22,18,11,9,28,50,56.0,22,39,7,32,47,85,42,0,2022
ITA-Serie A,2021,Inter,Joaquín Correa,ARG,FW,26,1994,11.4,11,5,2,6,3,1,13,7.7,12,8,1,7,3,14,2,0,2022
ITA-Serie A,2021,Inter,Lautaro Martínez,ARG,FW,23,1997,25.4,20,10,3,10,7,6,11,54.5,5,21,1,20,18,38,6,0,2022
ITA-Serie A,2021,Inter,Marcelo Brozović,CRO,MF,28,1992,32.6,77,45,34,35,8,34,68,50.0,34,28,10,18,37,114,36,2,2022
ITA-Serie A,2021,Inter,Martin Satriano,URU,"FW,MF",20,2001,0.4,1,0,0,0,1,1,1,100.0,0,0,0,0,0,1,0,0,2022
ITA-Serie A,2021,Inter,Matteo Darmian,ITA,DF,31,1989,16.7,32,16,17,9,6,16,41,39.0,25,16,1,15,19,51,25,0,2022
ITA-Serie A,2021,Inter,Mattia Zanotti,ITA,DF,18,2003,0.1,1,0,1,0,0,0,1,0.0,1,0,0,0,0,1,0,0,2022
ITA-Serie A,2021,Inter,Matías Vecino,URU,MF,29,1991,4.2,7,5,2,3,2,3,9,33.3,6,10,1,9,4,11,7,0,2022
ITA-Serie A,2021,Inter,Milan Škriniar,SVK,DF,26,1995,35.0,47,27,26,17,4,24,42,57.1,18,36,25,11,25,72,90,1,2022
ITA-Serie A,2021,Inter,Nicolò Barella,ITA,MF,24,1997,32.4,63,42,17,35,11,29,55,52.7,26,26,2,24,21,84,8,2,2022
ITA-Serie A,2021,Inter,Roberto Gagliardini,ITA,MF,27,1994,7.2,12,6,7,4,1,1,13,7.7,12,14,5,9,9,21,7,0,2022
ITA-Serie A,2021,Inter,Robin Gosens,GER,DF,27,1994,1.9,3,1,1,2,0,0,0,,0,5,2,3,3,6,3,0,2022
ITA-Serie A,2021,Inter,Samir Handanović,SVN,GK,37,1984,37.0,1,0,1,0,0,1,2,50.0,1,1,0,1,0,1,6,3,2022
ITA-Serie A,2021,Inter,Stefan de Vrij,NED,DF,29,1992,26.8,38,29,22,16,0,12,17,70.6,5,17,8,9,32,70,52,0,2022
ITA-Serie A,2021,Inter,Stefano Sensi,ITA,"MF,FW",25,1995,1.9,4,3,1,3,0,2,4,50.0,2,2,0,2,0,4,2,0,2022
ITA-Serie A,2021,Juventus,Aaron Ramsey,WAL,MF,30,1990,1.1,0,0,0,0,0,0,0,,0,0,0,0,1,1,0,0,2022
ITA-Serie A,2021,Juventus,Adrien Rabiot,FRA,MF,26,1995,25.4,64,43,32,24,8,15,34,44.1,19,34,8,26,20,84,41,1,2022
ITA-Serie A,2021,Juventus,Alex Sandro,BRA,DF,30,1991,19.8,27,16,15,9,3,11,25,44.0,14,17,6,11,27,54,40,0,2022
ITA-Serie A,2021,Juventus,Arthur Melo,BRA,MF,24,1996,10.7,25,12,10,14,1,13,24,54.2,11,11,2,9,7,32,8,1,2022
ITA-Serie A,2021,Juventus,Carlo Pinsoglio,ITA,GK,31,1990,0.5,0,0,0,0,0,0,0,,0,0,0,0,0,0,0,0,2022
ITA-Serie A,2021,Juventus,Cristiano Ronaldo,POR,FW,36,1985,0.3,1,0,0,1,0,1,1,100.0,0,0,0,0,0,1,0,0,2022
ITA-Serie A,2021,Juventus,Daniele Rugani,ITA,DF,27,1994,9.8,8,5,4,4,0,4,7,57.1,3,9,4,5,11,19,47,0,2022
ITA-Serie A,2021,Juventus,Danilo,BRA,"DF,MF",30,1991,21.0,37,26,20,13,4,18,28,64.3,10,21,12,9,32,69,53,1,2022
ITA-Serie A,2021,Juventus,Dejan Kulusevski,SWE,"FW,MF",21,2000,8.6,15,12,9,6,0,8,21,38.1,13,14,0,14,5,20,5,0,2022
ITA-Serie A,2021,Juventus,Denis Zakaria,SUI,MF,24,1996,6.6,11,7,3,6,2,3,11,27.3,8,16,3,13,11,22,7,0,2022
ITA-Serie A,2021,Juventus,Dušan Vlahović,SRB,FW,21,2000,12.0,0,0,0,0,0,0,4,0.0,4,3,0,3,0,0,7,0,2022
ITA-Serie A,2021,Juventus,Fabio Miretti,ITA,MF,17,2003,3.6,4,2,2,2,0,2,9,22.2,7,3,1,2,2,6,3,0,2022
ITA-Serie A,2021,Juventus,Federico Bernardeschi,ITA,"MF,FW",27,1994,16.4,16,10,7,4,5,6,13,46.2,7,12,4,8,5,21,15,0,2022
ITA-Serie A,2021,Juventus,Federico Chiesa,ITA,"MF,FW",23,1997,9.6,26,19,9,9,8,12,26,46.2,14,7,0,7,4,30,3,0,2022
ITA-Serie A,2021,Juventus,Giorgio Chiellini,ITA,DF,36,1984,15.0,22,13,17,4,1,7,13,53.8,6,24,18,6,22,44,59,0,2022
ITA-Serie A,2021,Juventus,Juan Cuadrado,COL,"DF,MF",33,1988,27.6,48,23,30,13,5,30,55,54.5,25,23,5,18,29,77,34,0,2022
ITA-Serie A,2021,Juventus,Kaio Jorge,BRA,"MF,FW",19,2002,1.3,2,1,0,2,0,1,3,33.3,2,1,0,1,0,2,2,0,2022
ITA-Serie A,2021,Juventus,Leonardo Bonucci,ITA,DF,34,1987,22.3,14,5,4,10,0,8,13,61.5,5,22,17,5,26,40,82,0,2022
ITA-Serie A,2021,Juventus,Luca Pellegrini,ITA,DF,22,1999,12.3,23,10,13,5,5,12,19,63.2,7,9,1,8,5,28,23,0,2022
ITA-Serie A,2021,Juventus,Manuel Locatelli,ITA,MF,23,1998,24.0,44,25,21,16,7,21,47,44.7,26,43,21,22,22,66,33,0,2022
ITA-Serie A,2021,Juventus,Marley Aké,FRA,"FW,MF",20,2001,0.9,0,0,0,0,0,0,2,0.0,2,0,0,0,1,1,0,0,2022
ITA-Serie A,2021,Juventus,Martin Palumbo,NOR,FW,19,2002,0.1,0,0,0,0,0,0,1,0.0,1,0,0,0,0,0,0,0,2022
ITA-Serie A,2021,Juventus,Matthijs de Ligt,NED,DF,21,1999,29.7,34,19,21,13,0,15,18,83.3,3,31,21,10,26,60,103,0,2022
ITA-Serie A,2021,Juventus,Mattia De Sciglio,ITA,DF,28,1992,13.0,24,12,7,9,8,11,24,45.8,13,10,0,10,10,34,30,0,2022
ITA-Serie A,2021,Juventus,Mattia Perin,ITA,GK,28,1992,4.5,0,0,0,0,0,0,0,,0,0,0,0,0,0,3,0,2022
ITA-Serie A,2021,Juventus,Matìas Soulé,ARG,FW,18,2003,0.1,0,0,0,0,0,0,1,0.0,1,0,0,0,0,0,0,0,2022
ITA-Serie A,2021,Juventus,Moise Kean,ITA,FW,21,2000,12.2,9,4,2,5,2,6,16,37.5,10,5,0,5,3,12,8,1,2022
ITA-Serie A,2021,Juventus,Paulo Dybala,ARG,"FW,MF",27,1993,22.9,30,13,7,14,9,8,35,22.9,27,19,0,19,9,39,4,3,2022
ITA-Serie A,2021,Juventus,Rodrigo Bentancur,URU,MF,24,1997,12.8,32,18,11,18,3,7,20,35.0,13,15,2,13,26,58,15,1,2022
ITA-Serie A,2021,Juventus,Weston McKennie,USA,MF,22,1998,15.2,20,11,11,7,2,8,26,30.8,18,17,8,9,23,43,20,0,2022
ITA-Serie A,2021,Juventus,Wojciech Szczęsny,POL,GK,31,1990,33.0,1,1,1,0,0,1,2,50.0,1,0,0,0,0,1,8,1,2022
ITA-Serie A,2021,Juventus,Álvaro Morata,ESP,FW,28,1992,25.6,18,9,4,9,5,8,31,25.8,23,26,1,25,5,23,24,0,2022
ITA-Serie A,2021,Lazio,Adam Marušić,MNE,DF,28,1992,30.2,30,18,16,12,2,13,32,40.6,19,19,8,11,41,71,71,0,2022
ITA-Serie A,2021,Lazio,Anderson Lima,BRA,MF,21,1999,0.7,2,0,1,1,0,0,2,0.0,2,1,0,1,2,4,1,0,2022
ITA-Serie A,2021,Lazio,Ciro Immobile,ITA,FW,31,1990,30.1,10,5,4,4,2,1,15,6.7,14,7,1,6,3,13,16,0,2022
ITA-Serie A,2021,Lazio,Danilo Cataldi,ITA,MF,26,1994,19.0,36,17,15,17,4,12,38,31.6,26,24,12,12,17,53,19,1,2022
ITA-Serie A,2021,Lazio,Denis Vavro,SVK,DF,25,1996,0.1,0,0,0,0,0,0,0,,0,0,0,0,0,0,0,0,2022
ITA-Serie A,2021,Lazio,Dimitrije Kamenović,SRB,DF,21,2000,0.5,1,1,1,0,0,1,1,100.0,0,0,0,0,2,3,1,0,2022
ITA-Serie A,2021,Lazio,Elseid Hysaj,ALB,DF,27,1994,22.5,46,30,25,17,4,29,45,64.4,16,18,6,12,24,70,34,1,2022
ITA-Serie A,2021,Lazio,Felipe Anderson,BRA,FW,28,1993,32.1,71,45,30,33,8,27,99,27.3,72,65,6,59,20,91,16,0,2022
ITA-Serie A,2021,Lazio,Francesco Acerbi,ITA,DF,33,1988,28.2,25,12,15,9,1,12,19,63.2,7,37,28,9,34,59,92,0,2022
ITA-Serie A,2021,Lazio,Gonzalo Escalante,ARG,MF,28,1993,0.1,1,0,1,0,0,1,1,100.0,0,2,1,1,1,2,0,0,2022
ITA-Serie A,2021,Lazio,Jean-Daniel Akpa-Akpro,CIV,MF,28,1992,3.5,17,10,7,9,1,7,12,58.3,5,4,2,2,2,19,6,0,2022
ITA-Serie A,2021,Lazio,Jovane Cabral,CPV,FW,23,1998,2.1,2,1,1,0,1,0,0,,0,1,1,0,1,3,1,0,2022
ITA-Serie A,2021,Lazio,Lucas Leiva,BRA,MF,34,1987,18.9,55,30,26,25,4,15,53,28.3,38,27,10,17,28,83,37,0,2022
ITA-Serie A,2021,Lazio,Luis Alberto,ESP,MF,28,1992,26.1,29,17,8,11,10,8,52,15.4,44,32,4,28,13,42,7,0,2022
ITA-Serie A,2021,Lazio,Luiz Felipe,ITA,DF,24,1997,27.7,41,23,21,16,4,20,34,58.8,14,40,33,7,33,74,102,1,2022
ITA-Serie A,2021,Lazio,Luka Romero,ARG,FW,16,2004,0.9,2,1,0,1,1,0,2,0.0,2,0,0,0,1,3,0,0,2022
ITA-Serie A,2021,Lazio,Manuel Lazzari,ITA,DF,27,1993,18.5,28,14,13,15,0,16,26,61.5,10,10,2,8,12,40,16,1,2022
ITA-Serie A,2021,Lazio,Mattia Zaccagni,ITA,FW,26,1995,20.8,33,16,10,13,10,11,19,57.9,8,17,2,15,20,53,5,0,2022
ITA-Serie A,2021,Lazio,Patric,ESP,DF,28,1993,18.3,21,15,17,4,0,9,20,45.0,11,22,11,11,12,33,44,2,2022
ITA-Serie A,2021,Lazio,Pedro,ESP,FW,34,1987,22.6,36,23,8,19,9,16,47,34.0,31,18,2,16,6,42,8,0,2022
ITA-Serie A,2021,Lazio,Pepe Reina,ESP,GK,38,1982,15.0,0,0,0,0,0,0,1,0.0,1,0,0,0,0,0,1,1,2022
ITA-Serie A,2021,Lazio,Raúl Moro,ESP,FW,18,2002,2.2,3,3,0,2,1,1,5,20.0,4,2,0,2,0,3,0,0,2022
ITA-Serie A,2021,Lazio,Sergej Milinković-Savić,SRB,MF,26,1995,34.4,67,44,20,32,15,29,67,43.3,38,50,9,41,34,101,43,1,2022
ITA-Serie A,2021,Lazio,Thomas Strakosha,ALB,GK,26,1995,23.0,0,0,0,0,0,0,0,,0,0,0,0,0,0,7,2,2022
ITA-Serie A,2021,Lazio,Toma Bašić,CRO,MF,24,1996,10.9,12,8,3,9,0,5,17,29.4,12,13,4,9,4,16,21,0,2022
ITA-Serie A,2021,Lazio,Vedat Muriqi,KVX,FW,27,1994,2.4,1,0,1,0,0,0,5,0.0,5,0,0,0,0,1,2,0,2022
ITA-Serie A,2021,Lazio,Ștefan Radu,ROU,DF,34,1986,6.2,9,6,3,6,0,5,9,55.6,4,7,2,5,5,14,15,0,2022
ITA-Serie A,2021,Milan,Alessandro Florenzi,ITA,"DF,FW",30,1991,12.8,28,14,14,7,7,14,32,43.8,18,9,2,7,27,55,10,1,2022
ITA-Serie A,2021,Milan,Alessio Romagnoli,ITA,DF,26,1995,15.7,24,14,14,10,0,14,18,77.8,4,21,12,9,19,43,45,0,2022
ITA-Serie A,2021,Milan,Alexis Saelemaekers,BEL,FW,22,1999,20.7,43,22,12,17,14,15,51,29.4,36,19,0,19,15,58,8,0,2022
ITA-Serie A,2021,Milan,Andrea Conti,ITA,DF,27,1994,0.1,0,0,0,0,0,0,0,,0,0,0,0,0,0,0,0,2022
ITA-Serie A,2021,Milan,Ante Rebić,CRO,FW,27,1993,9.9,14,8,3,6,5,7,20,35.0,13,14,0,14,3,17,3,1,2022
ITA-Serie A,2021,Milan,Brahim Díaz,ESP,MF,21,1999,20.6,23,17,3,11,9,8,22,36.4,14,11,0,11,8,31,4,0,2022
ITA-Serie A,2021,Milan,Ciprian Tătărușanu,ROU,GK,35,1986,6.0,0,0,0,0,0,0,1,0.0,1,0,0,0,0,0,2,1,2022
ITA-Serie A,2021,Milan,Daniel Maldini,ITA,MF,19,2001,1.6,8,3,4,3,1,2,6,33.3,4,4,0,4,1,9,0,0,2022
ITA-Serie A,2021,Milan,Davide Calabria,ITA,DF,24,1996,23.5,62,37,31,23,8,37,72,51.4,35,25,5,20,23,85,40,1,2022
ITA-Serie A,2021,Milan,Fikayo Tomori,ENG,DF,23,1997,30.2,73,44,36,34,3,18,26,69.2,8,37,23,14,45,118,84,1,2022
ITA-Serie A,2021,Milan,Fodé Ballo-Touré,SEN,DF,24,1997,5.0,18,14,5,13,0,4,9,44.4,5,6,2,4,3,21,5,0,2022
ITA-Serie A,2021,Milan,Franck Kessié,CIV,MF,24,1996,25.6,41,23,12,24,5,17,26,65.4,9,39,10,29,23,64,22,0,2022
ITA-Serie A,2021,Milan,Ismaël Bennacer,ALG,MF,23,1997,16.9,44,30,22,15,7,21,50,42.0,29,20,4,16,25,69,15,0,2022
ITA-Serie A,2021,Milan,Junior Messias,BRA,"FW,MF",30,1991,15.9,34,18,11,14,9,15,34,44.1,19,11,1,10,17,51,17,0,2022
ITA-Serie A,2021,Milan,Luca Stanga,ITA,DF,19,2002,0.0,1,0,0,1,0,0,0,,0,0,0,0,0,1,0,0,2022
ITA-Serie A,2021,Milan,Matteo Gabbia,ITA,DF,21,1999,6.0,4,3,1,3,0,0,4,0.0,4,2,2,0,8,12,12,0,2022
ITA-Serie A,2021,Milan,Mike Maignan,FRA,GK,26,1995,32.0,2,1,2,0,0,2,2,100.0,0,0,0,0,1,3,4,2,2022
ITA-Serie A,2021,Milan,Olivier Giroud,FRA,FW,34,1986,21.0,15,11,4,6,5,3,17,17.6,14,13,4,9,3,18,19,0,2022
ITA-Serie A,2021,Milan,Pierre Kalulu,FRA,DF,21,2000,21.6,61,36,36,21,4,17,22,77.3,5,36,15,21,26,87,54,0,2022
ITA-Serie A,2021,Milan,Pietro Pellegri,ITA,FW,20,2001,1.5,2,2,0,1,1,0,1,0.0,1,0,0,0,0,2,1,0,2022
ITA-Serie A,2021,Milan,Rade Krunić,BIH,"MF,FW",27,1993,15.7,33,18,16,14,3,15,31,48.4,16,19,2,17,16,49,17,0,2022
ITA-Serie A,2021,Milan,Rafael Leão,POR,FW,22,1999,28.9,17,7,3,9,5,10,20,50.0,10,12,1,11,12,29,8,0,2022
ITA-Serie A,2021,Milan,Samu Castillejo,ESP,"FW,MF",26,1995,1.4,4,2,0,2,2,1,8,12.5,7,4,1,3,2,6,1,0,2022
ITA-Serie A,2021,Milan,Sandro Tonali,ITA,MF,21,2000,28.9,54,37,23,25,6,21,41,51.2,20,26,8,18,34,88,19,0,2022
ITA-Serie A,2021,Milan,Simon Kjær,DEN,DF,32,1989,8.9,20,12,9,8,3,6,12,50.0,6,17,13,4,9,29,39,0,2022
ITA-Serie A,2021,Milan,Theo Hernández,FRA,DF,23,1997,30.1,53,35,34,14,5,29,40,72.5,11,16,3,13,23,76,29,3,2022
ITA-Serie A,2021,Milan,Tiemoué Bakayoko,FRA,MF,26,1994,5.6,19,13,9,7,3,5,16,31.3,11,8,1,7,9,28,10,2,2022
ITA-Serie A,2021,Milan,Zlatan Ibrahimović,SWE,FW,39,1981,11.3,0,0,0,0,0,0,2,0.0,2,2,1,1,3,3,9,0,2022
ITA-Serie A,2021,Napoli,Adam Ounas,ALG,"MF,FW",24,1996,3.6,6,1,0,3,3,3,7,42.9,4,3,0,3,2,8,3,0,2022
ITA-Serie A,2021,Napoli,Alessandro Zanoli,ITA,DF,20,2000,5.1,10,7,6,3,1,3,5,60.0,2,2,1,1,4,14,16,0,2022
ITA-Serie A,2021,Napoli,Alex Meret,ITA,GK,24,1997,6.9,0,0,0,0,0,0,0,,0,0,0,0,0,0,3,1,2022
ITA-Serie A,2021,Napoli,Amir Rrahmani,KVX,DF,27,1994,32.5,21,11,15,5,1,15,19,78.9,4,36,25,11,19,40,89,0,2022
ITA-Serie A,2021,Napoli,Andre-Frank Zambo Anguissa,CMR,MF,25,1995,21.4,50,26,24,17,9,25,51,49.0,26,31,5,26,24,74,33,1,2022
ITA-Serie A,2021,Napoli,Andrea Petagna,ITA,FW,26,1995,6.5,3,3,0,3,0,1,4,25.0,3,1,0,1,0,3,5,0,2022
ITA-Serie A,2021,Napoli,Axel Tuanzebe,ENG,DF,23,1997,0.1,0,0,0,0,0,0,0,,0,1,1,0,0,0,0,0,2022
ITA-Serie A,2021,Napoli,David Ospina,COL,GK,32,1988,31.0,0,0,0,0,0,0,0,,0,0,0,0,1,1,11,1,2022
ITA-Serie A,2021,Napoli,Davide Marfella,ITA,GK,21,1999,0.1,0,0,0,0,0,0,0,,0,0,0,0,0,0,0,0,2022
ITA-Serie A,2021,Napoli,Diego Demme,GER,MF,29,1991,7.7,21,12,4,13,4,10,21,47.6,11,11,2,9,9,30,2,0,2022
ITA-Serie A,2021,Napoli,Dries Mertens,BEL,"FW,MF",34,1987,15.4,16,7,1,11,4,3,16,18.8,13,8,2,6,9,25,2,0,2022
ITA-Serie A,2021,Napoli,Elif Elmas,MKD,"FW,MF",21,1999,18.0,25,15,10,10,5,12,28,42.9,16,13,2,11,8,33,17,0,2022
ITA-Serie A,2021,Napoli,Fabián Ruiz Peña,ESP,MF,25,1996,26.5,55,33,22,29,4,29,67,43.3,38,34,1,33,22,77,32,0,2022
ITA-Serie A,2021,Napoli,Faouzi Ghoulam,ALG,DF,30,1991,3.7,3,1,1,2,0,0,3,0.0,3,2,1,1,3,6,10,0,2022
ITA-Serie A,2021,Napoli,Gianluca Gaetano,ITA,MF,21,2000,0.2,1,1,1,0,0,1,2,50.0,1,0,0,0,2,3,0,0,2022
ITA-Serie A,2021,Napoli,Giovanni Di Lorenzo,ITA,DF,27,1993,31.9,58,36,30,20,8,33,58,56.9,25,28,10,18,38,96,46,1,2022
ITA-Serie A,2021,Napoli,Hirving Lozano,MEX,FW,26,1995,17.9,28,20,12,11,5,8,30,26.7,22,24,0,24,9,37,9,0,2022
ITA-Serie A,2021,Napoli,Juan Jesus,BRA,DF,30,1991,14.2,25,17,14,11,0,12,18,66.7,6,21,16,5,9,34,34,0,2022
ITA-Serie A,2021,Napoli,Kalidou Koulibaly,SEN,DF,30,1991,26.7,39,23,31,6,2,25,38,65.8,13,41,25,16,29,68,90,1,2022
ITA-Serie A,2021,Napoli,Kostas Manolas,GRE,DF,30,1991,3.5,2,2,1,1,0,2,3,66.7,1,2,1,1,4,6,10,1,2022
ITA-Serie A,2021,Napoli,Kévin Malcuit,MAR,"DF,MF",30,1991,3.2,4,2,4,0,0,2,2,100.0,0,3,0,3,8,12,6,0,2022
ITA-Serie A,2021,Napoli,Lorenzo Insigne,ITA,FW,30,1991,25.4,23,14,8,12,3,8,44,18.2,36,30,1,29,20,43,3,1,2022
ITA-Serie A,2021,Napoli,Matteo Politano,ITA,FW,27,1993,18.3,24,12,8,11,5,15,54,27.8,39,11,2,9,13,37,5,0,2022
ITA-Serie A,2021,Napoli,Mário Rui,POR,DF,30,1991,33.2,68,43,32,28,8,39,84,46.4,45,31,7,24,40,108,50,0,2022
ITA-Serie A,2021,Napoli,Piotr Zieliński,POL,MF,27,1994,23.2,19,12,5,9,5,6,21,28.6,15,13,2,11,8,27,4,0,2022
ITA-Serie A,2021,Napoli,Stanislav Lobotka,SVK,MF,26,1994,18.7,39,24,16,20,3,14,36,38.9,22,9,1,8,12,51,13,1,2022
ITA-Serie A,2021,Napoli,Victor Osimhen,NGA,FW,22,1998,22.0,10,5,1,2,7,2,6,33.3,4,16,3,13,3,13,17,0,2022
ITA-Serie A,2021,Roma,Ainsley Maitland-Niles,ENG,DF,23,1997,5.4,8,6,5,0,3,5,14,35.7,9,7,0,7,6,14,7,0,2022
ITA-Serie A,2021,Roma,Amadou Diawara,GUI,MF,24,1997,1.9,7,2,5,2,0,1,3,33.3,2,2,0,2,0,7,1,0,2022
ITA-Serie A,2021,Roma,Borja Mayoral,ESP,"FW,DF",24,1997,1.1,0,0,0,0,0,0,0,,0,0,0,0,0,0,0,0,2022
ITA-Serie A,2021,Roma,Bryan Cristante,ITA,MF,26,1995,29.8,79,39,31,39,9,37,69,53.6,32,31,5,26,40,119,45,0,2022
ITA-Serie A,2021,Roma,Bryan Reynolds,USA,DF,20,2001,0.0,0,0,0,0,0,0,1,0.0,1,0,0,0,0,0,1,0,2022
ITA-Serie A,2021,Roma,Carles Pérez,ESP,"MF,FW",23,1998,6.2,8,3,3,1,4,3,12,25.0,9,10,0,10,2,10,2,0,2022
ITA-Serie A,2021,Roma,Chris Smalling,ENG,DF,31,1989,23.2,36,23,28,8,0,18,25,72.0,7,32,24,8,26,62,92,1,2022
ITA-Serie A,2021,Roma,Cristian Volpato,ITA,"FW,MF",17,2003,0.4,1,1,0,0,1,1,1,100.0,0,0,0,0,0,1,0,0,2022
ITA-Serie A,2021,Roma,Dimitrios Keramitsis,GRE,MF,17,2004,0.0,0,0,0,0,0,0,0,,0,0,0,0,0,0,0,0,2022
ITA-Serie A,2021,Roma,Ebrima Darboe,GAM,MF,20,2001,0.7,1,1,0,1,0,0,0,,0,0,0,0,1,2,0,1,2022
ITA-Serie A,2021,Roma,Edoardo Bove,ITA,"MF,DF",19,2002,0.8,1,1,1,0,0,0,2,0.0,2,1,0,1,1,2,0,0,2022
ITA-Serie A,2021,Roma,Eldor Shomurodov,UZB,"FW,MF",26,1995,8.7,5,4,0,4,1,1,10,10.0,9,8,0,8,2,7,5,0,2022
ITA-Serie A,2021,Roma,Felix Afena-Gyan,GHA,"FW,MF",18,2003,7.4,10,3,1,6,3,4,7,57.1,3,4,0,4,3,13,0,0,2022
ITA-Serie A,2021,Roma,Gianluca Mancini,ITA,DF,25,1996,32.0,41,25,22,18,1,18,33,54.5,15,38,19,19,39,80,69,0,2022
ITA-Serie A,2021,Roma,Henrikh Mkhitaryan,ARM,"MF,FW",32,1989,27.7,45,29,11,27,7,17,52,32.7,35,33,2,31,22,67,33,0,2022
ITA-Serie A,2021,Roma,Jordan Veretout,FRA,MF,28,1993,25.8,34,25,20,12,2,15,39,38.5,24,12,1,11,27,61,22,1,2022
ITA-Serie A,2021,Roma,Leonardo Spinazzola,ITA,DF,28,1993,1.4,0,0,0,0,0,0,1,0.0,1,4,1,3,0,0,3,0,2022
ITA-Serie A,2021,Roma,Lorenzo Pellegrini,ITA,MF,25,1996,25.4,35,14,10,17,8,16,60,26.7,44,29,1,28,27,62,20,0,2022
ITA-Serie A,2021,Roma,Marash Kumbulla,ALB,DF,21,2000,11.4,21,13,13,7,1,8,15,53.3,7,17,8,9,16,37,26,0,2022
ITA-Serie A,2021,Roma,Matías Viña,URU,"DF,FW",23,1997,17.4,46,30,27,14,5,29,59,49.2,30,26,3,23,25,71,33,0,2022
ITA-Serie A,2021,Roma,Nicola Zalewski,POL,DF,19,2002,8.8,32,19,17,11,4,21,35,60.0,14,18,1,17,16,48,4,0,2022
ITA-Serie A,2021,Roma,Nicolò Zaniolo,ITA,"FW,MF",22,1999,21.9,24,15,0,15,9,6,28,21.4,22,19,0,19,7,31,6,0,2022
ITA-Serie A,2021,Roma,Riccardo Calafiori,ITA,DF,19,2002,1.9,5,4,2,2,1,1,5,20.0,4,3,0,3,3,8,1,0,2022
ITA-Serie A,2021,Roma,Rick Karsdorp,NED,"DF,FW",26,1995,32.0,53,38,33,13,7,28,50,56.0,22,22,5,17,34,87,26,1,2022
ITA-Serie A,2021,Roma,Roger Ibanez,BRA,DF,22,1998,32.1,54,32,31,19,4,26,43,60.5,17,26,7,19,62,116,104,2,2022
ITA-Serie A,2021,Roma,Rui Patrício,POR,GK,33,1988,38.0,0,0,0,0,0,0,0,,0,1,0,1,0,0,10,3,2022
ITA-Serie A,2021,Roma,Stephan El Shaarawy,ITA,"FW,DF",28,1992,11.7,13,8,4,9,0,4,6,66.7,2,10,2,8,11,24,8,0,2022
ITA-Serie A,2021,Roma,Sérgio Oliveira,POR,MF,29,1992,9.9,27,14,11,14,2,15,30,50.0,15,13,0,13,10,37,7,0,2022
ITA-Serie A,2021,Roma,Tammy Abraham,ENG,FW,23,1997,34.3,27,13,7,14,6,9,22,40.9,13,17,3,14,5,32,27,0,2022
ITA-Serie A,2021,Salernitana,Alessandro Russo,ITA,MF,17,2003,0.3,1,0,1,0,0,0,1,0.0,1,0,0,0,0,1,1,0,2022
ITA-Serie A,2021,Salernitana,Andrea Schiavone,ITA,MF,28,1993,6.3,14,8,5,9,0,10,23,43.5,13,13,3,10,8,22,12,0,2022
ITA-Serie A,2021,Salernitana,Andrei Motoc,ROU,DF,19,2002,1.0,1,1,0,1,0,0,0,,0,2,2,0,2,3,1,0,2022
ITA-Serie A,2021,Salernitana,Cedric Gondo,CIV,FW,24,1996,7.8,5,2,2,2,1,2,5,40.0,3,2,0,2,3,8,2,0,2022
ITA-Serie A,2021,Salernitana,Diego Perotti,ARG,"MF,FW",33,1988,3.2,11,5,7,1,3,4,13,30.8,9,1,0,1,2,13,6,0,2022
ITA-Serie A,2021,Salernitana,Edoardo Vergani,ITA,"FW,MF",20,2001,1.1,2,2,2,0,0,0,0,,0,2,2,0,0,2,2,0,2022
ITA-Serie A,2021,Salernitana,Emil Bohinen,NOR,MF,22,1999,7.8,15,9,4,9,2,10,20,50.0,10,17,3,14,12,27,14,0,2022
ITA-Serie A,2021,Salernitana,Federico Bonazzoli,ITA,"FW,MF",24,1997,20.7,24,12,9,8,7,6,25,24.0,19,17,1,16,6,30,7,0,2022
ITA-Serie A,2021,Salernitana,Federico Fazio,ARG,DF,34,1987,15.9,17,11,10,6,1,9,12,75.0,3,21,16,5,27,44,67,1,2022
ITA-Serie A,2021,Salernitana,Filippo Delli Carri,ITA,DF,22,1999,3.7,6,4,4,2,0,5,14,35.7,9,6,2,4,4,10,14,0,2022
ITA-Serie A,2021,Salernitana,Francesco Di Tacchio,ITA,MF,31,1990,13.9,17,7,5,10,2,9,25,36.0,16,16,8,8,22,39,25,0,2022
ITA-Serie A,2021,Salernitana,Franck Ribéry,FRA,"MF,FW",38,1983,15.8,17,10,6,6,5,8,13,61.5,5,12,0,12,3,20,1,0,2022
ITA-Serie A,2021,Salernitana,Freddie Veseli,ALB,DF,28,1992,6.6,7,2,4,3,0,5,6,83.3,1,10,5,5,4,11,19,0,2022
ITA-Serie A,2021,Salernitana,Grigoris Kastanos,CYP,"MF,FW",23,1998,15.0,30,19,9,19,2,7,23,30.4,16,21,5,16,22,52,8,0,2022
ITA-Serie A,2021,Salernitana,Ivan Radovanović,SRB,"DF,MF",32,1988,11.7,11,7,8,3,0,7,19,36.8,12,14,7,7,7,18,29,0,2022
ITA-Serie A,2021,Salernitana,Joel Obi,NGA,"MF,DF",30,1991,12.7,23,14,5,14,4,5,12,41.7,7,17,6,11,10,33,7,0,2022
ITA-Serie A,2021,Salernitana,Julian Kristoffersen,NOR,FW,24,1997,0.1,0,0,0,0,0,0,0,,0,0,0,0,0,0,0,0,2022
ITA-Serie A,2021,Salernitana,Lassana Coulibaly,MLI,MF,25,1996,25.9,58,32,29,26,3,24,62,38.7,38,40,13,27,22,80,27,0,2022
ITA-Serie A,2021,Salernitana,Leonardo Capezzi,ITA,MF,26,1995,1.9,3,1,0,3,0,1,4,25.0,3,8,4,4,0,3,2,0,2022
ITA-Serie A,2021,Salernitana,Luca Ranieri,ITA,DF,22,1999,23.4,38,21,23,11,4,19,33,57.6,14,18,8,10,22,60,67,0,2022
ITA-Serie A,2021,Salernitana,Luigi Sepe,ITA,GK,30,1991,15.5,0,0,0,0,0,0,0,,0,0,0,0,1,1,3,0,2022
ITA-Serie A,2021,Salernitana,Luka Bogdan,CRO,DF,25,1996,4.4,6,3,6,0,0,4,8,50.0,4,3,2,1,6,12,21,0,2022
ITA-Serie A,2021,Salernitana,Lys Mousset,FRA,"MF,FW",25,1996,1.8,1,0,0,1,0,0,0,,0,2,0,2,0,1,0,0,2022
ITA-Serie A,2021,Salernitana,Mamadou Coulibaly,SEN,MF,22,1999,9.0,15,12,8,5,2,7,20,35.0,13,9,0,9,11,26,9,0,2022
ITA-Serie A,2021,Salernitana,Mario Perrone,ITA,DF,18,2003,0.2,0,0,0,0,0,0,0,,0,0,0,0,0,0,0,0,2022
ITA-Serie A,2021,Salernitana,Matteo Ruggeri,ITA,DF,19,2002,7.5,8,4,5,2,1,7,10,70.0,3,6,1,5,2,10,25,0,2022
ITA-Serie A,2021,Salernitana,Mikael,BRA,"FW,MF",22,1999,1.0,1,1,0,1,0,0,0,,0,0,0,0,0,1,1,0,2022
ITA-Serie A,2021,Salernitana,Milan Đurić,BIH,FW,31,1990,24.1,1,1,0,1,0,1,3,33.3,2,6,1,5,2,3,32,0,2022
ITA-Serie A,2021,Salernitana,Nadir Zortea,ITA,"DF,MF",22,1999,15.7,21,15,9,7,5,11,19,57.9,8,14,2,12,7,28,33,0,2022
ITA-Serie A,2021,Salernitana,Norbert Gyömbér,SVK,DF,29,1992,28.5,53,32,40,11,2,33,50,66.0,17,38,24,14,44,97,126,1,2022
ITA-Serie A,2021,Salernitana,Pasquale Mazzocchi,ITA,DF,26,1995,14.1,28,19,15,11,2,14,34,41.2,20,5,0,5,11,39,31,0,2022
ITA-Serie A,2021,Salernitana,Paweł Jaroszyński,POL,DF,26,1994,5.7,10,5,7,3,0,5,7,71.4,2,4,0,4,10,20,19,0,2022
ITA-Serie A,2021,Salernitana,Radu Drăgușin,ROU,DF,19,2002,5.4,5,4,2,3,0,4,10,40.0,6,7,3,4,13,18,17,0,2022
ITA-Serie A,2021,Salernitana,Ramzi Aya,ITA,DF,30,1990,1.5,1,1,1,0,0,1,1,100.0,0,0,0,0,0,1,4,0,2022
ITA-Serie A,2021,Salernitana,Riccardo Gagliolo,SWE,DF,31,1990,12.6,23,12,16,4,3,16,27,59.3,11,15,8,7,28,51,52,0,2022
ITA-Serie A,2021,Salernitana,Simeon Nwankwo,NGA,FW,29,1992,9.4,5,5,0,4,1,4,10,40.0,6,8,3,5,3,8,10,0,2022
ITA-Serie A,2021,Salernitana,Simone Verdi,ITA,"FW,MF",29,1992,9.2,12,8,5,2,5,9,20,45.0,11,4,0,4,3,15,1,0,2022
ITA-Serie A,2021,Salernitana,Stefan Strandberg,NOR,DF,31,1990,10.4,13,8,10,3,0,8,11,72.7,3,15,13,2,9,22,49,0,2022
ITA-Serie A,2021,Salernitana,Vid Belec,SVN,GK,31,1990,21.5,0,0,0,0,0,0,0,,0,0,0,0,0,0,9,1,2022
ITA-Serie A,2021,Salernitana,Vincenzo Fiorillo,ITA,GK,31,1990,1.0,0,0,0,0,0,0,0,,0,0,0,0,0,0,1,0,2022
ITA-Serie A,2021,Salernitana,Wajdi Kechrida,TUN,"DF,MF",25,1995,10.6,9,6,6,3,0,8,13,61.5,5,10,2,8,8,17,15,0,2022
ITA-Serie A,2021,Salernitana,Éderson,BRA,MF,22,1999,12.7,29,18,11,14,4,14,26,53.8,12,11,2,9,19,48,8,0,2022
ITA-Serie A,2021,Sampdoria,Abdelhamid Sabiri,MAR,"MF,FW",24,1996,9.9,34,18,10,15,9,7,25,28.0,18,10,2,8,7,41,3,0,2022
ITA-Serie A,2021,Sampdoria,Adrien Silva,POR,MF,32,1989,12.0,24,12,14,5,5,9,33,27.3,24,15,5,10,23,47,23,0,2022
ITA-Serie A,2021,Sampdoria,Albin Ekdal,SWE,MF,32,1989,18.2,43,28,17,21,5,26,56,46.4,30,27,7,20,29,72,25,0,2022
ITA-Serie A,2021,Sampdoria,Alex Ferrari,ITA,DF,27,1994,18.3,40,22,28,9,3,19,33,57.6,14,31,22,9,39,79,63,1,2022
ITA-Serie A,2021,Sampdoria,Andrea Conti,ITA,"DF,MF",27,1994,2.6,4,2,2,1,1,3,6,50.0,3,4,0,4,7,11,4,0,2022
ITA-Serie A,2021,Sampdoria,Antonio Candreva,ITA,"MF,FW",34,1987,34.7,27,16,9,11,7,19,55,34.5,36,23,2,21,33,60,19,0,2022
ITA-Serie A,2021,Sampdoria,Bartosz Bereszyński,POL,DF,29,1992,32.7,64,38,34,25,5,37,80,46.3,43,38,12,26,42,106,73,1,2022
ITA-Serie A,2021,Sampdoria,Emil Audero,ITA,GK,24,1997,28.4,3,1,3,0,0,3,5,60.0,2,0,0,0,2,5,17,2,2022
ITA-Serie A,2021,Sampdoria,Ernesto Torregrossa,VEN,FW,29,1992,1.3,2,1,1,0,1,1,2,50.0,1,0,0,0,0,2,1,0,2022
ITA-Serie A,2021,Sampdoria,Fabio Depaoli,ITA,"MF,DF",24,1997,1.2,3,1,1,2,0,0,2,0.0,2,2,1,1,1,4,2,0,2022
ITA-Serie A,2021,Sampdoria,Fabio Quagliarella,ITA,FW,38,1983,18.5,6,2,2,2,2,2,15,13.3,13,14,1,13,3,9,12,0,2022
ITA-Serie A,2021,Sampdoria,Francesco Caputo,ITA,FW,33,1987,31.0,5,2,1,3,1,1,6,16.7,5,5,0,5,2,7,10,0,2022
ITA-Serie A,2021,Sampdoria,Gerard Yepes,ESP,"MF,DF",18,2002,0.2,1,0,0,1,0,1,1,100.0,0,1,0,1,0,1,0,0,2022
ITA-Serie A,2021,Sampdoria,Giangiacomo Magnani,ITA,DF,25,1995,2.7,4,2,4,0,0,1,1,100.0,0,2,2,0,7,11,12,0,2022
ITA-Serie A,2021,Sampdoria,Julian Chabot,GER,DF,23,1998,5.4,12,10,8,4,0,8,10,80.0,2,7,4,3,9,21,28,1,2022
ITA-Serie A,2021,Sampdoria,Kristoffer Askildsen,NOR,MF,20,2001,8.4,18,6,7,11,0,9,19,47.4,10,14,7,7,15,33,15,0,2022
ITA-Serie A,2021,Sampdoria,Manolo Gabbiadini,ITA,"FW,MF",29,1991,12.7,6,4,3,2,1,1,7,14.3,6,5,2,3,3,9,10,0,2022
ITA-Serie A,2021,Sampdoria,Maya Yoshida,JPN,DF,32,1988,20.3,17,10,8,9,0,8,15,53.3,7,27,20,7,28,45,72,1,2022
ITA-Serie A,2021,Sampdoria,Mikkel Damsgaard,DEN,"MF,FW",21,2000,6.4,27,13,12,11,4,20,36,55.6,16,16,1,15,7,34,7,0,2022
ITA-Serie A,2021,Sampdoria,Morten Thorsby,NOR,MF,25,1996,32.7,46,26,15,23,8,28,56,50.0,28,37,12,25,25,71,39,0,2022
ITA-Serie A,2021,Sampdoria,Nicola Murru,ITA,DF,26,1994,10.9,22,17,10,11,1,8,13,61.5,5,17,3,14,7,29,20,1,2022
ITA-Serie A,2021,Sampdoria,Nicola Ravaglia,ITA,GK,32,1988,0.1,0,0,0,0,0,0,0,,0,0,0,0,0,0,0,0,2022
ITA-Serie A,2021,Sampdoria,Omar Colley,GAM,DF,28,1992,30.5,47,36,32,14,1,22,32,68.8,10,31,19,12,80,127,135,2,2022
ITA-Serie A,2021,Sampdoria,Radu Drăgușin,ROU,DF,19,2002,6.9,4,3,2,2,0,2,6,33.3,4,8,4,4,10,14,33,0,2022
ITA-Serie A,2021,Sampdoria,Riccardo Ciervo,ITA,"MF,DF",19,2002,2.5,8,3,4,3,1,2,6,33.3,4,1,0,1,2,10,2,0,2022
ITA-Serie A,2021,Sampdoria,Ronaldo Vieira,GNB,MF,23,1998,5.5,,6,,,,,,,,,,,5,,,,2022
ITA-Serie A,2021,Sampdoria,Sebastian Giovinco,ITA,MF,34,1987,0.4,0,0,0,0,0,0,1,0.0,1,0,0,0,0,0,0,0,2022
ITA-Serie A,2021,Sampdoria,Simone Trimboli,ITA,MF,19,2002,0.7,2,1,2,0,0,2,2,100.0,0,0,0,0,2,4,0,0,2022
ITA-Serie A,2021,Sampdoria,Stefano Sensi,ITA,"MF,FW",25,1995,8.4,18,9,10,6,2,10,23,43.5,13,2,0,2,6,24,4,0,2022
ITA-Serie A,2021,Sampdoria,Tommaso Augello,ITA,DF,26,1994,26.6,36,20,22,8,6,17,29,58.6,12,19,4,15,29,65,68,1,2022
ITA-Serie A,2021,Sampdoria,Tomás Rincón,VEN,MF,33,1988,13.0,22,13,9,10,3,13,34,38.2,21,15,2,13,18,40,11,0,2022
ITA-Serie A,2021,Sampdoria,Valerio Verre,ITA,"MF,FW",27,1994,4.7,7,5,1,4,2,4,9,44.4,5,7,0,7,0,7,5,0,2022
ITA-Serie A,2021,Sampdoria,Vladyslav Supriaha,UKR,FW,21,2000,0.2,0,0,0,0,0,0,1,0.0,1,0,0,0,0,0,0,0,2022
ITA-Serie A,2021,Sampdoria,Wladimiro Falcone,ITA,GK,26,1995,9.5,0,0,0,0,0,0,0,,0,0,0,0,1,1,5,0,2022
ITA-Serie A,2021,Sassuolo,Abdou Harroui,NED,MF,23,1998,5.0,11,4,4,7,0,8,11,72.7,3,14,0,14,4,15,5,0,2022
ITA-Serie A,2021,Sassuolo,Andrea Consigli,ITA,GK,34,1987,36.9,0,0,0,0,0,0,2,0.0,2,0,0,0,0,0,23,3,2022
ITA-Serie A,2021,Sassuolo,Brian Oddei,ITA,FW,18,2002,0.1,0,0,0,0,0,0,0,,0,0,0,0,0,0,0,0,2022
ITA-Serie A,2021,Sassuolo,Davide Frattesi,ITA,MF,21,1999,31.7,46,16,26,18,2,26,52,50.0,26,44,12,32,29,75,62,1,2022
ITA-Serie A,2021,Sassuolo,Domenico Berardi,ITA,FW,26,1994,31.3,32,19,9,16,7,15,57,26.3,42,39,2,37,31,63,23,0,2022
ITA-Serie A,2021,Sassuolo,Edoardo Goldaniga,ITA,"DF,MF",27,1993,0.0,0,0,0,0,0,0,0,,0,0,0,0,0,0,0,0,2022
ITA-Serie A,2021,Sassuolo,Emil Ceide,NOR,"FW,MF",19,2001,0.6,1,1,0,1,0,1,2,50.0,1,1,0,1,0,1,0,0,2022
ITA-Serie A,2021,Sassuolo,Federico Peluso,ITA,DF,37,1984,0.1,1,1,0,1,0,1,1,100.0,0,0,0,0,0,1,0,0,2022
ITA-Serie A,2021,Sassuolo,Filip Đuričić,SRB,"MF,FW",29,1992,7.5,13,10,7,1,5,5,13,38.5,8,7,1,6,4,17,1,0,2022
ITA-Serie A,2021,Sassuolo,Francesco Caputo,ITA,FW,33,1987,1.7,0,0,0,0,0,0,0,,0,0,0,0,0,0,0,0,2022
ITA-Serie A,2021,Sassuolo,Francesco Magnanelli,ITA,MF,36,1984,3.0,5,4,4,1,0,1,9,11.1,8,3,1,2,1,6,3,0,2022
ITA-Serie A,2021,Sassuolo,Giacomo Raspadori,ITA,"MF,FW",21,2000,30.4,29,18,5,15,9,11,38,28.9,27,29,3,26,9,38,11,0,2022
ITA-Serie A,2021,Sassuolo,Giacomo Satalino,ITA,GK,22,1999,0.1,0,0,0,0,0,0,0,,0,0,0,0,0,0,0,0,2022
ITA-Serie A,2021,Sassuolo,Gian Marco Ferrari,ITA,DF,29,1992,34.7,16,11,10,6,0,10,23,43.5,13,37,27,10,43,59,114,2,2022
ITA-Serie A,2021,Sassuolo,Gianluca Pegolo,ITA,GK,40,1981,1.0,0,0,0,0,0,0,0,,0,0,0,0,0,0,0,1,2022
ITA-Serie A,2021,Sassuolo,Gianluca Scamacca,ITA,FW,22,1999,23.8,19,14,2,5,12,5,21,23.8,16,16,1,15,5,24,22,1,2022
ITA-Serie A,2021,Sassuolo,Giorgos Kyriakopoulos,GRE,"DF,FW",25,1996,21.9,30,14,19,7,4,19,38,50.0,19,32,9,23,11,41,52,0,2022
ITA-Serie A,2021,Sassuolo,Grégoire Defrel,MTQ,FW,30,1991,15.1,15,9,4,8,3,6,16,37.5,10,11,1,10,4,19,11,0,2022
ITA-Serie A,2021,Sassuolo,Hamed Junior Traorè,CIV,"FW,MF",21,2000,19.7,32,18,8,14,10,10,46,21.7,36,22,2,20,12,44,6,1,2022
ITA-Serie A,2021,Sassuolo,Jeremie Boga,CIV,"FW,MF",24,1997,7.4,7,4,1,2,4,2,3,66.7,1,3,0,3,2,9,1,1,2022
ITA-Serie A,2021,Sassuolo,Jeremy Toljan,GER,DF,26,1994,15.5,18,10,12,4,2,13,20,65.0,7,12,5,7,12,30,41,0,2022
ITA-Serie A,2021,Sassuolo,Kaan Ayhan,TUR,DF,26,1994,15.0,20,12,14,6,0,7,15,46.7,8,20,14,6,13,33,57,0,2022
ITA-Serie A,2021,Sassuolo,Luigi Samele,ITA,FW,19,2002,0.1,0,0,0,0,0,0,0,,0,0,0,0,0,0,1,0,2022
ITA-Serie A,2021,Sassuolo,Matheus Henrique,BRA,MF,23,1997,12.0,10,3,6,3,1,6,24,25.0,18,14,2,12,7,17,12,1,2022
ITA-Serie A,2021,Sassuolo,Maxime Lopez,FRA,MF,23,1997,32.6,69,36,40,27,2,35,87,40.2,52,33,7,26,42,111,38,1,2022
ITA-Serie A,2021,Sassuolo,Mert Müldür,TUR,DF,22,1999,22.7,52,35,43,7,2,27,49,55.1,22,25,6,19,24,76,44,1,2022
ITA-Serie A,2021,Sassuolo,Rogério,BRA,DF,23,1998,19.2,21,13,12,5,4,15,22,68.2,7,20,8,12,18,39,42,1,2022
ITA-Serie A,2021,Sassuolo,Ruan,BRA,DF,22,1999,2.4,7,4,7,0,0,3,4,75.0,1,6,5,1,2,9,24,1,2022
ITA-Serie A,2021,Sassuolo,Vlad Chiricheș,ROU,DF,31,1989,25.6,28,15,19,9,0,10,21,47.6,11,34,21,13,41,69,71,4,2022
ITA-Serie A,2021,Spezia,Aimar Sher,SWE,MF,18,2002,0.5,2,1,1,1,0,0,1,0.0,1,1,0,1,3,5,1,0,2022
ITA-Serie A,2021,Spezia,Arkadiusz Reca,POL,DF,26,1995,19.7,31,19,21,3,7,20,30,66.7,10,20,7,13,32,63,47,2,2022
ITA-Serie A,2021,Spezia,Aurélien Nguiamba,FRA,MF,22,1999,0.6,3,2,1,2,0,2,3,66.7,1,2,1,1,0,3,1,0,2022
ITA-Serie A,2021,Spezia,Daniele Verde,ITA,"FW,MF",25,1996,21.7,11,4,8,2,1,9,20,45.0,11,17,2,15,18,29,8,0,2022
ITA-Serie A,2021,Spezia,Dimitris Nikolaou,GRE,DF,22,1998,36.0,39,26,29,7,3,22,34,64.7,12,48,24,24,49,88,132,1,2022
ITA-Serie A,2021,Spezia,Dávid Strelec,SVK,"FW,MF",20,2001,5.6,4,4,1,2,1,2,9,22.2,7,8,1,7,2,6,1,0,2022
ITA-Serie A,2021,Spezia,Ebrima Colley,GAM,"FW,MF",21,2000,4.4,6,1,3,2,1,1,7,14.3,6,8,0,8,3,9,2,0,2022
ITA-Serie A,2021,Spezia,Eddie Salcedo,ITA,"MF,FW",19,2001,4.8,1,1,0,0,1,0,1,0.0,1,2,1,1,0,1,7,1,2022
ITA-Serie A,2021,Spezia,Emmanuel Gyasi,GHA,"FW,MF",27,1994,33.7,47,30,31,9,7,21,41,51.2,20,22,4,18,16,63,43,1,2022
ITA-Serie A,2021,Spezia,Giulio Maggiore,ITA,MF,23,1998,31.3,58,32,20,32,6,31,77,40.3,46,30,5,25,29,87,33,0,2022
ITA-Serie A,2021,Spezia,Ivan Provedel,ITA,GK,27,1994,30.7,0,0,0,0,0,0,1,0.0,1,0,0,0,2,2,10,2,2022
ITA-Serie A,2021,Spezia,Jacopo Sala,ITA,MF,29,1991,9.8,22,11,10,10,2,13,30,43.3,17,6,0,6,14,36,11,0,2022
ITA-Serie A,2021,Spezia,Jakub Kiwior,POL,MF,21,2000,21.8,50,27,25,19,6,26,57,45.6,31,38,15,23,40,90,53,0,2022
ITA-Serie A,2021,Spezia,Janis Antiste,FRA,FW,18,2002,8.8,18,11,6,6,6,5,13,38.5,8,7,1,6,4,22,6,0,2022
ITA-Serie A,2021,Spezia,Jeroen Zoet,NED,GK,30,1991,7.0,1,0,1,0,0,1,1,100.0,0,0,0,0,0,1,4,0,2022
ITA-Serie A,2021,Spezia,Kelvin Amian,FRA,DF,23,1998,29.4,66,42,43,18,5,30,41,73.2,11,39,21,18,32,98,75,0,2022
ITA-Serie A,2021,Spezia,Kevin Agudelo,COL,"MF,FW",22,1998,13.7,44,26,13,26,5,7,20,35.0,13,22,0,22,8,52,6,0,2022
ITA-Serie A,2021,Spezia,Luca Vignali,ITA,"DF,MF",25,1996,0.9,1,1,0,1,0,0,3,0.0,3,0,0,0,1,2,1,0,2022
ITA-Serie A,2021,Spezia,M'Bala Nzola,ANG,FW,24,1996,11.9,2,2,0,0,2,1,6,16.7,5,8,0,8,0,2,13,0,2022
ITA-Serie A,2021,Spezia,Martin Erlic,CRO,DF,23,1998,28.6,28,16,18,10,0,10,18,55.6,8,54,39,15,28,56,122,1,2022
ITA-Serie A,2021,Spezia,Mehdi Bourabia,MAR,MF,29,1991,3.1,5,1,2,3,0,3,11,27.3,8,7,6,1,3,8,10,0,2022
ITA-Serie A,2021,Spezia,Nicolò Bertola,ITA,"MF,DF",18,2003,0.4,3,2,3,0,0,3,4,75.0,1,0,0,0,3,6,1,0,2022
ITA-Serie A,2021,Spezia,Petar Zovko,BIH,GK,19,2002,0.3,0,0,0,0,0,0,0,,0,0,0,0,0,0,1,0,2022
ITA-Serie A,2021,Spezia,Petko Hristov,BUL,DF,22,1999,13.9,17,10,11,6,0,10,16,62.5,6,29,23,6,19,36,47,0,2022
ITA-Serie A,2021,Spezia,Rey Manaj,ALB,FW,24,1997,19.6,19,12,3,11,5,6,26,23.1,20,16,0,16,4,23,13,0,2022
ITA-Serie A,2021,Spezia,Salvador Ferrer,ESP,"DF,MF",23,1998,16.6,32,18,15,9,8,12,25,48.0,13,24,12,12,18,50,46,0,2022
ITA-Serie A,2021,Spezia,Samuel Mráz,SVK,FW,24,1997,0.6,0,0,0,0,0,0,0,,0,1,0,1,0,0,0,0,2022
ITA-Serie A,2021,Spezia,Simone Bastoni,ITA,"MF,DF",24,1996,25.4,52,34,28,17,7,21,65,32.3,44,38,11,27,30,82,31,0,2022
ITA-Serie A,2021,Spezia,Suf Podgoreanu,ISR,FW,19,2002,1.3,2,0,1,1,0,1,4,25.0,3,2,0,2,1,3,3,0,2022
ITA-Serie A,2021,Spezia,Viktor Kovalenko,UKR,MF,25,1996,14.7,16,10,7,8,1,9,21,42.9,12,16,3,13,13,29,8,0,2022
ITA-Serie A,2021,Torino,Alessandro Buongiorno,ITA,DF,22,1999,13.1,20,9,9,8,3,9,13,69.2,4,12,6,6,31,51,44,0,2022
ITA-Serie A,2021,Torino,Andrea Belotti,ITA,FW,27,1993,15.2,7,3,2,2,3,3,12,25.0,9,12,4,8,2,9,9,0,2022
ITA-Serie A,2021,Torino,Antonio Sanabria,PAR,FW,25,1996,20.0,3,2,0,1,2,1,4,25.0,3,11,4,7,2,5,10,0,2022
ITA-Serie A,2021,Torino,Armando Izzo,ITA,DF,29,1992,5.8,16,9,14,2,0,9,11,81.8,2,5,4,1,17,33,21,0,2022
ITA-Serie A,2021,Torino,Ben Lhassine Kone,CIV,MF,21,2000,0.9,3,3,1,2,0,1,2,50.0,1,0,0,0,1,4,1,0,2022
ITA-Serie A,2021,Torino,Cristian Ansaldi,ARG,DF,34,1986,7.7,20,9,11,7,2,10,13,76.9,3,9,1,8,6,26,10,0,2022
ITA-Serie A,2021,Torino,Daniele Baselli,ITA,"MF,FW",29,1992,1.7,3,3,2,0,1,2,6,33.3,4,0,0,0,1,4,2,0,2022
ITA-Serie A,2021,Torino,David Zima,CZE,DF,20,2000,14.6,20,12,8,11,1,9,20,45.0,11,15,13,2,23,43,42,0,2022
ITA-Serie A,2021,Torino,Demba Seck,SEN,"MF,FW",20,2001,1.6,2,1,0,2,0,0,0,,0,0,0,0,0,2,0,0,2022
ITA-Serie A,2021,Torino,Dennis Praet,BEL,MF,27,1994,17.1,19,10,6,8,5,8,22,36.4,14,12,1,11,3,22,4,0,2022
ITA-Serie A,2021,Torino,Etrit Berisha,ALB,GK,32,1989,10.0,0,0,0,0,0,0,0,,0,0,0,0,0,0,4,0,2022
ITA-Serie A,2021,Torino,Gleison Bremer,BRA,DF,24,1997,32.1,49,24,27,22,0,18,28,64.3,10,54,23,31,105,154,137,0,2022
ITA-Serie A,2021,Torino,Josip Brekalo,CRO,MF,23,1998,25.4,9,5,5,1,3,3,21,14.3,18,16,1,15,4,13,7,1,2022
ITA-Serie A,2021,Torino,Karol Linetty,POL,"MF,FW",26,1995,10.0,14,8,3,4,7,6,18,33.3,12,8,0,8,3,17,2,0,2022
ITA-Serie A,2021,Torino,Koffi Djidji,CIV,DF,28,1992,19.3,48,29,21,23,4,14,18,77.8,4,20,9,11,34,82,60,0,2022
ITA-Serie A,2021,Torino,Luca Gemello,ITA,GK,21,2000,1.0,0,0,0,0,0,0,0,,0,0,0,0,0,0,0,0,2022
ITA-Serie A,2021,Torino,Magnus Warming,DEN,"MF,FW",21,2000,0.6,1,1,0,1,0,0,0,,0,2,0,2,0,1,0,0,2022
ITA-Serie A,2021,Torino,Marko Pjaca,CRO,MF,26,1995,12.8,7,4,1,4,2,3,8,37.5,5,10,2,8,4,11,2,0,2022
ITA-Serie A,2021,Torino,Mërgim Vojvoda,KVX,DF,26,1995,22.0,38,23,23,11,4,20,36,55.6,16,27,8,19,20,58,51,0,2022
ITA-Serie A,2021,Torino,Ola Aina,NGA,DF,24,1996,16.0,27,19,11,10,6,15,23,65.2,8,17,3,14,28,55,30,0,2022
ITA-Serie A,2021,Torino,Pietro Pellegri,ITA,FW,20,2001,2.4,1,1,0,1,0,0,4,0.0,4,0,0,0,0,1,5,0,2022
ITA-Serie A,2021,Torino,Ricardo Rodríguez,SUI,DF,28,1992,27.5,36,21,11,23,2,18,33,54.5,15,22,8,14,41,77,48,1,2022
ITA-Serie A,2021,Torino,Rolando Mandragora,ITA,MF,24,1997,14.7,21,10,3,16,2,12,21,57.1,9,18,4,14,10,31,13,0,2022
ITA-Serie A,2021,Torino,Samuele Ricci,ITA,MF,19,2001,8.0,8,4,4,2,2,2,5,40.0,3,7,1,6,14,22,9,0,2022
ITA-Serie A,2021,Torino,Saša Lukić,SRB,MF,24,1996,33.1,51,34,17,27,7,19,43,44.2,24,34,6,28,24,75,41,0,2022
ITA-Serie A,2021,Torino,Simone Verdi,ITA,"MF,FW",29,1992,0.5,1,1,0,1,0,0,0,,0,0,0,0,0,1,0,0,2022
ITA-Serie A,2021,Torino,Simone Zaza,ITA,"FW,DF",30,1991,1.4,2,2,1,1,0,1,1,100.0,0,3,0,3,0,2,3,0,2022
ITA-Serie A,2021,Torino,Tommaso Pobega,ITA,MF,22,1999,24.9,48,30,17,20,11,21,40,52.5,19,32,3,29,25,73,38,0,2022
ITA-Serie A,2021,Torino,Tomás Rincón,VEN,MF,33,1988,1.8,2,2,2,0,0,0,3,0.0,3,3,1,2,2,4,4,0,2022
ITA-Serie A,2021,Torino,Vanja Milinković-Savić,SRB,GK,24,1997,27.0,0,0,0,0,0,0,1,0.0,1,0,0,0,0,0,7,2,2022
ITA-Serie A,2021,Torino,Wilfried Singo,CIV,DF,20,2000,29.0,55,35,24,24,7,24,34,70.6,10,26,6,20,23,78,47,0,2022
ITA-Serie A,2021,Udinese,Beto,GNB,FW,23,1998,24.1,21,6,2,14,5,9,19,47.4,10,16,1,15,5,26,25,1,2022
ITA-Serie A,2021,Udinese,Bram Nuytinck,NED,DF,31,1990,22.6,38,24,24,13,1,15,34,44.1,19,42,31,11,22,60,101,0,2022
ITA-Serie A,2021,Udinese,Brandon Soppy,FRA,"DF,MF",19,2002,8.6,20,9,8,10,2,11,16,68.8,5,10,2,8,5,25,9,1,2022
ITA-Serie A,2021,Udinese,Daniele Padelli,ITA,GK,35,1985,3.0,0,0,0,0,0,0,0,,0,0,0,0,0,0,2,1,2022
ITA-Serie A,2021,Udinese,Fernando Forestieri,ITA,"FW,MF",31,1990,0.6,0,0,0,0,0,0,1,0.0,1,1,0,1,0,0,1,0,2022
ITA-Serie A,2021,Udinese,Filip Benković,CRO,"DF,FW",24,1997,0.1,0,0,0,0,0,0,0,,0,0,0,0,0,0,0,0,2022
ITA-Serie A,2021,Udinese,Gerard Deulofeu,ESP,"FW,MF",27,1994,29.1,11,6,2,3,6,7,29,24.1,22,14,0,14,9,20,4,0,2022
ITA-Serie A,2021,Udinese,Ignacio Pussetto,ARG,"FW,MF",25,1995,13.4,17,9,2,9,6,2,10,20.0,8,18,2,16,4,21,13,0,2022
ITA-Serie A,2021,Udinese,Ilija Nestorovski,MKD,FW,31,1990,2.1,0,0,0,0,0,0,3,0.0,3,0,0,0,0,0,4,0,2022
ITA-Serie A,2021,Udinese,Isaac Success,NGA,"FW,MF",25,1996,10.1,5,2,0,3,2,1,5,20.0,4,2,0,2,2,7,6,0,2022
ITA-Serie A,2021,Udinese,Iyenoma Udogie,ITA,DF,18,2002,27.5,64,40,30,27,7,33,60,55.0,27,39,6,33,27,91,42,0,2022
ITA-Serie A,2021,Udinese,Jean-Victor Makengo,FRA,MF,23,1998,26.1,30,21,7,17,6,15,29,51.7,14,26,6,20,19,49,17,0,2022
ITA-Serie A,2021,Udinese,Jens Stryger Larsen,DEN,DF,30,1991,7.6,5,2,3,1,1,2,3,66.7,1,2,0,2,4,9,17,0,2022
ITA-Serie A,2021,Udinese,Lazar Samardzic,SRB,"MF,FW",19,2002,5.4,13,9,4,7,2,7,26,26.9,19,6,0,6,2,15,2,0,2022
ITA-Serie A,2021,Udinese,Marco Silvestri,ITA,GK,30,1991,35.0,0,0,0,0,0,0,1,0.0,1,0,0,0,1,1,11,1,2022
ITA-Serie A,2021,Udinese,Marvin Zeegelaar,NED,DF,30,1990,7.1,15,11,6,8,1,5,14,35.7,9,12,4,8,12,27,22,1,2022
ITA-Serie A,2021,Udinese,Mato Jajalo,BIH,MF,33,1988,7.0,24,14,14,7,3,11,23,47.8,12,7,0,7,11,35,5,0,2022
ITA-Serie A,2021,Udinese,Nahuel Molina,ARG,DF,23,1998,29.3,41,24,17,21,3,16,48,33.3,32,24,3,21,22,63,44,2,2022
ITA-Serie A,2021,Udinese,Nehuén Pérez,ARG,DF,21,2000,18.8,44,21,21,21,2,16,25,64.0,9,27,9,18,21,65,47,0,2022
ITA-Serie A,2021,Udinese,Pablo Marí,ESP,DF,27,1993,14.9,16,8,8,6,2,8,16,50.0,8,18,12,6,21,37,72,0,2022
ITA-Serie A,2021,Udinese,Riccardo Pinzi,ITA,FW,17,2003,0.0,0,0,0,0,0,0,0,,0,0,0,0,0,0,0,0,2022
ITA-Serie A,2021,Udinese,Roberto Pereyra,ARG,"MF,FW",30,1991,19.9,18,12,7,6,5,7,23,30.4,16,26,5,21,12,30,11,0,2022
ITA-Serie A,2021,Udinese,Rodrigo Becão,BRA,DF,25,1996,34.8,81,46,49,30,2,34,60,56.7,26,45,20,25,42,123,89,3,2022
ITA-Serie A,2021,Udinese,Samir Santos,BRA,DF,26,1994,15.8,36,16,22,13,1,15,25,60.0,10,21,7,14,42,78,62,0,2022
ITA-Serie A,2021,Udinese,Sebastien De Maio,FRA,DF,34,1987,2.0,5,1,4,1,0,1,9,11.1,8,6,5,1,1,6,9,0,2022
ITA-Serie A,2021,Udinese,Simone Pafundi,ITA,FW,15,2006,0.3,0,0,0,0,0,0,1,0.0,1,0,0,0,0,0,0,0,2022
ITA-Serie A,2021,Udinese,Stefano Okaka,ITA,FW,31,1989,0.2,0,0,0,0,0,0,0,,0,2,0,2,0,0,1,0,2022
ITA-Serie A,2021,Udinese,Tolgay Arslan,GER,MF,30,1990,18.4,35,20,15,16,4,19,50,38.0,31,17,4,13,13,48,23,1,2022
ITA-Serie A,2021,Udinese,Walace,BRA,MF,26,1995,33.0,83,49,37,38,8,50,113,44.2,63,51,5,46,54,137,32,1,2022
ITA-Serie A,2021,Venezia,Aleš Matějů,CZE,DF,25,1996,8.1,16,12,10,5,1,13,29,44.8,16,10,6,4,9,25,15,0,2022
ITA-Serie A,2021,Venezia,Antonio Vacca,ITA,MF,31,1990,11.8,36,20,24,10,2,14,36,38.9,22,16,8,8,20,56,16,0,2022
ITA-Serie A,2021,Venezia,Arnór Sigurðsson,ISL,"FW,MF",22,1999,2.0,1,1,0,1,0,1,2,50.0,1,2,0,2,1,2,0,0,2022
ITA-Serie A,2021,Venezia,Bjarki Bjarkason,ISL,MF,21,2000,0.0,0,0,0,0,0,0,0,,0,0,0,0,0,0,0,0,2022
ITA-Serie A,2021,Venezia,Cristian Molinaro,ITA,DF,38,1983,6.1,12,9,10,2,0,5,7,71.4,2,7,2,5,6,18,20,0,2022
ITA-Serie A,2021,Venezia,Daan Heymans,BEL,"MF,FW",22,1999,2.8,3,1,1,2,0,1,5,20.0,4,7,3,4,4,7,3,0,2022
ITA-Serie A,2021,Venezia,David Okereke,NGA,"FW,MF",23,1997,22.8,16,10,4,9,3,3,20,15.0,17,19,3,16,10,26,20,0,2022
ITA-Serie A,2021,Venezia,David Schnegg,AUT,DF,22,1998,1.6,2,0,1,1,0,1,3,33.3,2,4,0,4,3,5,6,0,2022
ITA-Serie A,2021,Venezia,Dennis Johnsen,NOR,"FW,MF",23,1998,16.1,14,10,8,4,2,6,18,33.3,12,14,1,13,5,19,3,0,2022
ITA-Serie A,2021,Venezia,Domen Črnigoj,SVN,MF,25,1995,20.9,21,13,7,11,3,11,29,37.9,18,27,8,19,24,45,42,0,2022
ITA-Serie A,2021,Venezia,Dor Peretz,ISR,MF,26,1995,6.5,27,18,8,16,3,13,25,52.0,12,8,4,4,8,35,11,0,2022
ITA-Serie A,2021,Venezia,Ethan Ampadu,WAL,"MF,DF",20,2000,25.4,67,43,37,27,3,24,58,41.4,34,49,19,30,51,118,76,0,2022
ITA-Serie A,2021,Venezia,Francesco Di Mariano,ITA,FW,25,1996,0.7,1,1,0,1,0,0,0,,0,2,1,1,0,1,0,0,2022
ITA-Serie A,2021,Venezia,Francesco Forte,ITA,FW,28,1993,4.7,3,2,0,2,1,2,5,40.0,3,1,0,1,0,3,2,0,2022
ITA-Serie A,2021,Venezia,Gianluca Busio,USA,MF,19,2002,21.7,53,28,27,20,6,28,63,44.4,35,45,13,32,21,74,30,1,2022
ITA-Serie A,2021,Venezia,Hilmir Mikaelsson,ISL,FW,17,2004,0.2,2,0,0,1,1,0,0,,0,0,0,0,0,2,0,0,2022
ITA-Serie A,2021,Venezia,Issa Bah,LUX,FW,19,2002,0.1,0,0,0,0,0,0,0,,0,0,0,0,0,0,0,0,2022
ITA-Serie A,2021,Venezia,Jacopo Dezi,ITA,MF,29,1992,0.2,0,0,0,0,0,0,1,0.0,1,0,0,0,1,1,0,0,2022
ITA-Serie A,2021,Venezia,Jean-Pierre Nsame,CMR,FW,28,1993,2.7,1,1,0,0,1,0,0,,0,0,0,0,0,1,1,0,2022
ITA-Serie A,2021,Venezia,Luca Fiordilino,ITA,MF,25,1996,7.3,21,13,11,6,4,13,27,48.1,14,14,4,10,11,32,12,0,2022
ITA-Serie A,2021,Venezia,Luca Lezzerini,ITA,GK,26,1995,5.5,0,0,0,0,0,0,0,,0,1,0,1,0,0,0,0,2022
ITA-Serie A,2021,Venezia,Marco Modolo,ITA,DF,32,1989,4.4,6,3,4,2,0,2,5,40.0,3,6,6,0,4,10,26,0,2022
ITA-Serie A,2021,Venezia,Mattia Aramu,ITA,"MF,FW",26,1995,23.3,20,15,5,9,6,8,33,24.2,25,20,2,18,8,28,19,0,2022
ITA-Serie A,2021,Venezia,Mattia Caldara,ITA,DF,27,1994,30.0,48,28,30,15,3,20,34,58.8,14,49,37,12,62,110,147,1,2022
ITA-Serie A,2021,Venezia,Maximilian Ullmann,AUT,DF,25,1996,2.7,0,0,0,0,0,0,1,0.0,1,4,0,4,2,2,7,0,2022
ITA-Serie A,2021,Venezia,Michael Svoboda,AUT,DF,22,1998,13.7,33,17,26,6,1,18,32,56.3,14,27,15,12,10,43,61,5,2022
ITA-Serie A,2021,Venezia,Mickaël Cuisance,FRA,MF,21,1999,10.2,23,9,7,12,4,10,28,35.7,18,14,0,14,12,35,5,0,2022
ITA-Serie A,2021,Venezia,Nani,POR,"MF,FW",34,1986,3.2,2,1,1,1,0,0,1,0.0,1,1,0,1,2,4,0,1,2022
ITA-Serie A,2021,Venezia,Nicolas Galazzi,ITA,MF,20,2000,0.2,2,1,1,0,1,0,1,0.0,1,0,0,0,0,2,0,0,2022
ITA-Serie A,2021,Venezia,Niki Mäenpää,FIN,GK,36,1985,16.5,0,0,0,0,0,0,0,,0,0,0,0,0,0,8,2,2022
ITA-Serie A,2021,Venezia,Pasquale Mazzocchi,ITA,DF,26,1995,13.8,18,8,11,4,3,10,26,38.5,16,11,8,3,21,39,31,1,2022
ITA-Serie A,2021,Venezia,Patrick Leal,USA,FW,18,2003,0.0,0,0,0,0,0,0,1,0.0,1,0,0,0,0,0,0,0,2022
ITA-Serie A,2021,Venezia,Pietro Ceccaroni,ITA,DF,25,1995,34.7,55,31,33,18,4,25,36,69.4,11,45,32,13,30,85,143,0,2022
ITA-Serie A,2021,Venezia,Ridgeciano Haps,SUR,DF,28,1993,22.8,36,20,26,4,6,11,21,52.4,10,34,12,22,29,65,57,1,2022
ITA-Serie A,2021,Venezia,Sergio Romero,ARG,GK,34,1987,16.0,2,2,2,0,0,2,2,100.0,0,0,0,0,1,3,10,0,2022
ITA-Serie A,2021,Venezia,Sofian Kiyine,MAR,"MF,FW",23,1997,13.8,24,14,9,11,4,12,32,37.5,20,15,1,14,10,34,9,0,2022
ITA-Serie A,2021,Venezia,Tanner Tessmann,USA,MF,19,2001,7.6,11,5,4,6,1,5,14,35.7,9,19,9,10,5,16,22,0,2022
ITA-Serie A,2021,Venezia,Thomas Henry,FRA,FW,26,1994,23.5,9,4,2,3,4,5,13,38.5,8,11,5,6,2,11,25,0,2022
ITA-Serie A,2021,Venezia,Tyronne Ebuehi,NGA,DF,25,1995,12.6,28,12,16,8,4,10,18,55.6,8,13,3,10,16,44,38,1,2022
ITA-Serie A,2022,Atalanta,Ademola Lookman,NGA,"FW,MF",24,1997,19.2,13,5,2,6,5,3,15,20.0,12,18,0,18,4,17,1,0,2023
ITA-Serie A,2022,Atalanta,Berat Djimsiti,ALB,DF,29,1993,20.0,34,19,21,13,0,17,25,68.0,8,17,7,10,36,70,74,1,2023
ITA-Serie A,2022,Atalanta,Brandon Soppy,FRA,DF,20,2002,7.1,8,5,4,4,0,3,9,33.3,6,10,0,10,3,11,7,0,2023
ITA-Serie A,2022,Atalanta,Caleb Okoli,ITA,DF,21,2001,10.7,21,17,14,6,1,10,25,40.0,15,10,5,5,30,51,44,3,2023
ITA-Serie A,2022,Atalanta,Davide Zappacosta,ITA,DF,30,1992,16.3,34,18,17,12,5,15,22,68.2,7,23,2,21,9,43,16,0,2023
ITA-Serie A,2022,Atalanta,Duván Zapata,COL,FW,31,1991,15.4,8,4,1,3,4,3,5,60.0,2,6,2,4,4,12,17,1,2023
ITA-Serie A,2022,Atalanta,Francesco Rossi,ITA,GK,31,1991,0.0,0,0,0,0,0,0,0,,0,0,0,0,0,0,0,0,2023
ITA-Serie A,2022,Atalanta,Giorgio Scalvini,ITA,DF,18,2003,25.9,54,29,30,18,6,29,55,52.7,26,36,13,23,56,110,57,2,2023
ITA-Serie A,2022,Atalanta,Hans Hateboer,NED,DF,28,1994,15.5,21,13,11,8,2,11,27,40.7,16,23,4,19,12,33,25,0,2023
ITA-Serie A,2022,Atalanta,Jeremie Boga,CIV,"MF,FW",25,1997,8.7,9,5,3,2,4,2,5,40.0,3,6,0,6,1,10,1,0,2023
ITA-Serie A,2022,Atalanta,Joakim Mæhle,DEN,"DF,MF",25,1997,24.5,32,18,12,7,13,22,39,56.4,17,29,6,23,24,56,26,0,2023
ITA-Serie A,2022,Atalanta,José Luis Palomino,ARG,DF,32,1990,8.4,23,14,16,7,0,11,19,57.9,8,11,4,7,28,51,20,0,2023
ITA-Serie A,2022,Atalanta,Juan Musso,ARG,GK,28,1994,23.1,1,1,1,0,0,1,1,100.0,0,0,0,0,0,1,11,1,2023
ITA-Serie A,2022,Atalanta,Luis Muriel,COL,"FW,MF",31,1991,11.9,9,6,2,3,4,5,16,31.3,11,9,0,9,2,11,2,0,2023
ITA-Serie A,2022,Atalanta,Lukáš Vorlický,CZE,"MF,FW",20,2002,0.3,0,0,0,0,0,0,0,,0,0,0,0,1,1,0,0,2023
ITA-Serie A,2022,Atalanta,Marco Sportiello,ITA,GK,30,1992,14.9,1,0,1,0,0,1,3,33.3,2,0,0,0,0,1,2,0,2023
ITA-Serie A,2022,Atalanta,Mario Pašalić,CRO,"MF,FW",27,1995,19.7,22,10,6,14,2,6,23,26.1,17,22,4,18,21,43,13,0,2023
ITA-Serie A,2022,Atalanta,Marten de Roon,NED,MF,31,1991,32.9,77,39,37,35,5,37,81,45.7,44,37,4,33,36,113,58,0,2023
ITA-Serie A,2022,Atalanta,Matteo Ruggeri,ITA,"DF,MF",20,2002,9.2,17,12,5,9,3,8,16,50.0,8,14,3,11,12,29,16,0,2023
ITA-Serie A,2022,Atalanta,Merih Demiral,TUR,DF,24,1998,17.1,41,29,30,11,0,26,36,72.2,10,24,7,17,24,65,57,1,2023
ITA-Serie A,2022,Atalanta,Nadir Zortea,ITA,"DF,MF",23,1999,2.5,10,5,3,7,0,3,4,75.0,1,4,0,4,0,10,4,0,2023
ITA-Serie A,2022,Atalanta,Rafael Tolói,ITA,DF,31,1990,30.9,69,44,37,32,0,35,64,54.7,29,42,18,24,57,126,88,1,2023
ITA-Serie A,2022,Atalanta,Rasmus Højlund,DEN,FW,19,2003,20.4,4,3,0,2,2,1,6,16.7,5,9,1,8,1,5,5,0,2023
ITA-Serie A,2022,Atalanta,Ruslan Malinovskyi,UKR,"MF,FW",29,1993,6.1,14,8,5,6,3,6,17,35.3,11,8,1,7,5,19,2,0,2023
ITA-Serie A,2022,Atalanta,Teun Koopmeiners,NED,MF,24,1998,31.8,46,26,15,24,7,28,55,50.9,27,41,5,36,19,65,36,2,2023
ITA-Serie A,2022,Atalanta,Tommaso De Nipoti,ITA,MF,19,2003,0.0,1,0,0,1,0,0,0,,0,0,0,0,0,1,0,0,2023
ITA-Serie A,2022,Atalanta,Éderson,BRA,MF,23,1999,24.6,67,34,18,42,7,29,66,43.9,37,56,7,49,36,103,31,0,2023
ITA-Serie A,2022,Bologna,Adama Soumaoro,FRA,DF,30,1992,20.7,25,17,11,12,2,5,7,71.4,2,18,13,5,15,40,75,1,2023
ITA-Serie A,2022,Bologna,Andrea Cambiaso,ITA,DF,22,2000,24.1,57,34,34,20,3,28,65,43.1,37,26,2,24,26,83,33,1,2023
ITA-Serie A,2022,Bologna,Antonio Raimondo,ITA,FW,18,2004,0.2,0,0,0,0,0,0,0,,0,0,0,0,0,0,1,0,2023
ITA-Serie A,2022,Bologna,Charalambos Lykogiannis,GRE,DF,28,1993,12.3,16,8,5,6,5,5,13,38.5,8,9,4,5,15,31,30,0,2023
ITA-Serie A,2022,Bologna,Denso Kasius,NED,DF,19,2002,3.8,12,6,7,4,1,8,10,80.0,2,6,3,3,3,15,6,0,2023
ITA-Serie A,2022,Bologna,Emanuel Vignato,ITA,"MF,FW",21,2000,2.7,4,4,2,2,0,2,4,50.0,2,2,0,2,3,7,0,0,2023
ITA-Serie A,2022,Bologna,Francesco Bardi,ITA,GK,30,1992,1.0,0,0,0,0,0,0,0,,0,0,0,0,0,0,0,0,2023
ITA-Serie A,2022,Bologna,Gary Medel,CHI,"MF,DF",34,1987,16.4,25,15,16,7,2,9,16,56.3,7,17,10,7,28,53,34,0,2023
ITA-Serie A,2022,Bologna,Giorgos Kyriakopoulos,GRE,"DF,FW",26,1996,7.8,13,6,4,5,4,10,23,43.5,13,14,2,12,4,17,10,0,2023
ITA-Serie A,2022,Bologna,Jerdy Schouten,NED,MF,25,1997,27.9,63,38,28,33,2,27,49,55.1,22,40,17,23,40,103,43,1,2023
ITA-Serie A,2022,Bologna,Jhon Lucumí,COL,DF,24,1998,32.2,53,37,39,13,1,24,43,55.8,19,43,26,17,35,88,100,1,2023
ITA-Serie A,2022,Bologna,Joaquin Sosa,URU,DF,20,2002,7.6,6,2,5,1,0,4,18,22.2,14,5,3,2,6,12,31,0,2023
ITA-Serie A,2022,Bologna,Joshua Zirkzee,NED,FW,21,2001,9.1,4,2,1,1,2,2,7,28.6,5,4,1,3,4,8,4,0,2023
ITA-Serie A,2022,Bologna,Kevin Bonifazi,ITA,DF,26,1996,10.0,13,8,7,6,0,6,12,50.0,6,11,8,3,12,25,39,0,2023
ITA-Serie A,2022,Bologna,Lewis Ferguson,SCO,"MF,FW",22,1999,25.7,44,25,16,20,8,20,40,50.0,20,22,7,15,19,63,25,0,2023
ITA-Serie A,2022,Bologna,Lorenzo De Silvestri,ITA,DF,34,1988,7.5,3,2,2,0,1,3,7,42.9,4,6,5,1,3,6,20,0,2023
ITA-Serie A,2022,Bologna,Marko Arnautović,AUT,FW,33,1989,17.0,9,6,2,5,2,1,6,16.7,5,11,1,10,2,11,10,0,2023
ITA-Serie A,2022,Bologna,Michel Aebischer,SUI,"FW,MF",25,1997,17.1,12,6,3,6,3,2,18,11.1,16,14,2,12,7,19,9,0,2023
ITA-Serie A,2022,Bologna,Musa Barrow,GAM,"FW,MF",23,1998,21.8,21,4,10,6,5,8,14,57.1,6,25,1,24,1,22,7,0,2023
ITA-Serie A,2022,Bologna,Nicola Sansone,ITA,FW,30,1991,8.2,12,4,6,4,2,5,10,50.0,5,0,0,0,0,12,4,0,2023
ITA-Serie A,2022,Bologna,Nicolás Domínguez,ARG,MF,24,1998,25.6,79,49,34,33,12,39,76,51.3,37,29,3,26,21,100,29,1,2023
ITA-Serie A,2022,Bologna,Niklas Pyyhtiä,FIN,MF,18,2003,1.2,1,0,0,1,0,0,1,0.0,1,1,1,0,1,2,4,0,2023
ITA-Serie A,2022,Bologna,Nikola Moro,CRO,MF,24,1998,13.6,32,21,11,15,6,14,36,38.9,22,15,2,13,8,40,18,0,2023
ITA-Serie A,2022,Bologna,Riccardo Orsolini,ITA,FW,25,1997,23.6,30,19,15,10,5,17,41,41.5,24,29,3,26,8,38,18,0,2023
ITA-Serie A,2022,Bologna,Roberto Soriano,ITA,"FW,MF",31,1991,14.7,31,16,9,16,6,13,25,52.0,12,23,2,21,6,37,14,0,2023
ITA-Serie A,2022,Bologna,Stefan Posch,AUT,DF,25,1997,28.1,81,43,41,29,11,44,75,58.7,31,44,15,29,35,116,69,0,2023
ITA-Serie A,2022,Bologna,Łukasz Skorupski,POL,GK,31,1991,37.0,2,1,2,0,0,1,2,50.0,1,0,0,0,0,2,19,2,2023
ITA-Serie A,2022,Cremonese,Alberto Basso,ITA,MF,18,2004,0.2,0,0,0,0,0,0,0,,0,0,0,0,0,0,0,0,2023
ITA-Serie A,2022,Cremonese,Alex Ferrari,ITA,DF,28,1994,11.2,40,23,32,7,1,28,42,66.7,14,19,4,15,25,65,45,1,2023
ITA-Serie A,2022,Cremonese,Charles Pickel,SUI,MF,25,1997,27.6,55,23,25,26,4,32,57,56.1,25,37,5,32,24,79,36,1,2023
ITA-Serie A,2022,Cremonese,Christian Acella,ITA,MF,20,2002,0.2,1,0,1,0,0,0,2,0.0,2,0,0,0,0,1,0,0,2023
ITA-Serie A,2022,Cremonese,Cristian Buonaiuto,ITA,"MF,FW",29,1992,10.9,25,16,8,11,6,12,26,46.2,14,11,0,11,14,39,7,0,2023
ITA-Serie A,2022,Cremonese,Cyriel Dessers,NGA,FW,27,1994,17.6,11,4,4,4,3,2,6,33.3,4,14,2,12,3,14,5,0,2023
ITA-Serie A,2022,Cremonese,Daniel Ciofani,ITA,FW,37,1985,11.8,6,3,1,2,3,4,7,57.1,3,7,1,6,2,8,10,0,2023
ITA-Serie A,2022,Cremonese,David Okereke,NGA,"FW,MF",24,1997,25.2,12,8,4,5,3,3,16,18.8,13,23,3,20,10,22,12,0,2023
ITA-Serie A,2022,Cremonese,Emanuel Aiwum,AUT,DF,21,2000,18.4,55,34,36,17,2,33,47,70.2,14,28,16,12,25,80,52,3,2023
ITA-Serie A,2022,Cremonese,Emanuele Valeri,ITA,DF,23,1998,30.9,54,27,29,21,4,29,69,42.0,40,17,3,14,22,76,44,1,2023
ITA-Serie A,2022,Cremonese,Felix Afena-Gyan,GHA,"FW,MF",19,2003,9.1,7,3,4,1,2,2,10,20.0,8,5,1,4,1,8,6,0,2023
ITA-Serie A,2022,Cremonese,Frank Tsadjout,ITA,FW,23,1999,11.7,10,8,3,6,1,3,9,33.3,6,7,1,6,8,18,9,0,2023
ITA-Serie A,2022,Cremonese,Giacomo Quagliata,ITA,DF,22,2000,7.8,10,8,7,1,2,5,11,45.5,6,7,2,5,11,21,8,0,2023
ITA-Serie A,2022,Cremonese,Gonzalo Escalante,ARG,MF,29,1993,6.2,16,8,8,8,0,10,13,76.9,3,7,1,6,10,26,4,0,2023
ITA-Serie A,2022,Cremonese,Ionuț Radu,ROU,GK,25,1997,9.0,0,0,0,0,0,0,0,,0,0,0,0,0,0,1,3,2023
ITA-Serie A,2022,Cremonese,Jack Hendry,SCO,DF,27,1995,2.4,0,0,0,0,0,0,1,0.0,1,2,1,1,1,1,7,0,2023
ITA-Serie A,2022,Cremonese,Jaime Báez,URU,DF,27,1995,1.1,4,2,3,0,1,3,6,50.0,3,0,0,0,0,4,2,1,2023
ITA-Serie A,2022,Cremonese,Johan Vásquez,MEX,DF,23,1998,20.1,41,26,34,7,0,18,39,46.2,21,27,20,7,45,86,93,1,2023
ITA-Serie A,2022,Cremonese,Leonardo Sernicola,ITA,DF,25,1997,25.7,45,33,25,13,7,29,43,67.4,14,23,6,17,38,83,55,0,2023
ITA-Serie A,2022,Cremonese,Luca Zanimacchia,ITA,"MF,FW",24,1998,8.3,21,13,11,6,4,8,21,38.1,13,9,0,9,9,30,5,0,2023
ITA-Serie A,2022,Cremonese,Luka Lochoshvili,GEO,DF,24,1998,20.4,45,19,30,11,4,22,31,71.0,9,31,10,21,22,67,89,0,2023
ITA-Serie A,2022,Cremonese,Marco Benassi,ITA,MF,27,1994,11.1,26,15,9,11,6,15,24,62.5,9,13,1,12,12,38,19,0,2023
ITA-Serie A,2022,Cremonese,Marco Carnesecchi,ITA,GK,22,2000,27.0,1,1,1,0,0,1,2,50.0,1,0,0,0,0,1,11,2,2023
ITA-Serie A,2022,Cremonese,Matteo Bianchetti,ITA,DF,29,1993,23.7,32,19,21,9,2,20,32,62.5,12,31,17,14,20,52,111,0,2023
ITA-Serie A,2022,Cremonese,Michele Castagnetti,ITA,MF,32,1989,15.7,46,21,20,24,2,18,54,33.3,36,14,4,10,15,61,22,0,2023
ITA-Serie A,2022,Cremonese,Mouhamadou Sarr,SEN,GK,25,1997,2.0,0,0,0,0,0,0,0,,0,0,0,0,0,0,2,0,2023
ITA-Serie A,2022,Cremonese,Pablo Galdames Millán,CHI,MF,25,1996,8.2,14,10,8,3,3,5,33,15.2,28,13,2,11,10,24,13,0,2023
ITA-Serie A,2022,Cremonese,Paolo Ghiglione,ITA,DF,25,1997,7.9,16,11,10,3,3,10,23,43.5,13,9,4,5,4,20,12,0,2023
ITA-Serie A,2022,Cremonese,Samuel Di Carmine,ITA,"FW,MF",33,1988,0.3,0,0,0,0,0,0,0,,0,0,0,0,0,0,0,0,2023
ITA-Serie A,2022,Cremonese,Santiago Ascacíbar,ARG,MF,25,1997,8.1,29,14,17,10,2,14,35,40.0,21,14,2,12,13,42,11,0,2023
ITA-Serie A,2022,Cremonese,Soualiho Meïté,FRA,MF,28,1994,26.3,47,31,25,15,7,22,46,47.8,24,27,6,21,27,74,36,0,2023
ITA-Serie A,2022,Cremonese,Tommaso Milanese,ITA,MF,20,2002,0.3,0,0,0,0,0,0,0,,0,1,1,0,0,0,0,0,2023
ITA-Serie A,2022,Cremonese,Vlad Chiricheș,ROU,DF,32,1989,10.9,35,20,27,7,1,16,24,66.7,8,36,23,13,22,57,44,0,2023
ITA-Serie A,2022,Empoli,Alberto Grassi,ITA,MF,27,1995,13.3,26,21,13,13,0,15,24,62.5,9,23,12,11,27,53,45,0,2023
ITA-Serie A,2022,Empoli,Ardian Ismajli,ALB,DF,25,1996,23.3,40,32,25,15,0,18,24,75.0,6,47,31,16,27,67,120,0,2023
ITA-Serie A,2022,Empoli,Duccio Degl'Innocenti,ITA,MF,19,2003,0.0,0,0,0,0,0,0,0,,0,0,0,0,1,1,0,0,2023
ITA-Serie A,2022,Empoli,Emanuel Vignato,ITA,"MF,FW",21,2000,0.6,2,0,2,0,0,0,0,,0,0,0,0,0,2,1,0,2023
ITA-Serie A,2022,Empoli,Emmanuel Ekong,SWE,"FW,MF",20,2002,0.2,0,0,0,0,0,0,0,,0,0,0,0,0,0,0,0,2023
ITA-Serie A,2022,Empoli,Fabiano Parisi,ITA,DF,21,2000,31.4,65,35,37,21,7,30,72,41.7,42,51,16,35,41,106,91,0,2023
ITA-Serie A,2022,Empoli,Filippo Bandinelli,ITA,MF,27,1995,25.1,55,34,19,26,10,17,45,37.8,28,20,7,13,18,73,40,0,2023
ITA-Serie A,2022,Empoli,Francesco Caputo,ITA,FW,34,1987,19.0,2,2,0,1,1,0,1,0.0,1,7,2,5,2,4,8,0,2023
ITA-Serie A,2022,Empoli,Guglielmo Vicario,ITA,GK,25,1996,30.9,1,1,1,0,0,1,2,50.0,1,0,0,0,0,1,15,2,2023
ITA-Serie A,2022,Empoli,Herculano Nabian,POR,MF,18,2004,0.0,0,0,0,0,0,0,0,,0,0,0,0,0,0,0,0,2023
ITA-Serie A,2022,Empoli,Jacopo Fazzini,ITA,MF,19,2003,9.2,31,17,20,8,3,18,34,52.9,16,15,3,12,7,38,19,0,2023
ITA-Serie A,2022,Empoli,Jean-Daniel Akpa-Akpro,CIV,"MF,FW",29,1992,15.1,53,37,25,19,9,23,42,54.8,19,35,4,31,13,66,27,0,2023
ITA-Serie A,2022,Empoli,Koni De Winter,BEL,DF,20,2002,11.4,14,9,11,3,0,5,13,38.5,8,14,12,2,6,20,65,0,2023
ITA-Serie A,2022,Empoli,Liam Henderson,SCO,MF,26,1996,11.2,13,10,6,5,2,4,21,19.0,17,10,2,8,10,23,10,0,2023
ITA-Serie A,2022,Empoli,Liberato Cacace,NZL,DF,21,2000,6.5,25,10,12,8,5,9,15,60.0,6,15,7,8,4,29,16,0,2023
ITA-Serie A,2022,Empoli,Lorenzo Tonelli,ITA,DF,32,1990,0.2,0,0,0,0,0,0,1,0.0,1,0,0,0,0,0,0,0,2023
ITA-Serie A,2022,Empoli,Marko Pjaca,CRO,"MF,FW",27,1995,5.8,4,3,3,1,0,3,5,60.0,2,3,0,3,3,7,3,0,2023
ITA-Serie A,2022,Empoli,Martin Satriano,URU,FW,21,2001,18.9,13,8,5,6,2,6,14,42.9,8,5,0,5,3,16,22,0,2023
ITA-Serie A,2022,Empoli,Mattia Destro,ITA,"FW,MF",31,1991,6.4,1,1,0,1,0,0,0,,0,2,0,2,1,2,5,0,2023
ITA-Serie A,2022,Empoli,Nedim Bajrami,ALB,"MF,FW",23,1999,10.4,8,4,3,3,2,4,6,66.7,2,5,0,5,7,15,4,0,2023
ITA-Serie A,2022,Empoli,Nicolas Haas,SUI,MF,26,1996,12.8,27,13,16,6,5,12,24,50.0,12,16,4,12,8,35,27,0,2023
ITA-Serie A,2022,Empoli,Nicolò Cambiaghi,ITA,"FW,MF",21,2000,14.3,30,22,11,12,7,8,27,29.6,19,19,1,18,9,39,8,0,2023
ITA-Serie A,2022,Empoli,Petar Stojanović,SVN,DF,26,1995,17.0,42,22,28,10,4,26,43,60.5,17,17,5,12,11,53,55,0,2023
ITA-Serie A,2022,Empoli,Roberto Piccoli,ITA,FW,21,2001,5.7,1,1,1,0,0,0,3,0.0,3,4,1,3,1,2,9,0,2023
ITA-Serie A,2022,Empoli,Răzvan Marin,ROU,MF,26,1996,28.2,44,22,22,21,1,19,40,47.5,21,29,11,18,14,58,33,0,2023
ITA-Serie A,2022,Empoli,Sam Lammers,NED,FW,25,1997,9.8,20,10,5,9,6,7,11,63.6,4,4,1,3,3,23,8,0,2023
ITA-Serie A,2022,Empoli,Samir Ujkani,KVX,GK,34,1988,0.1,0,0,0,0,0,0,0,,0,0,0,0,0,0,0,0,2023
ITA-Serie A,2022,Empoli,Samuele Perisan,ITA,GK,24,1997,7.0,0,0,0,0,0,0,0,,0,0,0,0,0,0,2,0,2023
ITA-Serie A,2022,Empoli,Sebastian Walukiewicz,POL,DF,22,2000,6.7,9,6,7,2,0,4,6,66.7,2,10,9,1,7,16,30,0,2023
ITA-Serie A,2022,Empoli,Sebastiano Luperto,ITA,DF,25,1996,34.8,33,18,24,8,1,9,20,45.0,11,54,42,12,43,76,163,1,2023
ITA-Serie A,2022,Empoli,Tommaso Baldanzi,ITA,MF,19,2003,19.7,25,12,9,13,3,7,32,21.9,25,21,1,20,2,27,5,0,2023
ITA-Serie A,2022,Empoli,Tyronne Ebuehi,NGA,DF,26,1995,21.4,22,14,11,7,4,9,13,69.2,4,23,12,11,12,34,79,1,2023
ITA-Serie A,2022,Fiorentina,Aleksa Terzić,SRB,DF,22,1999,10.4,16,9,9,4,3,11,21,52.4,10,13,4,9,5,21,16,0,2023
ITA-Serie A,2022,Fiorentina,Alessandro Bianco,ITA,MF,19,2002,1.7,5,2,2,3,0,2,3,66.7,1,1,0,1,0,5,0,0,2023
ITA-Serie A,2022,Fiorentina,Alfred Duncan,GHA,MF,29,1993,12.3,18,10,0,17,1,10,21,47.6,11,9,0,9,8,26,6,0,2023
ITA-Serie A,2022,Fiorentina,Antonín Barák,CZE,MF,27,1994,20.0,21,9,5,7,9,6,16,37.5,10,16,2,14,3,24,13,0,2023
ITA-Serie A,2022,Fiorentina,Arthur,BRA,FW,24,1998,15.9,9,2,1,4,4,4,8,50.0,4,10,1,9,1,10,12,0,2023
ITA-Serie A,2022,Fiorentina,Christian Kouamé,CIV,FW,24,1997,20.7,27,18,8,10,9,7,14,50.0,7,15,3,12,12,39,8,0,2023
ITA-Serie A,2022,Fiorentina,Cristiano Biraghi,ITA,DF,29,1992,28.3,65,38,29,29,7,32,65,49.2,33,32,7,25,14,79,42,1,2023
ITA-Serie A,2022,Fiorentina,Dodô,BRA,DF,23,1998,25.9,40,22,20,14,6,22,46,47.8,24,26,2,24,25,65,37,0,2023
ITA-Serie A,2022,Fiorentina,Gaetano Castrovilli,ITA,MF,25,1997,8.0,10,8,1,7,2,2,9,22.2,7,5,1,4,8,18,5,0,2023
ITA-Serie A,2022,Fiorentina,Giacomo Bonaventura,ITA,MF,32,1989,21.2,35,23,14,15,6,24,37,64.9,13,14,0,14,16,51,5,1,2023
ITA-Serie A,2022,Fiorentina,Igor,BRA,DF,24,1998,22.9,43,29,21,18,4,20,27,74.1,7,33,14,19,25,68,56,2,2023
ITA-Serie A,2022,Fiorentina,Jonathan Ikone,FRA,FW,24,1998,22.3,16,8,5,6,5,5,14,35.7,9,18,1,17,4,20,3,0,2023
ITA-Serie A,2022,Fiorentina,Josip Brekalo,CRO,"FW,MF",24,1998,2.5,2,1,0,1,1,1,4,25.0,3,1,0,1,1,3,1,0,2023
ITA-Serie A,2022,Fiorentina,Lorenzo Venuti,ITA,DF,27,1995,10.3,18,7,6,11,1,11,18,61.1,7,7,2,5,5,23,17,2,2023
ITA-Serie A,2022,Fiorentina,Luca Ranieri,ITA,DF,23,1999,5.6,9,4,6,3,0,6,9,66.7,3,5,3,2,11,20,15,1,2023
ITA-Serie A,2022,Fiorentina,Lucas Martínez Quarta,ARG,DF,26,1996,24.1,80,48,44,32,4,42,61,68.9,19,41,19,22,48,128,78,1,2023
ITA-Serie A,2022,Fiorentina,Luka Jović,SRB,"FW,MF",24,1997,17.0,6,3,1,4,1,2,8,25.0,6,7,2,5,2,8,10,0,2023
ITA-Serie A,2022,Fiorentina,Marco Benassi,ITA,DF,27,1994,1.0,3,3,2,0,1,3,4,75.0,1,0,0,0,1,4,1,0,2023
ITA-Serie A,2022,Fiorentina,Michele Cerofolini,ITA,GK,23,1999,5.0,0,0,0,0,0,0,0,,0,0,0,0,1,1,2,0,2023
ITA-Serie A,2022,Fiorentina,Nicolás González,ARG,"FW,MF",24,1998,15.0,17,10,3,10,4,5,16,31.3,11,14,0,14,4,21,6,0,2023
ITA-Serie A,2022,Fiorentina,Nikola Milenković,SRB,DF,24,1997,23.7,40,25,20,17,3,18,27,66.7,9,27,14,13,22,62,72,0,2023
ITA-Serie A,2022,Fiorentina,Pierluigi Gollini,ITA,GK,27,1995,3.0,1,0,1,0,0,1,1,100.0,0,0,0,0,0,1,2,0,2023
ITA-Serie A,2022,Fiorentina,Pietro Terracciano,ITA,GK,32,1990,29.0,2,1,2,0,0,2,3,66.7,1,0,0,0,1,3,14,0,2023
ITA-Serie A,2022,Fiorentina,Riccardo Saponara,ITA,FW,30,1991,13.4,10,5,3,6,1,5,9,55.6,4,7,1,6,5,15,9,1,2023
ITA-Serie A,2022,Fiorentina,Riccardo Sottil,ITA,FW,23,1999,9.3,4,3,2,0,2,2,5,40.0,3,2,0,2,0,4,0,0,2023
ITA-Serie A,2022,Fiorentina,Rolando Mandragora,ITA,MF,25,1997,21.7,42,24,12,22,8,23,52,44.2,29,25,3,22,16,58,21,0,2023
ITA-Serie A,2022,Fiorentina,Salvatore Sirigu,ITA,GK,35,1987,1.0,0,0,0,0,0,0,0,,0,0,0,0,0,0,1,0,2023
ITA-Serie A,2022,Fiorentina,Sofyan Amrabat,MAR,MF,25,1996,22.2,39,24,15,17,7,16,29,55.2,13,23,5,18,21,60,18,2,2023
ITA-Serie A,2022,Fiorentina,Szymon Żurkowski,POL,MF,24,1997,0.4,0,0,0,0,0,0,0,,0,0,0,0,0,0,0,0,2023
ITA-Serie A,2022,Fiorentina,Youssef Maleh,MAR,MF,23,1998,3.3,3,1,0,3,0,0,4,0.0,4,5,0,5,1,4,3,0,2023
ITA-Serie A,2022,Hellas Verona,Adolfo Gaich,ARG,FW,23,1999,8.1,5,3,0,3,2,1,6,16.7,5,7,2,5,3,8,7,1,2023
ITA-Serie A,2022,Hellas Verona,Adrien Tameze,CMR,MF,28,1994,33.7,51,30,21,26,4,28,63,44.4,35,51,14,37,37,88,55,2,2023
ITA-Serie A,2022,Hellas Verona,Ajdin Hrustic,AUS,MF,26,1996,2.5,2,1,1,1,0,1,2,50.0,1,2,0,2,0,2,2,1,2023
ITA-Serie A,2022,Hellas Verona,Alessandro Cortinovis,ITA,MF,21,2001,0.1,1,0,1,0,0,0,0,,0,1,0,1,0,1,0,0,2023
ITA-Serie A,2022,Hellas Verona,Antonín Barák,CZE,MF,27,1994,0.3,0,0,0,0,0,0,0,,0,0,0,0,0,0,0,0,2023
ITA-Serie A,2022,Hellas Verona,Bruno Amione,ARG,DF,20,2002,0.6,1,1,1,0,0,1,2,50.0,1,1,0,1,0,1,4,0,2023
ITA-Serie A,2022,Hellas Verona,Cyril Ngonge,BEL,"MF,FW",22,2000,8.3,7,3,2,2,3,3,11,27.3,8,7,0,7,6,13,4,0,2023
ITA-Serie A,2022,Hellas Verona,Darko Lazović,SRB,"MF,DF",31,1990,24.9,24,13,9,12,3,13,29,44.8,16,14,3,11,16,40,19,0,2023
ITA-Serie A,2022,Hellas Verona,Davide Faraoni,ITA,DF,30,1991,16.5,34,24,19,13,2,16,41,39.0,25,30,11,19,15,49,37,0,2023
ITA-Serie A,2022,Hellas Verona,Deyovaisio Zeefuik,NED,DF,24,1998,0.1,1,1,0,1,0,0,0,,0,0,0,0,0,1,0,0,2023
ITA-Serie A,2022,Hellas Verona,Diego Coppola,ITA,DF,18,2003,13.1,25,17,15,10,0,11,24,45.8,13,20,6,14,14,39,38,0,2023
ITA-Serie A,2022,Hellas Verona,Fabio Depaoli,ITA,DF,25,1997,24.1,48,28,25,16,7,25,44,56.8,19,32,6,26,18,66,33,3,2023
ITA-Serie A,2022,Hellas Verona,Federico Ceccherini,ITA,DF,30,1992,15.7,25,19,15,9,1,13,23,56.5,10,17,10,7,19,44,55,0,2023
ITA-Serie A,2022,Hellas Verona,Filippo Terracciano,ITA,"DF,MF",19,2003,9.1,20,13,11,7,2,15,20,75.0,5,7,4,3,10,30,14,0,2023
ITA-Serie A,2022,Hellas Verona,Giangiacomo Magnani,ITA,DF,26,1995,17.0,33,22,20,11,2,19,25,76.0,6,20,15,5,21,54,76,0,2023
ITA-Serie A,2022,Hellas Verona,Ibrahim Sulemana,GHA,MF,19,2003,7.2,19,13,10,7,2,6,12,50.0,6,8,2,6,14,33,15,0,2023
ITA-Serie A,2022,Hellas Verona,Isak Hien,SWE,DF,23,1999,29.0,73,36,54,19,0,38,61,62.3,23,40,17,23,31,104,92,1,2023
ITA-Serie A,2022,Hellas Verona,Ivan Ilić,SRB,MF,21,2001,9.5,16,10,9,7,0,6,11,54.5,5,10,1,9,8,24,14,0,2023
ITA-Serie A,2022,Hellas Verona,Jayden Braaf,NED,"MF,FW",19,2002,3.2,5,3,2,3,0,0,0,,0,1,0,1,2,7,1,0,2023
ITA-Serie A,2022,Hellas Verona,Josh Doig,SCO,DF,20,2002,15.0,19,8,6,7,6,6,16,37.5,10,25,6,19,11,30,13,1,2023
ITA-Serie A,2022,Hellas Verona,Juan Cabal,COL,DF,21,2001,4.9,10,6,7,3,0,7,12,58.3,5,8,5,3,13,23,12,0,2023
ITA-Serie A,2022,Hellas Verona,Kevin Lasagna,ITA,"FW,MF",29,1992,17.5,12,6,7,3,2,6,14,42.9,8,17,1,16,5,17,13,0,2023
ITA-Serie A,2022,Hellas Verona,Koray Günter,GER,DF,27,1994,11.1,10,6,1,8,1,4,7,57.1,3,24,15,9,30,40,46,0,2023
ITA-Serie A,2022,Hellas Verona,Lorenzo Montipò,ITA,GK,26,1996,37.0,1,0,1,0,0,0,3,0.0,3,1,0,1,0,1,26,3,2023
ITA-Serie A,2022,Hellas Verona,Martin Hongla,CMR,MF,24,1998,5.8,8,5,4,4,0,5,5,100.0,0,7,1,6,6,14,9,0,2023
ITA-Serie A,2022,Hellas Verona,Miguel Veloso,POR,MF,36,1986,12.9,33,10,20,12,1,16,26,61.5,10,26,6,20,6,39,14,0,2023
ITA-Serie A,2022,Hellas Verona,Milan Đurić,BIH,FW,32,1990,15.2,2,1,1,0,1,1,3,33.3,2,7,4,3,1,3,24,0,2023
ITA-Serie A,2022,Hellas Verona,Oliver Abildgaard,DEN,MF,26,1996,6.6,10,6,6,3,1,7,16,43.8,9,7,1,6,5,15,17,0,2023
ITA-Serie A,2022,Hellas Verona,Ondrej Duda,SVK,MF,27,1994,11.8,22,14,7,12,3,9,16,56.3,7,11,0,11,13,35,8,0,2023
ITA-Serie A,2022,Hellas Verona,Panagiotis Retsos,GRE,DF,23,1998,1.4,5,4,2,2,1,3,3,100.0,0,4,1,3,2,7,3,0,2023
ITA-Serie A,2022,Hellas Verona,Paweł Dawidowicz,POL,DF,27,1995,18.1,48,31,28,17,3,22,31,71.0,9,14,9,5,23,71,71,0,2023
ITA-Serie A,2022,Hellas Verona,Roberto Piccoli,ITA,FW,21,2001,2.1,1,0,1,0,0,0,2,0.0,2,2,0,2,0,1,2,0,2023
ITA-Serie A,2022,Hellas Verona,Simone Perilli,ITA,GK,27,1995,1.0,0,0,0,0,0,0,0,,0,0,0,0,0,0,0,0,2023
ITA-Serie A,2022,Hellas Verona,Simone Verdi,ITA,"MF,FW",30,1992,12.2,15,10,7,5,3,6,17,35.3,11,8,1,7,0,15,2,0,2023
ITA-Serie A,2022,Hellas Verona,Thomas Henry,FRA,FW,27,1994,11.4,5,3,1,1,3,1,5,20.0,4,6,2,4,0,5,14,0,2023
ITA-Serie A,2022,Hellas Verona,Yayah Kallon,SLE,"MF,FW",21,2001,9.6,14,10,5,4,5,7,12,58.3,5,10,0,10,8,22,5,0,2023
ITA-Serie A,2022,Inter,Alessandro Bastoni,ITA,DF,23,1999,24.0,41,20,20,14,7,11,27,40.7,16,27,13,14,24,65,45,0,2023
ITA-Serie A,2022,Inter,Alex Cordaz,ITA,GK,39,1983,0.3,0,0,0,0,0,0,0,,0,0,0,0,0,0,0,0,2023
ITA-Serie A,2022,Inter,André Onana,CMR,GK,26,1996,24.0,0,0,0,0,0,0,1,0.0,1,0,0,0,0,0,5,0,2023
ITA-Serie A,2022,Inter,Danilo D'Ambrosio,ITA,DF,33,1988,8.1,25,17,17,7,1,15,27,55.6,12,12,4,8,10,35,17,0,2023
ITA-Serie A,2022,Inter,Denzel Dumfries,NED,DF,26,1996,24.6,35,18,17,13,5,22,34,64.7,12,33,9,24,12,47,26,0,2023
ITA-Serie A,2022,Inter,Edin Džeko,BIH,FW,36,1986,19.2,3,2,0,3,0,0,4,0.0,4,15,1,14,3,6,25,0,2023
ITA-Serie A,2022,Inter,Federico Dimarco,ITA,DF,24,1997,23.0,31,25,6,18,7,9,19,47.4,10,15,4,11,18,49,20,0,2023
ITA-Serie A,2022,Inter,Francesco Acerbi,ITA,DF,34,1988,26.9,33,19,22,7,4,20,27,74.1,7,25,18,7,41,74,85,2,2023
ITA-Serie A,2022,Inter,Hakan Çalhanoğlu,TUR,MF,28,1994,26.3,48,27,17,26,5,16,43,37.2,27,30,5,25,25,73,13,1,2023
ITA-Serie A,2022,Inter,Henrikh Mkhitaryan,ARM,MF,33,1989,22.1,41,26,13,22,6,14,41,34.1,27,27,4,23,21,62,18,0,2023
ITA-Serie A,2022,Inter,Joaquín Correa,ARG,FW,27,1994,10.6,12,7,3,6,3,4,15,26.7,11,4,1,3,3,15,0,0,2023
ITA-Serie A,2022,Inter,Kristjan Asllani,ALB,MF,20,2002,6.6,11,5,1,8,2,7,10,70.0,3,3,1,2,6,17,4,0,2023
ITA-Serie A,2022,Inter,Lautaro Martínez,ARG,FW,24,1997,28.6,25,14,3,15,7,7,23,30.4,16,31,1,30,13,38,16,1,2023
ITA-Serie A,2022,Inter,Marcelo Brozović,CRO,MF,29,1992,19.7,37,22,13,22,2,11,37,29.7,26,23,7,16,22,59,28,0,2023
ITA-Serie A,2022,Inter,Matteo Darmian,ITA,DF,32,1989,22.5,56,30,29,15,12,31,47,66.0,16,33,5,28,21,77,36,0,2023
ITA-Serie A,2022,Inter,Mattia Zanotti,ITA,DF,19,2003,0.3,0,0,0,0,0,0,1,0.0,1,2,0,2,0,0,0,0,2023
ITA-Serie A,2022,Inter,Milan Škriniar,SVK,DF,27,1995,19.7,29,18,14,11,4,18,32,56.3,14,18,13,5,13,42,46,3,2023
ITA-Serie A,2022,Inter,Nicolò Barella,ITA,MF,25,1997,29.0,49,25,17,26,6,28,53,52.8,25,29,5,24,12,61,12,0,2023
ITA-Serie A,2022,Inter,Raoul Bellanova,ITA,DF,22,2000,5.5,14,6,11,2,1,9,14,64.3,5,6,1,5,4,18,14,0,2023
ITA-Serie A,2022,Inter,Roberto Gagliardini,ITA,MF,28,1994,8.7,16,6,9,6,1,10,21,47.6,11,14,5,9,4,20,15,0,2023
ITA-Serie A,2022,Inter,Robin Gosens,GER,DF,28,1994,13.2,34,18,15,10,9,15,25,60.0,10,16,2,14,23,57,15,0,2023
ITA-Serie A,2022,Inter,Romelu Lukaku,BEL,FW,29,1993,18.4,3,1,1,0,2,2,5,40.0,3,3,1,2,0,3,16,0,2023
ITA-Serie A,2022,Inter,Samir Handanović,SVN,GK,38,1984,13.7,0,0,0,0,0,0,0,,0,0,0,0,0,0,5,0,2023
ITA-Serie A,2022,Inter,Stefan de Vrij,NED,DF,30,1992,21.6,28,18,19,9,0,8,14,57.1,6,18,10,8,40,68,80,0,2023
ITA-Serie A,2022,Inter,Valentin Carboni,ARG,"MF,DF",17,2005,0.3,1,1,0,1,0,1,3,33.3,2,1,0,1,0,1,0,0,2023
ITA-Serie A,2022,Juventus,Adrien Rabiot,FRA,MF,27,1995,30.5,65,35,31,23,11,30,57,52.6,27,37,7,30,26,91,44,1,2023
ITA-Serie A,2022,Juventus,Alex Sandro,BRA,DF,31,1991,19.9,35,20,16,16,3,15,22,68.2,7,27,10,17,15,50,64,1,2023
ITA-Serie A,2022,Juventus,Arkadiusz Milik,POL,FW,28,1994,17.6,12,8,2,8,2,2,8,25.0,6,10,1,9,1,13,14,0,2023
ITA-Serie A,2022,Juventus,Daniele Rugani,ITA,DF,28,1994,6.3,7,0,6,1,0,4,4,100.0,0,7,5,2,7,14,32,0,2023
ITA-Serie A,2022,Juventus,Danilo,BRA,DF,31,1991,35.4,92,62,61,23,8,52,73,71.2,21,39,20,19,47,139,114,1,2023
ITA-Serie A,2022,Juventus,Denis Zakaria,SUI,MF,25,1996,1.4,6,3,1,4,1,2,2,100.0,0,2,0,2,2,8,1,0,2023
ITA-Serie A,2022,Juventus,Dušan Vlahović,SRB,FW,22,2000,21.4,11,6,0,7,4,4,10,40.0,6,10,3,7,3,14,8,1,2023
ITA-Serie A,2022,Juventus,Enzo Barrenechea,ARG,MF,21,2001,1.8,8,3,3,4,1,3,5,60.0,2,3,0,3,2,10,3,0,2023
ITA-Serie A,2022,Juventus,Fabio Miretti,ITA,"MF,FW",18,2003,13.7,24,11,15,6,3,12,29,41.4,17,20,1,19,4,28,11,0,2023
ITA-Serie A,2022,Juventus,Federico Chiesa,ITA,"DF,MF",24,1997,9.5,22,11,6,6,10,5,14,35.7,9,13,1,12,0,22,1,0,2023
ITA-Serie A,2022,Juventus,Federico Gatti,ITA,DF,24,1998,16.1,15,11,9,4,2,9,15,60.0,6,20,14,6,21,36,54,2,2023
ITA-Serie A,2022,Juventus,Filip Kostić,SRB,"DF,FW",29,1992,28.5,41,26,17,20,4,21,47,44.7,26,30,4,26,16,57,32,0,2023
ITA-Serie A,2022,Juventus,Gleison Bremer,BRA,DF,25,1997,29.3,29,20,23,5,1,19,26,73.1,7,44,22,22,42,71,120,2,2023
ITA-Serie A,2022,Juventus,Juan Cuadrado,COL,"DF,FW",34,1988,23.1,50,34,34,13,3,27,65,41.5,38,15,2,13,24,74,32,0,2023
ITA-Serie A,2022,Juventus,Leandro Paredes,ARG,MF,28,1994,10.9,19,13,7,11,1,10,22,45.5,12,8,0,8,17,36,22,0,2023
ITA-Serie A,2022,Juventus,Leonardo Bonucci,ITA,DF,35,1987,9.8,5,4,1,4,0,2,4,50.0,2,12,8,4,13,18,29,0,2023
ITA-Serie A,2022,Juventus,Manuel Locatelli,ITA,MF,24,1998,27.2,59,33,26,23,10,30,53,56.6,23,50,22,28,27,86,59,0,2023
ITA-Serie A,2022,Juventus,Mattia De Sciglio,ITA,DF,29,1992,11.6,14,7,8,3,3,9,14,64.3,5,9,3,6,4,18,20,0,2023
ITA-Serie A,2022,Juventus,Mattia Perin,ITA,GK,29,1992,10.5,0,0,0,0,0,0,0,,0,0,0,0,0,0,0,0,2023
ITA-Serie A,2022,Juventus,Matìas Soulé,ARG,"MF,FW",19,2003,4.7,7,4,3,2,2,5,7,71.4,2,7,1,6,3,10,3,0,2023
ITA-Serie A,2022,Juventus,Moise Kean,ITA,FW,22,2000,11.1,8,6,2,5,1,3,7,42.9,4,4,0,4,5,13,2,0,2023
ITA-Serie A,2022,Juventus,Nicolò Fagioli,ITA,MF,21,2001,16.9,29,19,12,15,2,8,27,29.6,19,16,2,14,8,37,7,1,2023
ITA-Serie A,2022,Juventus,Nicolò Rovella,ITA,MF,20,2001,0.3,1,1,0,1,0,1,1,100.0,0,0,0,0,0,1,0,0,2023
ITA-Serie A,2022,Juventus,Paul Pogba,FRA,"MF,FW",29,1993,1.2,0,0,0,0,0,0,1,0.0,1,0,0,0,0,0,2,0,2023
ITA-Serie A,2022,Juventus,Samuel Iling-Junior,ENG,"DF,FW",18,2003,3.5,7,2,3,1,3,4,9,44.4,5,5,1,4,2,9,6,0,2023
ITA-Serie A,2022,Juventus,Tommaso Barbieri,ITA,DF,19,2002,1.2,3,3,3,0,0,3,8,37.5,5,3,0,3,0,3,2,0,2023
ITA-Serie A,2022,Juventus,Weston McKennie,USA,"MF,DF",23,1998,11.7,14,5,3,9,2,5,8,62.5,3,15,4,11,11,25,15,1,2023
ITA-Serie A,2022,Juventus,Wojciech Szczęsny,POL,GK,32,1990,27.5,1,0,1,0,0,0,1,0.0,1,0,0,0,0,1,7,0,2023
ITA-Serie A,2022,Juventus,Ángel Di María,ARG,"FW,MF",34,1988,15.1,10,5,3,5,2,3,19,15.8,16,15,0,15,7,17,0,0,2023
ITA-Serie A,2022,Lazio,Adam Marušić,MNE,DF,29,1992,30.7,41,30,23,14,4,25,39,64.1,14,20,6,14,38,79,63,1,2023
ITA-Serie A,2022,Lazio,Alessio Romagnoli,ITA,DF,27,1995,32.5,33,15,19,14,0,11,22,50.0,11,33,26,7,38,71,108,0,2023
ITA-Serie A,2022,Lazio,Ciro Immobile,ITA,FW,32,1990,24.7,11,5,4,4,3,6,9,66.7,3,10,2,8,1,12,14,0,2023
ITA-Serie A,2022,Lazio,Danilo Cataldi,ITA,MF,27,1994,21.3,25,16,7,15,3,14,40,35.0,26,23,9,14,24,49,33,0,2023
ITA-Serie A,2022,Lazio,Elseid Hysaj,ALB,DF,28,1994,22.2,39,23,24,11,4,23,41,56.1,18,31,7,24,20,59,42,0,2023
ITA-Serie A,2022,Lazio,Felipe Anderson,BRA,FW,29,1993,32.9,80,50,31,41,8,31,88,35.2,57,58,6,52,31,111,27,0,2023
ITA-Serie A,2022,Lazio,Ivan Provedel,ITA,GK,28,1994,37.9,1,0,1,0,0,0,0,,0,0,0,0,0,1,15,1,2023
ITA-Serie A,2022,Lazio,Luca Pellegrini,ITA,DF,23,1999,2.0,1,0,0,1,0,1,4,25.0,3,3,0,3,7,8,4,0,2023
ITA-Serie A,2022,Lazio,Luis Alberto,ESP,MF,29,1992,27.1,49,29,18,20,11,23,72,31.9,49,35,6,29,9,58,4,0,2023
ITA-Serie A,2022,Lazio,Luka Romero,ARG,FW,17,2004,1.7,0,0,0,0,0,0,3,0.0,3,4,0,4,3,3,1,0,2023
ITA-Serie A,2022,Lazio,Luís Maximiano,POR,GK,23,1999,0.1,0,0,0,0,0,0,0,,0,0,0,0,0,0,0,0,2023
ITA-Serie A,2022,Lazio,Manuel Lazzari,ITA,DF,28,1993,20.9,33,21,13,14,6,21,36,58.3,15,20,6,14,18,51,36,1,2023
ITA-Serie A,2022,Lazio,Marco Bertini,ITA,MF,19,2002,0.0,0,0,0,0,0,0,0,,0,0,0,0,0,0,0,0,2023
ITA-Serie A,2022,Lazio,Marcos Antônio,BRA,MF,22,2000,6.6,9,6,4,5,0,9,20,45.0,11,7,2,5,11,20,18,0,2023
ITA-Serie A,2022,Lazio,Mario Gila,ESP,DF,21,2000,1.0,3,1,3,0,0,0,1,0.0,1,0,0,0,3,6,3,0,2023
ITA-Serie A,2022,Lazio,Matteo Cancellieri,ITA,FW,20,2002,2.8,10,4,5,3,2,5,9,55.6,4,4,0,4,1,11,2,0,2023
ITA-Serie A,2022,Lazio,Mattia Zaccagni,ITA,FW,27,1995,30.8,42,28,16,18,8,14,38,36.8,24,37,3,34,21,63,10,1,2023
ITA-Serie A,2022,Lazio,Matías Vecino,URU,MF,30,1991,18.8,47,27,13,23,11,23,48,47.9,25,33,10,23,16,63,39,1,2023
ITA-Serie A,2022,Lazio,Nicolò Casale,ITA,DF,24,1998,27.1,42,20,28,14,0,22,34,64.7,12,25,17,8,17,59,73,1,2023
ITA-Serie A,2022,Lazio,Patric,ESP,DF,29,1993,15.7,17,11,12,3,2,11,16,68.8,5,17,12,5,11,28,53,1,2023
ITA-Serie A,2022,Lazio,Pedro,ESP,FW,35,1987,21.1,35,24,14,10,11,11,30,36.7,19,18,2,16,6,41,4,1,2023
ITA-Serie A,2022,Lazio,Sergej Milinković-Savić,SRB,MF,27,1995,33.6,58,35,22,23,13,24,67,35.8,43,50,12,38,28,86,49,0,2023
ITA-Serie A,2022,Lazio,Toma Bašić,CRO,MF,25,1996,5.7,6,4,4,1,1,3,8,37.5,5,9,0,9,7,13,8,0,2023
ITA-Serie A,2022,Lazio,Ștefan Radu,ROU,FW,35,1986,0.0,0,0,0,0,0,0,0,,0,0,0,0,0,0,0,0,2023
ITA-Serie A,2022,Lecce,Alessandro Tuia,ITA,DF,32,1990,5.7,10,6,6,4,0,3,9,33.3,6,3,1,2,15,25,29,0,2023
ITA-Serie A,2022,Lecce,Alexis Blin,FRA,MF,25,1996,26.4,69,39,27,33,9,38,73,52.1,35,55,15,40,34,103,74,0,2023
ITA-Serie A,2022,Lecce,Antonino Gallo,ITA,DF,22,2000,27.6,56,36,35,12,9,38,57,66.7,19,37,6,31,13,69,71,0,2023
ITA-Serie A,2022,Lecce,Assan Ceesay,GAM,FW,28,1994,20.1,23,18,7,8,8,9,17,52.9,8,15,2,13,3,26,24,0,2023
ITA-Serie A,2022,Lecce,Federico Baschirotto,ITA,DF,25,1996,37.0,40,30,35,5,0,22,36,61.1,14,45,29,16,36,76,192,0,2023
ITA-Serie A,2022,Lecce,Federico Di Francesco,ITA,"FW,MF",28,1994,22.6,28,16,7,11,10,9,19,47.4,10,16,0,16,8,36,14,0,2023
ITA-Serie A,2022,Lecce,Gabriel Strefezza,BRA,"FW,MF",25,1997,27.1,50,24,18,20,12,27,53,50.9,26,36,3,33,16,66,15,0,2023
ITA-Serie A,2022,Lecce,Giuseppe Pezzella,ITA,DF,24,1997,10.2,21,9,16,2,3,9,16,56.3,7,11,3,8,8,29,31,1,2023
ITA-Serie A,2022,Lecce,Joan Gonzàlez,ESP,MF,20,2002,24.4,48,28,20,18,10,17,51,33.3,34,37,8,29,16,64,28,0,2023
ITA-Serie A,2022,Lecce,Joel Voelkerling Persson,SWE,"FW,MF",19,2003,1.1,1,1,0,0,1,0,1,0.0,1,1,0,1,0,1,0,0,2023
ITA-Serie A,2022,Lecce,Kastriot Dermaku,ALB,DF,30,1992,0.4,0,0,0,0,0,0,0,,0,0,0,0,0,0,0,0,2023
ITA-Serie A,2022,Lecce,Kristijan Bistrović,CRO,MF,24,1998,5.1,3,1,3,0,0,0,5,0.0,5,3,0,3,0,3,4,0,2023
ITA-Serie A,2022,Lecce,Kristoffer Askildsen,NOR,MF,21,2001,8.1,7,3,2,3,2,4,10,40.0,6,15,4,11,11,18,6,0,2023
ITA-Serie A,2022,Lecce,Lameck Banda,ZAM,"FW,MF",21,2001,18.2,30,20,13,14,3,15,41,36.6,26,24,2,22,8,38,5,0,2023
ITA-Serie A,2022,Lecce,Lorenzo Colombo,ITA,FW,20,2002,16.8,17,9,1,9,7,6,14,42.9,8,22,0,22,2,19,7,0,2023
ITA-Serie A,2022,Lecce,Marcin Listkowski,POL,"MF,FW",24,1998,0.9,0,0,0,0,0,0,0,,0,0,0,0,3,3,2,0,2023
ITA-Serie A,2022,Lecce,Marin Pongračić,CRO,DF,24,1997,8.8,16,14,8,7,1,5,7,71.4,2,4,3,1,16,32,31,0,2023
ITA-Serie A,2022,Lecce,Morten Hjulmand,DEN,MF,23,1999,32.9,90,52,49,40,1,37,67,55.2,30,43,11,32,72,162,54,0,2023
ITA-Serie A,2022,Lecce,Pablo Rodríguez,ESP,"FW,MF",20,2001,0.6,2,1,2,0,0,0,2,0.0,2,3,0,3,0,2,0,0,2023
ITA-Serie A,2022,Lecce,Pietro Ceccaroni,ITA,DF,26,1995,0.5,0,0,0,0,0,0,0,,0,1,1,0,3,3,2,0,2023
ITA-Serie A,2022,Lecce,Remi Oudin,FRA,"FW,MF",25,1996,14.7,25,13,9,12,4,10,23,43.5,13,16,2,14,29,54,23,0,2023
ITA-Serie A,2022,Lecce,Samuel Umtiti,FRA,DF,28,1993,23.5,52,34,25,25,2,18,26,69.2,8,26,14,12,26,78,79,0,2023
ITA-Serie A,2022,Lecce,Simone Romagnoli,ITA,DF,32,1990,1.9,6,5,3,3,0,2,2,100.0,0,4,1,3,1,7,11,0,2023
ITA-Serie A,2022,Lecce,Tommaso Cassandro,ITA,DF,22,2000,0.1,1,1,0,1,0,0,0,,0,1,1,0,0,1,0,0,2023
ITA-Serie A,2022,Lecce,Valentin Gendrey,FRA,DF,22,2000,34.5,88,57,54,25,9,40,71,56.3,31,45,4,41,37,125,89,0,2023
ITA-Serie A,2022,Lecce,Wladimiro Falcone,ITA,GK,27,1995,38.0,2,0,2,0,0,2,2,100.0,0,0,0,0,2,4,21,3,2023
ITA-Serie A,2022,Lecce,Youssef Maleh,MAR,MF,23,1998,7.5,17,8,3,7,7,6,14,42.9,8,20,1,19,5,22,10,0,2023
ITA-Serie A,2022,Lecce,Yıldırım Mert Çetin,TUR,DF,25,1997,0.2,1,0,1,0,0,0,0,,0,0,0,0,1,2,1,0,2023
ITA-Serie A,2022,Lecce,Þórir Jóhann Helgason,ISL,MF,21,2000,2.5,2,2,1,0,1,2,3,66.7,1,3,1,2,3,5,3,0,2023
ITA-Serie A,2022,Milan,Alessandro Florenzi,ITA,DF,31,1991,2.3,6,4,3,2,1,4,7,57.1,3,1,0,1,4,10,2,0,2023
ITA-Serie A,2022,Milan,Alexis Saelemaekers,BEL,"FW,DF",23,1999,15.6,31,20,12,16,3,19,41,46.3,22,13,1,12,19,50,11,0,2023
ITA-Serie A,2022,Milan,Ante Rebić,CRO,"FW,MF",28,1993,10.9,10,8,1,3,6,3,11,27.3,8,6,1,5,1,11,5,0,2023
ITA-Serie A,2022,Milan,Antonio Mirante,ITA,GK,39,1983,0.0,0,0,0,0,0,0,0,,0,0,0,0,0,0,0,0,2023
ITA-Serie A,2022,Milan,Aster Vranckx,BEL,MF,19,2002,2.7,3,2,0,2,1,2,7,28.6,5,3,1,2,2,5,1,0,2023
ITA-Serie A,2022,Milan,Brahim Díaz,ESP,"MF,FW",22,1999,21.4,32,15,5,22,5,5,15,33.3,10,11,0,11,7,39,6,0,2023
ITA-Serie A,2022,Milan,Charles De Ketelaere,BEL,"MF,FW",21,2001,12.4,26,12,7,14,5,13,30,43.3,17,14,2,12,4,30,9,0,2023
ITA-Serie A,2022,Milan,Ciprian Tătărușanu,ROU,GK,36,1986,16.0,0,0,0,0,0,0,0,,0,0,0,0,1,1,2,0,2023
ITA-Serie A,2022,Milan,Davide Calabria,ITA,DF,25,1996,18.8,71,44,31,32,8,38,61,62.3,23,22,7,15,25,96,34,0,2023
ITA-Serie A,2022,Milan,Divock Origi,BEL,FW,27,1995,11.4,10,5,4,3,3,5,10,50.0,5,6,2,4,0,10,13,0,2023
ITA-Serie A,2022,Milan,Fikayo Tomori,ENG,DF,24,1997,30.7,70,34,44,25,1,22,34,64.7,12,46,25,21,29,99,88,1,2023
ITA-Serie A,2022,Milan,Fodé Ballo-Touré,SEN,DF,25,1997,5.8,14,9,7,6,1,7,10,70.0,3,11,3,8,2,16,3,0,2023
ITA-Serie A,2022,Milan,Ismaël Bennacer,ALG,MF,24,1997,22.3,59,33,26,31,2,30,51,58.8,21,25,7,18,26,85,16,1,2023
ITA-Serie A,2022,Milan,Junior Messias,BRA,"FW,DF",31,1991,16.6,24,18,9,9,6,5,19,26.3,14,20,4,16,7,31,28,0,2023
ITA-Serie A,2022,Milan,Malick Thiaw,GER,DF,20,2001,15.1,31,26,22,9,0,11,20,55.0,9,11,5,6,12,43,65,1,2023
ITA-Serie A,2022,Milan,Marko Lazetić,SRB,FW,18,2004,0.1,0,0,0,0,0,0,0,,0,0,0,0,0,0,0,0,2023
ITA-Serie A,2022,Milan,Matteo Gabbia,ITA,DF,22,1999,6.8,17,10,12,5,0,6,8,75.0,2,8,3,5,5,22,29,0,2023
ITA-Serie A,2022,Milan,Mike Maignan,FRA,GK,27,1995,22.0,1,0,1,0,0,1,1,100.0,0,0,0,0,1,2,10,1,2023
ITA-Serie A,2022,Milan,Olivier Giroud,FRA,FW,35,1986,23.8,8,5,2,4,2,2,10,20.0,8,11,3,8,3,11,23,0,2023
ITA-Serie A,2022,Milan,Pierre Kalulu,FRA,DF,22,2000,28.3,57,39,33,21,3,28,42,66.7,14,41,17,24,41,98,56,1,2023
ITA-Serie A,2022,Milan,Rade Krunić,BIH,MF,28,1993,18.4,40,28,18,18,4,16,50,32.0,34,31,11,20,16,56,21,0,2023
ITA-Serie A,2022,Milan,Rafael Leão,POR,"FW,MF",23,1999,26.9,8,7,2,3,3,6,14,42.9,8,9,2,7,15,23,8,0,2023
ITA-Serie A,2022,Milan,Sandro Tonali,ITA,MF,22,2000,30.1,64,41,35,24,5,27,44,61.4,17,34,9,25,25,89,26,1,2023
ITA-Serie A,2022,Milan,Sergiño Dest,USA,DF,21,2000,3.7,12,6,3,5,4,3,4,75.0,1,1,0,1,4,16,2,0,2023
ITA-Serie A,2022,Milan,Simon Kjær,DEN,DF,33,1989,11.2,15,8,9,6,0,7,11,63.6,4,14,11,3,9,24,35,1,2023
ITA-Serie A,2022,Milan,Theo Hernández,FRA,DF,24,1997,30.8,43,24,27,15,1,22,38,57.9,16,34,7,27,21,64,35,1,2023
ITA-Serie A,2022,Milan,Tiemoué Bakayoko,FRA,MF,27,1994,0.5,5,5,4,1,0,3,3,100.0,0,0,0,0,0,5,0,1,2023
ITA-Serie A,2022,Milan,Tommaso Pobega,ITA,MF,23,1999,9.8,27,16,8,15,4,13,20,65.0,7,12,4,8,9,36,11,0,2023
ITA-Serie A,2022,Milan,Yacine Adli,FRA,"MF,FW",22,2000,1.6,6,3,2,4,0,2,2,100.0,0,2,0,2,1,7,1,0,2023
ITA-Serie A,2022,Milan,Zlatan Ibrahimović,SWE,FW,40,1981,1.6,0,0,0,0,0,0,0,,0,1,1,0,0,0,2,0,2023
ITA-Serie A,2022,Monza,Alessio Cragno,ITA,GK,28,1994,1.0,0,0,0,0,0,0,1,0.0,1,0,0,0,0,0,0,0,2023
ITA-Serie A,2022,Monza,Andrea Barberis,ITA,MF,28,1993,3.8,7,2,4,3,0,5,11,45.5,6,0,0,0,8,15,1,0,2023
ITA-Serie A,2022,Monza,Andrea Carboni,ITA,DF,21,2001,1.9,3,2,2,0,1,2,5,40.0,3,3,2,1,3,6,2,1,2023
ITA-Serie A,2022,Monza,Andrea Colpani,ITA,MF,23,1999,10.5,14,9,6,5,3,8,12,66.7,4,14,2,12,3,17,6,0,2023
ITA-Serie A,2022,Monza,Andrea Petagna,ITA,FW,27,1995,18.5,7,5,2,3,2,3,6,50.0,3,16,4,12,3,10,18,0,2023
ITA-Serie A,2022,Monza,Andrea Ranocchia,ITA,DF,34,1988,0.5,3,1,1,2,0,3,4,75.0,1,5,5,0,0,3,7,0,2023
ITA-Serie A,2022,Monza,Armando Izzo,ITA,DF,30,1992,27.4,73,50,44,27,2,29,45,64.4,16,29,17,12,50,123,87,1,2023
ITA-Serie A,2022,Monza,Carlos,BRA,DF,23,1999,34.3,73,38,42,23,8,33,54,61.1,21,24,6,18,24,97,85,1,2023
ITA-Serie A,2022,Monza,Christian Gytkjær,DEN,"FW,MF",32,1990,6.2,6,2,1,4,1,2,5,40.0,3,6,1,5,0,6,2,0,2023
ITA-Serie A,2022,Monza,Dany Mota,POR,"FW,MF",24,1998,21.2,8,7,1,3,4,2,10,20.0,8,5,1,4,6,14,25,0,2023
ITA-Serie A,2022,Monza,Filippo Ranocchia,ITA,MF,21,2001,5.9,11,6,5,4,2,4,12,33.3,8,5,1,4,4,15,7,0,2023
ITA-Serie A,2022,Monza,Franco Carboni,ITA,"DF,FW",19,2003,0.7,1,1,1,0,0,0,2,0.0,2,3,0,3,1,2,0,0,2023
ITA-Serie A,2022,Monza,Gianluca Caprari,ITA,"MF,FW",29,1993,27.1,16,6,3,11,2,8,26,30.8,18,22,1,21,8,24,3,0,2023
ITA-Serie A,2022,Monza,Giulio Donati,ITA,DF,32,1990,4.7,4,1,1,1,2,3,6,50.0,3,3,1,2,4,8,11,0,2023
ITA-Serie A,2022,Monza,Luca Caldirola,ITA,DF,31,1991,26.1,26,14,19,4,3,13,26,50.0,13,32,18,14,25,51,66,1,2023
ITA-Serie A,2022,Monza,Luca Marrone,ITA,DF,32,1990,1.5,0,0,0,0,0,0,2,0.0,2,2,2,0,0,0,4,1,2023
ITA-Serie A,2022,Monza,Marco D'Alessandro,ITA,"DF,FW",31,1991,3.2,4,4,3,1,0,2,5,40.0,3,2,0,2,1,5,3,0,2023
ITA-Serie A,2022,Monza,Marlon,BRA,DF,26,1995,17.7,35,21,20,14,1,15,29,51.7,14,13,4,9,18,53,50,0,2023
ITA-Serie A,2022,Monza,Matteo Pessina,ITA,MF,25,1997,32.6,57,36,28,21,8,26,62,41.9,36,50,15,35,37,94,33,1,2023
ITA-Serie A,2022,Monza,Mattia Valoti,ITA,"MF,FW",28,1993,5.0,17,10,7,9,1,5,16,31.3,11,13,3,10,3,20,6,0,2023
ITA-Serie A,2022,Monza,Michele Di Gregorio,ITA,GK,25,1997,37.0,0,0,0,0,0,0,3,0.0,3,1,0,1,4,4,18,3,2023
ITA-Serie A,2022,Monza,Nicolò Rovella,ITA,MF,20,2001,19.3,45,29,22,21,2,13,36,36.1,23,20,1,19,40,85,17,0,2023
ITA-Serie A,2022,Monza,Pablo Marí,ESP,DF,28,1993,27.6,37,19,29,7,1,17,26,65.4,9,22,14,8,31,68,111,3,2023
ITA-Serie A,2022,Monza,Patrick Ciurria,ITA,"DF,MF",27,1995,30.6,31,18,20,10,1,17,33,51.5,16,24,2,22,7,38,32,0,2023
ITA-Serie A,2022,Monza,Pepín,EQG,MF,25,1996,12.5,28,19,10,11,7,9,27,33.3,18,14,3,11,13,41,17,0,2023
ITA-Serie A,2022,Monza,Salvatore Molina,ITA,DF,30,1992,2.5,6,5,2,4,0,4,5,80.0,1,4,2,2,1,7,2,0,2023
ITA-Serie A,2022,Monza,Samuele Birindelli,ITA,DF,23,1999,15.6,35,19,21,10,4,18,29,62.1,11,28,8,20,16,51,30,0,2023
ITA-Serie A,2022,Monza,Samuele Vignato,ITA,"MF,FW",18,2004,0.7,0,0,0,0,0,0,0,,0,1,0,1,0,0,0,0,2023
ITA-Serie A,2022,Monza,Stefano Sensi,ITA,MF,26,1995,18.0,41,26,25,13,3,18,48,37.5,30,13,3,10,20,61,4,0,2023
ITA-Serie A,2022,Monza,Valentin Antov,BUL,DF,21,2000,3.4,6,5,3,3,0,1,5,20.0,4,5,4,1,4,10,14,1,2023
ITA-Serie A,2022,Monza,Warren Bondo,FRA,MF,18,2003,0.7,1,0,1,0,0,0,0,,0,1,0,1,0,1,0,0,2023
ITA-Serie A,2022,Napoli,Adam Ounas,ALG,FW,25,1996,0.2,0,0,0,0,0,0,0,,0,0,0,0,1,1,0,0,2023
ITA-Serie A,2022,Napoli,Alessandro Zanoli,ITA,DF,21,2000,0.1,1,0,0,1,0,0,0,,0,0,0,0,0,1,1,0,2023
ITA-Serie A,2022,Napoli,Alessio Zerbin,ITA,FW,23,1999,2.2,10,5,4,5,1,4,8,50.0,4,2,0,2,2,12,2,0,2023
ITA-Serie A,2022,Napoli,Alex Meret,ITA,GK,25,1997,34.0,0,0,0,0,0,0,0,,0,0,0,0,0,0,6,1,2023
ITA-Serie A,2022,Napoli,Amir Rrahmani,KVX,DF,28,1994,27.2,33,18,20,13,0,17,26,65.4,9,36,20,16,14,47,79,1,2023
ITA-Serie A,2022,Napoli,Andre-Frank Zambo Anguissa,CMR,MF,26,1995,33.9,53,32,16,29,8,16,64,25.0,48,50,4,46,49,102,25,0,2023
ITA-Serie A,2022,Napoli,Bartosz Bereszyński,POL,DF,30,1992,1.8,3,2,1,1,1,2,2,100.0,0,4,0,4,3,6,3,0,2023
ITA-Serie A,2022,Napoli,Diego Demme,GER,MF,30,1991,1.6,1,0,1,0,0,0,4,0.0,4,2,0,2,0,1,1,0,2023
ITA-Serie A,2022,Napoli,Elif Elmas,MKD,"FW,MF",22,1999,18.1,24,13,8,12,4,11,23,47.8,12,18,2,16,11,35,5,0,2023
ITA-Serie A,2022,Napoli,Giacomo Raspadori,ITA,"FW,MF",22,2000,10.1,10,8,0,6,4,4,10,40.0,6,9,0,9,4,14,4,0,2023
ITA-Serie A,2022,Napoli,Gianluca Gaetano,ITA,MF,22,2000,0.8,5,3,1,3,1,0,0,,0,1,0,1,1,6,0,0,2023
ITA-Serie A,2022,Napoli,Giovanni Di Lorenzo,ITA,DF,28,1993,36.2,60,29,33,19,8,25,49,51.0,24,30,9,21,30,90,60,0,2023
ITA-Serie A,2022,Napoli,Giovanni Simeone,ARG,FW,27,1995,4.5,12,3,3,5,4,3,8,37.5,5,2,1,1,1,13,4,0,2023
ITA-Serie A,2022,Napoli,Hirving Lozano,MEX,FW,27,1995,17.8,24,13,10,6,8,9,21,42.9,12,31,0,31,15,39,6,0,2023
ITA-Serie A,2022,Napoli,Juan Jesus,BRA,DF,31,1991,10.4,16,11,9,6,1,9,12,75.0,3,18,11,7,10,26,29,0,2023
ITA-Serie A,2022,Napoli,Karim Zedadka,FRA,FW,22,2000,0.2,0,0,0,0,0,0,0,,0,0,0,0,0,0,1,0,2023
ITA-Serie A,2022,Napoli,Khvicha Kvaratskhelia,GEO,FW,21,2001,28.0,43,23,12,8,23,17,43,39.5,26,20,0,20,5,48,6,1,2023
ITA-Serie A,2022,Napoli,Kim Min-jae,KOR,DF,25,1996,33.9,55,30,32,22,1,25,29,86.2,4,36,26,10,41,96,123,1,2023
ITA-Serie A,2022,Napoli,Leo Skiri Østigård,NOR,DF,22,1999,4.7,4,1,3,1,0,1,1,100.0,0,3,3,0,6,10,18,1,2023
ITA-Serie A,2022,Napoli,Mathías Olivera,URU,DF,24,1997,18.3,39,23,16,16,7,22,43,51.2,21,28,2,26,22,61,26,0,2023
ITA-Serie A,2022,Napoli,Matteo Politano,ITA,FW,28,1993,13.0,18,9,9,5,4,11,25,44.0,14,6,0,6,7,25,7,0,2023
ITA-Serie A,2022,Napoli,Mário Rui,POR,DF,31,1991,19.4,34,22,17,13,4,20,41,48.8,21,17,4,13,15,49,24,1,2023
ITA-Serie A,2022,Napoli,Pierluigi Gollini,ITA,GK,27,1995,4.0,0,0,0,0,0,0,0,,0,0,0,0,0,0,1,0,2023
ITA-Serie A,2022,Napoli,Piotr Zieliński,POL,MF,28,1994,25.4,17,10,1,11,5,12,25,48.0,13,16,5,11,14,31,7,0,2023
ITA-Serie A,2022,Napoli,Stanislav Lobotka,SVK,MF,27,1994,34.5,83,44,35,35,13,43,73,58.9,30,29,7,22,23,106,16,0,2023
ITA-Serie A,2022,Napoli,Tanguy Ndombele,FRA,MF,25,1996,9.0,14,8,4,8,2,4,7,57.1,3,10,1,9,7,21,7,1,2023
ITA-Serie A,2022,Napoli,Victor Osimhen,NGA,FW,23,1998,28.5,10,6,1,2,7,0,7,0.0,7,6,1,5,6,16,29,0,2023
ITA-Serie A,2022,Roma,Andrea Belotti,ITA,FW,28,1993,12.7,12,5,3,5,4,5,11,45.5,6,11,1,10,3,15,5,0,2023
ITA-Serie A,2022,Roma,Benjamin Tahirovic,BIH,MF,19,2003,3.9,8,5,5,2,1,4,12,33.3,8,9,4,5,3,11,3,0,2023
ITA-Serie A,2022,Roma,Bryan Cristante,ITA,"MF,DF",27,1995,32.6,113,62,55,49,9,55,90,61.1,35,39,10,29,18,131,53,0,2023
ITA-Serie A,2022,Roma,Chris Smalling,ENG,DF,32,1989,31.2,26,15,16,10,0,13,21,61.9,8,51,36,15,43,69,123,0,2023
ITA-Serie A,2022,Roma,Cristian Volpato,ITA,MF,18,2003,2.5,3,2,1,1,1,0,2,0.0,2,2,0,2,2,5,0,0,2023
ITA-Serie A,2022,Roma,Diego Llorente,ESP,DF,28,1993,6.4,10,5,6,4,0,5,12,41.7,7,4,2,2,11,21,20,0,2023
ITA-Serie A,2022,Roma,Edoardo Bove,ITA,MF,20,2002,11.0,35,18,12,15,8,16,39,41.0,23,15,1,14,10,45,11,0,2023
ITA-Serie A,2022,Roma,Eldor Shomurodov,UZB,FW,27,1995,1.3,1,0,1,0,0,0,2,0.0,2,1,0,1,1,2,0,0,2023
ITA-Serie A,2022,Roma,Filippo Missori,ITA,DF,18,2004,2.0,4,3,3,0,1,3,6,50.0,3,0,0,0,3,7,5,0,2023
ITA-Serie A,2022,Roma,Georginio Wijnaldum,NED,MF,31,1990,8.5,4,3,1,3,0,0,2,0.0,2,7,1,6,2,6,3,0,2023
ITA-Serie A,2022,Roma,Gianluca Mancini,ITA,DF,26,1996,31.8,37,19,27,9,1,18,34,52.9,16,38,17,21,46,83,67,0,2023
ITA-Serie A,2022,Roma,Jordan Majchrzak,POL,FW,17,2004,0.2,0,0,0,0,0,0,0,,0,0,0,0,0,0,0,0,2023
ITA-Serie A,2022,Roma,Leonardo Spinazzola,ITA,DF,29,1993,18.4,15,8,7,6,2,8,23,34.8,15,13,3,10,9,24,25,0,2023
ITA-Serie A,2022,Roma,Lorenzo Pellegrini,ITA,MF,26,1996,28.3,52,29,24,24,4,22,48,45.8,26,27,4,23,26,78,22,0,2023
ITA-Serie A,2022,Roma,Marash Kumbulla,ALB,DF,22,2000,2.9,4,4,2,2,0,2,3,66.7,1,2,1,1,4,8,6,0,2023
ITA-Serie A,2022,Roma,Matías Viña,URU,DF,24,1997,0.6,3,1,1,1,1,1,3,33.3,2,5,1,4,2,5,5,0,2023
ITA-Serie A,2022,Roma,Mile Svilar,SRB,GK,22,1999,3.0,0,0,0,0,0,0,0,,0,0,0,0,0,0,1,0,2023
ITA-Serie A,2022,Roma,Mohamed Camara,GUI,MF,25,1997,7.7,13,10,3,7,3,5,15,33.3,10,5,1,4,10,23,8,0,2023
ITA-Serie A,2022,Roma,Nemanja Matić,SRB,MF,33,1988,20.6,47,27,24,19,4,19,33,57.6,14,27,7,20,25,72,21,1,2023
ITA-Serie A,2022,Roma,Niccolò Pisilli,ITA,MF,17,2004,0.0,0,0,0,0,0,0,0,,0,0,0,0,0,0,0,0,2023
ITA-Serie A,2022,Roma,Nicola Zalewski,POL,DF,20,2002,24.4,45,26,25,15,5,22,71,31.0,49,27,1,26,31,76,23,0,2023
ITA-Serie A,2022,Roma,Nicolò Zaniolo,ITA,"MF,FW",23,1999,9.9,7,5,2,4,1,2,7,28.6,5,11,0,11,2,9,0,0,2023
ITA-Serie A,2022,Roma,Ola Solbakken,NOR,"MF,FW",23,1998,5.6,2,2,1,1,0,2,7,28.6,5,2,0,2,2,4,8,0,2023
ITA-Serie A,2022,Roma,Paulo Dybala,ARG,"MF,FW",28,1993,19.3,14,4,1,8,5,8,26,30.8,18,12,1,11,8,22,4,0,2023
ITA-Serie A,2022,Roma,Rick Karsdorp,NED,DF,27,1995,7.9,21,13,11,7,3,13,22,59.1,9,0,0,0,7,28,15,1,2023
ITA-Serie A,2022,Roma,Roger Ibanez,BRA,DF,23,1998,31.1,67,33,38,26,3,32,48,66.7,16,30,11,19,66,133,95,2,2023
ITA-Serie A,2022,Roma,Rui Patrício,POR,GK,34,1988,35.0,1,1,1,0,0,1,1,100.0,0,0,0,0,2,3,6,3,2023
ITA-Serie A,2022,Roma,Stephan El Shaarawy,ITA,"DF,MF",29,1992,16.9,21,9,8,10,3,6,22,27.3,16,11,1,10,15,36,11,0,2023
ITA-Serie A,2022,Roma,Tammy Abraham,ENG,FW,24,1997,24.3,17,10,4,8,5,3,16,18.8,13,10,4,6,3,20,14,0,2023
ITA-Serie A,2022,Roma,Zeki Çelik,TUR,DF,25,1997,16.7,42,21,19,21,2,24,41,58.5,17,33,6,27,14,56,36,2,2023
ITA-Serie A,2022,Salernitana,Antonio Candreva,ITA,"MF,DF",35,1987,30.3,17,7,13,2,2,11,38,28.9,27,7,3,4,17,34,32,0,2023
ITA-Serie A,2022,Salernitana,Antonio Iervolino,ITA,MF,19,2003,0.1,0,0,0,0,0,0,1,0.0,1,0,0,0,0,0,0,0,2023
ITA-Serie A,2022,Salernitana,Boulaye Dia,SEN,"FW,MF",25,1996,28.0,12,5,3,6,3,2,7,28.6,5,10,0,10,7,19,27,1,2023
ITA-Serie A,2022,Salernitana,Diego Valencia,CHI,"MF,FW",22,2000,2.6,8,5,4,2,2,2,9,22.2,7,10,1,9,1,9,2,0,2023
ITA-Serie A,2022,Salernitana,Domagoj Bradarić,CRO,DF,22,1999,25.0,26,19,14,8,4,7,16,43.8,9,20,5,15,21,47,44,0,2023
ITA-Serie A,2022,Salernitana,Domen Črnigoj,SVN,MF,26,1995,3.3,8,3,0,7,1,1,2,50.0,1,9,1,8,9,17,6,0,2023
ITA-Serie A,2022,Salernitana,Dylan Bronn,TUN,DF,27,1995,18.7,34,18,17,16,1,20,30,66.7,10,32,20,12,20,54,58,1,2023
ITA-Serie A,2022,Salernitana,Emil Bohinen,NOR,MF,23,1999,9.2,25,13,15,8,2,12,23,52.2,11,25,7,18,17,42,21,0,2023
ITA-Serie A,2022,Salernitana,Erik Botheim,NOR,"MF,FW",22,2000,9.6,11,7,3,4,4,6,13,46.2,7,3,0,3,0,11,4,0,2023
ITA-Serie A,2022,Salernitana,Federico Bonazzoli,ITA,"FW,MF",25,1997,12.4,5,3,0,3,2,0,9,0.0,9,9,1,8,3,8,0,0,2023
ITA-Serie A,2022,Salernitana,Federico Fazio,ARG,DF,35,1987,11.9,15,12,8,7,0,4,11,36.4,7,9,4,5,28,43,61,0,2023
ITA-Serie A,2022,Salernitana,Flavius Daniliuc,AUT,DF,21,2001,24.4,57,29,37,17,3,26,47,55.3,21,30,13,17,29,86,76,0,2023
ITA-Serie A,2022,Salernitana,Franck Ribéry,FRA,MF,39,1983,0.4,0,0,0,0,0,0,0,,0,1,0,1,0,0,0,0,2023
ITA-Serie A,2022,Salernitana,Giulio Maggiore,ITA,MF,24,1998,9.9,20,8,11,6,3,10,21,47.6,11,19,4,15,8,28,10,0,2023
ITA-Serie A,2022,Salernitana,Grigoris Kastanos,CYP,"MF,DF",24,1998,14.3,39,23,18,19,2,16,40,40.0,24,20,6,14,8,47,8,0,2023
ITA-Serie A,2022,Salernitana,Guillermo Ochoa,MEX,GK,37,1985,20.0,0,0,0,0,0,0,2,0.0,2,0,0,0,0,0,9,1,2023
ITA-Serie A,2022,Salernitana,Hans Nicolussi Caviglia,ITA,MF,22,2000,6.5,15,6,5,8,2,9,15,60.0,6,9,0,9,7,22,7,1,2023
ITA-Serie A,2022,Salernitana,Ivan Radovanović,SRB,"MF,DF",33,1988,7.5,12,4,8,4,0,4,10,40.0,6,9,3,6,7,19,9,1,2023
ITA-Serie A,2022,Salernitana,Julian Kristoffersen,NOR,FW,25,1997,0.2,0,0,0,0,0,0,0,,0,1,0,1,0,0,0,0,2023
ITA-Serie A,2022,Salernitana,Junior Sambia,FRA,DF,25,1996,7.7,12,5,7,4,1,6,10,60.0,4,9,3,6,8,20,16,1,2023
ITA-Serie A,2022,Salernitana,Krzysztof Piątek,POL,FW,27,1995,23.8,18,11,3,9,6,5,21,23.8,16,17,4,13,2,20,39,0,2023
ITA-Serie A,2022,Salernitana,Lassana Coulibaly,MLI,MF,26,1996,32.1,84,50,42,35,7,30,73,41.1,43,35,7,28,25,109,33,2,2023
ITA-Serie A,2022,Salernitana,Lorenzo Pirola,ITA,DF,20,2002,21.6,33,29,18,14,1,19,27,70.4,8,50,35,15,30,63,85,1,2023
ITA-Serie A,2022,Salernitana,Luigi Sepe,ITA,GK,31,1991,17.0,0,0,0,0,0,0,1,0.0,1,0,0,0,0,0,0,0,2023
ITA-Serie A,2022,Salernitana,Matteo Lovato,ITA,DF,22,2000,9.0,17,14,14,3,0,10,25,40.0,15,8,5,3,13,30,33,2,2023
ITA-Serie A,2022,Salernitana,Norbert Gyömbér,SVK,DF,30,1992,19.3,32,23,25,6,1,16,24,66.7,8,33,22,11,35,67,92,0,2023
ITA-Serie A,2022,Salernitana,Pasquale Mazzocchi,ITA,DF,27,1995,21.8,32,18,21,5,6,17,37,45.9,20,10,2,8,10,42,37,2,2023
ITA-Serie A,2022,Salernitana,Tonny Vilhena,NED,MF,27,1995,25.2,44,22,16,23,5,20,50,40.0,30,17,7,10,18,62,21,0,2023
ITA-Serie A,2022,Salernitana,Vincenzo Fiorillo,ITA,GK,32,1990,1.0,0,0,0,0,0,0,0,,0,0,0,0,0,0,0,0,2023
ITA-Serie A,2022,Salernitana,William Troost-Ekong,NGA,DF,28,1993,4.9,11,3,7,4,0,6,7,85.7,1,7,4,3,6,17,10,0,2023
ITA-Serie A,2022,Sampdoria,Abdelhamid Sabiri,MAR,"MF,FW",25,1996,11.9,18,7,5,9,4,4,13,30.8,9,18,4,14,2,20,5,0,2023
ITA-Serie A,2022,Sampdoria,Alessandro Zanoli,ITA,DF,21,2000,17.1,22,14,14,6,2,8,17,47.1,9,19,15,4,12,34,39,0,2023
ITA-Serie A,2022,Sampdoria,Alex Ferrari,ITA,DF,28,1994,9.6,9,5,7,2,0,4,8,50.0,4,21,10,11,19,28,25,0,2023
ITA-Serie A,2022,Sampdoria,Andrea Conti,ITA,DF,28,1994,0.3,0,0,0,0,0,0,0,,0,0,0,0,0,0,0,0,2023
ITA-Serie A,2022,Sampdoria,Bartosz Bereszyński,POL,DF,30,1992,13.3,28,18,15,11,2,17,26,65.4,9,18,4,14,21,49,25,0,2023
ITA-Serie A,2022,Sampdoria,Bram Nuytinck,NED,DF,32,1990,16.6,54,38,33,21,0,23,34,67.6,11,36,21,15,23,77,84,0,2023
ITA-Serie A,2022,Sampdoria,Bruno Amione,ARG,DF,20,2002,23.2,50,33,36,14,0,19,43,44.2,24,26,11,15,25,75,62,1,2023
ITA-Serie A,2022,Sampdoria,Daniele Montevago,ITA,FW,19,2003,2.6,1,0,0,0,1,0,1,0.0,1,2,1,1,0,1,1,0,2023
ITA-Serie A,2022,Sampdoria,Emil Audero,ITA,GK,25,1997,25.0,0,0,0,0,0,0,2,0.0,2,0,0,0,0,0,7,1,2023
ITA-Serie A,2022,Sampdoria,Emirhan İlkhan,TUR,MF,18,2004,1.3,6,3,2,2,2,2,3,66.7,1,5,1,4,0,6,3,0,2023
ITA-Serie A,2022,Sampdoria,Fabio Depaoli,ITA,"DF,MF",25,1997,1.5,5,3,2,3,0,3,4,75.0,1,1,0,1,1,6,4,0,2023
ITA-Serie A,2022,Sampdoria,Fabio Quagliarella,ITA,FW,39,1983,8.9,2,1,1,1,0,1,7,14.3,6,5,1,4,0,2,9,0,2023
ITA-Serie A,2022,Sampdoria,Filip Đuričić,SRB,"MF,FW",30,1992,24.1,43,22,18,20,5,14,32,43.8,18,19,6,13,7,50,8,0,2023
ITA-Serie A,2022,Sampdoria,Flavio Paoletti,ITA,MF,19,2003,3.2,2,2,0,2,0,1,5,20.0,4,1,0,1,5,7,9,0,2023
ITA-Serie A,2022,Sampdoria,Francesco Caputo,ITA,FW,34,1987,12.2,3,1,0,0,3,0,3,0.0,3,0,0,0,1,4,3,0,2023
ITA-Serie A,2022,Sampdoria,Gerard Yepes,ESP,MF,19,2002,2.2,5,3,2,3,0,1,3,33.3,2,3,0,3,4,9,3,0,2023
ITA-Serie A,2022,Sampdoria,Gonzalo Villar,ESP,MF,24,1998,7.7,13,7,4,8,1,7,15,46.7,8,11,3,8,4,17,9,1,2023
ITA-Serie A,2022,Sampdoria,Harry Winks,ENG,MF,26,1996,19.1,27,12,7,18,2,14,43,32.6,29,14,8,6,24,51,24,0,2023
ITA-Serie A,2022,Sampdoria,Ignacio Pussetto,ARG,"MF,DF",26,1995,1.7,6,3,2,3,1,3,4,75.0,1,4,0,4,0,6,3,0,2023
ITA-Serie A,2022,Sampdoria,Jeison Murillo,COL,DF,30,1992,11.7,22,11,16,6,0,17,26,65.4,9,22,14,8,8,30,39,0,2023
ITA-Serie A,2022,Sampdoria,Jesé,ESP,FW,29,1993,2.3,2,0,0,2,0,0,1,0.0,1,3,1,2,1,3,2,0,2023
ITA-Serie A,2022,Sampdoria,Koray Günter,GER,DF,27,1994,8.6,10,8,6,4,0,6,9,66.7,3,10,5,5,11,21,46,0,2023
ITA-Serie A,2022,Sampdoria,Lorenzo Malagrida,ITA,"MF,DF",18,2003,1.2,1,0,0,0,1,1,3,33.3,2,1,0,1,0,1,1,0,2023
ITA-Serie A,2022,Sampdoria,Manolo Gabbiadini,ITA,"FW,MF",30,1991,26.2,23,15,8,9,6,9,23,39.1,14,16,2,14,6,29,25,0,2023
ITA-Serie A,2022,Sampdoria,Manuel De Luca,ITA,"FW,MF",24,1998,0.5,0,0,0,0,0,0,0,,0,0,0,0,0,0,0,0,2023
ITA-Serie A,2022,Sampdoria,Marios Oikonomou,GRE,DF,29,1992,2.4,3,2,3,0,0,1,3,33.3,2,5,4,1,4,7,13,0,2023
ITA-Serie A,2022,Sampdoria,Martin Turk,SVN,GK,18,2003,4.0,0,0,0,0,0,0,0,,0,0,0,0,0,0,1,0,2023
ITA-Serie A,2022,Sampdoria,Mehdi Léris,ALG,"MF,DF",24,1998,27.3,63,46,30,24,9,23,55,41.8,32,38,6,32,27,90,34,0,2023
ITA-Serie A,2022,Sampdoria,Mickaël Cuisance,FRA,MF,22,1999,6.9,13,10,7,5,1,5,23,21.7,18,10,0,10,5,18,4,0,2023
ITA-Serie A,2022,Sampdoria,Mihailo Ivanović,SRB,FW,17,2004,0.0,0,0,0,0,0,0,0,,0,0,0,0,0,0,0,0,2023
ITA-Serie A,2022,Sampdoria,Nicola Murru,ITA,DF,27,1994,8.7,24,14,15,8,1,7,13,53.8,6,17,7,10,10,34,21,0,2023
ITA-Serie A,2022,Sampdoria,Nicola Ravaglia,ITA,GK,33,1988,9.0,0,0,0,0,0,0,1,0.0,1,0,0,0,0,0,7,0,2023
ITA-Serie A,2022,Sampdoria,Omar Colley,GAM,DF,29,1992,15.4,17,10,10,7,0,9,12,75.0,3,9,5,4,22,39,69,1,2023
ITA-Serie A,2022,Sampdoria,Ronaldo Vieira,GNB,MF,24,1998,9.1,,10,,,,,,,,,,,13,,,,2023
ITA-Serie A,2022,Sampdoria,Sam Lammers,NED,FW,25,1997,12.2,12,5,2,7,3,6,15,40.0,9,10,3,7,6,18,11,0,2023
ITA-Serie A,2022,Sampdoria,Samuel Ntanda,BEL,MF,17,2005,0.0,0,0,0,0,0,0,0,,0,0,0,0,0,0,0,0,2023
ITA-Serie A,2022,Sampdoria,Telasco Segovia,VEN,MF,19,2003,0.0,0,0,0,0,0,0,0,,0,0,0,0,0,0,0,0,2023
ITA-Serie A,2022,Sampdoria,Tommaso Augello,ITA,DF,27,1994,34.0,17,14,13,2,2,9,20,45.0,11,23,7,16,17,34,61,1,2023
ITA-Serie A,2022,Sampdoria,Tomás Rincón,VEN,MF,34,1988,28.4,56,27,22,26,8,29,61,47.5,32,37,7,30,30,86,18,0,2023
ITA-Serie A,2022,Sampdoria,Valerio Verre,ITA,MF,28,1994,7.5,14,7,6,5,3,8,17,47.1,9,9,1,8,9,23,3,0,2023
ITA-Serie A,2022,Sassuolo,Abdou Harroui,NED,MF,24,1998,7.2,17,6,6,7,4,2,7,28.6,5,6,1,5,2,19,10,0,2023
ITA-Serie A,2022,Sassuolo,Agustín Álvarez Martínez,URU,"FW,MF",21,2001,4.1,6,3,0,5,1,1,4,25.0,3,5,1,4,3,9,3,0,2023
ITA-Serie A,2022,Sassuolo,Alessandro Russo,ITA,GK,21,2001,1.0,0,0,0,0,0,0,0,,0,0,0,0,0,0,1,1,2023
ITA-Serie A,2022,Sassuolo,Andrea Consigli,ITA,GK,35,1987,35.0,1,0,1,0,0,0,1,0.0,1,0,0,0,0,1,13,3,2023
ITA-Serie A,2022,Sassuolo,Andrea Pinamonti,ITA,FW,23,1999,24.0,10,7,0,5,5,3,7,42.9,4,19,2,17,2,12,11,0,2023
ITA-Serie A,2022,Sassuolo,Armand Lauriente,FRA,FW,23,1998,24.2,21,15,5,7,9,8,21,38.1,13,20,0,20,12,33,8,0,2023
ITA-Serie A,2022,Sassuolo,Davide Frattesi,ITA,MF,22,1999,31.9,63,36,24,29,10,25,44,56.8,19,27,6,21,16,79,42,0,2023
ITA-Serie A,2022,Sassuolo,Domenico Berardi,ITA,FW,27,1994,20.7,23,14,8,10,5,9,40,22.5,31,13,0,13,19,42,18,0,2023
ITA-Serie A,2022,Sassuolo,Emil Ceide,NOR,FW,20,2001,5.7,5,2,5,0,0,3,5,60.0,2,3,1,2,1,6,0,0,2023
ITA-Serie A,2022,Sassuolo,Filippo Romagna,ITA,DF,25,1997,0.5,0,0,0,0,0,0,0,,0,1,1,0,0,0,2,0,2023
ITA-Serie A,2022,Sassuolo,Giacomo Raspadori,ITA,FW,22,2000,0.5,0,0,0,0,0,0,0,,0,0,0,0,0,0,0,0,2023
ITA-Serie A,2022,Sassuolo,Gian Marco Ferrari,ITA,DF,30,1992,24.7,23,16,11,10,2,10,17,58.8,7,29,20,9,23,46,81,4,2023
ITA-Serie A,2022,Sassuolo,Gianluca Pegolo,ITA,GK,41,1981,2.0,0,0,0,0,0,0,1,0.0,1,0,0,0,0,0,1,0,2023
ITA-Serie A,2022,Sassuolo,Giorgos Kyriakopoulos,GRE,"FW,DF",26,1996,8.5,21,8,7,9,5,10,14,71.4,4,7,1,6,11,32,12,1,2023
ITA-Serie A,2022,Sassuolo,Grégoire Defrel,MTQ,FW,31,1991,13.0,9,7,5,2,2,4,13,30.8,9,11,0,11,2,11,5,0,2023
ITA-Serie A,2022,Sassuolo,Hamed Junior Traorè,CIV,"MF,FW",22,2000,6.6,11,6,4,6,1,4,11,36.4,7,4,0,4,2,13,0,1,2023
ITA-Serie A,2022,Sassuolo,Janis Antiste,FRA,FW,19,2002,0.6,1,0,1,0,0,1,1,100.0,0,0,0,0,0,1,0,0,2023
ITA-Serie A,2022,Sassuolo,Jeremy Toljan,GER,DF,27,1994,29.7,36,23,17,14,5,22,33,66.7,11,31,14,17,18,54,60,1,2023
ITA-Serie A,2022,Sassuolo,Kaan Ayhan,TUR,DF,27,1994,6.1,10,4,6,4,0,7,7,100.0,0,5,4,1,5,15,26,1,2023
ITA-Serie A,2022,Sassuolo,Kristian Thorstvedt,NOR,MF,23,1999,12.6,16,7,4,9,3,6,17,35.3,11,19,5,14,14,30,13,0,2023
ITA-Serie A,2022,Sassuolo,Luca D'Andrea,ITA,FW,17,2004,3.5,4,0,2,1,1,1,4,25.0,3,2,0,2,1,5,1,0,2023
ITA-Serie A,2022,Sassuolo,Martin Erlic,CRO,DF,24,1998,25.9,27,16,18,8,1,10,23,43.5,13,36,23,13,31,58,120,1,2023
ITA-Serie A,2022,Sassuolo,Matheus Henrique,BRA,MF,24,1997,21.6,26,12,9,11,6,12,24,50.0,12,15,4,11,12,38,10,0,2023
ITA-Serie A,2022,Sassuolo,Maxime Lopez,FRA,MF,24,1997,25.5,42,18,26,12,4,16,56,28.6,40,24,6,18,22,64,21,0,2023
ITA-Serie A,2022,Sassuolo,Mert Müldür,TUR,"FW,DF",23,1999,0.1,0,0,0,0,0,0,0,,0,0,0,0,0,0,0,0,2023
ITA-Serie A,2022,Sassuolo,Nadir Zortea,ITA,DF,23,1999,7.3,15,8,12,2,1,9,14,64.3,5,10,4,6,4,19,21,0,2023
ITA-Serie A,2022,Sassuolo,Nedim Bajrami,ALB,"FW,MF",23,1999,9.1,12,7,6,2,4,5,11,45.5,6,9,1,8,7,19,6,0,2023
ITA-Serie A,2022,Sassuolo,Pedro Obiang,EQG,MF,30,1992,9.7,26,17,12,12,2,10,18,55.6,8,12,2,10,8,34,15,0,2023
ITA-Serie A,2022,Sassuolo,Riccardo Marchizza,ITA,DF,24,1998,3.1,2,2,1,1,0,2,4,50.0,2,2,0,2,2,4,8,0,2023
ITA-Serie A,2022,Sassuolo,Rogério,BRA,DF,24,1998,33.3,37,21,22,8,7,17,35,48.6,18,32,9,23,37,74,70,0,2023
ITA-Serie A,2022,Sassuolo,Ruan,BRA,DF,23,1999,19.0,38,26,25,12,1,19,29,65.5,10,29,17,12,24,62,80,3,2023
ITA-Serie A,2022,Spezia,Albin Ekdal,SWE,MF,33,1989,19.3,37,20,14,20,3,19,45,42.2,26,24,2,22,26,63,36,0,2023
ITA-Serie A,2022,Spezia,Arkadiusz Reca,POL,DF,27,1995,24.1,44,28,22,12,10,19,32,59.4,13,21,5,16,24,68,54,0,2023
ITA-Serie A,2022,Spezia,Bartłomiej Drągowski,POL,GK,24,1997,32.7,1,0,1,0,0,1,5,20.0,4,0,0,0,1,2,15,3,2023
ITA-Serie A,2022,Spezia,Daniel Maldini,ITA,"FW,MF",20,2001,7.0,12,5,3,4,5,4,11,36.4,7,9,0,9,1,13,8,0,2023
ITA-Serie A,2022,Spezia,Daniele Verde,ITA,"FW,MF",26,1996,11.1,4,4,3,0,1,3,7,42.9,4,6,0,6,8,12,4,0,2023
ITA-Serie A,2022,Spezia,Dimitris Nikolaou,GRE,DF,23,1998,32.9,45,32,31,10,4,25,37,67.6,12,41,26,15,27,72,82,0,2023
ITA-Serie A,2022,Spezia,Dávid Strelec,SVK,FW,21,2001,1.9,2,2,0,1,1,2,2,100.0,0,0,0,0,0,2,0,0,2023
ITA-Serie A,2022,Spezia,Eldor Shomurodov,UZB,FW,27,1995,9.0,5,5,3,1,1,2,11,18.2,9,5,1,4,3,8,4,0,2023
ITA-Serie A,2022,Spezia,Emil Holm,SWE,DF,22,2000,15.5,26,15,13,8,5,16,31,51.6,15,21,6,15,9,35,41,0,2023
ITA-Serie A,2022,Spezia,Emmanuel Gyasi,GHA,"FW,DF",28,1994,31.2,24,15,11,10,3,9,36,25.0,27,24,6,18,8,32,26,0,2023
ITA-Serie A,2022,Spezia,Ethan Ampadu,WAL,"DF,MF",21,2000,29.3,66,37,33,28,5,17,41,41.5,24,48,23,25,36,102,98,0,2023
ITA-Serie A,2022,Spezia,Federico Marchetti,ITA,GK,39,1983,0.7,0,0,0,0,0,0,0,,0,0,0,0,0,0,0,0,2023
ITA-Serie A,2022,Spezia,Jacopo Sala,ITA,MF,30,1991,1.2,1,0,1,0,0,0,2,0.0,2,2,0,2,1,2,2,0,2023
ITA-Serie A,2022,Spezia,Jakub Kiwior,POL,DF,22,2000,16.0,22,17,15,7,0,6,24,25.0,18,26,18,8,24,46,71,1,2023
ITA-Serie A,2022,Spezia,Jeroen Zoet,NED,GK,31,1991,3.7,1,1,1,0,0,1,1,100.0,0,0,0,0,0,1,1,0,2023
ITA-Serie A,2022,Spezia,João Moutinho,POR,"DF,FW",24,1998,0.6,7,1,5,1,1,3,4,75.0,1,1,1,0,0,7,0,0,2023
ITA-Serie A,2022,Spezia,Julius Beck,DEN,MF,17,2005,0.1,2,1,1,1,0,0,0,,0,0,0,0,0,2,0,0,2023
ITA-Serie A,2022,Spezia,Kelvin Amian,FRA,DF,24,1998,26.4,54,32,33,12,9,24,31,77.4,7,34,12,22,22,76,87,1,2023
ITA-Serie A,2022,Spezia,Kevin Agudelo,COL,"MF,FW",23,1998,23.7,71,38,22,30,19,25,59,42.4,34,39,5,34,10,81,6,0,2023
ITA-Serie A,2022,Spezia,Leandro Sanca,GNB,"FW,MF",22,2000,0.4,1,1,0,0,1,1,1,100.0,0,0,0,0,0,1,0,0,2023
ITA-Serie A,2022,Spezia,M'Bala Nzola,ANG,FW,25,1996,29.5,12,5,0,6,6,3,9,33.3,6,20,6,14,7,19,21,0,2023
ITA-Serie A,2022,Spezia,Mattia Caldara,ITA,DF,28,1994,13.9,23,14,10,11,2,9,20,45.0,11,23,16,7,17,40,88,2,2023
ITA-Serie A,2022,Spezia,Mehdi Bourabia,MAR,MF,30,1991,30.8,41,20,13,22,6,19,41,46.3,22,39,12,27,32,73,57,0,2023
ITA-Serie A,2022,Spezia,Mikael Ellertsson,ISL,"MF,DF",20,2002,1.9,4,2,1,3,0,0,3,0.0,3,2,1,1,2,6,0,0,2023
ITA-Serie A,2022,Spezia,Petar Zovko,BIH,GK,20,2002,0.8,1,0,1,0,0,1,1,100.0,0,0,0,0,0,1,0,0,2023
ITA-Serie A,2022,Spezia,Petko Hristov,BUL,DF,23,1999,4.1,6,4,2,4,0,5,8,62.5,3,4,2,2,4,10,12,0,2023
ITA-Serie A,2022,Spezia,Przemysław Wiśniewski,POL,DF,24,1998,11.1,13,6,7,6,0,6,18,33.3,12,16,8,8,11,24,66,0,2023
ITA-Serie A,2022,Spezia,Raimonds Krollis,LVA,"FW,DF",20,2001,0.4,1,1,0,0,1,0,1,0.0,1,0,0,0,0,1,0,0,2023
ITA-Serie A,2022,Spezia,Salvador Ferrer,ESP,DF,24,1998,1.5,4,2,2,2,0,1,3,33.3,2,3,1,2,1,5,4,0,2023
ITA-Serie A,2022,Spezia,Salvatore Esposito,ITA,MF,21,2000,10.8,15,12,8,5,2,5,21,23.8,16,9,1,8,11,26,18,0,2023
ITA-Serie A,2022,Spezia,Simone Bastoni,ITA,"MF,DF",25,1996,13.2,47,24,23,19,5,15,33,45.5,18,20,5,15,8,55,14,0,2023
ITA-Serie A,2022,Spezia,Szymon Żurkowski,POL,MF,24,1997,4.7,9,3,4,4,1,2,15,13.3,13,9,2,7,4,13,6,0,2023
ITA-Serie A,2022,Spezia,Tio Cipot,SVN,"FW,MF",19,2003,1.5,12,7,6,3,3,6,8,75.0,2,0,0,0,0,12,2,0,2023
ITA-Serie A,2022,Spezia,Viktor Kovalenko,UKR,MF,26,1996,6.1,9,5,1,6,2,5,8,62.5,3,11,2,9,4,13,7,0,2023
ITA-Serie A,2022,Torino,Aleksei Miranchuk,RUS,MF,26,1995,23.2,11,5,3,4,4,3,11,27.3,8,11,0,11,2,13,5,0,2023
ITA-Serie A,2022,Torino,Alessandro Buongiorno,ITA,DF,23,1999,30.2,38,25,22,16,0,16,31,51.6,15,38,19,19,60,98,105,2,2023
ITA-Serie A,2022,Torino,Andrew Gravillon,GLP,DF,24,1998,3.5,3,3,0,3,0,0,0,,0,4,2,2,9,12,16,0,2023
ITA-Serie A,2022,Torino,Antonio Sanabria,PAR,FW,26,1996,27.0,11,5,3,3,5,1,7,14.3,6,9,2,7,4,15,7,0,2023
ITA-Serie A,2022,Torino,Brian Bayeye,FRA,DF,22,2000,0.7,3,0,3,0,0,1,1,100.0,0,1,1,0,1,4,2,0,2023
ITA-Serie A,2022,Torino,David Zima,CZE,DF,21,2000,4.5,9,5,5,4,0,3,4,75.0,1,7,2,5,9,18,11,2,2023
ITA-Serie A,2022,Torino,Demba Seck,SEN,"MF,FW",21,2001,5.8,5,2,3,2,0,2,3,66.7,1,3,1,2,1,6,1,0,2023
ITA-Serie A,2022,Torino,Emirhan İlkhan,TUR,MF,18,2004,1.0,1,1,0,1,0,1,1,100.0,0,3,1,2,2,3,2,0,2023
ITA-Serie A,2022,Torino,Gvidas Gineitis,LTU,MF,18,2004,1.5,3,1,0,2,1,1,2,50.0,1,0,0,0,0,3,1,0,2023
ITA-Serie A,2022,Torino,Ivan Ilić,SRB,MF,21,2001,13.1,18,7,6,11,1,10,20,50.0,10,12,3,9,5,23,10,0,2023
ITA-Serie A,2022,Torino,Jacopo Segre,ITA,DF,25,1997,0.2,0,0,0,0,0,0,0,,0,0,0,0,0,0,0,0,2023
ITA-Serie A,2022,Torino,Karol Linetty,POL,MF,27,1995,21.0,32,17,7,22,3,13,25,52.0,12,28,8,20,19,51,25,0,2023
ITA-Serie A,2022,Torino,Koffi Djidji,CIV,DF,29,1992,26.9,50,25,32,17,1,18,32,56.3,14,29,14,15,34,84,72,0,2023
ITA-Serie A,2022,Torino,Michel Ndary Adopo,FRA,"MF,DF",22,2000,2.9,7,2,4,2,1,1,3,33.3,2,2,2,0,1,8,4,0,2023
ITA-Serie A,2022,Torino,Mërgim Vojvoda,KVX,DF,27,1995,19.1,22,12,15,6,1,12,24,50.0,12,14,2,12,10,32,31,1,2023
ITA-Serie A,2022,Torino,Nemanja Radonjić,SRB,"MF,FW",26,1996,16.2,2,1,2,0,0,0,4,0.0,4,3,0,3,2,4,4,0,2023
ITA-Serie A,2022,Torino,Nikola Vlašić,CRO,"MF,FW",24,1997,30.3,32,21,9,16,7,15,34,44.1,19,25,2,23,10,42,14,0,2023
ITA-Serie A,2022,Torino,Ola Aina,NGA,DF,25,1996,9.7,17,13,5,8,4,9,15,60.0,6,12,2,10,11,28,26,0,2023
ITA-Serie A,2022,Torino,Perr Schuurs,NED,DF,22,1999,25.8,51,25,29,17,5,14,26,53.8,12,28,16,12,28,79,102,0,2023
ITA-Serie A,2022,Torino,Pietro Pellegri,ITA,FW,21,2001,5.2,6,2,1,3,2,2,3,66.7,1,5,1,4,0,6,4,0,2023
ITA-Serie A,2022,Torino,Ricardo Rodríguez,SUI,DF,29,1992,29.7,54,33,30,17,7,28,42,66.7,14,30,15,15,38,92,61,0,2023
ITA-Serie A,2022,Torino,Ronaldo Vieira,GNB,MF,24,1998,0.2,,0,,,,,,,,,,,0,,,,2023
ITA-Serie A,2022,Torino,Samuele Ricci,ITA,MF,20,2001,23.0,32,21,17,10,5,18,23,78.3,5,20,5,15,17,49,29,1,2023
ITA-Serie A,2022,Torino,Saša Lukić,SRB,MF,25,1996,13.3,21,14,10,10,1,9,15,60.0,6,17,7,10,13,34,10,0,2023
ITA-Serie A,2022,Torino,Valentino Lazaro,AUT,DF,26,1996,15.3,10,5,6,0,4,6,14,42.9,8,16,3,13,3,13,29,0,2023
ITA-Serie A,2022,Torino,Vanja Milinković-Savić,SRB,GK,25,1997,38.0,2,1,2,0,0,2,2,100.0,0,0,0,0,1,3,19,1,2023
ITA-Serie A,2022,Torino,Wilfried Singo,CIV,DF,21,2000,22.7,27,17,14,10,3,12,19,63.2,7,15,2,13,12,39,33,1,2023
ITA-Serie A,2022,Torino,Yann Karamoh,FRA,"MF,FW",24,1998,8.0,5,2,3,2,0,1,5,20.0,4,5,0,5,0,5,2,1,2023
ITA-Serie A,2022,Udinese,Adam Masina,MAR,DF,28,1994,8.8,10,7,7,3,0,6,15,40.0,9,11,4,7,10,20,28,1,2023
ITA-Serie A,2022,Udinese,Axel Guessand,FRA,DF,17,2004,0.9,2,1,2,0,0,1,2,50.0,1,1,0,1,2,4,3,0,2023
ITA-Serie A,2022,Udinese,Beto,GNB,FW,24,1998,23.7,16,9,0,9,7,4,17,23.5,13,18,3,15,6,22,30,0,2023
ITA-Serie A,2022,Udinese,Bram Nuytinck,NED,DF,32,1990,4.3,7,4,3,4,0,4,8,50.0,4,6,6,0,5,12,22,0,2023
ITA-Serie A,2022,Udinese,Brandon Soppy,FRA,DF,20,2002,1.0,1,1,0,1,0,0,0,,0,4,0,4,1,2,1,0,2023
ITA-Serie A,2022,Udinese,Enzo Ebosse,CMR,DF,23,1999,10.3,15,9,11,4,0,9,13,69.2,4,27,6,21,11,26,29,0,2023
ITA-Serie A,2022,Udinese,Festy Ebosele,IRL,DF,19,2002,4.6,15,10,8,7,0,4,10,40.0,6,5,0,5,2,17,5,0,2023
ITA-Serie A,2022,Udinese,Florian Thauvin,FRA,"FW,MF",29,1993,6.1,2,1,0,2,0,2,13,15.4,11,5,0,5,2,4,2,0,2023
ITA-Serie A,2022,Udinese,Gerard Deulofeu,ESP,FW,28,1994,13.5,8,5,5,1,2,5,15,33.3,10,8,1,7,2,10,1,0,2023
ITA-Serie A,2022,Udinese,Ilija Nestorovski,MKD,"FW,MF",32,1990,7.1,7,3,2,1,4,5,11,45.5,6,6,1,5,2,9,10,0,2023
ITA-Serie A,2022,Udinese,Isaac Success,NGA,FW,26,1996,20.2,8,4,2,5,1,3,8,37.5,5,13,2,11,4,12,18,0,2023
ITA-Serie A,2022,Udinese,Iyenoma Udogie,ITA,DF,19,2002,30.0,71,45,42,24,5,34,59,57.6,25,34,6,28,36,107,25,0,2023
ITA-Serie A,2022,Udinese,Jaka Bijol,SVN,DF,23,1999,30.3,39,23,32,7,0,16,27,59.3,11,41,25,16,29,68,165,0,2023
ITA-Serie A,2022,Udinese,James Abankwah,IRL,DF,18,2004,0.7,1,1,0,1,0,0,0,,0,4,2,2,0,1,5,0,2023
ITA-Serie A,2022,Udinese,Jean-Victor Makengo,FRA,MF,24,1998,8.9,16,13,7,7,2,5,9,55.6,4,8,2,6,9,25,3,0,2023
ITA-Serie A,2022,Udinese,Kingsley Ehizibue,NED,DF,27,1995,17.1,47,31,28,13,6,29,45,64.4,16,21,3,18,10,57,42,1,2023
ITA-Serie A,2022,Udinese,Lazar Samardzic,SRB,MF,20,2002,20.5,33,16,9,20,4,17,43,39.5,26,13,0,13,11,44,16,0,2023
ITA-Serie A,2022,Udinese,Leonardo Buta,POR,DF,20,2002,0.2,1,1,0,1,0,0,0,,0,0,0,0,0,1,0,0,2023
ITA-Serie A,2022,Udinese,Marco Silvestri,ITA,GK,31,1991,38.0,2,1,2,0,0,2,3,66.7,1,0,0,0,1,3,15,1,2023
ITA-Serie A,2022,Udinese,Marvin Zeegelaar,NED,DF,31,1990,3.9,8,4,6,2,0,3,4,75.0,1,2,0,2,3,11,5,0,2023
ITA-Serie A,2022,Udinese,Mato Jajalo,BIH,MF,34,1988,0.7,0,0,0,0,0,0,1,0.0,1,0,0,0,0,0,2,0,2023
ITA-Serie A,2022,Udinese,Nehuén Pérez,ARG,DF,22,2000,31.3,77,40,54,20,3,39,55,70.9,16,53,23,30,35,112,106,1,2023
ITA-Serie A,2022,Udinese,Nicolò Cocetta,ITA,DF,18,2003,0.4,0,0,0,0,0,0,1,0.0,1,1,1,0,1,1,1,0,2023
ITA-Serie A,2022,Udinese,Roberto Pereyra,ARG,"DF,MF",31,1991,31.3,36,20,21,12,3,16,44,36.4,28,20,5,15,16,52,28,0,2023
ITA-Serie A,2022,Udinese,Rodrigo Becão,BRA,DF,26,1996,27.6,70,36,50,17,3,40,53,75.5,13,44,24,20,26,96,68,2,2023
ITA-Serie A,2022,Udinese,Sandi Lovrić,SVN,MF,24,1998,25.9,40,18,16,16,8,25,43,58.1,18,25,2,23,26,66,21,0,2023
ITA-Serie A,2022,Udinese,Simone Pafundi,ITA,"MF,FW",16,2006,0.9,8,5,1,5,2,2,4,50.0,2,0,0,0,1,9,0,0,2023
ITA-Serie A,2022,Udinese,Tolgay Arslan,GER,MF,31,1990,13.5,29,18,13,15,1,14,39,35.9,25,19,0,19,12,41,9,1,2023
ITA-Serie A,2022,Udinese,Vivaldo Semedo,POR,"FW,MF",17,2005,0.4,0,0,0,0,0,0,0,,0,1,0,1,0,0,1,0,2023
ITA-Serie A,2022,Udinese,Walace,BRA,MF,27,1995,35.4,82,39,42,31,9,41,90,45.6,49,47,12,35,51,133,51,1,2023
