league,season,team,players_used,90s,Tackles_Tkl,Tackles_TklW,Tackles_Def 3rd,Tackles_Mid 3rd,Tackles_Att 3rd,Challenges_Tkl,Challenges_Att,Challenges_Tkl%,Challenges_Lost,Blocks_Blocks,Blocks_Sh,Blocks_Pass,Int,Tkl+Int,Clr,Err,url,nextSeason
ENG-Premier League,2017,Arsenal,30,38.0,623,425,312,227,84,218,581,37.5,363,372,103,269,427,1050,879,33,/en/squads/18bb7c10/2017-2018/Arsenal-Stats,2018
ENG-Premier League,2017,Bournemouth,22,38.0,509,324,272,187,50,198,525,37.7,327,453,160,293,367,876,1129,25,/en/squads/4ba7cbea/2017-2018/Bournemouth-Stats,2018
ENG-Premier League,2017,Brighton,24,38.0,599,380,360,205,34,205,642,31.9,437,430,190,240,449,1048,1182,18,/en/squads/d07537b9/2017-2018/Brighton-and-Hove-Albion-Stats,2018
ENG-Premier League,2017,Burnley,24,38.0,533,355,272,217,44,204,553,36.9,349,457,191,266,400,933,1300,8,/en/squads/943e8050/2017-2018/Burnley-Stats,2018
ENG-Premier League,2017,Chelsea,26,38.0,636,426,321,251,64,208,550,37.8,342,365,107,258,424,1060,842,24,/en/squads/cff3d9bb/2017-2018/Chelsea-Stats,2018
ENG-Premier League,2017,Crystal Palace,28,38.0,686,447,393,237,56,260,666,39.0,406,466,117,349,552,1238,1110,22,/en/squads/47c64c55/2017-2018/Crystal-Palace-Stats,2018
ENG-Premier League,2017,Everton,30,38.0,644,447,360,206,78,223,612,36.4,389,426,160,266,514,1158,1308,22,/en/squads/d3fd31cc/2017-2018/Everton-Stats,2018
ENG-Premier League,2017,Huddersfield,25,38.0,743,502,354,306,83,249,630,39.5,381,453,118,335,518,1261,1129,22,/en/squads/f5922ca5/2017-2018/Huddersfield-Town-Stats,2018
ENG-Premier League,2017,Leicester City,27,38.0,630,417,332,249,49,208,616,33.8,408,465,130,335,414,1044,1007,17,/en/squads/a2d435b3/2017-2018/Leicester-City-Stats,2018
ENG-Premier League,2017,Liverpool,27,38.0,637,450,265,285,87,196,521,37.6,325,388,71,317,379,1016,788,12,/en/squads/822bd0ba/2017-2018/Liverpool-Stats,2018
ENG-Premier League,2017,Manchester City,25,38.0,563,381,257,215,91,195,561,34.8,366,328,53,275,346,909,620,19,/en/squads/b8fd03ef/2017-2018/Manchester-City-Stats,2018
ENG-Premier League,2017,Manchester Utd,27,38.0,564,369,275,218,71,173,555,31.2,382,382,112,270,481,1045,926,20,/en/squads/19538871/2017-2018/Manchester-United-Stats,2018
ENG-Premier League,2017,Newcastle Utd,27,38.0,645,426,338,255,52,221,638,34.6,417,475,117,358,441,1086,1219,17,/en/squads/b2b47a98/2017-2018/Newcastle-United-Stats,2018
ENG-Premier League,2017,Southampton,26,38.0,658,454,342,250,66,244,605,40.3,361,455,128,327,462,1120,1034,25,/en/squads/33c895d4/2017-2018/Southampton-Stats,2018
ENG-Premier League,2017,Stoke City,30,38.0,678,437,370,252,56,228,600,38.0,372,424,142,282,461,1139,1265,20,/en/squads/17892952/2017-2018/Stoke-City-Stats,2018
ENG-Premier League,2017,Swansea City,26,38.0,610,417,286,241,83,221,550,40.2,329,411,124,287,390,1000,1019,21,/en/squads/fb10988f/2017-2018/Swansea-City-Stats,2018
ENG-Premier League,2017,Tottenham,25,38.0,618,399,272,259,87,212,537,39.5,325,360,74,286,380,998,878,22,/en/squads/361ca564/2017-2018/Tottenham-Hotspur-Stats,2018
ENG-Premier League,2017,Watford,29,38.0,668,432,337,263,68,237,609,38.9,372,359,98,261,467,1135,997,17,/en/squads/2abfe087/2017-2018/Watford-Stats,2018
ENG-Premier League,2017,West Brom,24,38.0,603,385,336,204,63,218,625,34.9,407,420,148,272,470,1073,1087,9,/en/squads/60c6b05f/2017-2018/West-Bromwich-Albion-Stats,2018
ENG-Premier League,2017,West Ham,27,38.0,621,410,327,238,56,235,620,37.9,385,437,154,283,482,1103,1085,17,/en/squads/7c21e445/2017-2018/West-Ham-United-Stats,2018
ENG-Premier League,2018,Arsenal,28,38.0,609,366,294,236,79,228,535,42.6,307,424,118,306,412,1021,798,28,/en/squads/18bb7c10/2018-2019/Arsenal-Stats,2019
ENG-Premier League,2018,Bournemouth,28,38.0,525,299,285,185,55,216,494,43.7,278,405,152,253,371,896,1098,21,/en/squads/4ba7cbea/2018-2019/Bournemouth-Stats,2019
ENG-Premier League,2018,Brighton,21,38.0,679,391,363,238,78,264,582,45.4,318,415,170,245,463,1142,1001,17,/en/squads/d07537b9/2018-2019/Brighton-and-Hove-Albion-Stats,2019
ENG-Premier League,2018,Burnley,23,38.0,584,311,280,246,58,237,539,44.0,302,516,222,294,367,951,1156,19,/en/squads/943e8050/2018-2019/Burnley-Stats,2019
ENG-Premier League,2018,Cardiff City,25,38.0,655,375,357,234,64,241,607,39.7,366,490,147,343,529,1184,1034,18,/en/squads/75fae011/2018-2019/Cardiff-City-Stats,2019
ENG-Premier League,2018,Chelsea,24,38.0,618,365,280,245,93,241,541,44.5,300,357,73,284,353,971,645,16,/en/squads/cff3d9bb/2018-2019/Chelsea-Stats,2019
ENG-Premier League,2018,Crystal Palace,26,38.0,733,446,398,270,65,281,590,47.6,309,441,141,300,445,1178,1011,17,/en/squads/47c64c55/2018-2019/Crystal-Palace-Stats,2019
ENG-Premier League,2018,Everton,23,38.0,699,441,326,290,83,220,511,43.1,291,414,85,329,453,1152,877,21,/en/squads/d3fd31cc/2018-2019/Everton-Stats,2019
ENG-Premier League,2018,Fulham,28,38.0,596,362,310,231,55,224,524,42.7,300,425,144,281,434,1030,1030,28,/en/squads/fd962109/2018-2019/Fulham-Stats,2019
ENG-Premier League,2018,Huddersfield,31,38.0,708,425,323,315,70,263,625,42.1,362,496,130,366,531,1239,682,15,/en/squads/f5922ca5/2018-2019/Huddersfield-Town-Stats,2019
ENG-Premier League,2018,Leicester City,25,38.0,675,393,344,277,54,237,549,43.2,312,429,96,333,438,1113,1034,24,/en/squads/a2d435b3/2018-2019/Leicester-City-Stats,2019
ENG-Premier League,2018,Liverpool,23,38.0,613,377,257,280,76,251,556,45.1,305,361,78,283,314,927,670,16,/en/squads/822bd0ba/2018-2019/Liverpool-Stats,2019
ENG-Premier League,2018,Manchester City,21,38.0,518,327,214,215,89,193,467,41.3,274,319,63,256,362,880,570,15,/en/squads/b8fd03ef/2018-2019/Manchester-City-Stats,2019
ENG-Premier League,2018,Manchester Utd,28,38.0,581,347,280,239,62,240,544,44.1,304,445,128,317,355,936,847,26,/en/squads/19538871/2018-2019/Manchester-United-Stats,2019
ENG-Premier League,2018,Newcastle Utd,24,38.0,711,433,356,291,64,241,565,42.7,324,472,135,337,506,1217,1204,16,/en/squads/b2b47a98/2018-2019/Newcastle-United-Stats,2019
ENG-Premier League,2018,Southampton,30,38.0,698,428,335,283,80,277,646,42.9,369,533,153,380,549,1247,1128,18,/en/squads/33c895d4/2018-2019/Southampton-Stats,2019
ENG-Premier League,2018,Tottenham,28,38.0,627,373,310,237,80,268,577,46.4,309,415,112,303,325,952,823,20,/en/squads/361ca564/2018-2019/Tottenham-Hotspur-Stats,2019
ENG-Premier League,2018,Watford,25,38.0,656,391,350,243,63,257,622,41.3,365,404,120,284,428,1084,1022,18,/en/squads/2abfe087/2018-2019/Watford-Stats,2019
ENG-Premier League,2018,West Ham,26,38.0,723,393,385,279,59,295,697,42.3,402,488,142,346,457,1180,926,16,/en/squads/7c21e445/2018-2019/West-Ham-United-Stats,2019
ENG-Premier League,2018,Wolves,21,38.0,720,408,385,284,51,283,664,42.6,381,499,148,351,501,1221,895,23,/en/squads/8cec06e1/2018-2019/Wolverhampton-Wanderers-Stats,2019
ENG-Premier League,2019,Arsenal,29,38.0,584,336,296,217,71,249,612,40.7,363,398,141,257,351,935,754,18,/en/squads/18bb7c10/2019-2020/Arsenal-Stats,2020
ENG-Premier League,2019,Aston Villa,28,38.0,523,291,285,174,64,223,597,37.4,374,456,184,272,423,946,928,26,/en/squads/8602292d/2019-2020/Aston-Villa-Stats,2020
ENG-Premier League,2019,Bournemouth,27,38.0,507,299,254,206,47,207,567,36.5,360,439,160,279,475,982,1008,16,/en/squads/4ba7cbea/2019-2020/Bournemouth-Stats,2020
ENG-Premier League,2019,Brighton,25,38.0,641,379,295,269,77,245,642,38.2,397,437,137,300,419,1060,750,15,/en/squads/d07537b9/2019-2020/Brighton-and-Hove-Albion-Stats,2020
ENG-Premier League,2019,Burnley,22,38.0,547,344,238,241,68,240,585,41.0,345,450,175,275,387,934,901,15,/en/squads/943e8050/2019-2020/Burnley-Stats,2020
ENG-Premier League,2019,Chelsea,27,38.0,638,362,304,258,76,246,604,40.7,358,361,91,270,459,1097,631,14,/en/squads/cff3d9bb/2019-2020/Chelsea-Stats,2020
ENG-Premier League,2019,Crystal Palace,25,38.0,686,390,367,244,75,316,711,44.4,395,399,135,264,444,1130,856,18,/en/squads/47c64c55/2019-2020/Crystal-Palace-Stats,2020
ENG-Premier League,2019,Everton,24,38.0,671,408,328,262,81,282,672,42.0,390,372,111,261,408,1079,778,13,/en/squads/d3fd31cc/2019-2020/Everton-Stats,2020
ENG-Premier League,2019,Leicester City,24,38.0,742,432,347,320,75,298,725,41.1,427,420,92,328,423,1165,767,16,/en/squads/a2d435b3/2019-2020/Leicester-City-Stats,2020
ENG-Premier League,2019,Liverpool,24,38.0,550,325,195,243,112,217,588,36.9,371,302,68,234,352,902,634,25,/en/squads/822bd0ba/2019-2020/Liverpool-Stats,2020
ENG-Premier League,2019,Manchester City,24,38.0,514,301,204,210,100,230,605,38.0,375,292,66,226,352,866,495,21,/en/squads/b8fd03ef/2019-2020/Manchester-City-Stats,2020
ENG-Premier League,2019,Manchester Utd,29,38.0,579,333,267,231,81,254,634,40.1,380,360,99,261,379,958,703,14,/en/squads/19538871/2019-2020/Manchester-United-Stats,2020
ENG-Premier League,2019,Newcastle Utd,28,38.0,603,357,364,198,41,273,632,43.2,359,402,152,250,391,994,988,19,/en/squads/b2b47a98/2019-2020/Newcastle-United-Stats,2020
ENG-Premier League,2019,Norwich City,30,38.0,628,379,359,210,59,267,700,38.1,433,453,171,282,397,1025,959,20,/en/squads/1c781004/2019-2020/Norwich-City-Stats,2020
ENG-Premier League,2019,Sheffield Utd,26,38.0,611,377,304,229,78,261,646,40.4,385,336,106,230,420,1031,931,16,/en/squads/1df6b87e/2019-2020/Sheffield-United-Stats,2020
ENG-Premier League,2019,Southampton,25,38.0,706,416,325,287,94,324,793,40.9,469,488,124,364,425,1131,867,21,/en/squads/33c895d4/2019-2020/Southampton-Stats,2020
ENG-Premier League,2019,Tottenham,29,38.0,665,415,331,281,53,253,681,37.2,428,441,148,293,381,1046,894,24,/en/squads/361ca564/2019-2020/Tottenham-Hotspur-Stats,2020
ENG-Premier League,2019,Watford,26,38.0,657,369,347,249,61,267,713,37.4,446,396,135,261,424,1081,869,4,/en/squads/2abfe087/2019-2020/Watford-Stats,2020
ENG-Premier League,2019,West Ham,29,38.0,696,417,374,263,59,300,745,40.3,445,383,117,266,421,1117,789,16,/en/squads/7c21e445/2019-2020/West-Ham-United-Stats,2020
ENG-Premier League,2019,Wolves,21,38.0,646,367,358,227,61,281,685,41.0,404,378,109,269,437,1083,702,23,/en/squads/8cec06e1/2019-2020/Wolverhampton-Wanderers-Stats,2020
ENG-Premier League,2020,Arsenal,29,38.0,456,252,206,184,66,212,547,38.8,335,368,113,255,351,807,643,16,/en/squads/18bb7c10/2020-2021/Arsenal-Stats,2021
ENG-Premier League,2020,Aston Villa,24,38.0,530,282,262,202,66,250,571,43.8,321,438,159,279,387,917,783,17,/en/squads/8602292d/2020-2021/Aston-Villa-Stats,2021
ENG-Premier League,2020,Brighton,27,38.0,628,334,297,251,80,252,603,41.8,351,417,97,320,425,1053,604,8,/en/squads/d07537b9/2020-2021/Brighton-and-Hove-Albion-Stats,2021
ENG-Premier League,2020,Burnley,25,38.0,507,293,241,203,63,229,564,40.6,335,440,180,260,416,923,824,11,/en/squads/943e8050/2020-2021/Burnley-Stats,2021
ENG-Premier League,2020,Chelsea,27,38.0,612,341,257,282,73,231,570,40.5,339,420,83,337,382,994,661,16,/en/squads/cff3d9bb/2020-2021/Chelsea-Stats,2021
ENG-Premier League,2020,Crystal Palace,24,38.0,636,366,329,234,73,283,620,45.6,337,447,138,309,396,1032,774,13,/en/squads/47c64c55/2020-2021/Crystal-Palace-Stats,2021
ENG-Premier League,2020,Everton,29,38.0,640,381,325,242,73,266,664,40.1,398,458,157,301,392,1032,847,19,/en/squads/d3fd31cc/2020-2021/Everton-Stats,2021
ENG-Premier League,2020,Fulham,28,38.0,601,329,282,231,88,254,581,43.7,327,356,95,261,437,1038,794,13,/en/squads/fd962109/2020-2021/Fulham-Stats,2021
ENG-Premier League,2020,Leeds United,23,38.0,740,417,378,279,83,310,769,40.3,459,406,149,257,397,1137,646,26,/en/squads/5bfb9659/2020-2021/Leeds-United-Stats,2021
ENG-Premier League,2020,Leicester City,27,38.0,681,403,319,263,99,295,676,43.6,381,386,90,296,438,1119,685,9,/en/squads/a2d435b3/2020-2021/Leicester-City-Stats,2021
ENG-Premier League,2020,Liverpool,28,38.0,526,303,195,231,100,220,543,40.5,323,338,58,280,347,873,563,20,/en/squads/822bd0ba/2020-2021/Liverpool-Stats,2021
ENG-Premier League,2020,Manchester City,24,38.0,498,271,198,212,88,234,576,40.6,342,310,82,228,319,817,453,11,/en/squads/b8fd03ef/2020-2021/Manchester-City-Stats,2021
ENG-Premier League,2020,Manchester Utd,29,38.0,551,311,252,239,60,231,572,40.4,341,418,116,302,386,937,634,20,/en/squads/19538871/2020-2021/Manchester-United-Stats,2021
ENG-Premier League,2020,Newcastle Utd,27,38.0,512,268,257,213,42,207,547,37.8,340,423,160,263,362,874,908,10,/en/squads/b2b47a98/2020-2021/Newcastle-United-Stats,2021
ENG-Premier League,2020,Sheffield Utd,27,38.0,634,356,325,239,70,294,720,40.8,426,442,152,290,351,985,839,19,/en/squads/1df6b87e/2020-2021/Sheffield-United-Stats,2021
ENG-Premier League,2020,Southampton,29,38.0,727,419,335,325,67,341,731,46.6,390,439,95,344,401,1128,681,10,/en/squads/33c895d4/2020-2021/Southampton-Stats,2021
ENG-Premier League,2020,Tottenham,24,38.0,636,361,313,244,79,277,683,40.6,406,434,147,287,342,978,795,15,/en/squads/361ca564/2020-2021/Tottenham-Hotspur-Stats,2021
ENG-Premier League,2020,West Brom,30,38.0,581,328,329,192,60,271,656,41.3,385,455,159,296,435,1016,876,13,/en/squads/60c6b05f/2020-2021/West-Bromwich-Albion-Stats,2021
ENG-Premier League,2020,West Ham,24,38.0,514,280,269,195,50,224,573,39.1,349,405,124,281,437,951,779,11,/en/squads/7c21e445/2020-2021/West-Ham-United-Stats,2021
ENG-Premier League,2020,Wolves,27,38.0,588,335,322,220,46,277,611,45.3,334,359,117,242,432,1020,727,15,/en/squads/8cec06e1/2020-2021/Wolverhampton-Wanderers-Stats,2021
ENG-Premier League,2021,Arsenal,27,38.0,540,311,261,195,84,244,500,48.8,256,386,123,263,296,836,658,20,/en/squads/18bb7c10/2021-2022/Arsenal-Stats,2022
ENG-Premier League,2021,Aston Villa,31,38.0,634,382,300,259,75,300,649,46.2,349,453,140,313,339,973,693,13,/en/squads/8602292d/2021-2022/Aston-Villa-Stats,2022
ENG-Premier League,2021,Brentford,29,38.0,607,342,299,228,80,291,616,47.2,325,383,113,270,393,1000,863,7,/en/squads/cd051869/2021-2022/Brentford-Stats,2022
ENG-Premier League,2021,Brighton,26,38.0,668,403,306,257,105,243,563,43.2,320,480,150,330,358,1026,723,12,/en/squads/d07537b9/2021-2022/Brighton-and-Hove-Albion-Stats,2022
ENG-Premier League,2021,Burnley,23,38.0,590,324,273,235,82,250,534,46.8,284,509,211,298,410,1000,887,18,/en/squads/943e8050/2021-2022/Burnley-Stats,2022
ENG-Premier League,2021,Chelsea,26,38.0,621,348,267,269,85,257,567,45.3,310,408,96,312,347,968,641,15,/en/squads/cff3d9bb/2021-2022/Chelsea-Stats,2022
ENG-Premier League,2021,Crystal Palace,24,38.0,637,374,323,236,78,273,575,47.5,302,452,135,317,333,970,761,5,/en/squads/47c64c55/2021-2022/Crystal-Palace-Stats,2022
ENG-Premier League,2021,Everton,33,38.0,705,402,369,252,84,336,735,45.7,399,496,140,356,365,1070,815,15,/en/squads/d3fd31cc/2021-2022/Everton-Stats,2022
ENG-Premier League,2021,Leeds United,29,38.0,787,437,396,298,93,408,886,46.0,478,473,143,330,395,1182,621,15,/en/squads/5bfb9659/2021-2022/Leeds-United-Stats,2022
ENG-Premier League,2021,Leicester City,28,38.0,690,384,336,270,84,306,720,42.5,414,469,146,323,367,1057,777,15,/en/squads/a2d435b3/2021-2022/Leicester-City-Stats,2022
ENG-Premier League,2021,Liverpool,27,38.0,554,320,207,240,107,233,576,40.5,343,359,74,285,340,894,523,8,/en/squads/822bd0ba/2021-2022/Liverpool-Stats,2022
ENG-Premier League,2021,Manchester City,26,38.0,498,284,183,214,101,227,509,44.6,282,267,55,212,279,777,403,7,/en/squads/b8fd03ef/2021-2022/Manchester-City-Stats,2022
ENG-Premier League,2021,Manchester Utd,29,38.0,585,358,320,197,68,265,608,43.6,343,404,133,271,340,925,704,20,/en/squads/19538871/2021-2022/Manchester-United-Stats,2022
ENG-Premier League,2021,Newcastle Utd,29,38.0,659,383,334,266,59,304,641,47.4,337,420,162,258,360,1019,776,14,/en/squads/b2b47a98/2021-2022/Newcastle-United-Stats,2022
ENG-Premier League,2021,Norwich City,28,38.0,614,368,322,242,50,297,714,41.6,417,450,180,270,381,995,860,14,/en/squads/1c781004/2021-2022/Norwich-City-Stats,2022
ENG-Premier League,2021,Southampton,25,38.0,602,340,285,243,74,248,581,42.7,333,430,132,298,446,1048,795,13,/en/squads/33c895d4/2021-2022/Southampton-Stats,2022
ENG-Premier League,2021,Tottenham,25,38.0,598,349,286,244,68,262,584,44.9,322,470,161,309,355,953,793,15,/en/squads/361ca564/2021-2022/Tottenham-Hotspur-Stats,2022
ENG-Premier League,2021,Watford,30,38.0,614,356,341,213,60,278,626,44.4,348,440,148,292,444,1058,899,19,/en/squads/2abfe087/2021-2022/Watford-Stats,2022
ENG-Premier League,2021,West Ham,25,38.0,534,301,273,199,62,240,557,43.1,317,420,175,245,374,908,781,5,/en/squads/7c21e445/2021-2022/West-Ham-United-Stats,2022
ENG-Premier League,2021,Wolves,26,38.0,673,377,377,242,54,273,671,40.7,398,437,135,302,389,1062,820,20,/en/squads/8cec06e1/2021-2022/Wolverhampton-Wanderers-Stats,2022
ENG-Premier League,2022,Arsenal,26,38.0,568,343,238,212,118,249,506,49.2,257,362,86,276,237,805,599,22,/en/squads/18bb7c10/Arsenal-Stats,2023
ENG-Premier League,2022,Aston Villa,26,38.0,633,338,305,251,77,313,646,48.5,333,438,118,320,324,957,714,13,/en/squads/8602292d/Aston-Villa-Stats,2023
ENG-Premier League,2022,Bournemouth,31,38.0,618,371,316,249,53,256,606,42.2,350,499,170,329,353,971,1027,10,/en/squads/4ba7cbea/Bournemouth-Stats,2023
ENG-Premier League,2022,Brentford,25,38.0,587,337,270,228,89,253,599,42.2,346,456,168,288,341,928,822,12,/en/squads/cd051869/Brentford-Stats,2023
ENG-Premier League,2022,Brighton,29,38.0,616,340,270,242,104,266,560,47.5,294,392,104,288,303,919,432,15,/en/squads/d07537b9/Brighton-and-Hove-Albion-Stats,2023
ENG-Premier League,2022,Chelsea,32,38.0,740,445,363,267,110,333,654,50.9,321,466,108,358,341,1081,661,20,/en/squads/cff3d9bb/Chelsea-Stats,2023
ENG-Premier League,2022,Crystal Palace,26,38.0,690,421,354,246,90,281,532,52.8,251,463,119,344,359,1049,807,5,/en/squads/47c64c55/Crystal-Palace-Stats,2023
ENG-Premier League,2022,Everton,28,38.0,708,424,362,257,89,309,611,50.6,302,510,180,330,390,1098,874,17,/en/squads/d3fd31cc/Everton-Stats,2023
ENG-Premier League,2022,Fulham,29,38.0,623,349,294,228,101,299,578,51.7,279,455,125,330,340,963,749,13,/en/squads/fd962109/Fulham-Stats,2023
ENG-Premier League,2022,Leeds United,29,38.0,840,480,376,343,121,412,863,47.7,451,536,131,405,392,1232,734,18,/en/squads/5bfb9659/Leeds-United-Stats,2023
ENG-Premier League,2022,Leicester City,28,38.0,700,412,345,292,63,308,669,46.0,361,517,170,347,367,1067,777,11,/en/squads/a2d435b3/Leicester-City-Stats,2023
ENG-Premier League,2022,Liverpool,28,38.0,590,370,228,250,112,281,648,43.4,367,350,74,276,333,923,568,19,/en/squads/822bd0ba/Liverpool-Stats,2023
ENG-Premier League,2022,Manchester City,24,38.0,471,272,185,198,88,212,455,46.6,243,339,95,244,223,694,402,8,/en/squads/b8fd03ef/Manchester-City-Stats,2023
ENG-Premier League,2022,Manchester Utd,26,38.0,658,400,343,231,84,301,598,50.3,297,496,146,350,352,1010,771,10,/en/squads/19538871/Manchester-United-Stats,2023
ENG-Premier League,2022,Newcastle Utd,27,38.0,607,360,268,254,85,307,642,47.8,335,448,116,332,333,940,680,10,/en/squads/b2b47a98/Newcastle-United-Stats,2023
ENG-Premier League,2022,Nott'ham Forest,33,38.0,659,387,380,201,78,296,584,50.7,288,500,156,344,349,1008,944,6,/en/squads/e4a775cb/Nottingham-Forest-Stats,2023
ENG-Premier League,2022,Southampton,36,38.0,713,426,377,279,57,297,609,48.8,312,542,165,377,428,1141,852,10,/en/squads/33c895d4/Southampton-Stats,2023
ENG-Premier League,2022,Tottenham,29,38.0,619,353,325,215,79,275,574,47.9,299,428,148,280,340,959,762,19,/en/squads/361ca564/Tottenham-Hotspur-Stats,2023
ENG-Premier League,2022,West Ham,25,38.0,607,335,289,226,92,269,558,48.2,289,415,139,276,408,1015,810,10,/en/squads/7c21e445/West-Ham-United-Stats,2023
ENG-Premier League,2022,Wolves,32,38.0,661,370,364,222,75,286,609,47.0,323,497,175,322,279,940,817,18,/en/squads/8cec06e1/Wolverhampton-Wanderers-Stats,2023
ESP-La Liga,2017,Alavés,30,38.0,702,464,364,265,73,267,663,40.3,396,407,133,274,498,1200,981,11,/en/squads/8d6fd021/2017-2018/Alaves-Stats,2018
ESP-La Liga,2017,Athletic Club,26,38.0,739,486,359,304,76,296,735,40.3,439,432,103,329,465,1204,820,9,/en/squads/2b390eca/2017-2018/Athletic-Club-Stats,2018
ESP-La Liga,2017,Atlético Madrid,26,38.0,917,614,442,372,103,377,847,44.5,470,462,129,333,513,1430,885,4,/en/squads/db3b9613/2017-2018/Atletico-Madrid-Stats,2018
ESP-La Liga,2017,Barcelona,25,38.0,629,413,281,262,86,229,552,41.5,323,366,103,263,424,1053,525,10,/en/squads/206d90db/2017-2018/Barcelona-Stats,2018
ESP-La Liga,2017,Betis,29,38.0,635,424,319,252,64,213,537,39.7,324,356,95,261,427,1062,869,17,/en/squads/fc536746/2017-2018/Real-Betis-Stats,2018
ESP-La Liga,2017,Celta Vigo,23,38.0,589,420,304,232,53,218,556,39.2,338,327,101,226,497,1086,780,10,/en/squads/f25da7fb/2017-2018/Celta-Vigo-Stats,2018
ESP-La Liga,2017,Eibar,27,38.0,643,436,271,282,90,258,613,42.1,355,349,53,296,554,1197,712,9,/en/squads/bea5c710/2017-2018/Eibar-Stats,2018
ESP-La Liga,2017,Espanyol,25,38.0,716,500,357,278,81,271,700,38.7,429,362,116,246,515,1231,902,9,/en/squads/a8661628/2017-2018/Espanyol-Stats,2018
ESP-La Liga,2017,Getafe,32,38.0,715,491,369,267,79,276,732,37.7,456,350,69,281,487,1202,899,5,/en/squads/7848bd64/2017-2018/Getafe-Stats,2018
ESP-La Liga,2017,Girona,25,38.0,611,403,299,254,58,240,606,39.6,366,329,84,245,490,1101,858,6,/en/squads/9024a00a/2017-2018/Girona-Stats,2018
ESP-La Liga,2017,La Coruña,32,38.0,728,500,386,282,60,292,679,43.0,387,391,113,278,484,1212,942,13,/en/squads/2a60ed82/2017-2018/Deportivo-La-Coruna-Stats,2018
ESP-La Liga,2017,Las Palmas,36,38.0,654,433,325,269,60,268,647,41.4,379,367,112,255,508,1162,713,21,/en/squads/0049d422/2017-2018/Las-Palmas-Stats,2018
ESP-La Liga,2017,Leganés,28,38.0,721,483,350,307,64,323,697,46.3,374,361,87,274,583,1304,777,9,/en/squads/7c6f2c78/2017-2018/Leganes-Stats,2018
ESP-La Liga,2017,Levante,33,38.0,616,414,328,222,66,239,625,38.2,386,395,127,268,477,1093,811,9,/en/squads/9800b6a1/2017-2018/Levante-Stats,2018
ESP-La Liga,2017,Málaga,37,38.0,745,509,383,276,86,272,707,38.5,435,362,101,261,497,1242,890,3,/en/squads/1c896955/2017-2018/Malaga-Stats,2018
ESP-La Liga,2017,Real Madrid,24,38.0,687,470,317,275,95,252,621,40.6,369,362,83,279,424,1111,536,16,/en/squads/53a2f082/2017-2018/Real-Madrid-Stats,2018
ESP-La Liga,2017,Real Sociedad,27,38.0,547,374,249,228,70,227,536,42.4,309,367,91,276,446,993,665,6,/en/squads/e31d1cd9/2017-2018/Real-Sociedad-Stats,2018
ESP-La Liga,2017,Sevilla,31,38.0,768,535,354,325,89,296,685,43.2,389,419,114,305,409,1177,849,17,/en/squads/ad2be733/2017-2018/Sevilla-Stats,2018
ESP-La Liga,2017,Valencia,25,38.0,745,492,407,267,71,309,692,44.7,383,416,108,308,459,1204,910,9,/en/squads/dcc91a7b/2017-2018/Valencia-Stats,2018
ESP-La Liga,2017,Villarreal,32,38.0,711,466,356,278,77,277,700,39.6,423,447,131,316,427,1138,1023,7,/en/squads/2a8183b3/2017-2018/Villarreal-Stats,2018
ESP-La Liga,2018,Alavés,26,38.0,646,389,352,228,66,254,595,42.7,341,419,117,302,390,1036,1066,13,/en/squads/8d6fd021/2018-2019/Alaves-Stats,2019
ESP-La Liga,2018,Athletic Club,27,38.0,643,384,311,245,87,245,646,37.9,401,414,93,321,453,1096,815,7,/en/squads/2b390eca/2018-2019/Athletic-Club-Stats,2019
ESP-La Liga,2018,Atlético Madrid,29,38.0,784,487,402,298,84,319,700,45.6,381,374,94,280,463,1247,837,12,/en/squads/db3b9613/2018-2019/Atletico-Madrid-Stats,2019
ESP-La Liga,2018,Barcelona,30,38.0,537,346,218,232,87,226,492,45.9,266,360,101,259,391,928,565,16,/en/squads/206d90db/2018-2019/Barcelona-Stats,2019
ESP-La Liga,2018,Betis,25,38.0,615,378,309,227,79,219,544,40.3,325,382,80,302,361,976,702,21,/en/squads/fc536746/2018-2019/Real-Betis-Stats,2019
ESP-La Liga,2018,Celta Vigo,28,38.0,634,377,364,213,57,258,562,45.9,304,380,105,275,382,1016,889,19,/en/squads/f25da7fb/2018-2019/Celta-Vigo-Stats,2019
ESP-La Liga,2018,Eibar,25,38.0,637,424,238,289,110,240,563,42.6,323,357,53,304,368,1005,683,10,/en/squads/bea5c710/2018-2019/Eibar-Stats,2019
ESP-La Liga,2018,Espanyol,25,38.0,655,394,324,244,87,263,684,38.5,421,402,134,268,408,1063,950,14,/en/squads/a8661628/2018-2019/Espanyol-Stats,2019
ESP-La Liga,2018,Getafe,26,38.0,604,358,246,281,77,255,617,41.3,362,422,81,341,453,1057,888,15,/en/squads/7848bd64/2018-2019/Getafe-Stats,2019
ESP-La Liga,2018,Girona,26,38.0,613,367,309,247,57,264,636,41.5,372,401,124,277,432,1045,928,14,/en/squads/9024a00a/2018-2019/Girona-Stats,2019
ESP-La Liga,2018,Huesca,30,38.0,712,452,363,290,59,303,694,43.7,391,414,107,307,440,1152,953,12,/en/squads/c6c493e6/2018-2019/Huesca-Stats,2019
ESP-La Liga,2018,Leganés,29,38.0,609,382,325,221,63,227,581,39.1,354,329,84,245,432,1041,907,10,/en/squads/7c6f2c78/2018-2019/Leganes-Stats,2019
ESP-La Liga,2018,Levante,26,38.0,572,372,308,196,68,264,722,36.6,458,455,151,304,422,994,842,12,/en/squads/9800b6a1/2018-2019/Levante-Stats,2019
ESP-La Liga,2018,Rayo Vallecano,29,38.0,651,422,369,223,59,257,592,43.4,335,388,77,311,433,1084,931,16,/en/squads/98e8af82/2018-2019/Rayo-Vallecano-Stats,2019
ESP-La Liga,2018,Real Madrid,27,38.0,626,395,267,253,106,245,629,39.0,384,374,78,296,373,999,602,11,/en/squads/53a2f082/2018-2019/Real-Madrid-Stats,2019
ESP-La Liga,2018,Real Sociedad,30,38.0,579,344,299,219,61,248,584,42.5,336,444,109,335,425,1004,842,19,/en/squads/e31d1cd9/2018-2019/Real-Sociedad-Stats,2019
ESP-La Liga,2018,Sevilla,27,38.0,598,408,288,237,73,203,513,39.6,310,370,114,256,365,963,817,15,/en/squads/ad2be733/2018-2019/Sevilla-Stats,2019
ESP-La Liga,2018,Valencia,25,38.0,598,384,299,228,71,238,588,40.5,350,447,120,327,418,1016,860,12,/en/squads/dcc91a7b/2018-2019/Valencia-Stats,2019
ESP-La Liga,2018,Valladolid,28,38.0,714,441,369,265,80,280,678,41.3,398,413,113,300,387,1101,874,16,/en/squads/17859612/2018-2019/Valladolid-Stats,2019
ESP-La Liga,2018,Villarreal,26,38.0,667,413,333,255,79,273,659,41.4,386,406,142,264,390,1057,877,12,/en/squads/2a8183b3/2018-2019/Villarreal-Stats,2019
ESP-La Liga,2019,Alavés,32,38.0,579,346,261,265,53,255,619,41.2,364,385,114,271,392,971,766,7,/en/squads/8d6fd021/2019-2020/Alaves-Stats,2020
ESP-La Liga,2019,Athletic Club,26,38.0,533,324,262,204,67,217,613,35.4,396,339,92,247,373,906,755,7,/en/squads/2b390eca/2019-2020/Athletic-Club-Stats,2020
ESP-La Liga,2019,Atlético Madrid,30,38.0,658,406,293,272,93,283,640,44.2,357,380,108,272,412,1070,729,18,/en/squads/db3b9613/2019-2020/Atletico-Madrid-Stats,2020
ESP-La Liga,2019,Barcelona,28,38.0,536,323,216,223,97,211,501,42.1,290,313,87,226,342,878,529,16,/en/squads/206d90db/2019-2020/Barcelona-Stats,2020
ESP-La Liga,2019,Betis,27,38.0,501,299,276,173,52,221,511,43.2,290,336,119,217,302,803,682,8,/en/squads/fc536746/2019-2020/Real-Betis-Stats,2020
ESP-La Liga,2019,Celta Vigo,30,38.0,589,357,344,193,52,251,615,40.8,364,345,89,256,396,985,807,12,/en/squads/f25da7fb/2019-2020/Celta-Vigo-Stats,2020
ESP-La Liga,2019,Eibar,26,38.0,567,338,240,228,99,264,607,43.5,343,332,81,251,430,997,692,8,/en/squads/bea5c710/2019-2020/Eibar-Stats,2020
ESP-La Liga,2019,Espanyol,31,38.0,628,364,303,253,72,257,701,36.7,444,380,96,284,360,988,731,17,/en/squads/a8661628/2019-2020/Espanyol-Stats,2020
ESP-La Liga,2019,Getafe,30,38.0,580,341,235,263,82,235,573,41.0,338,374,60,314,367,947,625,12,/en/squads/7848bd64/2019-2020/Getafe-Stats,2020
ESP-La Liga,2019,Granada,27,38.0,584,349,257,257,70,238,570,41.8,332,375,118,257,383,967,750,10,/en/squads/a0435291/2019-2020/Granada-Stats,2020
ESP-La Liga,2019,Leganés,29,38.0,603,357,317,215,71,254,610,41.6,356,320,73,247,418,1021,687,7,/en/squads/7c6f2c78/2019-2020/Leganes-Stats,2020
ESP-La Liga,2019,Levante,29,38.0,507,288,281,173,53,204,532,38.3,328,317,107,210,331,838,763,14,/en/squads/9800b6a1/2019-2020/Levante-Stats,2020
ESP-La Liga,2019,Mallorca,32,38.0,545,338,280,213,52,227,602,37.7,375,360,117,243,376,921,672,9,/en/squads/2aa12281/2019-2020/Mallorca-Stats,2020
ESP-La Liga,2019,Osasuna,31,38.0,613,361,275,267,71,267,617,43.3,350,385,98,287,417,1030,738,19,/en/squads/03c57e2b/2019-2020/Osasuna-Stats,2020
ESP-La Liga,2019,Real Madrid,26,38.0,586,355,252,253,81,226,595,38.0,369,367,77,290,381,967,590,13,/en/squads/53a2f082/2019-2020/Real-Madrid-Stats,2020
ESP-La Liga,2019,Real Sociedad,27,38.0,551,321,254,224,73,252,573,44.0,321,346,79,267,320,871,694,12,/en/squads/e31d1cd9/2019-2020/Real-Sociedad-Stats,2020
ESP-La Liga,2019,Sevilla,26,38.0,587,344,274,246,67,261,661,39.5,400,331,94,237,346,933,704,10,/en/squads/ad2be733/2019-2020/Sevilla-Stats,2020
ESP-La Liga,2019,Valencia,28,38.0,500,311,270,173,57,232,589,39.4,357,334,130,204,360,860,748,12,/en/squads/dcc91a7b/2019-2020/Valencia-Stats,2020
ESP-La Liga,2019,Valladolid,30,38.0,568,327,316,204,48,239,672,35.6,433,391,112,279,390,958,749,13,/en/squads/17859612/2019-2020/Valladolid-Stats,2020
ESP-La Liga,2019,Villarreal,25,38.0,553,323,250,239,64,218,602,36.2,384,362,116,246,339,892,814,12,/en/squads/2a8183b3/2019-2020/Villarreal-Stats,2020
ESP-La Liga,2020,Alavés,30,38.0,499,292,263,181,55,197,565,34.9,368,341,90,251,427,926,766,8,/en/squads/8d6fd021/2020-2021/Alaves-Stats,2021
ESP-La Liga,2020,Athletic Club,27,38.0,462,269,194,200,68,168,516,32.6,348,341,74,267,344,806,684,9,/en/squads/2b390eca/2020-2021/Athletic-Club-Stats,2021
ESP-La Liga,2020,Atlético Madrid,25,38.0,622,367,291,253,78,296,631,46.9,335,361,83,278,386,1008,671,7,/en/squads/db3b9613/2020-2021/Atletico-Madrid-Stats,2021
ESP-La Liga,2020,Barcelona,25,38.0,499,293,223,195,81,224,522,42.9,298,325,70,255,361,860,429,16,/en/squads/206d90db/2020-2021/Barcelona-Stats,2021
ESP-La Liga,2020,Betis,25,38.0,556,315,274,221,61,211,556,37.9,345,362,74,288,453,1009,687,11,/en/squads/fc536746/2020-2021/Real-Betis-Stats,2021
ESP-La Liga,2020,Celta Vigo,30,38.0,662,368,332,259,71,238,694,34.3,456,399,89,310,405,1067,751,12,/en/squads/f25da7fb/2020-2021/Celta-Vigo-Stats,2021
ESP-La Liga,2020,Cádiz,34,38.0,573,317,305,216,52,247,607,40.7,360,368,99,269,437,1010,788,8,/en/squads/ee7c297c/2020-2021/Cadiz-Stats,2021
ESP-La Liga,2020,Eibar,30,38.0,514,309,228,204,82,203,518,39.2,315,360,63,297,434,948,593,11,/en/squads/bea5c710/2020-2021/Eibar-Stats,2021
ESP-La Liga,2020,Elche,30,38.0,551,336,324,189,38,210,577,36.4,367,357,97,260,386,937,689,10,/en/squads/6c8b07df/2020-2021/Elche-Stats,2021
ESP-La Liga,2020,Getafe,31,38.0,579,352,232,276,71,241,619,38.9,378,361,53,308,393,972,615,4,/en/squads/7848bd64/2020-2021/Getafe-Stats,2021
ESP-La Liga,2020,Granada,34,38.0,499,279,226,213,60,185,468,39.5,283,388,128,260,392,891,764,7,/en/squads/a0435291/2020-2021/Granada-Stats,2021
ESP-La Liga,2020,Huesca,27,38.0,556,321,309,191,56,239,579,41.3,340,342,83,259,437,993,616,7,/en/squads/c6c493e6/2020-2021/Huesca-Stats,2021
ESP-La Liga,2020,Levante,29,38.0,511,282,268,188,55,208,543,38.3,335,335,93,242,435,946,681,15,/en/squads/9800b6a1/2020-2021/Levante-Stats,2021
ESP-La Liga,2020,Osasuna,28,38.0,524,281,223,217,84,224,552,40.6,328,349,100,249,392,916,774,7,/en/squads/03c57e2b/2020-2021/Osasuna-Stats,2021
ESP-La Liga,2020,Real Madrid,30,38.0,531,318,266,188,77,192,532,36.1,340,344,83,261,398,929,544,12,/en/squads/53a2f082/2020-2021/Real-Madrid-Stats,2021
ESP-La Liga,2020,Real Sociedad,30,38.0,547,322,240,227,80,200,480,41.7,280,353,96,257,315,862,563,5,/en/squads/e31d1cd9/2020-2021/Real-Sociedad-Stats,2021
ESP-La Liga,2020,Sevilla,26,38.0,492,297,220,200,72,184,510,36.1,326,310,90,220,362,854,636,10,/en/squads/ad2be733/2020-2021/Sevilla-Stats,2021
ESP-La Liga,2020,Valencia,30,38.0,463,277,241,163,59,198,592,33.4,394,372,123,249,392,855,785,12,/en/squads/dcc91a7b/2020-2021/Valencia-Stats,2021
ESP-La Liga,2020,Valladolid,32,38.0,559,321,285,208,66,247,681,36.3,434,379,102,277,431,990,812,9,/en/squads/17859612/2020-2021/Valladolid-Stats,2021
ESP-La Liga,2020,Villarreal,29,38.0,539,313,256,205,78,239,588,40.6,349,358,101,257,371,910,638,17,/en/squads/2a8183b3/2020-2021/Villarreal-Stats,2021
ESP-La Liga,2021,Alavés,33,38.0,550,324,271,221,58,262,637,41.1,375,373,106,267,376,926,890,7,/en/squads/8d6fd021/2021-2022/Alaves-Stats,2022
ESP-La Liga,2021,Athletic Club,26,38.0,508,292,217,216,75,224,582,38.5,358,411,128,283,339,847,788,8,/en/squads/2b390eca/2021-2022/Athletic-Club-Stats,2022
ESP-La Liga,2021,Atlético Madrid,26,38.0,636,346,290,279,67,293,619,47.3,326,372,98,274,365,1001,649,14,/en/squads/db3b9613/2021-2022/Atletico-Madrid-Stats,2022
ESP-La Liga,2021,Barcelona,38,38.0,587,331,236,270,81,244,493,49.5,249,346,85,261,325,912,467,17,/en/squads/206d90db/2021-2022/Barcelona-Stats,2022
ESP-La Liga,2021,Betis,31,38.0,662,392,322,261,79,324,695,46.6,371,386,112,274,361,1023,777,11,/en/squads/fc536746/2021-2022/Real-Betis-Stats,2022
ESP-La Liga,2021,Celta Vigo,25,38.0,696,409,324,279,93,286,762,37.5,476,423,91,332,376,1072,634,11,/en/squads/f25da7fb/2021-2022/Celta-Vigo-Stats,2022
ESP-La Liga,2021,Cádiz,33,38.0,647,380,346,238,63,301,711,42.3,410,390,106,284,413,1060,768,5,/en/squads/ee7c297c/2021-2022/Cadiz-Stats,2022
ESP-La Liga,2021,Elche,28,38.0,589,325,335,191,63,268,622,43.1,354,367,126,241,305,894,769,14,/en/squads/6c8b07df/2021-2022/Elche-Stats,2022
ESP-La Liga,2021,Espanyol,34,38.0,557,338,308,196,53,275,646,42.6,371,360,114,246,326,883,892,20,/en/squads/a8661628/2021-2022/Espanyol-Stats,2022
ESP-La Liga,2021,Getafe,31,38.0,587,360,266,243,78,248,594,41.8,346,400,96,304,401,988,719,8,/en/squads/7848bd64/2021-2022/Getafe-Stats,2022
ESP-La Liga,2021,Granada,32,38.0,611,343,310,240,61,274,632,43.4,358,437,130,307,326,937,841,8,/en/squads/a0435291/2021-2022/Granada-Stats,2022
ESP-La Liga,2021,Levante,31,38.0,558,305,268,212,78,237,611,38.8,374,326,110,216,377,935,735,12,/en/squads/9800b6a1/2021-2022/Levante-Stats,2022
ESP-La Liga,2021,Mallorca,33,38.0,607,332,301,235,71,248,551,45.0,303,374,119,255,344,951,826,9,/en/squads/2aa12281/2021-2022/Mallorca-Stats,2022
ESP-La Liga,2021,Osasuna,29,38.0,577,331,270,236,71,251,598,42.0,347,340,115,225,368,945,758,5,/en/squads/03c57e2b/2021-2022/Osasuna-Stats,2022
ESP-La Liga,2021,Rayo Vallecano,28,38.0,621,359,320,237,64,280,688,40.7,408,410,95,315,365,986,686,9,/en/squads/98e8af82/2021-2022/Rayo-Vallecano-Stats,2022
ESP-La Liga,2021,Real Madrid,31,38.0,560,345,281,195,84,211,502,42.0,291,379,114,265,334,894,526,17,/en/squads/53a2f082/2021-2022/Real-Madrid-Stats,2022
ESP-La Liga,2021,Real Sociedad,32,38.0,586,339,271,234,81,260,546,47.6,286,382,105,277,348,934,703,6,/en/squads/e31d1cd9/2021-2022/Real-Sociedad-Stats,2022
ESP-La Liga,2021,Sevilla,33,38.0,534,302,252,211,71,236,542,43.5,306,367,124,243,270,804,603,18,/en/squads/ad2be733/2021-2022/Sevilla-Stats,2022
ESP-La Liga,2021,Valencia,34,38.0,591,364,289,217,85,266,623,42.7,357,373,93,280,339,930,746,8,/en/squads/dcc91a7b/2021-2022/Valencia-Stats,2022
ESP-La Liga,2021,Villarreal,29,38.0,538,312,250,197,91,229,476,48.1,247,330,109,221,329,867,644,16,/en/squads/2a8183b3/2021-2022/Villarreal-Stats,2022
ESP-La Liga,2022,Almería,29,38.0,557,322,292,202,63,280,623,44.9,343,435,122,313,322,879,855,13,/en/squads/78ecf4bb/Almeria-Stats,2023
ESP-La Liga,2022,Athletic Club,26,38.0,608,369,267,254,87,322,642,50.2,320,415,95,320,310,918,598,14,/en/squads/2b390eca/Athletic-Club-Stats,2023
ESP-La Liga,2022,Atlético Madrid,27,38.0,667,408,332,245,90,334,685,48.8,351,396,103,293,304,971,704,9,/en/squads/db3b9613/Atletico-Madrid-Stats,2023
ESP-La Liga,2022,Barcelona,29,38.0,522,324,211,216,95,227,496,45.8,269,353,82,271,253,775,439,17,/en/squads/206d90db/Barcelona-Stats,2023
ESP-La Liga,2022,Betis,30,38.0,665,421,373,238,54,338,701,48.2,363,411,112,299,364,1029,857,7,/en/squads/fc536746/Real-Betis-Stats,2023
ESP-La Liga,2022,Celta Vigo,26,38.0,664,413,319,269,76,295,676,43.6,381,393,84,309,368,1032,666,5,/en/squads/f25da7fb/Celta-Vigo-Stats,2023
ESP-La Liga,2022,Cádiz,38,38.0,623,410,358,205,60,320,671,47.7,351,425,128,297,270,893,853,13,/en/squads/ee7c297c/Cadiz-Stats,2023
ESP-La Liga,2022,Elche,32,38.0,633,363,367,212,54,280,603,46.4,323,413,131,282,323,956,766,13,/en/squads/6c8b07df/Elche-Stats,2023
ESP-La Liga,2022,Espanyol,33,38.0,652,379,330,239,83,301,600,50.2,299,416,134,282,338,990,788,9,/en/squads/a8661628/Espanyol-Stats,2023
ESP-La Liga,2022,Getafe,25,38.0,541,339,282,199,60,285,619,46.0,334,404,113,291,320,861,794,10,/en/squads/7848bd64/Getafe-Stats,2023
ESP-La Liga,2022,Girona,29,38.0,551,321,271,213,67,244,532,45.9,288,379,111,268,266,817,662,20,/en/squads/9024a00a/Girona-Stats,2023
ESP-La Liga,2022,Mallorca,31,38.0,583,344,318,213,52,283,581,48.7,298,402,146,256,318,901,859,7,/en/squads/2aa12281/Mallorca-Stats,2023
ESP-La Liga,2022,Osasuna,26,38.0,534,328,256,196,82,266,588,45.2,322,392,97,295,315,849,749,10,/en/squads/03c57e2b/Osasuna-Stats,2023
ESP-La Liga,2022,Rayo Vallecano,28,38.0,636,393,262,276,98,281,664,42.3,383,428,92,336,309,945,680,11,/en/squads/98e8af82/Rayo-Vallecano-Stats,2023
ESP-La Liga,2022,Real Madrid,26,38.0,542,353,242,212,88,259,565,45.8,306,365,105,260,296,838,469,5,/en/squads/53a2f082/Real-Madrid-Stats,2023
ESP-La Liga,2022,Real Sociedad,30,38.0,660,395,304,254,102,285,613,46.5,328,399,103,296,271,931,624,13,/en/squads/e31d1cd9/Real-Sociedad-Stats,2023
ESP-La Liga,2022,Sevilla,35,38.0,587,367,261,230,96,281,591,47.5,310,361,127,234,339,926,633,9,/en/squads/ad2be733/Sevilla-Stats,2023
ESP-La Liga,2022,Valencia,28,38.0,678,428,340,254,84,311,645,48.2,334,370,75,295,288,966,643,21,/en/squads/dcc91a7b/Valencia-Stats,2023
ESP-La Liga,2022,Valladolid,36,38.0,671,396,334,251,86,296,628,47.1,332,432,149,283,345,1016,767,8,/en/squads/17859612/Valladolid-Stats,2023
ESP-La Liga,2022,Villarreal,32,38.0,578,370,276,201,101,270,534,50.6,264,372,125,247,262,840,691,16,/en/squads/2a8183b3/Villarreal-Stats,2023
FRA-Ligue 1,2017,Amiens,30,38.0,658,445,336,252,70,243,623,39.0,380,444,164,280,523,1181,1128,20,/en/squads/25622401/2017-2018/Amiens-Stats,2018
FRA-Ligue 1,2017,Angers,27,38.0,661,427,350,240,71,244,766,31.9,522,402,79,323,410,1071,853,14,/en/squads/69236f98/2017-2018/Angers-Stats,2018
FRA-Ligue 1,2017,Bordeaux,31,38.0,699,459,311,322,66,246,682,36.1,436,355,110,245,464,1163,855,13,/en/squads/123f3efe/2017-2018/Bordeaux-Stats,2018
FRA-Ligue 1,2017,Caen,26,38.0,733,478,369,295,69,276,747,36.9,471,450,97,353,476,1209,961,12,/en/squads/74229020/2017-2018/Caen-Stats,2018
FRA-Ligue 1,2017,Dijon,26,38.0,685,462,363,264,58,250,687,36.4,437,385,118,267,544,1229,977,20,/en/squads/8dfb7350/2017-2018/Dijon-Stats,2018
FRA-Ligue 1,2017,Guingamp,23,38.0,640,437,310,271,59,228,672,33.9,444,368,121,247,475,1115,976,15,/en/squads/d41b5f53/2017-2018/Guingamp-Stats,2018
FRA-Ligue 1,2017,Lille,25,38.0,681,453,364,261,56,229,606,37.8,377,378,108,270,492,1173,776,21,/en/squads/cb188c0c/2017-2018/Lille-Stats,2018
FRA-Ligue 1,2017,Lyon,26,38.0,639,411,283,285,71,207,573,36.1,366,352,101,251,450,1089,863,18,/en/squads/d53c0b06/2017-2018/Lyon-Stats,2018
FRA-Ligue 1,2017,Marseille,26,38.0,757,505,331,340,86,291,755,38.5,464,392,102,290,448,1205,797,17,/en/squads/5725cc7b/2017-2018/Marseille-Stats,2018
FRA-Ligue 1,2017,Metz,36,38.0,707,458,359,281,67,252,682,37.0,430,375,94,281,511,1218,848,12,/en/squads/f83960ae/2017-2018/Metz-Stats,2018
FRA-Ligue 1,2017,Monaco,32,38.0,719,433,283,347,89,263,700,37.6,437,394,107,287,497,1216,1000,9,/en/squads/fd6114db/2017-2018/Monaco-Stats,2018
FRA-Ligue 1,2017,Montpellier,23,38.0,680,450,307,303,70,229,589,38.9,360,343,97,246,499,1179,879,16,/en/squads/281b0e73/2017-2018/Montpellier-Stats,2018
FRA-Ligue 1,2017,Nantes,30,38.0,756,510,383,302,71,272,662,41.1,390,495,138,357,426,1182,1052,14,/en/squads/d7a486cd/2017-2018/Nantes-Stats,2018
FRA-Ligue 1,2017,Nice,31,38.0,588,398,327,215,46,230,572,40.2,342,369,115,254,437,1025,687,32,/en/squads/132ebc33/2017-2018/Nice-Stats,2018
FRA-Ligue 1,2017,Paris S-G,28,38.0,646,435,285,264,97,213,594,35.9,381,322,97,225,329,975,620,19,/en/squads/e2d8892c/2017-2018/Paris-Saint-Germain-Stats,2018
FRA-Ligue 1,2017,Rennes,28,38.0,656,409,295,277,84,263,747,35.2,484,408,89,319,415,1071,1012,19,/en/squads/b3072e00/2017-2018/Rennes-Stats,2018
FRA-Ligue 1,2017,Saint-Étienne,30,38.0,679,447,364,253,62,243,680,35.7,437,400,121,279,401,1080,965,16,/en/squads/d298ef2c/2017-2018/Saint-Etienne-Stats,2018
FRA-Ligue 1,2017,Strasbourg,25,38.0,750,490,388,298,64,243,661,36.8,418,360,91,269,515,1265,879,20,/en/squads/c0d3eab4/2017-2018/Strasbourg-Stats,2018
FRA-Ligue 1,2017,Toulouse,25,38.0,699,465,349,275,75,254,662,38.4,408,392,101,291,479,1178,928,18,/en/squads/3f8c4b5f/2017-2018/Toulouse-Stats,2018
FRA-Ligue 1,2017,Troyes,25,38.0,657,410,365,221,71,225,673,33.4,448,383,129,254,437,1094,1094,18,/en/squads/54195385/2017-2018/Troyes-Stats,2018
FRA-Ligue 1,2018,Amiens,26,38.0,629,384,313,244,72,256,611,41.9,355,389,141,248,396,1025,876,16,/en/squads/25622401/2018-2019/Amiens-Stats,2019
FRA-Ligue 1,2018,Angers,24,38.0,673,399,351,254,68,260,624,41.7,364,396,109,287,420,1093,889,8,/en/squads/69236f98/2018-2019/Angers-Stats,2019
FRA-Ligue 1,2018,Bordeaux,33,38.0,720,447,359,303,58,296,666,44.4,370,394,114,280,391,1111,966,20,/en/squads/123f3efe/2018-2019/Bordeaux-Stats,2019
FRA-Ligue 1,2018,Caen,26,38.0,709,435,373,271,65,291,621,46.9,330,403,141,262,489,1198,952,18,/en/squads/74229020/2018-2019/Caen-Stats,2019
FRA-Ligue 1,2018,Dijon,26,38.0,674,408,339,254,81,261,645,40.5,384,417,119,298,482,1156,826,14,/en/squads/8dfb7350/2018-2019/Dijon-Stats,2019
FRA-Ligue 1,2018,Guingamp,30,38.0,684,431,320,299,65,275,551,49.9,276,416,112,304,421,1105,768,17,/en/squads/d41b5f53/2018-2019/Guingamp-Stats,2019
FRA-Ligue 1,2018,Lille,25,38.0,628,378,295,272,61,263,583,45.1,320,377,106,271,387,1015,764,15,/en/squads/cb188c0c/2018-2019/Lille-Stats,2019
FRA-Ligue 1,2018,Lyon,25,38.0,637,384,285,266,86,231,492,47.0,261,406,136,270,363,1000,680,19,/en/squads/d53c0b06/2018-2019/Lyon-Stats,2019
FRA-Ligue 1,2018,Marseille,24,38.0,781,489,349,332,100,318,698,45.6,380,346,98,248,401,1182,690,18,/en/squads/5725cc7b/2018-2019/Marseille-Stats,2019
FRA-Ligue 1,2018,Monaco,42,38.0,686,422,322,271,93,301,660,45.6,359,334,86,248,386,1072,841,15,/en/squads/fd6114db/2018-2019/Monaco-Stats,2019
FRA-Ligue 1,2018,Montpellier,25,38.0,759,431,364,305,90,304,676,45.0,372,411,105,306,484,1243,751,11,/en/squads/281b0e73/2018-2019/Montpellier-Stats,2019
FRA-Ligue 1,2018,Nantes,33,38.0,767,478,360,315,92,321,690,46.5,369,382,106,276,435,1202,831,6,/en/squads/d7a486cd/2018-2019/Nantes-Stats,2019
FRA-Ligue 1,2018,Nice,30,38.0,662,420,331,264,67,287,617,46.5,330,410,108,302,450,1112,777,11,/en/squads/132ebc33/2018-2019/Nice-Stats,2019
FRA-Ligue 1,2018,Nîmes,23,38.0,733,442,373,282,78,325,757,42.9,432,378,119,259,443,1176,832,8,/en/squads/1cbf5f9e/2018-2019/Nimes-Stats,2019
FRA-Ligue 1,2018,Paris S-G,30,38.0,701,434,286,315,100,282,625,45.1,343,335,93,242,342,1043,535,20,/en/squads/e2d8892c/2018-2019/Paris-Saint-Germain-Stats,2019
FRA-Ligue 1,2018,Reims,27,38.0,760,454,423,257,80,291,647,45.0,356,364,111,253,486,1246,886,18,/en/squads/7fdd64e0/2018-2019/Reims-Stats,2019
FRA-Ligue 1,2018,Rennes,28,38.0,652,395,307,271,74,292,650,44.9,358,405,119,286,389,1041,779,10,/en/squads/b3072e00/2018-2019/Rennes-Stats,2019
FRA-Ligue 1,2018,Saint-Étienne,29,38.0,672,406,307,272,93,278,633,43.9,355,357,97,260,441,1113,774,24,/en/squads/d298ef2c/2018-2019/Saint-Etienne-Stats,2019
FRA-Ligue 1,2018,Strasbourg,26,38.0,649,405,320,256,73,257,570,45.1,313,373,127,246,428,1077,751,12,/en/squads/c0d3eab4/2018-2019/Strasbourg-Stats,2019
FRA-Ligue 1,2018,Toulouse,29,38.0,669,418,362,243,64,265,582,45.5,317,433,126,307,384,1053,947,17,/en/squads/3f8c4b5f/2018-2019/Toulouse-Stats,2019
FRA-Ligue 1,2019,Amiens,27,28.0,425,238,194,184,47,201,510,39.4,309,280,87,193,300,725,615,17,/en/squads/25622401/2019-2020/Amiens-Stats,2020
FRA-Ligue 1,2019,Angers,26,28.0,439,279,206,178,55,177,452,39.2,275,229,51,178,267,706,513,8,/en/squads/69236f98/2019-2020/Angers-Stats,2020
FRA-Ligue 1,2019,Bordeaux,26,28.0,483,284,232,206,45,230,595,38.7,365,237,89,148,302,785,575,13,/en/squads/123f3efe/2019-2020/Bordeaux-Stats,2020
FRA-Ligue 1,2019,Brest,24,28.0,484,282,238,186,60,184,472,39.0,288,263,82,181,352,836,537,11,/en/squads/fb08dbb3/2019-2020/Brest-Stats,2020
FRA-Ligue 1,2019,Dijon,28,28.0,516,304,259,208,49,239,548,43.6,309,277,100,177,332,848,596,14,/en/squads/8dfb7350/2019-2020/Dijon-Stats,2020
FRA-Ligue 1,2019,Lille,25,28.0,424,237,163,203,58,183,467,39.2,284,263,62,201,278,702,450,9,/en/squads/cb188c0c/2019-2020/Lille-Stats,2020
FRA-Ligue 1,2019,Lyon,27,28.0,492,304,232,193,67,201,442,45.5,241,241,94,147,311,803,540,7,/en/squads/d53c0b06/2019-2020/Lyon-Stats,2020
FRA-Ligue 1,2019,Marseille,23,28.0,564,325,246,246,72,235,560,42.0,325,264,58,206,312,876,533,9,/en/squads/5725cc7b/2019-2020/Marseille-Stats,2020
FRA-Ligue 1,2019,Metz,24,28.0,526,337,295,186,45,213,475,44.8,262,293,97,196,312,838,635,5,/en/squads/f83960ae/2019-2020/Metz-Stats,2020
FRA-Ligue 1,2019,Monaco,28,28.0,504,307,231,221,52,235,556,42.3,321,249,70,179,281,785,495,15,/en/squads/fd6114db/2019-2020/Monaco-Stats,2020
FRA-Ligue 1,2019,Montpellier,27,28.0,449,286,215,190,44,217,570,38.1,353,220,83,137,308,757,520,7,/en/squads/281b0e73/2019-2020/Montpellier-Stats,2020
FRA-Ligue 1,2019,Nantes,29,28.0,548,347,245,249,54,265,550,48.2,285,217,72,145,305,853,512,4,/en/squads/d7a486cd/2019-2020/Nantes-Stats,2020
FRA-Ligue 1,2019,Nice,31,28.0,471,279,246,180,45,212,516,41.1,304,280,81,199,343,814,480,13,/en/squads/132ebc33/2019-2020/Nice-Stats,2020
FRA-Ligue 1,2019,Nîmes,28,28.0,552,302,235,258,59,249,599,41.6,350,272,75,197,329,881,469,6,/en/squads/1cbf5f9e/2019-2020/Nimes-Stats,2020
FRA-Ligue 1,2019,Paris S-G,31,27.0,484,295,191,220,73,191,473,40.4,282,258,57,201,255,739,303,13,/en/squads/e2d8892c/2019-2020/Paris-Saint-Germain-Stats,2020
FRA-Ligue 1,2019,Reims,26,28.0,490,324,259,185,46,184,401,45.9,217,228,72,156,325,815,514,8,/en/squads/7fdd64e0/2019-2020/Reims-Stats,2020
FRA-Ligue 1,2019,Rennes,26,28.0,501,296,251,205,45,218,533,40.9,315,277,96,181,272,773,594,7,/en/squads/b3072e00/2019-2020/Rennes-Stats,2020
FRA-Ligue 1,2019,Saint-Étienne,31,28.0,512,318,212,238,62,219,508,43.1,289,267,63,204,376,888,478,15,/en/squads/d298ef2c/2019-2020/Saint-Etienne-Stats,2020
FRA-Ligue 1,2019,Strasbourg,25,27.0,472,293,234,193,45,189,403,46.9,214,198,51,147,301,773,436,11,/en/squads/c0d3eab4/2019-2020/Strasbourg-Stats,2020
FRA-Ligue 1,2019,Toulouse,30,28.0,549,346,270,227,52,220,508,43.3,288,252,77,175,320,869,592,13,/en/squads/3f8c4b5f/2019-2020/Toulouse-Stats,2020
FRA-Ligue 1,2020,Angers,31,38.0,626,376,302,256,68,314,754,41.6,440,330,78,252,443,1069,654,1,/en/squads/69236f98/2020-2021/Angers-Stats,2021
FRA-Ligue 1,2020,Bordeaux,28,38.0,567,329,294,212,61,253,623,40.6,370,383,123,260,503,1070,677,9,/en/squads/123f3efe/2020-2021/Bordeaux-Stats,2021
FRA-Ligue 1,2020,Brest,26,38.0,610,355,321,236,53,284,633,44.9,349,358,109,249,463,1073,685,12,/en/squads/fb08dbb3/2020-2021/Brest-Stats,2021
FRA-Ligue 1,2020,Dijon,33,38.0,601,367,329,225,47,278,661,42.1,383,351,112,239,471,1072,729,16,/en/squads/8dfb7350/2020-2021/Dijon-Stats,2021
FRA-Ligue 1,2020,Lens,27,38.0,601,358,264,253,84,237,533,44.5,296,375,92,283,508,1109,690,12,/en/squads/fd4e0f7d/2020-2021/Lens-Stats,2021
FRA-Ligue 1,2020,Lille,21,38.0,653,370,273,288,92,305,707,43.1,402,339,90,249,424,1077,590,6,/en/squads/cb188c0c/2020-2021/Lille-Stats,2021
FRA-Ligue 1,2020,Lorient,27,38.0,722,424,353,303,66,333,812,41.0,479,422,114,308,527,1249,670,11,/en/squads/d2c87802/2020-2021/Lorient-Stats,2021
FRA-Ligue 1,2020,Lyon,29,38.0,584,346,251,249,84,264,639,41.3,375,366,115,251,408,992,594,14,/en/squads/d53c0b06/2020-2021/Lyon-Stats,2021
FRA-Ligue 1,2020,Marseille,31,38.0,655,391,266,302,87,313,667,46.9,354,365,105,260,442,1097,710,12,/en/squads/5725cc7b/2020-2021/Marseille-Stats,2021
FRA-Ligue 1,2020,Metz,27,38.0,685,417,368,252,65,305,675,45.2,370,394,116,278,572,1257,745,9,/en/squads/f83960ae/2020-2021/Metz-Stats,2021
FRA-Ligue 1,2020,Monaco,30,38.0,733,432,296,346,91,332,696,47.7,364,356,66,290,436,1169,513,15,/en/squads/fd6114db/2020-2021/Monaco-Stats,2021
FRA-Ligue 1,2020,Montpellier,25,38.0,529,334,301,183,45,284,707,40.2,423,372,150,222,420,949,705,14,/en/squads/281b0e73/2020-2021/Montpellier-Stats,2021
FRA-Ligue 1,2020,Nantes,25,38.0,697,385,357,270,70,369,778,47.4,409,391,107,284,464,1161,707,6,/en/squads/d7a486cd/2020-2021/Nantes-Stats,2021
FRA-Ligue 1,2020,Nice,31,38.0,599,364,281,243,75,256,628,40.8,372,355,123,232,435,1034,644,15,/en/squads/132ebc33/2020-2021/Nice-Stats,2021
FRA-Ligue 1,2020,Nîmes,33,38.0,625,372,301,244,80,310,709,43.7,399,407,122,285,501,1126,710,17,/en/squads/1cbf5f9e/2020-2021/Nimes-Stats,2021
FRA-Ligue 1,2020,Paris S-G,33,38.0,609,385,217,278,114,293,700,41.9,407,327,81,246,373,982,448,22,/en/squads/e2d8892c/2020-2021/Paris-Saint-Germain-Stats,2021
FRA-Ligue 1,2020,Reims,29,38.0,656,372,336,242,78,276,645,42.8,369,335,121,214,487,1143,762,18,/en/squads/7fdd64e0/2020-2021/Reims-Stats,2021
FRA-Ligue 1,2020,Rennes,32,38.0,587,337,242,254,91,234,564,41.5,330,347,74,273,361,948,510,12,/en/squads/b3072e00/2020-2021/Rennes-Stats,2021
FRA-Ligue 1,2020,Saint-Étienne,40,38.0,716,428,394,253,69,326,700,46.6,374,374,88,286,471,1187,665,10,/en/squads/d298ef2c/2020-2021/Saint-Etienne-Stats,2021
FRA-Ligue 1,2020,Strasbourg,26,38.0,633,396,313,247,73,280,615,45.5,335,303,77,226,521,1154,641,11,/en/squads/c0d3eab4/2020-2021/Strasbourg-Stats,2021
FRA-Ligue 1,2021,Angers,30,38.0,619,370,301,253,65,284,659,43.1,375,384,99,285,423,1042,631,9,/en/squads/69236f98/2021-2022/Angers-Stats,2022
FRA-Ligue 1,2021,Bordeaux,39,38.0,642,377,321,243,78,323,741,43.6,418,357,104,253,454,1096,688,19,/en/squads/123f3efe/2021-2022/Bordeaux-Stats,2022
FRA-Ligue 1,2021,Brest,25,38.0,682,400,342,249,91,310,655,47.3,345,369,108,261,469,1151,707,4,/en/squads/fb08dbb3/2021-2022/Brest-Stats,2022
FRA-Ligue 1,2021,Clermont Foot,28,38.0,622,361,285,262,75,291,665,43.8,374,372,99,273,386,1008,527,9,/en/squads/d9676424/2021-2022/Clermont-Foot-Stats,2022
FRA-Ligue 1,2021,Lens,28,38.0,591,359,273,243,75,266,602,44.2,336,360,99,261,455,1046,616,7,/en/squads/fd4e0f7d/2021-2022/Lens-Stats,2022
FRA-Ligue 1,2021,Lille,26,38.0,653,359,310,274,69,305,619,49.3,314,351,111,240,377,1030,672,6,/en/squads/cb188c0c/2021-2022/Lille-Stats,2022
FRA-Ligue 1,2021,Lorient,29,38.0,696,412,337,292,67,383,811,47.2,428,405,115,290,412,1108,776,9,/en/squads/d2c87802/2021-2022/Lorient-Stats,2022
FRA-Ligue 1,2021,Lyon,30,38.0,632,367,264,270,98,279,614,45.4,335,385,91,294,396,1028,621,17,/en/squads/d53c0b06/2021-2022/Lyon-Stats,2022
FRA-Ligue 1,2021,Marseille,27,38.0,556,319,252,238,66,232,501,46.3,269,263,65,198,327,883,437,10,/en/squads/5725cc7b/2021-2022/Marseille-Stats,2022
FRA-Ligue 1,2021,Metz,36,38.0,711,442,395,275,41,300,649,46.2,349,452,139,313,507,1218,782,11,/en/squads/f83960ae/2021-2022/Metz-Stats,2022
FRA-Ligue 1,2021,Monaco,27,38.0,745,435,292,368,85,324,701,46.2,377,378,103,275,424,1169,487,10,/en/squads/fd6114db/2021-2022/Monaco-Stats,2022
FRA-Ligue 1,2021,Montpellier,26,38.0,625,380,340,210,75,309,723,42.7,414,363,134,229,356,981,675,13,/en/squads/281b0e73/2021-2022/Montpellier-Stats,2022
FRA-Ligue 1,2021,Nantes,26,38.0,685,405,331,262,92,353,774,45.6,421,419,136,283,415,1100,680,9,/en/squads/d7a486cd/2021-2022/Nantes-Stats,2022
FRA-Ligue 1,2021,Nice,27,38.0,610,369,291,253,66,314,590,53.2,276,392,119,273,441,1051,595,7,/en/squads/132ebc33/2021-2022/Nice-Stats,2022
FRA-Ligue 1,2021,Paris S-G,36,38.0,607,360,229,276,102,290,599,48.4,309,330,106,224,303,910,437,14,/en/squads/e2d8892c/2021-2022/Paris-Saint-Germain-Stats,2022
FRA-Ligue 1,2021,Reims,35,38.0,615,365,328,221,66,286,629,45.5,343,460,154,306,493,1108,753,7,/en/squads/7fdd64e0/2021-2022/Reims-Stats,2022
FRA-Ligue 1,2021,Rennes,28,38.0,546,318,234,215,97,261,550,47.5,289,347,92,255,315,861,646,12,/en/squads/b3072e00/2021-2022/Rennes-Stats,2022
FRA-Ligue 1,2021,Saint-Étienne,39,38.0,695,397,341,265,89,295,638,46.2,343,398,93,305,452,1147,563,10,/en/squads/d298ef2c/2021-2022/Saint-Etienne-Stats,2022
FRA-Ligue 1,2021,Strasbourg,26,38.0,660,392,302,257,101,293,626,46.8,333,380,93,287,433,1093,563,6,/en/squads/c0d3eab4/2021-2022/Strasbourg-Stats,2022
FRA-Ligue 1,2021,Troyes,35,38.0,636,351,351,221,64,285,625,45.6,340,375,107,268,430,1066,656,8,/en/squads/54195385/2021-2022/Troyes-Stats,2022
FRA-Ligue 1,2022,Ajaccio,36,38.0,637,382,321,236,80,313,693,45.2,380,359,85,274,420,1057,670,10,/en/squads/7a54bb4f/Ajaccio-Stats,2023
FRA-Ligue 1,2022,Angers,33,38.0,652,386,311,268,73,310,610,50.8,300,402,99,303,375,1027,605,13,/en/squads/69236f98/Angers-Stats,2023
FRA-Ligue 1,2022,Auxerre,33,38.0,674,378,337,263,74,313,678,46.2,365,441,118,323,454,1128,782,10,/en/squads/5ae09109/Auxerre-Stats,2023
FRA-Ligue 1,2022,Brest,29,38.0,705,417,348,289,68,356,740,48.1,384,435,115,320,475,1180,686,13,/en/squads/fb08dbb3/Brest-Stats,2023
FRA-Ligue 1,2022,Clermont Foot,28,38.0,685,398,350,250,85,351,779,45.1,428,424,126,298,440,1125,571,17,/en/squads/d9676424/Clermont-Foot-Stats,2023
FRA-Ligue 1,2022,Lens,29,38.0,540,323,225,238,77,262,570,46.0,308,401,112,289,339,879,559,7,/en/squads/fd4e0f7d/Lens-Stats,2023
FRA-Ligue 1,2022,Lille,26,38.0,635,370,266,265,104,314,658,47.7,344,390,74,316,301,936,543,13,/en/squads/cb188c0c/Lille-Stats,2023
FRA-Ligue 1,2022,Lorient,30,38.0,736,420,409,244,83,315,690,45.7,375,484,141,343,369,1105,849,17,/en/squads/d2c87802/Lorient-Stats,2023
FRA-Ligue 1,2022,Lyon,29,38.0,723,423,306,282,135,367,771,47.6,404,433,107,326,481,1204,542,12,/en/squads/d53c0b06/Lyon-Stats,2023
FRA-Ligue 1,2022,Marseille,30,38.0,685,404,271,304,110,301,591,50.9,290,366,101,265,420,1105,570,11,/en/squads/5725cc7b/Marseille-Stats,2023
FRA-Ligue 1,2022,Monaco,27,38.0,696,400,284,310,102,323,701,46.1,378,459,120,339,426,1122,549,14,/en/squads/fd6114db/Monaco-Stats,2023
FRA-Ligue 1,2022,Montpellier,31,38.0,684,413,362,249,73,361,745,48.5,384,448,121,327,404,1088,686,9,/en/squads/281b0e73/Montpellier-Stats,2023
FRA-Ligue 1,2022,Nantes,29,38.0,709,431,367,249,93,367,730,50.3,363,427,107,320,431,1140,731,8,/en/squads/d7a486cd/Nantes-Stats,2023
FRA-Ligue 1,2022,Nice,34,38.0,818,467,415,295,108,382,680,56.2,298,419,115,304,413,1231,588,9,/en/squads/132ebc33/Nice-Stats,2023
FRA-Ligue 1,2022,Paris S-G,26,38.0,612,362,253,255,104,339,693,48.9,354,378,109,269,296,908,432,20,/en/squads/e2d8892c/Paris-Saint-Germain-Stats,2023
FRA-Ligue 1,2022,Reims,34,38.0,703,407,338,259,106,339,747,45.4,408,468,127,341,397,1100,633,15,/en/squads/7fdd64e0/Reims-Stats,2023
FRA-Ligue 1,2022,Rennes,32,38.0,600,335,255,251,94,289,616,46.9,327,392,91,301,341,941,587,10,/en/squads/b3072e00/Rennes-Stats,2023
FRA-Ligue 1,2022,Strasbourg,29,38.0,690,409,316,284,90,344,666,51.7,322,423,98,325,437,1127,688,5,/en/squads/c0d3eab4/Strasbourg-Stats,2023
FRA-Ligue 1,2022,Toulouse,29,38.0,716,406,349,264,103,368,842,43.7,474,476,138,338,409,1125,656,15,/en/squads/3f8c4b5f/Toulouse-Stats,2023
FRA-Ligue 1,2022,Troyes,32,38.0,608,361,333,207,68,272,606,44.9,334,416,144,272,398,1006,779,5,/en/squads/54195385/Troyes-Stats,2023
GER-Bundesliga,2017,Augsburg,27,34.0,723,543,361,292,70,364,603,60.4,239,400,107,293,400,1123,835,15,/en/squads/0cdc4311/2017-2018/Augsburg-Stats,2018
GER-Bundesliga,2017,Bayern Munich,28,34.0,609,467,269,248,92,308,549,56.1,241,313,75,238,355,964,399,11,/en/squads/054efa67/2017-2018/Bayern-Munich-Stats,2018
GER-Bundesliga,2017,Dortmund,30,34.0,695,510,305,307,83,346,602,57.5,256,390,73,317,336,1031,657,17,/en/squads/add600ae/2017-2018/Dortmund-Stats,2018
GER-Bundesliga,2017,Eint Frankfurt,28,34.0,623,483,271,295,57,289,541,53.4,252,465,101,364,409,1032,918,8,/en/squads/f0ac8ee6/2017-2018/Eintracht-Frankfurt-Stats,2018
GER-Bundesliga,2017,Freiburg,29,34.0,639,465,300,289,50,284,551,51.5,267,421,117,304,392,1031,802,6,/en/squads/a486e511/2017-2018/Freiburg-Stats,2018
GER-Bundesliga,2017,Hamburger SV,29,34.0,729,543,346,313,70,331,641,51.6,310,496,112,384,367,1096,768,16,/en/squads/26790c6a/2017-2018/Hamburger-SV-Stats,2018
GER-Bundesliga,2017,Hannover 96,26,34.0,668,490,346,269,53,353,661,53.4,308,474,134,340,382,1050,962,19,/en/squads/60b5e41f/2017-2018/Hannover-96-Stats,2018
GER-Bundesliga,2017,Hertha BSC,25,34.0,655,488,325,268,62,313,515,60.8,202,436,91,345,386,1041,876,13,/en/squads/2818f8bc/2017-2018/Hertha-BSC-Stats,2018
GER-Bundesliga,2017,Hoffenheim,26,34.0,688,516,325,300,63,320,571,56.0,251,440,98,342,345,1033,648,15,/en/squads/033ea6b8/2017-2018/Hoffenheim-Stats,2018
GER-Bundesliga,2017,Köln,31,34.0,678,502,363,274,41,337,635,53.1,298,421,106,315,389,1067,832,17,/en/squads/bc357bf7/2017-2018/Koln-Stats,2018
GER-Bundesliga,2017,Leverkusen,24,34.0,645,482,292,291,62,325,560,58.0,235,480,83,397,390,1035,621,9,/en/squads/c7a9f859/2017-2018/Bayer-Leverkusen-Stats,2018
GER-Bundesliga,2017,M'Gladbach,27,34.0,674,488,326,277,71,343,598,57.4,255,466,108,358,384,1058,719,17,/en/squads/32f3ee20/2017-2018/Monchengladbach-Stats,2018
GER-Bundesliga,2017,Mainz 05,27,34.0,699,522,339,277,83,353,625,56.5,272,502,107,395,402,1101,796,15,/en/squads/a224b06a/2017-2018/Mainz-05-Stats,2018
GER-Bundesliga,2017,RB Leipzig,23,34.0,698,509,318,309,71,342,617,55.4,275,471,76,395,397,1095,822,10,/en/squads/acbb6a5b/2017-2018/RB-Leipzig-Stats,2018
GER-Bundesliga,2017,Schalke 04,24,34.0,720,534,335,325,60,332,628,52.9,296,483,89,394,498,1218,773,15,/en/squads/c539e393/2017-2018/Schalke-04-Stats,2018
GER-Bundesliga,2017,Stuttgart,26,34.0,696,496,332,299,65,328,560,58.6,232,439,107,332,414,1110,814,17,/en/squads/598bc722/2017-2018/Stuttgart-Stats,2018
GER-Bundesliga,2017,Werder Bremen,25,34.0,600,435,288,264,48,294,528,55.7,234,353,77,276,421,1021,738,18,/en/squads/62add3bf/2017-2018/Werder-Bremen-Stats,2018
GER-Bundesliga,2017,Wolfsburg,29,34.0,589,430,329,213,47,306,546,56.0,240,420,119,301,403,992,730,12,/en/squads/4eaa11d7/2017-2018/Wolfsburg-Stats,2018
GER-Bundesliga,2018,Augsburg,30,34.0,591,376,280,262,49,238,515,46.2,277,404,130,274,467,1058,754,15,/en/squads/0cdc4311/2018-2019/Augsburg-Stats,2019
GER-Bundesliga,2018,Bayern Munich,24,34.0,465,294,172,210,83,165,410,40.2,245,313,61,252,336,801,368,10,/en/squads/054efa67/2018-2019/Bayern-Munich-Stats,2019
GER-Bundesliga,2018,Dortmund,23,34.0,497,319,242,194,61,181,402,45.0,221,334,79,255,384,881,659,17,/en/squads/add600ae/2018-2019/Dortmund-Stats,2019
GER-Bundesliga,2018,Düsseldorf,24,34.0,625,384,345,233,47,250,621,40.3,371,374,107,267,419,1044,760,14,/en/squads/b1278397/2018-2019/Dusseldorf-Stats,2019
GER-Bundesliga,2018,Eint Frankfurt,30,34.0,598,371,291,246,61,233,539,43.2,306,465,102,363,360,958,708,4,/en/squads/f0ac8ee6/2018-2019/Eintracht-Frankfurt-Stats,2019
GER-Bundesliga,2018,Freiburg,28,34.0,570,357,301,211,58,213,503,42.3,290,401,121,280,374,944,882,12,/en/squads/a486e511/2018-2019/Freiburg-Stats,2019
GER-Bundesliga,2018,Hannover 96,32,34.0,583,342,305,228,50,262,628,41.7,366,434,124,310,459,1042,797,10,/en/squads/60b5e41f/2018-2019/Hannover-96-Stats,2019
GER-Bundesliga,2018,Hertha BSC,26,34.0,538,352,251,235,52,178,451,39.5,273,423,117,306,381,919,823,7,/en/squads/2818f8bc/2018-2019/Hertha-BSC-Stats,2019
GER-Bundesliga,2018,Hoffenheim,29,34.0,571,363,260,237,74,206,528,39.0,322,419,104,315,399,970,638,13,/en/squads/033ea6b8/2018-2019/Hoffenheim-Stats,2019
GER-Bundesliga,2018,Leverkusen,21,34.0,583,368,298,217,68,230,543,42.4,313,416,96,320,358,941,687,7,/en/squads/c7a9f859/2018-2019/Bayer-Leverkusen-Stats,2019
GER-Bundesliga,2018,M'Gladbach,22,34.0,498,292,258,192,48,198,466,42.5,268,382,102,280,310,808,648,18,/en/squads/32f3ee20/2018-2019/Monchengladbach-Stats,2019
GER-Bundesliga,2018,Mainz 05,28,34.0,528,309,256,219,53,220,467,47.1,247,455,123,332,395,923,728,12,/en/squads/a224b06a/2018-2019/Mainz-05-Stats,2019
GER-Bundesliga,2018,Nürnberg,27,34.0,551,350,335,175,41,253,560,45.2,307,382,119,263,354,905,840,12,/en/squads/6f2c108c/2018-2019/Nurnberg-Stats,2019
GER-Bundesliga,2018,RB Leipzig,23,34.0,657,398,300,279,78,282,580,48.6,298,455,70,385,416,1073,717,1,/en/squads/acbb6a5b/2018-2019/RB-Leipzig-Stats,2019
GER-Bundesliga,2018,Schalke 04,32,34.0,631,381,279,286,66,251,594,42.3,343,464,119,345,419,1050,657,16,/en/squads/c539e393/2018-2019/Schalke-04-Stats,2019
GER-Bundesliga,2018,Stuttgart,26,34.0,576,362,299,217,60,204,476,42.9,272,422,116,306,399,975,898,12,/en/squads/598bc722/2018-2019/Stuttgart-Stats,2019
GER-Bundesliga,2018,Werder Bremen,24,34.0,549,344,256,230,63,216,553,39.1,337,426,109,317,407,956,817,10,/en/squads/62add3bf/2018-2019/Werder-Bremen-Stats,2019
GER-Bundesliga,2018,Wolfsburg,25,34.0,542,343,272,209,61,219,505,43.4,286,399,95,304,426,968,791,18,/en/squads/4eaa11d7/2018-2019/Wolfsburg-Stats,2019
GER-Bundesliga,2019,Augsburg,28,34.0,534,314,271,215,48,220,563,39.1,343,362,123,239,434,968,778,8,/en/squads/0cdc4311/2019-2020/Augsburg-Stats,2020
GER-Bundesliga,2019,Bayern Munich,29,34.0,500,293,180,222,98,211,503,41.9,292,290,79,211,342,842,382,9,/en/squads/054efa67/2019-2020/Bayern-Munich-Stats,2020
GER-Bundesliga,2019,Dortmund,27,34.0,529,329,249,214,66,226,509,44.4,283,353,88,265,375,904,463,10,/en/squads/add600ae/2019-2020/Dortmund-Stats,2020
GER-Bundesliga,2019,Düsseldorf,28,34.0,496,307,244,199,53,200,540,37.0,340,350,105,245,376,872,610,9,/en/squads/b1278397/2019-2020/Dusseldorf-Stats,2020
GER-Bundesliga,2019,Eint Frankfurt,27,34.0,596,377,278,246,72,232,617,37.6,385,403,97,306,376,972,520,5,/en/squads/f0ac8ee6/2019-2020/Eintracht-Frankfurt-Stats,2020
GER-Bundesliga,2019,Freiburg,26,34.0,431,252,226,162,43,175,497,35.2,322,401,157,244,354,785,810,18,/en/squads/a486e511/2019-2020/Freiburg-Stats,2020
GER-Bundesliga,2019,Hertha BSC,32,34.0,555,340,282,221,52,208,521,39.9,313,434,130,304,410,965,794,12,/en/squads/2818f8bc/2019-2020/Hertha-BSC-Stats,2020
GER-Bundesliga,2019,Hoffenheim,31,34.0,529,309,283,196,50,239,578,41.3,339,384,121,263,349,878,719,9,/en/squads/033ea6b8/2019-2020/Hoffenheim-Stats,2020
GER-Bundesliga,2019,Köln,29,34.0,610,414,293,258,59,249,622,40.0,373,397,97,300,435,1045,681,5,/en/squads/bc357bf7/2019-2020/Koln-Stats,2020
GER-Bundesliga,2019,Leverkusen,24,34.0,557,353,239,244,74,263,600,43.8,337,365,71,294,333,890,496,11,/en/squads/c7a9f859/2019-2020/Bayer-Leverkusen-Stats,2020
GER-Bundesliga,2019,M'Gladbach,25,34.0,552,322,254,215,83,228,586,38.9,358,398,106,292,381,933,596,11,/en/squads/32f3ee20/2019-2020/Monchengladbach-Stats,2020
GER-Bundesliga,2019,Mainz 05,25,34.0,576,331,280,233,63,225,542,41.5,317,403,110,293,363,939,724,13,/en/squads/a224b06a/2019-2020/Mainz-05-Stats,2020
GER-Bundesliga,2019,Paderborn 07,27,34.0,632,400,354,221,57,301,722,41.7,421,435,111,324,364,996,747,9,/en/squads/d9f93f02/2019-2020/Paderborn-07-Stats,2020
GER-Bundesliga,2019,RB Leipzig,29,34.0,616,361,280,251,85,258,624,41.3,366,397,86,311,364,980,610,16,/en/squads/acbb6a5b/2019-2020/RB-Leipzig-Stats,2020
GER-Bundesliga,2019,Schalke 04,29,34.0,589,361,268,242,79,255,625,40.8,370,474,118,356,407,996,656,15,/en/squads/c539e393/2019-2020/Schalke-04-Stats,2020
GER-Bundesliga,2019,Union Berlin,26,34.0,550,322,265,220,65,213,565,37.7,352,396,124,272,421,971,775,8,/en/squads/7a41008f/2019-2020/Union-Berlin-Stats,2020
GER-Bundesliga,2019,Werder Bremen,30,34.0,550,345,285,199,66,216,573,37.7,357,369,123,246,423,973,775,11,/en/squads/62add3bf/2019-2020/Werder-Bremen-Stats,2020
GER-Bundesliga,2019,Wolfsburg,26,34.0,598,363,277,247,74,241,589,40.9,348,378,87,291,377,975,649,9,/en/squads/4eaa11d7/2019-2020/Wolfsburg-Stats,2020
GER-Bundesliga,2020,Arminia,26,34.0,552,328,268,229,55,214,536,39.9,322,393,122,271,418,970,739,9,/en/squads/247c4b67/2020-2021/Arminia-Stats,2021
GER-Bundesliga,2020,Augsburg,25,34.0,509,308,251,211,47,201,503,40.0,302,395,116,279,454,963,852,8,/en/squads/0cdc4311/2020-2021/Augsburg-Stats,2021
GER-Bundesliga,2020,Bayern Munich,29,34.0,510,316,174,231,105,224,541,41.4,317,388,75,313,399,909,398,10,/en/squads/054efa67/2020-2021/Bayern-Munich-Stats,2021
GER-Bundesliga,2020,Dortmund,26,34.0,516,318,221,210,85,219,487,45.0,268,379,95,284,413,929,472,12,/en/squads/add600ae/2020-2021/Dortmund-Stats,2021
GER-Bundesliga,2020,Eint Frankfurt,25,34.0,594,352,273,245,76,263,596,44.1,333,371,77,294,428,1022,594,10,/en/squads/f0ac8ee6/2020-2021/Eintracht-Frankfurt-Stats,2021
GER-Bundesliga,2020,Freiburg,24,34.0,431,247,188,186,57,168,448,37.5,280,365,118,247,452,883,631,8,/en/squads/a486e511/2020-2021/Freiburg-Stats,2021
GER-Bundesliga,2020,Hertha BSC,32,34.0,485,270,242,201,42,205,493,41.6,288,377,89,288,417,902,687,8,/en/squads/2818f8bc/2020-2021/Hertha-BSC-Stats,2021
GER-Bundesliga,2020,Hoffenheim,30,34.0,508,296,229,204,75,229,539,42.5,310,370,90,280,431,939,619,8,/en/squads/033ea6b8/2020-2021/Hoffenheim-Stats,2021
GER-Bundesliga,2020,Köln,28,34.0,586,328,299,234,53,248,546,45.4,298,382,101,281,429,1015,670,8,/en/squads/bc357bf7/2020-2021/Koln-Stats,2021
GER-Bundesliga,2020,Leverkusen,30,34.0,500,282,209,238,53,213,498,42.8,285,368,87,281,322,822,481,10,/en/squads/c7a9f859/2020-2021/Bayer-Leverkusen-Stats,2021
GER-Bundesliga,2020,M'Gladbach,23,34.0,503,307,221,221,61,215,531,40.5,316,424,116,308,436,939,616,6,/en/squads/32f3ee20/2020-2021/Monchengladbach-Stats,2021
GER-Bundesliga,2020,Mainz 05,31,34.0,593,364,266,239,88,258,574,44.9,316,419,109,310,500,1093,662,6,/en/squads/a224b06a/2020-2021/Mainz-05-Stats,2021
GER-Bundesliga,2020,RB Leipzig,25,34.0,460,305,167,229,64,190,460,41.3,270,336,63,273,353,813,504,5,/en/squads/acbb6a5b/2020-2021/RB-Leipzig-Stats,2021
GER-Bundesliga,2020,Schalke 04,42,34.0,552,337,283,224,45,203,546,37.2,343,437,143,294,411,963,693,12,/en/squads/c539e393/2020-2021/Schalke-04-Stats,2021
GER-Bundesliga,2020,Stuttgart,29,34.0,496,294,227,201,68,235,531,44.3,296,379,108,271,426,922,654,8,/en/squads/598bc722/2020-2021/Stuttgart-Stats,2021
GER-Bundesliga,2020,Union Berlin,27,34.0,503,283,240,218,45,232,501,46.3,269,367,85,282,405,908,605,9,/en/squads/7a41008f/2020-2021/Union-Berlin-Stats,2021
GER-Bundesliga,2020,Werder Bremen,27,34.0,542,333,270,217,55,228,556,41.0,328,368,101,267,407,949,798,10,/en/squads/62add3bf/2020-2021/Werder-Bremen-Stats,2021
GER-Bundesliga,2020,Wolfsburg,26,34.0,594,363,271,256,67,271,599,45.2,328,465,79,386,477,1071,700,6,/en/squads/4eaa11d7/2020-2021/Wolfsburg-Stats,2021
GER-Bundesliga,2021,Arminia,26,34.0,549,311,270,235,44,238,543,43.8,305,395,110,285,421,970,770,7,/en/squads/247c4b67/2021-2022/Arminia-Stats,2022
GER-Bundesliga,2021,Augsburg,26,34.0,561,335,254,236,71,250,584,42.8,334,397,116,281,363,924,769,12,/en/squads/0cdc4311/2021-2022/Augsburg-Stats,2022
GER-Bundesliga,2021,Bayern Munich,30,34.0,563,338,231,237,95,259,559,46.3,300,338,68,270,349,912,404,18,/en/squads/054efa67/2021-2022/Bayern-Munich-Stats,2022
GER-Bundesliga,2021,Bochum,28,34.0,566,353,298,199,69,277,574,48.3,297,420,119,301,429,995,616,13,/en/squads/b42c6323/2021-2022/Bochum-Stats,2022
GER-Bundesliga,2021,Dortmund,33,34.0,541,322,232,236,73,255,550,46.4,295,351,82,269,347,888,519,11,/en/squads/add600ae/2021-2022/Dortmund-Stats,2022
GER-Bundesliga,2021,Eint Frankfurt,27,34.0,595,330,260,252,83,283,673,42.1,390,435,95,340,377,972,592,12,/en/squads/f0ac8ee6/2021-2022/Eintracht-Frankfurt-Stats,2022
GER-Bundesliga,2021,Freiburg,26,34.0,518,299,246,207,65,215,477,45.1,262,352,130,222,355,873,751,13,/en/squads/a486e511/2021-2022/Freiburg-Stats,2022
GER-Bundesliga,2021,Greuther Fürth,29,34.0,568,336,258,252,58,270,567,47.6,297,416,124,292,374,942,712,8,/en/squads/12192a4c/2021-2022/Greuther-Furth-Stats,2022
GER-Bundesliga,2021,Hertha BSC,36,34.0,546,321,294,197,55,252,544,46.3,292,377,105,272,406,952,816,15,/en/squads/2818f8bc/2021-2022/Hertha-BSC-Stats,2022
GER-Bundesliga,2021,Hoffenheim,32,34.0,483,291,191,216,76,223,484,46.1,261,390,88,302,285,768,520,17,/en/squads/033ea6b8/2021-2022/Hoffenheim-Stats,2022
GER-Bundesliga,2021,Köln,26,34.0,598,361,264,246,88,288,665,43.3,377,442,99,343,426,1024,628,10,/en/squads/bc357bf7/2021-2022/Koln-Stats,2022
GER-Bundesliga,2021,Leverkusen,29,34.0,484,281,235,199,50,225,493,45.6,268,350,101,249,360,844,620,12,/en/squads/c7a9f859/2021-2022/Bayer-Leverkusen-Stats,2022
GER-Bundesliga,2021,M'Gladbach,26,34.0,572,345,260,252,60,285,615,46.3,330,402,91,311,326,898,553,13,/en/squads/32f3ee20/2021-2022/Monchengladbach-Stats,2022
GER-Bundesliga,2021,Mainz 05,28,34.0,579,305,291,220,68,282,595,47.4,313,404,94,310,439,1018,584,9,/en/squads/a224b06a/2021-2022/Mainz-05-Stats,2022
GER-Bundesliga,2021,RB Leipzig,29,34.0,499,289,218,222,59,219,512,42.8,293,399,81,318,349,848,523,12,/en/squads/acbb6a5b/2021-2022/RB-Leipzig-Stats,2022
GER-Bundesliga,2021,Stuttgart,34,34.0,532,307,231,236,65,241,530,45.5,289,386,124,262,342,874,708,8,/en/squads/598bc722/2021-2022/Stuttgart-Stats,2022
GER-Bundesliga,2021,Union Berlin,28,34.0,538,296,266,223,49,268,568,47.2,300,322,90,232,376,914,657,7,/en/squads/7a41008f/2021-2022/Union-Berlin-Stats,2022
GER-Bundesliga,2021,Wolfsburg,30,34.0,539,298,278,201,60,257,540,47.6,283,388,103,285,388,927,740,9,/en/squads/4eaa11d7/2021-2022/Wolfsburg-Stats,2022
GER-Bundesliga,2022,Augsburg,34,34.0,522,299,251,202,69,232,479,48.4,247,429,126,303,286,808,755,14,/en/squads/0cdc4311/Augsburg-Stats,2023
GER-Bundesliga,2022,Bayern Munich,28,34.0,623,387,263,258,102,287,538,53.3,251,381,77,304,287,910,477,19,/en/squads/054efa67/Bayern-Munich-Stats,2023
GER-Bundesliga,2022,Bochum,26,34.0,626,386,301,247,78,310,635,48.8,325,402,118,284,337,963,776,13,/en/squads/b42c6323/Bochum-Stats,2023
GER-Bundesliga,2022,Dortmund,30,34.0,580,334,246,241,93,287,551,52.1,264,382,95,287,298,878,491,9,/en/squads/add600ae/Dortmund-Stats,2023
GER-Bundesliga,2022,Eint Frankfurt,28,34.0,562,357,244,248,70,265,585,45.3,320,415,88,327,284,846,687,5,/en/squads/f0ac8ee6/Eintracht-Frankfurt-Stats,2023
GER-Bundesliga,2022,Freiburg,27,34.0,498,289,223,211,64,207,450,46.0,243,375,106,269,325,823,612,10,/en/squads/a486e511/Freiburg-Stats,2023
GER-Bundesliga,2022,Hertha BSC,32,34.0,576,344,307,215,54,251,521,48.2,270,416,132,284,366,942,797,8,/en/squads/2818f8bc/Hertha-BSC-Stats,2023
GER-Bundesliga,2022,Hoffenheim,31,34.0,543,323,254,231,58,236,474,49.8,238,428,119,309,285,828,665,8,/en/squads/033ea6b8/Hoffenheim-Stats,2023
GER-Bundesliga,2022,Köln,27,34.0,615,370,287,263,65,310,666,46.5,356,423,99,324,372,987,716,5,/en/squads/bc357bf7/Koln-Stats,2023
GER-Bundesliga,2022,Leverkusen,27,34.0,494,280,242,206,46,236,421,56.1,185,358,99,259,294,788,599,12,/en/squads/c7a9f859/Bayer-Leverkusen-Stats,2023
GER-Bundesliga,2022,M'Gladbach,27,34.0,497,275,274,171,52,267,536,49.8,269,405,104,301,267,764,728,7,/en/squads/32f3ee20/Monchengladbach-Stats,2023
GER-Bundesliga,2022,Mainz 05,27,34.0,547,341,268,206,73,270,559,48.3,289,419,98,321,433,980,673,9,/en/squads/a224b06a/Mainz-05-Stats,2023
GER-Bundesliga,2022,RB Leipzig,25,34.0,534,312,237,231,66,253,512,49.4,259,428,94,334,310,844,552,3,/en/squads/acbb6a5b/RB-Leipzig-Stats,2023
GER-Bundesliga,2022,Schalke 04,35,34.0,542,329,240,246,56,253,551,45.9,298,397,110,287,306,848,723,12,/en/squads/c539e393/Schalke-04-Stats,2023
GER-Bundesliga,2022,Stuttgart,30,34.0,528,316,255,207,66,268,524,51.1,256,421,113,308,308,836,666,10,/en/squads/598bc722/Stuttgart-Stats,2023
GER-Bundesliga,2022,Union Berlin,28,34.0,494,278,217,216,61,239,525,45.5,286,356,101,255,262,756,704,6,/en/squads/7a41008f/Union-Berlin-Stats,2023
GER-Bundesliga,2022,Werder Bremen,25,34.0,595,349,269,273,53,300,617,48.6,317,371,103,268,321,916,789,7,/en/squads/62add3bf/Werder-Bremen-Stats,2023
GER-Bundesliga,2022,Wolfsburg,28,34.0,543,324,255,206,82,265,521,50.9,256,443,116,327,292,835,701,9,/en/squads/4eaa11d7/Wolfsburg-Stats,2023
ITA-Serie A,2017,Atalanta,25,38.0,725,488,334,313,78,272,650,41.8,378,430,107,323,476,1201,820,11,/en/squads/922493f3/2017-2018/Atalanta-Stats,2018
ITA-Serie A,2017,Benevento,41,38.0,581,409,320,206,55,191,551,34.7,360,398,140,258,449,1030,925,25,/en/squads/4fcb34fd/2017-2018/Benevento-Stats,2018
ITA-Serie A,2017,Bologna,30,38.0,661,456,356,257,48,231,588,39.3,357,488,127,361,462,1123,1121,14,/en/squads/1d8099f8/2017-2018/Bologna-Stats,2018
ITA-Serie A,2017,Cagliari,29,38.0,640,447,323,239,78,214,559,38.3,345,425,126,299,431,1071,1018,4,/en/squads/c4260e09/2017-2018/Cagliari-Stats,2018
ITA-Serie A,2017,Chievo,25,38.0,543,367,273,199,71,208,566,36.7,358,443,158,285,444,987,1140,14,/en/squads/cc919b35/2017-2018/Chievo-Stats,2018
ITA-Serie A,2017,Crotone,29,38.0,697,440,365,255,77,222,613,36.2,391,449,119,330,578,1275,1233,10,/en/squads/3074d7b1/2017-2018/Crotone-Stats,2018
ITA-Serie A,2017,Fiorentina,27,38.0,742,497,362,284,96,267,656,40.7,389,438,75,363,489,1231,983,17,/en/squads/421387cf/2017-2018/Fiorentina-Stats,2018
ITA-Serie A,2017,Genoa,33,38.0,551,395,281,223,47,191,524,36.5,333,412,119,293,394,945,950,11,/en/squads/658bf2de/2017-2018/Genoa-Stats,2018
ITA-Serie A,2017,Hellas Verona,32,38.0,664,459,351,245,68,213,603,35.3,390,425,146,279,541,1205,1113,24,/en/squads/0e72edf2/2017-2018/Hellas-Verona-Stats,2018
ITA-Serie A,2017,Inter,22,38.0,632,435,318,252,62,237,612,38.7,375,349,109,240,402,1034,804,11,/en/squads/d609edc0/2017-2018/Internazionale-Stats,2018
ITA-Serie A,2017,Juventus,24,38.0,517,359,234,204,79,155,447,34.7,292,312,77,235,421,938,747,17,/en/squads/e0652b02/2017-2018/Juventus-Stats,2018
ITA-Serie A,2017,Lazio,24,38.0,677,450,299,298,80,223,632,35.3,409,410,107,303,494,1171,789,12,/en/squads/7213da33/2017-2018/Lazio-Stats,2018
ITA-Serie A,2017,Milan,23,38.0,533,376,244,214,75,181,466,38.8,285,422,103,319,354,887,855,20,/en/squads/dc56fe14/2017-2018/Milan-Stats,2018
ITA-Serie A,2017,Napoli,23,38.0,599,407,208,308,83,221,581,38.0,360,403,67,336,341,940,565,16,/en/squads/d48ad4ff/2017-2018/Napoli-Stats,2018
ITA-Serie A,2017,Roma,27,38.0,548,384,251,212,85,183,470,38.9,287,320,104,216,477,1025,821,19,/en/squads/cf74a709/2017-2018/Roma-Stats,2018
ITA-Serie A,2017,SPAL,29,38.0,586,414,308,217,61,209,539,38.8,330,389,145,244,527,1113,1111,11,/en/squads/1d2fe027/2017-2018/SPAL-Stats,2018
ITA-Serie A,2017,Sampdoria,27,38.0,624,423,254,274,96,223,600,37.2,377,505,117,388,335,959,856,25,/en/squads/8ff9e3b3/2017-2018/Sampdoria-Stats,2018
ITA-Serie A,2017,Sassuolo,28,38.0,568,375,294,208,66,204,594,34.3,390,396,98,298,506,1074,1085,16,/en/squads/e2befd26/2017-2018/Sassuolo-Stats,2018
ITA-Serie A,2017,Torino,27,38.0,609,405,295,256,58,182,465,39.1,283,380,112,268,421,1030,960,15,/en/squads/105360fe/2017-2018/Torino-Stats,2018
ITA-Serie A,2017,Udinese,27,38.0,618,415,321,240,57,224,565,39.6,341,482,154,328,459,1077,992,13,/en/squads/04eea015/2017-2018/Udinese-Stats,2018
ITA-Serie A,2018,Atalanta,27,38.0,638,397,278,277,83,269,577,46.6,308,433,96,337,454,1092,675,10,/en/squads/922493f3/2018-2019/Atalanta-Stats,2019
ITA-Serie A,2018,Bologna,29,38.0,689,430,365,252,72,262,631,41.5,369,463,142,321,372,1061,863,17,/en/squads/1d8099f8/2018-2019/Bologna-Stats,2019
ITA-Serie A,2018,Cagliari,30,38.0,603,388,259,249,95,211,524,40.3,313,449,126,323,344,947,837,4,/en/squads/c4260e09/2018-2019/Cagliari-Stats,2019
ITA-Serie A,2018,Chievo,36,38.0,623,374,320,243,60,252,605,41.7,353,421,132,289,471,1094,988,18,/en/squads/cc919b35/2018-2019/Chievo-Stats,2019
ITA-Serie A,2018,Empoli,29,38.0,552,328,257,223,72,216,510,42.4,294,353,133,220,333,885,797,10,/en/squads/a3d88bd8/2018-2019/Empoli-Stats,2019
ITA-Serie A,2018,Fiorentina,27,38.0,592,371,272,238,82,199,470,42.3,271,401,130,271,413,1005,887,11,/en/squads/421387cf/2018-2019/Fiorentina-Stats,2019
ITA-Serie A,2018,Frosinone,33,38.0,571,353,303,204,64,213,530,40.2,317,416,151,265,384,955,918,12,/en/squads/6a7ad59d/2018-2019/Frosinone-Stats,2019
ITA-Serie A,2018,Genoa,31,38.0,670,424,329,249,92,253,541,46.8,288,377,114,263,424,1094,858,10,/en/squads/658bf2de/2018-2019/Genoa-Stats,2019
ITA-Serie A,2018,Inter,23,38.0,614,409,278,244,92,253,596,42.4,343,388,104,284,311,925,642,14,/en/squads/d609edc0/2018-2019/Internazionale-Stats,2019
ITA-Serie A,2018,Juventus,31,38.0,571,355,259,234,78,213,452,47.1,239,383,130,253,396,967,681,16,/en/squads/e0652b02/2018-2019/Juventus-Stats,2019
ITA-Serie A,2018,Lazio,30,38.0,658,406,295,284,79,280,599,46.7,319,415,136,279,432,1090,798,14,/en/squads/7213da33/2018-2019/Lazio-Stats,2019
ITA-Serie A,2018,Milan,23,38.0,641,382,336,233,72,268,559,47.9,291,408,109,299,373,1014,845,14,/en/squads/dc56fe14/2018-2019/Milan-Stats,2019
ITA-Serie A,2018,Napoli,26,38.0,574,359,233,254,87,223,553,40.3,330,353,107,246,358,932,645,8,/en/squads/d48ad4ff/2018-2019/Napoli-Stats,2019
ITA-Serie A,2018,Parma,31,38.0,580,351,329,197,54,195,500,39.0,305,445,182,263,399,979,1147,12,/en/squads/eab4234c/2018-2019/Parma-Stats,2019
ITA-Serie A,2018,Roma,26,38.0,535,344,246,212,77,199,479,41.5,280,389,154,235,419,954,822,16,/en/squads/cf74a709/2018-2019/Roma-Stats,2019
ITA-Serie A,2018,SPAL,28,38.0,579,374,314,201,64,218,493,44.2,275,411,136,275,388,967,877,15,/en/squads/1d2fe027/2018-2019/SPAL-Stats,2019
ITA-Serie A,2018,Sampdoria,24,38.0,647,425,290,258,99,276,567,48.7,291,418,122,296,363,1010,838,9,/en/squads/8ff9e3b3/2018-2019/Sampdoria-Stats,2019
ITA-Serie A,2018,Sassuolo,29,38.0,529,328,288,175,66,216,517,41.8,301,387,110,277,378,907,841,15,/en/squads/e2befd26/2018-2019/Sassuolo-Stats,2019
ITA-Serie A,2018,Torino,25,38.0,636,394,272,283,81,226,506,44.7,280,462,117,345,451,1087,848,12,/en/squads/105360fe/2018-2019/Torino-Stats,2019
ITA-Serie A,2018,Udinese,31,38.0,651,387,341,250,60,245,554,44.2,309,450,161,289,381,1032,1065,15,/en/squads/04eea015/2018-2019/Udinese-Stats,2019
ITA-Serie A,2019,Atalanta,30,38.0,627,351,252,278,97,263,643,40.9,380,396,111,285,418,1045,532,12,/en/squads/922493f3/2019-2020/Atalanta-Stats,2020
ITA-Serie A,2019,Bologna,31,38.0,575,338,270,238,67,226,619,36.5,393,390,125,265,412,987,667,13,/en/squads/1d8099f8/2019-2020/Bologna-Stats,2020
ITA-Serie A,2019,Brescia,32,38.0,507,273,256,195,56,226,559,40.4,333,399,170,229,361,868,886,12,/en/squads/4ef57aeb/2019-2020/Brescia-Stats,2020
ITA-Serie A,2019,Cagliari,33,38.0,560,338,300,203,57,231,619,37.3,388,445,174,271,337,897,855,13,/en/squads/c4260e09/2019-2020/Cagliari-Stats,2020
ITA-Serie A,2019,Fiorentina,33,38.0,571,333,300,205,66,213,628,33.9,415,346,98,248,347,918,719,9,/en/squads/421387cf/2019-2020/Fiorentina-Stats,2020
ITA-Serie A,2019,Genoa,34,38.0,551,335,268,210,73,212,589,36.0,377,410,150,260,385,936,775,16,/en/squads/658bf2de/2019-2020/Genoa-Stats,2020
ITA-Serie A,2019,Hellas Verona,30,38.0,488,290,237,187,64,203,463,43.8,260,361,173,188,398,886,825,10,/en/squads/0e72edf2/2019-2020/Hellas-Verona-Stats,2020
ITA-Serie A,2019,Inter,29,38.0,524,287,228,212,84,196,575,34.1,379,371,120,251,370,894,657,12,/en/squads/d609edc0/2019-2020/Internazionale-Stats,2020
ITA-Serie A,2019,Juventus,30,38.0,539,318,225,219,95,224,582,38.5,358,374,120,254,370,909,590,14,/en/squads/e0652b02/2019-2020/Juventus-Stats,2020
ITA-Serie A,2019,Lazio,27,38.0,547,311,270,205,72,224,612,36.6,388,404,142,262,378,925,642,9,/en/squads/7213da33/2019-2020/Lazio-Stats,2020
ITA-Serie A,2019,Lecce,30,38.0,525,293,288,192,45,234,628,37.3,394,395,150,245,383,908,793,30,/en/squads/ffcbe334/2019-2020/Lecce-Stats,2020
ITA-Serie A,2019,Milan,32,38.0,581,345,270,237,74,234,620,37.7,386,353,106,247,419,1000,652,19,/en/squads/dc56fe14/2019-2020/Milan-Stats,2020
ITA-Serie A,2019,Napoli,25,38.0,487,295,223,183,81,206,540,38.1,334,322,86,236,330,817,464,11,/en/squads/d48ad4ff/2019-2020/Napoli-Stats,2020
ITA-Serie A,2019,Parma,25,38.0,615,348,329,228,58,282,708,39.8,426,423,177,246,394,1009,859,14,/en/squads/eab4234c/2019-2020/Parma-Stats,2020
ITA-Serie A,2019,Roma,31,38.0,493,303,202,203,88,197,503,39.2,306,347,107,240,400,893,644,15,/en/squads/cf74a709/2019-2020/Roma-Stats,2020
ITA-Serie A,2019,SPAL,34,38.0,554,327,299,197,58,222,571,38.9,349,390,170,220,394,948,748,15,/en/squads/1d2fe027/2019-2020/SPAL-Stats,2020
ITA-Serie A,2019,Sampdoria,31,38.0,584,356,267,224,93,230,605,38.0,375,397,116,281,397,981,778,5,/en/squads/8ff9e3b3/2019-2020/Sampdoria-Stats,2020
ITA-Serie A,2019,Sassuolo,31,38.0,553,332,273,211,69,249,556,44.8,307,392,130,262,348,901,666,9,/en/squads/e2befd26/2019-2020/Sassuolo-Stats,2020
ITA-Serie A,2019,Torino,27,38.0,572,314,266,236,70,212,549,38.6,337,433,160,273,495,1067,875,14,/en/squads/105360fe/2019-2020/Torino-Stats,2020
ITA-Serie A,2019,Udinese,25,38.0,597,340,329,214,54,253,593,42.7,340,434,153,281,375,972,789,13,/en/squads/04eea015/2019-2020/Udinese-Stats,2020
ITA-Serie A,2020,Atalanta,30,38.0,606,343,252,256,98,265,591,44.8,326,421,92,329,516,1122,484,11,/en/squads/922493f3/2020-2021/Atalanta-Stats,2021
ITA-Serie A,2020,Benevento,29,38.0,511,288,278,179,54,243,646,37.6,403,382,123,259,383,894,746,13,/en/squads/4fcb34fd/2020-2021/Benevento-Stats,2021
ITA-Serie A,2020,Bologna,37,38.0,542,313,273,186,83,209,538,38.8,329,452,147,305,424,966,740,21,/en/squads/1d8099f8/2020-2021/Bologna-Stats,2021
ITA-Serie A,2020,Cagliari,32,38.0,589,336,296,229,64,269,647,41.6,378,421,130,291,388,977,777,6,/en/squads/c4260e09/2020-2021/Cagliari-Stats,2021
ITA-Serie A,2020,Crotone,31,38.0,540,311,288,196,56,225,556,40.5,331,406,137,269,380,920,748,12,/en/squads/3074d7b1/2020-2021/Crotone-Stats,2021
ITA-Serie A,2020,Fiorentina,30,38.0,496,263,228,198,70,229,544,42.1,315,362,127,235,388,884,619,8,/en/squads/421387cf/2020-2021/Fiorentina-Stats,2021
ITA-Serie A,2020,Genoa,34,38.0,555,309,293,197,65,255,640,39.8,385,437,123,314,520,1075,785,12,/en/squads/658bf2de/2020-2021/Genoa-Stats,2021
ITA-Serie A,2020,Hellas Verona,32,38.0,465,269,224,183,58,173,413,41.9,240,374,144,230,492,957,756,12,/en/squads/0e72edf2/2020-2021/Hellas-Verona-Stats,2021
ITA-Serie A,2020,Inter,25,38.0,506,286,214,206,86,213,527,40.4,314,383,102,281,371,877,582,8,/en/squads/d609edc0/2020-2021/Internazionale-Stats,2021
ITA-Serie A,2020,Juventus,30,38.0,566,323,244,242,80,243,612,39.7,369,390,114,276,458,1024,581,14,/en/squads/e0652b02/2020-2021/Juventus-Stats,2021
ITA-Serie A,2020,Lazio,30,38.0,595,346,284,244,67,254,678,37.5,424,404,92,312,445,1040,649,7,/en/squads/7213da33/2020-2021/Lazio-Stats,2021
ITA-Serie A,2020,Milan,29,38.0,627,357,299,257,71,276,605,45.6,329,435,133,302,382,1009,732,13,/en/squads/dc56fe14/2020-2021/Milan-Stats,2021
ITA-Serie A,2020,Napoli,25,38.0,574,345,280,213,81,257,635,40.5,378,381,98,283,369,943,532,17,/en/squads/d48ad4ff/2020-2021/Napoli-Stats,2021
ITA-Serie A,2020,Parma,42,38.0,585,317,317,215,53,269,695,38.7,426,412,116,296,463,1048,806,14,/en/squads/eab4234c/2020-2021/Parma-Stats,2021
ITA-Serie A,2020,Roma,31,38.0,478,273,192,218,68,206,582,35.4,376,360,83,277,489,967,521,26,/en/squads/cf74a709/2020-2021/Roma-Stats,2021
ITA-Serie A,2020,Sampdoria,27,38.0,576,326,275,235,66,251,634,39.6,383,470,154,316,453,1029,745,6,/en/squads/8ff9e3b3/2020-2021/Sampdoria-Stats,2021
ITA-Serie A,2020,Sassuolo,28,38.0,528,310,276,164,88,241,543,44.4,302,383,141,242,426,954,629,11,/en/squads/e2befd26/2020-2021/Sassuolo-Stats,2021
ITA-Serie A,2020,Spezia,35,38.0,568,320,264,223,81,265,617,42.9,352,364,101,263,394,962,551,12,/en/squads/68449f6d/2020-2021/Spezia-Stats,2021
ITA-Serie A,2020,Torino,29,38.0,530,306,241,205,84,247,569,43.4,322,412,127,285,444,974,727,13,/en/squads/105360fe/2020-2021/Torino-Stats,2021
ITA-Serie A,2020,Udinese,33,38.0,502,294,264,199,39,209,547,38.2,338,428,131,297,440,942,683,8,/en/squads/04eea015/2020-2021/Udinese-Stats,2021
ITA-Serie A,2021,Atalanta,32,38.0,630,341,252,271,107,299,635,47.1,336,436,96,340,441,1071,483,6,/en/squads/922493f3/2021-2022/Atalanta-Stats,2022
ITA-Serie A,2021,Bologna,36,38.0,530,298,261,202,67,216,528,40.9,312,384,127,257,370,900,678,5,/en/squads/1d8099f8/2021-2022/Bologna-Stats,2022
ITA-Serie A,2021,Cagliari,33,38.0,557,303,263,229,65,230,544,42.3,314,406,128,278,397,954,747,5,/en/squads/c4260e09/2021-2022/Cagliari-Stats,2022
ITA-Serie A,2021,Empoli,28,38.0,568,327,268,208,92,273,606,45.0,333,451,177,274,352,920,772,10,/en/squads/a3d88bd8/2021-2022/Empoli-Stats,2022
ITA-Serie A,2021,Fiorentina,28,38.0,508,301,232,203,73,268,540,49.6,272,357,91,266,244,752,407,15,/en/squads/421387cf/2021-2022/Fiorentina-Stats,2022
ITA-Serie A,2021,Genoa,40,38.0,739,416,324,302,113,349,727,48.0,378,487,134,353,449,1188,751,15,/en/squads/658bf2de/2021-2022/Genoa-Stats,2022
ITA-Serie A,2021,Hellas Verona,31,38.0,534,308,248,214,72,238,557,42.7,319,414,107,307,392,926,779,9,/en/squads/0e72edf2/2021-2022/Hellas-Verona-Stats,2022
ITA-Serie A,2021,Inter,27,38.0,588,332,265,240,83,247,545,45.3,298,360,110,250,332,920,485,11,/en/squads/d609edc0/2021-2022/Internazionale-Stats,2022
ITA-Serie A,2021,Juventus,32,38.0,555,316,260,217,78,236,529,44.6,293,392,134,258,332,887,677,9,/en/squads/e0652b02/2021-2022/Juventus-Stats,2022
ITA-Serie A,2021,Lazio,27,38.0,578,339,246,255,77,238,621,38.3,383,416,144,272,315,893,565,10,/en/squads/7213da33/2021-2022/Lazio-Stats,2022
ITA-Serie A,2021,Milan,28,38.0,697,421,304,288,105,281,583,48.2,302,371,110,261,355,1052,477,12,/en/squads/dc56fe14/2021-2022/Milan-Stats,2022
ITA-Serie A,2021,Napoli,27,38.0,550,327,246,227,77,268,617,43.4,349,371,108,263,296,846,510,8,/en/squads/d48ad4ff/2021-2022/Napoli-Stats,2022
ITA-Serie A,2021,Roma,29,38.0,613,362,282,253,78,283,622,45.5,339,383,82,301,385,998,552,9,/en/squads/cf74a709/2021-2022/Roma-Stats,2022
ITA-Serie A,2021,Salernitana,42,38.0,541,321,274,208,59,277,579,47.8,302,394,146,248,353,894,777,3,/en/squads/c5577084/2021-2022/Salernitana-Stats,2022
ITA-Serie A,2021,Sampdoria,34,38.0,562,327,277,217,68,288,629,45.8,341,383,134,249,442,1004,723,11,/en/squads/8ff9e3b3/2021-2022/Sampdoria-Stats,2022
ITA-Serie A,2021,Sassuolo,29,38.0,482,271,252,163,67,236,574,41.1,338,422,127,295,314,796,664,19,/en/squads/e2befd26/2021-2022/Sassuolo-Stats,2022
ITA-Serie A,2021,Spezia,30,38.0,580,343,301,205,74,266,585,45.5,319,465,176,289,372,952,736,8,/en/squads/68449f6d/2021-2022/Spezia-Stats,2022
ITA-Serie A,2021,Torino,31,38.0,531,314,223,234,74,228,440,51.8,212,375,108,267,423,954,651,4,/en/squads/105360fe/2021-2022/Torino-Stats,2022
ITA-Serie A,2021,Udinese,29,38.0,622,350,282,271,69,284,643,44.2,359,432,122,310,351,973,671,12,/en/squads/04eea015/2021-2022/Udinese-Stats,2022
ITA-Serie A,2021,Venezia,39,38.0,613,352,325,217,71,273,626,43.6,353,495,202,293,388,1001,865,13,/en/squads/af5d5982/2021-2022/Venezia-Stats,2022
ITA-Serie A,2022,Atalanta,27,38.0,636,364,291,272,73,312,634,49.2,322,455,93,362,421,1057,613,12,/en/squads/922493f3/Atalanta-Stats,2023
ITA-Serie A,2022,Bologna,27,38.0,648,373,310,255,83,297,618,48.1,321,414,131,283,302,950,652,7,/en/squads/1d8099f8/Bologna-Stats,2023
ITA-Serie A,2022,Cremonese,33,38.0,704,400,403,228,73,364,729,49.9,365,432,136,296,393,1097,771,13,/en/squads/9aad3a77/Cremonese-Stats,2023
ITA-Serie A,2022,Empoli,32,38.0,606,364,316,218,72,254,538,47.2,284,449,183,266,280,886,910,4,/en/squads/a3d88bd8/Empoli-Stats,2023
ITA-Serie A,2022,Fiorentina,30,38.0,581,337,232,260,89,282,531,53.1,249,356,84,272,260,841,473,11,/en/squads/421387cf/Fiorentina-Stats,2023
ITA-Serie A,2022,Hellas Verona,36,38.0,605,357,319,228,58,296,562,52.7,266,445,143,302,337,942,745,12,/en/squads/0e72edf2/Hellas-Verona-Stats,2023
ITA-Serie A,2022,Inter,25,38.0,572,325,247,241,84,258,523,49.3,265,385,110,275,315,887,541,7,/en/squads/d609edc0/Internazionale-Stats,2023
ITA-Serie A,2022,Juventus,29,38.0,594,352,296,219,79,288,558,51.6,270,421,131,290,307,901,704,10,/en/squads/e0652b02/Juventus-Stats,2023
ITA-Serie A,2022,Lazio,24,38.0,582,349,261,234,87,277,625,44.3,348,437,126,311,310,892,606,8,/en/squads/7213da33/Lazio-Stats,2023
ITA-Serie A,2022,Lecce,29,38.0,705,427,347,259,99,319,619,51.5,300,486,112,374,368,1073,826,4,/en/squads/ffcbe334/Lecce-Stats,2023
ITA-Serie A,2022,Milan,30,38.0,690,422,327,295,68,300,563,53.3,263,387,126,261,289,979,542,9,/en/squads/dc56fe14/Milan-Stats,2023
ITA-Serie A,2022,Monza,31,38.0,595,355,323,214,58,260,551,47.2,291,380,120,260,334,929,661,13,/en/squads/21680aa4/Monza-Stats,2023
ITA-Serie A,2022,Napoli,27,38.0,569,313,236,227,106,255,521,48.9,266,374,96,278,287,856,490,7,/en/squads/d48ad4ff/Napoli-Stats,2023
ITA-Serie A,2022,Roma,30,38.0,624,340,301,257,66,289,617,46.8,328,392,113,279,368,992,590,9,/en/squads/cf74a709/Roma-Stats,2023
ITA-Serie A,2022,Salernitana,30,38.0,587,337,309,220,58,259,569,45.5,310,409,157,252,329,916,740,13,/en/squads/c5577084/Salernitana-Stats,2023
ITA-Serie A,2022,Sampdoria,40,38.0,589,351,290,240,59,261,558,46.8,297,428,152,276,317,906,688,7,/en/squads/8ff9e3b3/Sampdoria-Stats,2023
ITA-Serie A,2022,Sassuolo,31,38.0,502,281,237,186,79,216,461,46.9,245,371,122,249,278,780,658,16,/en/squads/e2befd26/Sassuolo-Stats,2023
ITA-Serie A,2022,Spezia,34,38.0,622,359,290,236,96,254,569,44.6,315,457,161,296,301,923,830,7,/en/squads/68449f6d/Spezia-Stats,2023
ITA-Serie A,2022,Torino,28,38.0,473,265,231,187,55,199,367,54.2,168,337,110,227,292,765,627,9,/en/squads/105360fe/Torino-Stats,2023
ITA-Serie A,2022,Udinese,30,38.0,651,365,363,228,60,326,632,51.6,306,437,128,309,314,965,712,8,/en/squads/04eea015/Udinese-Stats,2023
